,loss,mae,mean_q,mean_eps,episode_reward,nb_episode_steps,nb_steps,episode,duration
0,0,0,0,0,30.0,479,479,0,1.0369185000000005
1, 0, 0, 0, 0, 215.0, 832, 1311, 1, 1.7631611000000014
2, 0, 0, 0, 0, 150.0, 783, 2094, 2, 1.6808353
3, 0, 0, 0, 0, 125.0, 463, 2557, 3, 0.9925435999999994
4, 0, 0, 0, 0, 35.0, 380, 2937, 4, 0.8412413000000001
5, 0, 0, 0, 0, 80.0, 381, 3318, 5, 0.8894591999999992
6, 0, 0, 0, 0, 50.0, 537, 3855, 6, 1.2899884000000021
7, 0, 0, 0, 0, 120.0, 568, 4423, 7, 1.2172677000000007
8, 0, 0, 0, 0, 135.0, 823, 5246, 8, 1.6699283999999999
9, 0, 0, 0, 0, 120.0, 775, 6021, 9, 1.5868402999999986
10, 0, 0, 0, 0, 105.0, 665, 6686, 10, 1.4840423999999999
11, 0, 0, 0, 0, 125.0, 827, 7513, 11, 1.7255636999999986
12, 0, 0, 0, 0, 55.0, 675, 8188, 12, 1.449903599999999
13, 0, 0, 0, 0, 210.0, 946, 9134, 13, 2.014791500000001
14, 0, 0, 0, 0, 20.0, 433, 9567, 14, 0.9167991999999998
15, 0, 0, 0, 0, 310.0, 1028, 10595, 15, 2.0893015000000013
16, 0, 0, 0, 0, 210.0, 659, 11254, 16, 1.4217961999999993
17, 0, 0, 0, 0, 185.0, 883, 12137, 17, 1.8740152000000023
18, 0, 0, 0, 0, 105.0, 720, 12857, 18, 1.5229951999999969
19, 0, 0, 0, 0, 165.0, 906, 13763, 19, 1.9816584999999947
20, 0, 0, 0, 0, 55.0, 378, 14141, 20, 0.7943326000000042
21, 0, 0, 0, 0, 105.0, 547, 14688, 21, 1.1418600000000012
22, 0, 0, 0, 0, 140.0, 622, 15310, 22, 1.2998620999999986
23, 0, 0, 0, 0, 145.0, 647, 15957, 23, 1.4024366999999955
24, 0, 0, 0, 0, 105.0, 675, 16632, 24, 1.4854133999999988
25, 0, 0, 0, 0, 180.0, 703, 17335, 25, 1.4553149000000047
26, 0, 0, 0, 0, 210.0, 781, 18116, 26, 1.6258041999999975
27, 0, 0, 0, 0, 100.0, 491, 18607, 27, 1.1271254999999982
28, 0, 0, 0, 0, 205.0, 912, 19519, 28, 1.910050500000004
29, 0, 0, 0, 0, 5.0, 570, 20089, 29, 1.2040429999999986
30, 0, 0, 0, 0, 210.0, 952, 21041, 30, 2.046947000000003
31, 0, 0, 0, 0, 185.0, 656, 21697, 31, 1.3901486000000034
32, 0, 0, 0, 0, 35.0, 596, 22293, 32, 1.2625375000000005
33, 0, 0, 0, 0, 150.0, 633, 22926, 33, 1.3456758999999963
34, 0, 0, 0, 0, 80.0, 590, 23516, 34, 1.3244471999999945
35, 0, 0, 0, 0, 120.0, 732, 24248, 35, 1.5383897999999974
36, 0, 0, 0, 0, 240.0, 806, 25054, 36, 1.674935700000006
37, 0, 0, 0, 0, 315.0, 998, 26052, 37, 2.1054795000000013
38, 0, 0, 0, 0, 125.0, 757, 26809, 38, 1.6051817000000028
39, 0, 0, 0, 0, 105.0, 639, 27448, 39, 1.329860299999993
40, 0, 0, 0, 0, 80.0, 429, 27877, 40, 0.9077569000000096
41, 0, 0, 0, 0, 105.0, 656, 28533, 41, 1.4729851999999966
42, 0, 0, 0, 0, 135.0, 542, 29075, 42, 1.122940700000001
43, 0, 0, 0, 0, 170.0, 967, 30042, 43, 1.9758519000000092
44, 0, 0, 0, 0, 210.0, 916, 30958, 44, 1.9793849999999935
45, 0, 0, 0, 0, 30.0, 462, 31420, 45, 0.9652287999999913
46, 0, 0, 0, 0, 155.0, 648, 32068, 46, 1.3795166999999964
47, 0, 0, 0, 0, 80.0, 648, 32716, 47, 1.3512146999999999
48, 0, 0, 0, 0, 135.0, 813, 33529, 48, 1.8049647999999934
49, 0, 0, 0, 0, 80.0, 419, 33948, 49, 0.8737868000000049
50, 0, 0, 0, 0, 105.0, 533, 34481, 50, 1.1097287999999992
51, 0, 0, 0, 0, 75.0, 539, 35020, 51, 1.1527657000000033
52, 0, 0, 0, 0, 325.0, 695, 35715, 52, 1.600011699999996
53, 0, 0, 0, 0, 155.0, 718, 36433, 53, 1.4893789999999996
54, 0, 0, 0, 0, 410.0, 884, 37317, 54, 1.8624276000000037
55, 0, 0, 0, 0, 270.0, 1293, 38610, 55, 2.727754400000009
56, 0, 0, 0, 0, 155.0, 713, 39323, 56, 1.5157363000000004
57, 0, 0, 0, 0, 90.0, 448, 39771, 57, 0.9198434999999989
58, 0, 0, 0, 0, 110.0, 499, 40270, 58, 1.067313999999996
59, 0, 0, 0, 0, 295.0, 1333, 41603, 59, 2.771483500000002
60, 0, 0, 0, 0, 135.0, 786, 42389, 60, 1.6103067999999894
61, 0, 0, 0, 0, 255.0, 880, 43269, 61, 1.9289184999999947
62, 0, 0, 0, 0, 135.0, 562, 43831, 62, 1.205440699999997
63, 0, 0, 0, 0, 110.0, 641, 44472, 63, 1.3667226999999968
64, 0, 0, 0, 0, 125.0, 817, 45289, 64, 1.7502987000000019
65, 0, 0, 0, 0, 105.0, 572, 45861, 65, 1.2641801999999984
66, 0, 0, 0, 0, 135.0, 642, 46503, 66, 1.3036632999999966
67, 0, 0, 0, 0, 110.0, 624, 47127, 67, 1.2678731999999968
68, 0, 0, 0, 0, 155.0, 783, 47910, 68, 1.6410233999999946
69, 0, 0, 0, 0, 225.0, 710, 48620, 69, 1.5489181999999886
70, 0, 0, 0, 0, 210.0, 825, 49445, 70, 1.7051025999999894
71, 0, 0, 0, 0, 30.0, 499, 49944, 71, 1.0618188000000117
72, 0, 0, 0, 0, 210.0, 918, 50862, 72, 1.9914467999999914
73, 0, 0, 0, 0, 380.0, 1183, 52045, 73, 2.405224599999997
74, 0, 0, 0, 0, 230.0, 969, 53014, 74, 2.1059403000000003
75, 0, 0, 0, 0, 110.0, 605, 53619, 75, 1.2760351999999955
76, 0, 0, 0, 0, 210.0, 806, 54425, 76, 1.614766099999997
77, 0, 0, 0, 0, 105.0, 641, 55066, 77, 1.344302099999993
78, 0, 0, 0, 0, 90.0, 567, 55633, 78, 1.2780898999999977
79, 0, 0, 0, 0, 75.0, 401, 56034, 79, 0.8604097999999993
80, 0, 0, 0, 0, 195.0, 817, 56851, 80, 1.694675000000018
81, 0, 0, 0, 0, 180.0, 666, 57517, 81, 1.4050920999999903
82, 0, 0, 0, 0, 165.0, 761, 58278, 82, 1.651152599999989
83, 0, 0, 0, 0, 155.0, 622, 58900, 83, 1.3016762000000028
84, 0, 0, 0, 0, 40.0, 428, 59328, 84, 0.8807395000000042
85, 0, 0, 0, 0, 110.0, 413, 59741, 85, 0.8617332000000033
86, 0, 0, 0, 0, 155.0, 394, 60135, 86, 0.868587500000018
87, 0, 0, 0, 0, 110.0, 647, 60782, 87, 1.4372807999999964
88, 0, 0, 0, 0, 155.0, 698, 61480, 88, 1.4571765000000028
89, 0, 0, 0, 0, 80.0, 411, 61891, 89, 0.8714669000000015
90, 0, 0, 0, 0, 65.0, 476, 62367, 90, 1.0049597999999946
91, 0, 0, 0, 0, 100.0, 397, 62764, 91, 0.9389122999999984
92, 0, 0, 0, 0, 80.0, 480, 63244, 92, 0.9878957999999898
93, 0, 0, 0, 0, 155.0, 655, 63899, 93, 1.4054695000000095
94, 0, 0, 0, 0, 210.0, 606, 64505, 94, 1.255073799999991
95, 0, 0, 0, 0, 215.0, 821, 65326, 95, 1.8018289000000038
96, 0, 0, 0, 0, 180.0, 726, 66052, 96, 1.5440175999999894
97, 0, 0, 0, 0, 20.0, 584, 66636, 97, 1.2188401000000226
98, 0, 0, 0, 0, 80.0, 605, 67241, 98, 1.283499500000005
99, 0, 0, 0, 0, 45.0, 388, 67629, 99, 0.9036632000000111
100, 0, 0, 0, 0, 120.0, 621, 68250, 100, 1.306551600000006
101, 0, 0, 0, 0, 50.0, 503, 68753, 101, 1.036387899999994
102, 0, 0, 0, 0, 130.0, 553, 69306, 102, 1.1494381999999916
103, 0, 0, 0, 0, 140.0, 749, 70055, 103, 1.651973699999985
104, 0, 0, 0, 0, 105.0, 525, 70580, 104, 1.1214616999999976
105, 0, 0, 0, 0, 35.0, 653, 71233, 105, 1.3855092000000013
106, 0, 0, 0, 0, 155.0, 614, 71847, 106, 1.3331651000000022
107, 0, 0, 0, 0, 230.0, 1294, 73141, 107, 2.732734999999991
108, 0, 0, 0, 0, 150.0, 629, 73770, 108, 1.322956099999999
109, 0, 0, 0, 0, 165.0, 683, 74453, 109, 1.412407700000017
110, 0, 0, 0, 0, 75.0, 602, 75055, 110, 1.3736918000000173
111, 0, 0, 0, 0, 105.0, 647, 75702, 111, 1.362591000000009
112, 0, 0, 0, 0, 100.0, 635, 76337, 112, 1.3514519999999948
113, 0, 0, 0, 0, 185.0, 812, 77149, 113, 1.732451200000014
114, 0, 0, 0, 0, 90.0, 584, 77733, 114, 1.2870384999999942
115, 0, 0, 0, 0, 135.0, 401, 78134, 115, 0.8436334000000159
116, 0, 0, 0, 0, 230.0, 795, 78929, 116, 1.7047773000000177
117, 0, 0, 0, 0, 595.0, 1180, 80109, 117, 2.8003745000000038
118, 0, 0, 0, 0, 105.0, 523, 80632, 118, 1.2216717999999958
119, 0, 0, 0, 0, 210.0, 804, 81436, 119, 1.8357944999999916
120, 0, 0, 0, 0, 370.0, 1140, 82576, 120, 2.4260824000000127
121, 0, 0, 0, 0, 80.0, 457, 83033, 121, 1.0356111000000112
122, 0, 0, 0, 0, 315.0, 1111, 84144, 122, 2.5291706999999803
123, 0, 0, 0, 0, 210.0, 750, 84894, 123, 1.5952722000000108
124, 0, 0, 0, 0, 125.0, 772, 85666, 124, 1.644963099999984
125, 0, 0, 0, 0, 135.0, 525, 86191, 125, 1.1774360000000001
126, 0, 0, 0, 0, 210.0, 547, 86738, 126, 1.2123120999999912
127, 0, 0, 0, 0, 65.0, 414, 87152, 127, 0.9061427000000037
128, 0, 0, 0, 0, 100.0, 643, 87795, 128, 1.4295267999999908
129, 0, 0, 0, 0, 210.0, 990, 88785, 129, 2.1311838000000023
130, 0, 0, 0, 0, 225.0, 831, 89616, 130, 1.7795595000000048
131, 0, 0, 0, 0, 15.0, 436, 90052, 131, 0.9745862000000045
132, 0, 0, 0, 0, 105.0, 527, 90579, 132, 1.1484413999999958
133, 0, 0, 0, 0, 105.0, 660, 91239, 133, 1.4473030999999992
134, 0, 0, 0, 0, 135.0, 639, 91878, 134, 1.4106900999999823
135, 0, 0, 0, 0, 180.0, 597, 92475, 135, 1.2913180999999838
136, 0, 0, 0, 0, 70.0, 442, 92917, 136, 0.9785713999999928
137, 0, 0, 0, 0, 260.0, 1294, 94211, 137, 2.801400699999988
138, 0, 0, 0, 0, 50.0, 419, 94630, 138, 0.9208629999999971
139, 0, 0, 0, 0, 110.0, 615, 95245, 139, 1.354844799999995
140, 0, 0, 0, 0, 225.0, 888, 96133, 140, 1.8837023000000102
141, 0, 0, 0, 0, 65.0, 487, 96620, 141, 1.0643531000000053
142, 0, 0, 0, 0, 160.0, 537, 97157, 142, 1.2253412000000026
143, 0, 0, 0, 0, 135.0, 789, 97946, 143, 1.689187799999985
144, 0, 0, 0, 0, 120.0, 794, 98740, 144, 1.7076430999999843
145, 0, 0, 0, 0, 120.0, 787, 99527, 145, 1.771842200000009
146, 0, 0, 0, 0, 35.0, 382, 99909, 146, 0.8577009999999916
147, 8.669579539618153, 18.079183595011553, 22.900680740236297, 0.9097137999999995, 110.0, 727, 100636, 147, 6.943978200000004
148, 3.8825501239358498, 18.052702092889493, 22.40659500084487, 0.9089712999999996, 395.0, 1015, 101651, 148, 9.913550999999984
149, 3.672975701676018, 17.998523035268676, 22.20838574979497, 0.9082013499999999, 110.0, 696, 102347, 149, 6.881065700000022
150, 5.335832066351877, 18.01123508565566, 22.183420991897584, 0.9075821500000003, 155.0, 680, 103027, 150, 6.762047199999984
151, 4.195978834621632, 18.027915753555693, 22.176032101006275, 0.9068427999999993, 210.0, 963, 103990, 151, 9.462031499999995
152, 3.585488012389225, 18.01901963353157, 22.08054708032047, 0.90616465, 135.0, 544, 104534, 152, 5.349612100000002
153, 5.0161006905606405, 18.022357835861797, 22.076382531060112, 0.9055472500000001, 150.0, 828, 105362, 153, 8.233454999999992
154, 5.237516821660693, 18.037479561094255, 22.018883920094325, 0.9048911500000002, 105.0, 630, 105992, 154, 6.281417099999999
155, 4.335365733351357, 18.027738228584955, 22.00586345423938, 0.9042831999999998, 210.0, 721, 106713, 155, 7.144226500000002
156, 4.314180011720399, 18.039788182304797, 21.941176243317432, 0.9036428499999999, 150.0, 702, 107415, 156, 6.944657600000028
157, 5.305900534064294, 18.027768334708423, 22.084960702790905, 0.9030088000000003, 225.0, 707, 108122, 157, 7.140614099999993
158, 3.4269946579492525, 18.045020268170617, 21.900802698334715, 0.9022816000000004, 405.0, 909, 109031, 158, 9.103499899999974
159, 3.1024607404378743, 17.98031766011165, 21.825751043466422, 0.9015800499999999, 110.0, 650, 109681, 159, 6.586781700000017
160, 5.0763575229302855, 17.953169679272083, 21.85597856506821, 0.9009972999999997, 75.0, 645, 110326, 160, 6.420294200000001
161, 2.9234497366051606, 17.907804001856896, 21.725210624889737, 0.9004604500000002, 75.0, 548, 110874, 161, 5.530178399999954
162, 2.605191386210454, 17.866738960959694, 21.67358383079628, 0.9000405999999999, 55.0, 385, 111259, 162, 3.915091699999948
163, 2.5047593061680806, 17.912150944668824, 21.738891987712837, 0.8995739500000001, 140.0, 652, 111911, 163, 6.618929400000013
164, 3.9313812555690992, 17.896198298167256, 21.7851530510245, 0.8990951500000004, 65.0, 412, 112323, 164, 4.099228299999993
165, 2.552898219022343, 17.890665192144652, 21.683401465812, 0.8983679499999995, 300.0, 1204, 113527, 165, 12.151980900000012
166, 3.0559126069112517, 17.869654874652444, 21.679672080543785, 0.8974522000000006, 155.0, 831, 114358, 166, 8.440118900000016
167, 2.4609864996491577, 17.863795320250148, 21.671404724669973, 0.8967655000000001, 110.0, 695, 115053, 167, 6.975829099999999
168, 7.474923027510731, 17.92258871966646, 21.877175072157264, 0.8960401000000001, 210.0, 917, 115970, 168, 9.343009600000016
169, 3.135475396568125, 17.88530570764861, 21.641501327222613, 0.8951571999999991, 170.0, 1045, 117015, 169, 10.69919219999997
170, 2.5108638049454877, 17.905395702336797, 21.647921601352312, 0.8943472000000001, 110.0, 755, 117770, 170, 7.574488200000019
171, 5.671801655054092, 17.895838465881347, 21.746046649169923, 0.8937262000000006, 120.0, 625, 118395, 171, 6.447228800000005
172, 3.428397260428612, 17.882581948854966, 21.664347243801778, 0.8931619000000001, 110.0, 629, 119024, 172, 6.508210399999996
173, 3.6460988457109913, 17.895334241841944, 21.667159253461502, 0.892434699999999, 160.0, 987, 120011, 173, 10.13950699999998
174, 3.2866870244380464, 18.628269752157767, 22.54479941576537, 0.8916220000000005, 140.0, 819, 120830, 174, 8.321852799999988
175, 2.5336163524639748, 18.59912397085306, 22.497999201179635, 0.8909065000000004, 170.0, 771, 121601, 175, 8.026280600000007
176, 3.7269210055332493, 18.62588374879625, 22.588455839510317, 0.89031655, 120.0, 540, 122141, 176, 5.5717743000000155
177, 2.944639723063544, 18.596512903855555, 22.54101776518157, 0.8897085999999995, 260.0, 811, 122952, 177, 8.390051500000027
178, 3.646227258405519, 18.612033977105707, 22.54797155031707, 0.8888536000000009, 130.0, 1089, 124041, 178, 11.292547200000001
179, 3.293115510334199, 18.624679056986608, 22.565065356427723, 0.8880512500000003, 135.0, 694, 124735, 179, 7.173722099999964
180, 4.269012520926293, 18.654902335261394, 22.6026122275654, 0.8874072999999998, 210.0, 737, 125472, 180, 7.689308100000005
181, 3.5114899528899577, 18.591753813233037, 22.512738368487117, 0.8866301499999995, 260.0, 990, 126462, 181, 10.246866299999965
182, 2.2221894221383423, 18.58655536155135, 22.45175595417054, 0.8859114999999997, 75.0, 607, 127069, 182, 6.314705500000002
183, 4.35862753917522, 18.60781239054877, 22.553021029916327, 0.8853184000000002, 130.0, 711, 127780, 183, 7.514527499999986
184, 2.79895352255553, 18.613462501102024, 22.50731389257643, 0.8848364500000001, 65.0, 360, 128140, 184, 3.7804335999999807
185, 3.1922583090922525, 18.58283285940847, 22.474845145338325, 0.8843396499999996, 210.0, 744, 128884, 185, 7.847596899999985
186, 2.336514202992292, 18.56765161743914, 22.476783260373576, 0.8836385499999997, 180.0, 814, 129698, 186, 8.49406119999992
187, 3.556797310945666, 18.843505938082647, 22.820600158082733, 0.8829450999999999, 135.0, 727, 130425, 187, 7.6059602999999925
188, 2.2098561557885037, 18.979308961385705, 22.91023021433727, 0.88231915, 120.0, 664, 131089, 188, 7.0840601999999535
189, 2.2751205082771913, 18.907818337860892, 22.80806471757578, 0.8817579999999999, 105.0, 583, 131672, 189, 6.208945500000027
190, 3.705994574852239, 18.983682545181974, 22.987753411004228, 0.8810825499999995, 215.0, 918, 132590, 190, 9.727195700000038
191, 2.2793597851201866, 18.953718492245397, 22.846271840691763, 0.8803980999999997, 65.0, 603, 133193, 191, 6.5400615999999445
192, 3.2602753118060197, 18.957041607996462, 22.949130909913663, 0.8797735000000004, 210.0, 785, 133978, 192, 8.435651399999983
193, 2.4962514191673897, 18.918690715868447, 22.844332419719894, 0.8792456500000001, 45.0, 388, 134366, 193, 4.153342500000008
194, 3.3394493460216297, 18.9784878659143, 22.964836786351604, 0.8787654999999994, 135.0, 679, 135045, 194, 7.3050657
195, 3.914223332496563, 19.000865418840164, 22.98842373838519, 0.8782327000000003, 105.0, 505, 135550, 195, 5.430411400000025
196, 2.130359292953751, 18.91458616920562, 22.787940490023185, 0.8777403999999999, 85.0, 589, 136139, 196, 6.406009400000016
197, 2.116594685266024, 18.901259800267656, 22.83409600245358, 0.8773038999999997, 65.0, 381, 136520, 197, 4.180154899999934
198, 2.367281852677886, 18.95939252799458, 22.88854541631468, 0.8769574000000001, 80.0, 389, 136909, 198, 4.123544600000059
199, 2.5207984491898654, 19.00342245779583, 22.990783906272213, 0.8765227000000003, 120.0, 577, 137486, 199, 6.252114900000038
200, 3.9683130924407664, 18.97648808272211, 22.982686019774736, 0.8760951999999997, 80.0, 373, 137859, 200, 4.0778818
201, 3.1161574641047003, 18.97606564003583, 22.929948961353738, 0.8755331499999993, 170.0, 876, 138735, 201, 9.505719699999986
202, 2.4425964966391565, 18.97775783634027, 22.880829047839377, 0.8748684999999999, 170.0, 601, 139336, 202, 6.40782020000006
203, 3.7261973695990047, 18.960710622343854, 22.951154404857505, 0.8742169000000002, 200.0, 847, 140183, 203, 9.14711669999997
204, 4.4998990582733995, 18.982662994849502, 22.995686635954932, 0.8735698000000002, 135.0, 591, 140774, 204, 6.458727099999919
205, 3.011615297526319, 18.938883779323206, 22.900028064187648, 0.8728970499999993, 215.0, 904, 141678, 205, 9.754678600000034
206, 2.370512178259306, 18.934598059732405, 22.87958128256876, 0.8722157500000003, 105.0, 610, 142288, 206, 6.81893940000009
207, 4.052800500803769, 18.940850769377867, 22.924664210880735, 0.8716131999999998, 145.0, 729, 143017, 207, 7.907179600000063
208, 2.070902401366983, 18.88063902729262, 22.795621099485274, 0.8709607000000001, 180.0, 721, 143738, 208, 7.834582800000021
209, 2.9981101420006504, 18.910664565251924, 22.871808723876605, 0.8703225999999996, 105.0, 697, 144435, 209, 7.733485099999939
210, 3.466159338871694, 18.94254660202285, 22.915003922026035, 0.86953105, 225.0, 1062, 145497, 210, 11.682451000000015
211, 5.2124939836453, 18.948382747038064, 22.96511994459254, 0.8687754999999998, 90.0, 617, 146114, 211, 6.760745400000019
212, 2.3174784441232514, 18.913322359034957, 22.859296893677772, 0.8681725000000001, 140.0, 723, 146837, 212, 7.922535299999936
213, 7.23967170068248, 18.99771507508164, 23.06431534385098, 0.8675528499999996, 120.0, 654, 147491, 213, 7.29448160000004
214, 2.058358090220565, 18.874575886003047, 22.771338433334506, 0.8669530000000003, 170.0, 679, 148170, 214, 7.532240100000081
215, 2.3972819481573464, 18.929336143667353, 22.82547598336081, 0.8663905, 155.0, 571, 148741, 215, 6.2845479999999725
216, 1.9510669506630118, 18.91374968509285, 22.81571390190903, 0.8656925500000004, 135.0, 980, 149721, 216, 10.840072599999985
217, 3.1825634320361025, 19.00970124783723, 22.97130185002866, 0.8649410499999999, 110.0, 690, 150411, 217, 7.733797699999968
218, 2.2643645490423574, 19.136947835157365, 23.106965463576987, 0.8643646, 85.0, 591, 151002, 218, 6.521196400000008
219, 2.0614652447462176, 19.057304758291977, 23.015131537730877, 0.8638178500000003, 55.0, 624, 151626, 219, 6.985410799999954
220, 4.219409337337851, 19.126960421539202, 23.135183973783192, 0.8631451, 240.0, 871, 152497, 220, 9.737197999999921
221, 2.8189736302099635, 19.08503038991037, 23.055279847724954, 0.8623054, 345.0, 995, 153492, 221, 11.051928900000007
222, 1.8544468412925286, 19.051572567913162, 22.9937655916252, 0.8616317499999997, 90.0, 502, 153994, 222, 5.649804200000062
223, 2.5949729157513692, 19.067809849454644, 22.99343282716316, 0.8609954500000002, 225.0, 912, 154906, 223, 10.187609700000053
224, 2.3255502451763017, 19.045348274778426, 22.985439311838057, 0.8599015000000004, 450.0, 1519, 156425, 224, 16.858033100000057
225, 2.160734503725875, 19.02675246575118, 22.987729026275932, 0.8589398499999995, 110.0, 618, 157043, 225, 6.979507300000023
226, 2.5036334785484717, 19.024411683273883, 22.95759491828363, 0.8580560500000001, 290.0, 1346, 158389, 226, 15.002183399999922
227, 2.0195345514910317, 19.04497739533892, 22.991522977198837, 0.8572474000000002, 135.0, 451, 158840, 227, 5.126515799999993
228, 3.3084813534676494, 19.020658781721785, 22.983088785463625, 0.8565449499999999, 410.0, 1110, 159950, 228, 12.559472299999925
229, 3.9481550215450696, 19.058158769050102, 23.018733053222462, 0.8557606000000003, 90.0, 633, 160583, 229, 7.208686299999954
230, 3.565480103431811, 19.08194248782003, 23.04077408231538, 0.8552930500000001, 60.0, 406, 160989, 230, 4.636924900000054
231, 1.9137276494283106, 19.100038111058204, 23.032598655642445, 0.8549334999999997, 60.0, 393, 161382, 231, 4.492672999999968
232, 3.058120824555393, 19.110676165096095, 23.127352051656754, 0.8544821500000004, 120.0, 610, 161992, 232, 6.946920100000057
233, 3.0534175941661283, 19.128650990261395, 23.047226031115102, 0.8539250500000002, 110.0, 628, 162620, 233, 7.204198700000006
234, 3.4634747222181437, 19.17648451950507, 23.192761330025448, 0.8534682999999996, 100.0, 387, 163007, 234, 4.388772499999959
235, 3.9581881324348327, 19.120081397135802, 23.10440154933027, 0.8528661999999997, 465.0, 951, 163958, 235, 11.012656499999935
236, 4.570465795630711, 19.13798140646589, 23.120411402273387, 0.8521290999999999, 155.0, 687, 164645, 236, 7.889796199999978
237, 1.9942177069460096, 19.14679410925996, 23.067644987007714, 0.8515153000000003, 180.0, 677, 165322, 237, 7.683689699999945
238, 1.7921230290627594, 19.11847355296311, 23.039208276372126, 0.85093255, 125.0, 618, 165940, 238, 7.129050799999959
239, 3.902134909919138, 19.178879384500572, 23.18964293025246, 0.8503155999999995, 240.0, 753, 166693, 239, 8.71636490000003
240, 2.7800494282030694, 19.154479127993685, 23.103061482203092, 0.8494763500000008, 415.0, 1112, 167805, 240, 12.777795699999956
241, 2.04294993478682, 19.132846905634953, 23.121190631782614, 0.8488121499999999, 75.0, 364, 168169, 241, 4.263078299999961
242, 2.0548527632857048, 19.131183297959463, 23.05889130804058, 0.8484274000000003, 70.0, 491, 168660, 242, 5.690544100000011
243, 4.392944018892794, 19.16603942717482, 23.13118055202817, 0.8478711999999994, 225.0, 745, 169405, 243, 8.649446699999999
244, 2.131773657710464, 19.142873712233555, 23.072176172703873, 0.8473537000000001, 15.0, 405, 169810, 244, 4.687002399999983
245, 4.545817762442135, 19.413064371572958, 23.451258837210165, 0.8468384500000006, 335.0, 740, 170550, 245, 8.746987200000035
246, 1.9756445846675585, 19.439308018911454, 23.444370953809646, 0.8462030500000001, 135.0, 672, 171222, 246, 7.847060800000008
247, 3.3139447877571606, 19.482594020309904, 23.495510294323875, 0.8452958500000001, 195.0, 1344, 172566, 247, 15.573134800000048
248, 2.7970517985351075, 19.481732200001424, 23.519107581283638, 0.8443981000000002, 85.0, 651, 173217, 248, 7.679339099999993
249, 2.9692778043688257, 19.48777536573357, 23.554038079757266, 0.8437829500000003, 110.0, 716, 173933, 249, 8.452271900000028
250, 3.347744367260864, 19.431691137488915, 23.474950412621244, 0.8432744500000003, 20.0, 414, 174347, 250, 4.7839230000000725
251, 1.8736027369203494, 19.445383148784785, 23.416277126933252, 0.8427979000000001, 110.0, 645, 174992, 251, 7.594778200000064
252, 2.8110757438338894, 19.420567685530045, 23.44747542227647, 0.8421975999999995, 135.0, 689, 175681, 252, 8.106934599999931
253, 5.545125490371828, 19.50183722178141, 23.582704671223958, 0.8416445500000003, 20.0, 540, 176221, 253, 6.4140107999999145
254, 6.5247323627288045, 19.52223796816057, 23.69445286280352, 0.8410996000000002, 120.0, 671, 176892, 254, 7.811763000000155
255, 8.608114790151028, 19.520506233465476, 23.787664726132252, 0.8406329499999999, 90.0, 366, 177258, 255, 4.370600700000068
256, 1.81692719810653, 19.453667074327726, 23.427348959034887, 0.8402333500000002, 135.0, 522, 177780, 256, 6.238571099999945
257, 1.9457731987207216, 19.46875968417108, 23.464495798623886, 0.8397189999999999, 110.0, 621, 178401, 257, 7.381163699999888
258, 1.823388128464568, 19.454508617766226, 23.44267729328017, 0.8391668499999997, 120.0, 606, 179007, 258, 7.132556300000033
259, 2.864065784774721, 19.45365570012261, 23.44007796680226, 0.8385881500000001, 155.0, 680, 179687, 259, 8.122365599999966
260, 1.9124304329581332, 19.728975989601828, 23.812938774956596, 0.8380593999999996, 65.0, 495, 180182, 260, 5.908066299999973
261, 5.599153979224327, 20.324092079022424, 24.593557187578497, 0.8376652000000001, 30.0, 381, 180563, 261, 4.607066199999963
262, 4.834414273205198, 20.314413859849765, 24.553930562692923, 0.8371076500000001, 110.0, 858, 181421, 262, 10.198365899999999
263, 2.5679760475868103, 20.290380344474265, 24.461803569710305, 0.8360010999999993, 825.0, 1601, 183022, 263, 19.040202200000067
264, 2.073881849319117, 20.273117871044978, 24.43532284572607, 0.8346893500000002, 615.0, 1314, 184336, 264, 15.683332999999948
265, 3.123303491600841, 20.225447167857883, 24.43691798879357, 0.8338626999999997, 110.0, 523, 184859, 265, 6.29011249999985
266, 4.569447207369955, 20.26356002324307, 24.511061137617983, 0.8334284500000002, 45.0, 442, 185301, 266, 5.285978899999918
267, 1.8349988751275383, 20.235619976900626, 24.347150664398637, 0.8329811500000001, 210.0, 552, 185853, 267, 6.704769599999963
268, 3.1939419624970014, 20.245109476672177, 24.436209801704653, 0.8322584500000004, 210.0, 1054, 186907, 268, 12.86530730000004
269, 7.888355145646597, 20.33878362399288, 24.67687543782, 0.8314192000000001, 235.0, 811, 187718, 269, 9.801802999999836
270, 2.6585829952275573, 20.272164950565415, 24.42782163619995, 0.8307014499999993, 210.0, 784, 188502, 270, 9.482101499999999
271, 1.8344797677806417, 20.261431274662577, 24.396395757842917, 0.8300723500000002, 80.0, 614, 189116, 271, 7.50064650000013
272, 4.027719895458222, 20.306983560180665, 24.51498812561035, 0.8295147999999996, 155.0, 625, 189741, 272, 7.5804769000001215
273, 5.419105028583934, 20.24208129303796, 24.457163436072214, 0.8289311500000003, 80.0, 672, 190413, 273, 8.30854549999981
274, 1.5471348514446965, 20.163109502674622, 24.272582401464014, 0.8283371499999997, 125.0, 648, 191061, 274, 7.980322500000057
275, 4.5220073018505715, 20.240754189064656, 24.46987210421708, 0.8276481999999996, 200.0, 883, 191944, 275, 10.819406200000003
276, 2.5815149286342445, 20.214673529525648, 24.397239495709215, 0.8268791500000005, 215.0, 826, 192770, 276, 10.141285200000084
277, 2.856619362226886, 20.21926909447561, 24.391203007727622, 0.8259994000000003, 320.0, 1129, 193899, 277, 13.825989400000026
278, 4.616912780300841, 20.22891210037985, 24.469372225396427, 0.8251997499999995, 45.0, 648, 194547, 278, 8.030875899999955
279, 5.199463822474507, 20.287655842931645, 24.5060560138602, 0.8246345500000001, 125.0, 608, 195155, 279, 7.543713399999888
280, 3.3609556544974972, 20.24181674897019, 24.427237196652307, 0.8239906000000001, 210.0, 823, 195978, 280, 10.210427299999992
281, 2.8861794420553526, 20.153927515481264, 24.263708242023263, 0.8233844500000002, 80.0, 524, 196502, 281, 6.514434000000165
282, 4.558561177373682, 20.230611221345466, 24.481672243002325, 0.8229339999999999, 50.0, 477, 196979, 282, 6.011311999999862
283, 3.624933678558325, 20.22571435278719, 24.42908072582856, 0.8224299999999993, 120.0, 643, 197622, 283, 7.993320100000119
284, 5.002260157432232, 20.238234774168937, 24.496405230200157, 0.8218621000000002, 145.0, 619, 198241, 284, 7.684911399999919
285, 1.7073902274702781, 20.18531828074111, 24.294323424703066, 0.8212343500000001, 180.0, 776, 199017, 285, 9.600911600000018
286, 6.76634896091551, 20.24452207963678, 24.493587436555305, 0.8206007500000002, 185.0, 632, 199649, 286, 7.775785300000052
287, 3.243455570543886, 20.24507731378216, 24.444107720813356, 0.8201215, 80.0, 433, 200082, 287, 5.482151599999952
288, 2.205579469807869, 20.17114581800487, 24.27371227018054, 0.8196966999999995, 90.0, 511, 200593, 288, 6.349444100000028
289, 2.595180567556848, 20.185963983193194, 24.30727212315777, 0.8190783999999998, 225.0, 863, 201456, 289, 10.944007000000056
290, 2.611954330758927, 20.138869096091206, 24.3120816610794, 0.8182756000000002, 210.0, 921, 202377, 290, 11.705244400000083
291, 4.029129446777579, 20.188055086975695, 24.40381696966063, 0.8176312000000001, 30.0, 511, 202888, 291, 6.414082000000008
292, 3.5076326995798253, 20.161888162503068, 24.33087005415512, 0.8167995999999995, 770.0, 1337, 204225, 292, 16.7730368
293, 5.090449252553774, 20.15914049196806, 24.32453554677722, 0.8159311000000001, 75.0, 593, 204818, 293, 7.42817070000001
294, 3.5815447965962486, 20.17804779906373, 24.33730570919864, 0.8153424999999997, 110.0, 715, 205533, 294, 9.131985200000145
295, 3.9173856122539883, 20.208867198106425, 24.39485651471227, 0.8147359000000003, 135.0, 633, 206166, 295, 8.12124319999998
296, 3.546564732326866, 20.160774953234913, 24.336024146594973, 0.8141301999999996, 170.0, 713, 206879, 296, 9.081626599999936
297, 4.5483205006820855, 20.190958477606486, 24.38705707286673, 0.8136073000000001, 60.0, 449, 207328, 297, 5.737885499999948
298, 2.701163340525802, 20.15386031509994, 24.308575562953063, 0.8129201500000007, 315.0, 1078, 208406, 298, 13.75058369999988
299, 3.1079618420683595, 20.23477094975765, 24.428348118418523, 0.8121529000000003, 120.0, 627, 209033, 299, 7.984244499999932
300, 3.3822535718551157, 20.164967229685832, 24.31047200419239, 0.8115215499999999, 160.0, 776, 209809, 300, 10.005433599999833
301, 1.832716582109209, 20.282483792015416, 24.40786359892522, 0.8108388999999998, 180.0, 741, 210550, 301, 9.526756400000068
302, 2.83976784569697, 20.34328876633242, 24.500318615859225, 0.810244, 110.0, 581, 211131, 302, 7.614227600000049
303, 4.58443198934219, 20.384238829661037, 24.671770799694805, 0.8096715999999998, 105.0, 691, 211822, 303, 9.001326100000142
304, 4.720103710221755, 20.38161271103972, 24.604167132392117, 0.80906455, 180.0, 658, 212480, 304, 8.587849400000096
305, 1.683619455132075, 20.363483387309913, 24.527805872532653, 0.8084592999999995, 135.0, 687, 213167, 305, 8.937225300000136
306, 1.7530823455803184, 20.313595716065677, 24.441380075699897, 0.8078806000000003, 125.0, 599, 213766, 306, 7.852065100000118
307, 5.318463391816987, 20.316816119229152, 24.58044606768038, 0.8072933500000001, 150.0, 706, 214472, 307, 9.058588099999952
308, 4.249349452424467, 20.343048619945147, 24.54203859221401, 0.8067448000000004, 50.0, 513, 214985, 308, 6.783809399999882
309, 2.7465545201567165, 20.354358047119245, 24.549638184299813, 0.8059887999999998, 125.0, 1167, 216152, 309, 15.159233900000118
310, 3.360555934593803, 20.35419745118869, 24.53233083301474, 0.8049245499999997, 460.0, 1198, 217350, 310, 15.540884600000027
311, 5.9581665382730336, 20.380053498117547, 24.595001630281146, 0.8041716999999997, 45.0, 475, 217825, 311, 6.24783669999988
312, 3.5998833104119004, 20.360053929168615, 24.571875455372695, 0.8038000000000001, 75.0, 351, 218176, 312, 4.6418634999999995
313, 5.615037815036629, 20.376617107516022, 24.625273975671508, 0.8033666500000002, 50.0, 612, 218788, 313, 7.9894914999999855
314, 3.681111264633116, 20.38616695256196, 24.580823052576346, 0.8028009999999994, 100.0, 645, 219433, 314, 8.488350000000082
315, 6.053395299361898, 20.412505257181277, 24.641427143311603, 0.80230285, 120.0, 462, 219895, 315, 6.1244980999999825
316, 4.227214092738235, 20.441943264990737, 24.699878610040724, 0.8018767000000001, 35.0, 485, 220380, 316, 6.320946400000139
317, 3.3727680691995596, 20.388885748163066, 24.55201592219929, 0.801154, 285.0, 1121, 221501, 317, 14.779278900000008
318, 1.6000023727685633, 20.35445296059192, 24.488009863840023, 0.8004898, 50.0, 355, 221856, 318, 4.705044900000075
319, 3.6548019732206556, 20.407130217623497, 24.610324119879742, 0.7998786999999994, 410.0, 1003, 222859, 319, 13.192099699999972
320, 2.4327038116449, 20.394440641208572, 24.57961843451675, 0.798986350000001, 245.0, 980, 223839, 320, 13.015240200000108
321, 4.7633705187472515, 20.41454946100712, 24.724305748939514, 0.7982573500000003, 155.0, 640, 224479, 321, 8.568875800000114
322, 4.60147593770353, 20.359234689690673, 24.60272548007497, 0.7976944, 110.0, 611, 225090, 322, 8.09777639999993
323, 2.9751831608770907, 20.34894861243237, 24.551957009852618, 0.7972236999999995, 90.0, 435, 225525, 323, 5.8992657999999665
324, 3.966179997785959, 20.427116424595464, 24.64598032211548, 0.7966346499999997, 230.0, 874, 226399, 324, 11.695044900000084
325, 5.408699366531087, 20.38530726031468, 24.644320225409537, 0.7959259000000001, 125.0, 701, 227100, 325, 9.30270540000015
326, 3.2952002501883304, 20.37423026438841, 24.550111800124967, 0.7952612500000005, 180.0, 776, 227876, 326, 10.361495200000036
327, 5.95928806646542, 20.412803625050895, 24.702536459725014, 0.7944975999999997, 250.0, 921, 228797, 327, 12.278823299999885
328, 3.3452062354652425, 20.37959490828778, 24.594952789383317, 0.7939040500000001, 75.0, 398, 229195, 328, 5.37716260000002
329, 5.908088337328109, 20.4487129886846, 24.73479764419898, 0.7933640500000005, 115.0, 802, 229997, 329, 10.919613400000117
330, 3.2224345198661393, 20.54381825486008, 24.7893840463794, 0.7926503500000004, 220.0, 784, 230781, 330, 10.570150199999944
331, 4.0451085194480765, 20.534568798514147, 24.814204958576013, 0.7917201999999997, 350.0, 1283, 232064, 331, 17.18335030000003
332, 6.427644375596294, 20.527939756359675, 24.852096091329525, 0.7907360500000002, 215.0, 904, 232968, 332, 12.28707170000007
333, 4.19901501073096, 20.54234693967379, 24.837141902630147, 0.7899782499999999, 120.0, 780, 233748, 333, 10.68547680000006
334, 3.224822105562433, 20.453214396821693, 24.65965117799475, 0.78945805, 50.0, 376, 234124, 334, 5.189006800000016
335, 4.023003093002794, 20.51403522032958, 24.787131969745342, 0.7889144499999996, 200.0, 832, 234956, 335, 11.338549000000057
336, 3.020002744827355, 20.553730600397326, 24.81821600901188, 0.7883056000000003, 105.0, 521, 235477, 336, 7.186201199999914
337, 2.683829189425879, 20.485564555596866, 24.674242294631497, 0.7877278000000003, 180.0, 763, 236240, 337, 10.337349599999925
338, 3.4116163123823418, 20.490413941009134, 24.733668146254143, 0.7872066999999999, 85.0, 395, 236635, 338, 5.459712399999944
339, 3.1370510017753324, 20.512297838384455, 24.761740081960504, 0.7866329500000001, 120.0, 880, 237515, 339, 12.15566560000002
340, 4.478076878668244, 20.494436564623115, 24.74569656240906, 0.7859228499999994, 150.0, 698, 238213, 340, 9.44927319999988
341, 2.6965807897044334, 20.507795962031015, 24.693850428758267, 0.78530815, 180.0, 668, 238881, 341, 9.228284399999893
342, 1.6275190817100749, 20.429639022787722, 24.594514166661934, 0.7848334000000001, 30.0, 387, 239268, 342, 5.449281400000018
343, 3.4773425663663455, 20.50254984348141, 24.790843994296782, 0.7843514499999998, 120.0, 684, 239952, 343, 9.534837899999957
344, 2.945505113943535, 20.825186046899535, 25.084803204131283, 0.78376825, 35.0, 612, 240564, 344, 8.461644700000079
345, 3.1737363537620094, 20.857693786621095, 25.145641717349783, 0.7833015999999998, 125.0, 425, 240989, 345, 5.985381899999993
346, 3.01822800871985, 20.80675664671664, 25.086409490859925, 0.78287905, 110.0, 514, 241503, 346, 7.118306600000096
347, 2.396052879638819, 20.81301073112873, 25.075027446554163, 0.7822913500000002, 270.0, 792, 242295, 347, 11.040555399999903
348, 3.8464621642825905, 20.820983310957335, 25.180955846826514, 0.7815488499999999, 180.0, 858, 243153, 348, 11.838813000000073
349, 1.9187533827697707, 20.853514387022773, 25.078211478467257, 0.7808050000000001, 135.0, 795, 243948, 349, 11.042163899999878
350, 5.45772517362698, 20.807978391937738, 25.17122416897029, 0.7800777999999993, 380.0, 821, 244769, 350, 11.536188299999822
351, 1.735855766195566, 20.796487412554153, 25.0454224525614, 0.7795391500000004, 20.0, 376, 245145, 351, 5.359768099999883
352, 2.4079750015440844, 20.85440501752107, 25.142892512031224, 0.7789559500000003, 195.0, 920, 246065, 352, 12.910506799999894
353, 4.808870001026421, 20.831744302796924, 25.133700905161454, 0.7782697000000002, 135.0, 605, 246670, 353, 8.613832399999865
354, 4.280395024519119, 20.838506427688525, 25.18743076269915, 0.7775253999999995, 140.0, 1049, 247719, 354, 14.791686300000038
355, 3.927769587354746, 20.843004723232674, 25.139597888567412, 0.7765417000000006, 285.0, 1137, 248856, 355, 16.095343700000058
356, 2.513327441775799, 20.805101174926758, 25.07354140319824, 0.7757488000000005, 110.0, 625, 249481, 356, 8.858864699999913
357, 1.7472747928297314, 20.809501210316647, 25.043052345115413, 0.7752322000000003, 95.0, 523, 250004, 357, 7.438398799999959
358, 2.499034692135395, 20.874669779616944, 25.14818163781095, 0.7746039999999993, 160.0, 873, 250877, 358, 12.407020699999975
359, 5.167612568411721, 20.928707398563983, 25.26791411199404, 0.773875, 225.0, 747, 251624, 359, 10.661979400000064
360, 1.8004778975831164, 20.890262580687, 25.173692930129267, 0.7733156499999997, 100.0, 496, 252120, 360, 7.000433100000009
361, 2.9043131265642605, 20.8809206279244, 25.208459052513902, 0.7726352500000003, 290.0, 1016, 253136, 361, 14.558303599999817
362, 1.8228383575188347, 20.890714817736523, 25.167173580951, 0.7719539499999997, 105.0, 498, 253634, 362, 7.105994200000168
363, 4.8856521115678, 20.95461515077672, 25.34941584364812, 0.7715503000000001, 80.0, 399, 254033, 363, 5.777623100000255
364, 1.7197819928413036, 20.87608837933274, 25.133537644925326, 0.7710809500000001, 80.0, 644, 254677, 364, 9.321686699999645
365, 3.210114015075077, 20.97954131441878, 25.31592516300796, 0.7705544499999997, 35.0, 526, 255203, 365, 7.554955600000085
366, 3.5421594469462496, 20.89443899801679, 25.178682544627375, 0.7698083500000005, 270.0, 1132, 256335, 366, 16.31815430000006
367, 3.621932632690512, 20.917273122210837, 25.22885092191918, 0.7689893499999993, 115.0, 688, 257023, 367, 9.878057999999783
368, 1.7813957024492577, 20.85610486796958, 25.127774114360314, 0.7684552, 75.0, 499, 257522, 368, 7.321357899999839
369, 1.7634628108879995, 20.94680622645787, 25.18890102704366, 0.76807945, 30.0, 336, 257858, 369, 5.009959699999854
370, 4.7033907555709344, 20.9277756430886, 25.324471004330626, 0.7676411499999996, 180.0, 638, 258496, 370, 9.306097600000157
371, 1.60164271720574, 20.92654064160968, 25.206428545330642, 0.76715785, 65.0, 436, 258932, 371, 6.42005059999974
372, 4.314542519071334, 20.866532777900776, 25.199174703278157, 0.7667443000000002, 55.0, 483, 259415, 372, 7.141191599999729
373, 2.6460717964846308, 20.894867898434093, 25.182258003783822, 0.7662204999999995, 105.0, 681, 260096, 373, 9.987058300000172
374, 4.564615788466277, 21.0558785530637, 25.436475082349926, 0.7656251500000001, 155.0, 642, 260738, 374, 9.289185200000247
375, 1.5231398940674878, 20.96528293736173, 25.231560416319546, 0.7650513999999999, 135.0, 633, 261371, 375, 9.219401900000321
376, 2.643855036345104, 21.036301975122235, 25.35773640319005, 0.7644313000000005, 210.0, 745, 262116, 376, 10.961033799999768
377, 3.398003721927076, 21.05904237337138, 25.382214621919058, 0.7635915999999997, 240.0, 1121, 263237, 377, 16.341235399999732
378, 2.925489006379542, 21.060079620288203, 25.430883462436665, 0.7628054500000001, 210.0, 626, 263863, 378, 9.159500299999763
379, 2.8132257574648434, 21.001738101704042, 25.28838978500759, 0.7622613999999998, 105.0, 583, 264446, 379, 8.640460300000086
380, 3.600519263383114, 21.07377755940353, 25.410533779380508, 0.7616575000000004, 210.0, 759, 265205, 380, 11.10963109999966
381, 3.8835067531186427, 21.078664661299253, 25.443310169463462, 0.76106215, 135.0, 564, 265769, 381, 8.402232299999923
382, 2.93388139541744, 21.055757074901575, 25.33557030341094, 0.7605801999999997, 75.0, 507, 266276, 382, 7.576579600000059
383, 1.6860824890042607, 21.032427182818385, 25.299042149593955, 0.7601895999999999, 60.0, 361, 266637, 383, 5.3427473000001555
384, 3.4994439834532045, 21.06415811393419, 25.356409072875977, 0.7598440000000002, 45.0, 407, 267044, 384, 6.146769199999653
385, 4.394850423464927, 21.015258924708483, 25.367232376674437, 0.7593507999999997, 135.0, 689, 267733, 385, 10.29303260000006
386, 5.234915309580682, 21.11676396522968, 25.53092568992428, 0.7586173000000004, 470.0, 941, 268674, 386, 13.895525000000362
387, 5.250339750290742, 21.078096158776727, 25.43893185783835, 0.7578036999999996, 210.0, 867, 269541, 387, 12.960352199999761
388, 4.156849361739952, 21.13675932450728, 25.520185992611676, 0.7569482500000003, 255.0, 1034, 270575, 388, 15.523712100000012
389, 2.990908092010605, 21.179805012072546, 25.516085382235254, 0.7562439999999998, 75.0, 531, 271106, 389, 8.007663599999887
390, 1.893553112413137, 21.213895836555928, 25.523411971618806, 0.7558282, 35.0, 393, 271499, 390, 5.830646300000353
391, 1.8732946845210665, 21.174793739628985, 25.555565143988385, 0.75542995, 120.0, 492, 271991, 391, 7.50221479999982
392, 2.966597137858372, 21.18484471387202, 25.553810236713673, 0.7549812999999995, 110.0, 505, 272496, 392, 7.59523930000023
393, 3.7858980598982552, 21.21946825833344, 25.606512869357285, 0.7544782000000002, 60.0, 613, 273109, 393, 9.252859299999727
394, 1.863407779003588, 21.177050763048662, 25.46589503278789, 0.7539759999999999, 85.0, 503, 273612, 394, 7.521130000000085
395, 6.6107183919849, 21.259604116625717, 25.728424474616872, 0.7534125999999999, 140.0, 749, 274361, 395, 11.395629100000406
396, 3.7831748455501724, 21.16076929859107, 25.508715509454365, 0.7526647000000001, 240.0, 913, 275274, 396, 13.653175100000226
397, 3.835289712935117, 21.235838045632786, 25.571543750958995, 0.7519473999999998, 175.0, 681, 275955, 397, 10.326226700000007
398, 4.968304780460894, 21.24149355888367, 25.68505593776703, 0.7514609500000001, 60.0, 400, 276355, 398, 6.222746899999947
399, 4.118164358337537, 21.200031913954394, 25.554277142035566, 0.7510370499999999, 105.0, 542, 276897, 399, 8.326744899999994
400, 1.867804866427089, 21.195348231571792, 25.498891546279527, 0.7505938, 105.0, 443, 277340, 400, 6.77873929999987
401, 3.6046257752903625, 21.22659677714971, 25.608234529550366, 0.7500830500000002, 135.0, 692, 278032, 401, 10.679063999999926
402, 2.7522081223962545, 21.22483188182384, 25.555870660432465, 0.7494719499999997, 55.0, 666, 278698, 402, 10.166088399999808
403, 4.176815664304918, 21.2010295879074, 25.58094692416126, 0.7487105499999996, 295.0, 1026, 279724, 403, 15.849048399999901
404, 2.6515890723953928, 21.380709562758287, 25.745230754823176, 0.7476003999999998, 390.0, 1441, 281165, 404, 22.173882699999922
405, 2.388400600716314, 21.454188892782366, 25.868692494112697, 0.7464425499999994, 360.0, 1132, 282297, 405, 17.308378600000196
406, 3.165700457916255, 21.417860962095716, 25.82673654102144, 0.7457063500000002, 90.0, 504, 282801, 406, 7.858550099999775
407, 3.473186458304563, 21.483119481601765, 25.88678575855817, 0.7453053999999997, 80.0, 387, 283188, 407, 6.123036299999967
408, 3.183042597730025, 21.53933947267588, 25.955613206934046, 0.7446695500000003, 255.0, 1026, 284214, 408, 15.831632499999614
409, 7.174260004409582, 21.476360399108305, 25.997943969247775, 0.7438779999999997, 155.0, 733, 284947, 409, 11.499536799999987
410, 2.540988726157213, 21.420105848678656, 25.81104524376382, 0.7432318000000002, 180.0, 703, 285650, 410, 10.923356199999944
411, 1.7148904612384224, 21.398976276660786, 25.74403465616292, 0.74270665, 35.0, 464, 286114, 411, 7.357253799999853
412, 3.2357223357738, 21.460740656061557, 25.833056415677603, 0.74209645, 185.0, 892, 287006, 412, 14.061151000000336
413, 1.637018621910231, 21.390879687584437, 25.75060540225666, 0.7414673500000002, 95.0, 506, 287512, 413, 7.963385300000027
414, 1.7813744880163025, 21.422031623801004, 25.790274339852875, 0.7408904499999994, 110.0, 776, 288288, 414, 12.24206920000006
415, 4.837945433827399, 21.482517446532395, 25.935797104329772, 0.7400660500000004, 225.0, 1056, 289344, 415, 16.744331699999748
416, 3.9376487015788233, 21.508839203943662, 25.94522847544099, 0.7393195000000001, 120.0, 603, 289947, 416, 9.545606200000293
417, 4.188740384330121, 21.684590468535553, 26.142701475173652, 0.7385652999999999, 385.0, 1073, 291020, 417, 17.124654599999758
418, 1.794593996801918, 21.685780877973123, 26.099925656861895, 0.7377625000000002, 160.0, 711, 291731, 418, 11.384304499999871
419, 1.723411267162079, 21.625390252612885, 26.03484581538609, 0.7371590500000001, 120.0, 630, 292361, 419, 9.92415039999969
420, 3.306996268244382, 21.616543080361428, 26.107458718021178, 0.7363720000000002, 330.0, 1119, 293480, 420, 17.930361599999742
421, 2.09693565981597, 21.694729724372785, 26.15488480243486, 0.7356502, 55.0, 485, 293965, 421, 7.8388606000003165
422, 1.8361540925959425, 21.622568348915348, 26.03641126386581, 0.7351529499999996, 160.0, 620, 294585, 422, 10.024288199999773
423, 4.204948758690476, 21.69133857347544, 26.168930230377878, 0.7346116, 210.0, 583, 295168, 423, 9.52177729999994
424, 2.5628883543977703, 21.617322764189346, 26.05616899849712, 0.7340387499999996, 105.0, 690, 295858, 424, 11.098566200000278
425, 3.6269804183373404, 21.63848254412835, 26.10769620040511, 0.7333156000000004, 240.0, 917, 296775, 425, 14.88945139999987
426, 3.706427108273356, 21.614617910213813, 26.09112699874147, 0.7326023499999997, 135.0, 668, 297443, 426, 10.860972700000275
427, 3.4802615882151504, 21.624276876449585, 26.07831346988678, 0.7321433500000001, 95.0, 352, 297795, 427, 5.676748899999893
428, 3.4421389141944565, 21.666808688412807, 26.100886083712243, 0.7316317000000003, 260.0, 785, 298580, 428, 12.687552200000027
429, 2.502100574429943, 21.668152245713205, 26.123682188352717, 0.7309067499999999, 105.0, 826, 299406, 429, 13.503292500000043
430, 3.6667097542467046, 21.693950757213024, 26.169629203862158, 0.7302218500000003, 125.0, 696, 300102, 430, 11.382253400000081
431, 3.2226298092221968, 21.76330702179663, 26.247453573131445, 0.7295400999999994, 300.0, 819, 300921, 431, 13.296894200000224
432, 3.8341824079378566, 21.733691217112582, 26.19603890270444, 0.7289029000000002, 180.0, 597, 301518, 432, 9.924658200000067
433, 3.3174956205553836, 21.756993166562587, 26.22908068704056, 0.7279696000000002, 605.0, 1477, 302995, 433, 24.12612940000008
434, 4.718031723300616, 21.857020283520708, 26.39863758552365, 0.7270281999999998, 105.0, 615, 303610, 434, 10.183148000000074
435, 5.336699262268842, 21.764051052093507, 26.317870761871337, 0.7265264500000003, 50.0, 500, 304110, 435, 8.042337100000168
436, 6.629938698440518, 21.818921639990776, 26.3952636296, 0.7259563000000004, 155.0, 767, 304877, 436, 12.668474200000219
437, 4.915133129284172, 21.81533947880404, 26.282525294802966, 0.72543745, 60.0, 386, 305263, 437, 6.497118899999805
438, 1.6731521805462988, 21.740376035398103, 26.146196410974998, 0.7245676000000003, 670.0, 1547, 306810, 438, 25.350022600000102
439, 4.2532073581069705, 21.78608957417806, 26.270865346272785, 0.7235339500000002, 220.0, 750, 307560, 439, 12.34200409999994
440, 3.6414014777191075, 21.752912006224975, 26.261298916904803, 0.7227482500000002, 440.0, 996, 308556, 440, 16.424486199999592
441, 4.760261018486065, 21.838819092970628, 26.334179664927827, 0.7219198000000002, 195.0, 845, 309401, 441, 14.001514499999757
442, 2.977502456661273, 21.78616360018196, 26.290158614613652, 0.7213329999999996, 100.0, 459, 309860, 442, 7.593581600000107
443, 8.244999547710504, 21.86176155168382, 26.40674834483115, 0.7209504999999999, 20.0, 391, 310251, 443, 6.498163799999929
444, 3.6763225385625113, 21.8127700404117, 26.253653506228797, 0.7206035500000001, 50.0, 380, 310631, 444, 6.315309900000102
445, 3.3982065074586885, 21.81157196565331, 26.278125787487056, 0.7200829, 210.0, 777, 311408, 445, 12.916145400000005
446, 2.549211316892216, 21.8190631141311, 26.26109751028949, 0.7193426500000004, 310.0, 868, 312276, 446, 14.306382400000075
447, 3.8307289088063237, 21.838246208143136, 26.338842286446397, 0.7185209499999995, 285.0, 958, 313234, 447, 15.803871899999649
448, 4.021675654976483, 21.849388547690516, 26.380753303435913, 0.71771635, 145.0, 830, 314064, 448, 13.819656000000123
449, 4.105037021491463, 21.846173796990904, 26.311428240252663, 0.7170755499999996, 10.0, 594, 314658, 449, 9.814241699999911
450, 3.846660894914398, 21.858347733349394, 26.32633240551543, 0.7163479000000001, 255.0, 1023, 315681, 450, 17.071505500000058
451, 2.877131750791314, 21.81360184892695, 26.27675223654889, 0.7154645499999992, 225.0, 940, 316621, 451, 15.652734100000089
452, 2.963370120031486, 21.79864886839926, 26.25504593429814, 0.7147652500000001, 135.0, 614, 317235, 452, 10.25209470000027
453, 6.051234487607517, 21.89676282342105, 26.48605507223364, 0.7140681999999998, 410.0, 935, 318170, 453, 15.534936799999741
454, 2.690400980424843, 21.83175270409105, 26.271950449479633, 0.7133653000000001, 155.0, 627, 318797, 454, 10.548619700000017
455, 3.686526956892497, 21.823826006940894, 26.331084586478568, 0.7128167499999996, 145.0, 592, 319389, 455, 9.898302000000058
456, 3.0708978487790084, 21.88578999351909, 26.321609995019344, 0.7122556000000003, 135.0, 655, 320044, 456, 10.922312599999714
457, 3.2339514372254916, 21.772962948299188, 26.262400188109947, 0.7115522500000001, 385.0, 908, 320952, 457, 15.149557400000049
458, 5.378836722125834, 21.740504004477017, 26.29334494359173, 0.7108453000000002, 180.0, 663, 321615, 458, 11.162247600000228
459, 4.601541522676377, 21.76330672244768, 26.24218496116432, 0.7100141499999995, 240.0, 1184, 322799, 459, 19.742894499999693
460, 2.9534247279897206, 21.72017163982996, 26.204650598575473, 0.7091690500000002, 80.0, 694, 323493, 460, 11.646094400000038
461, 3.4391765569407586, 21.750196661340972, 26.214068812444918, 0.7084368999999999, 300.0, 933, 324426, 461, 15.673022800000126
462, 2.5973437868541094, 21.758155726700377, 26.206013849068277, 0.7075792, 560.0, 973, 325399, 462, 16.336713300000156
463, 2.5540726832534166, 21.73982671662873, 26.162222118003697, 0.7066823499999997, 245.0, 1020, 326419, 463, 17.101545500000157
464, 2.8825878749465232, 21.751275895876805, 26.226078698762564, 0.7057099000000001, 305.0, 1141, 327560, 464, 19.233117400000083
465, 3.562756133929718, 21.82210890413062, 26.296361356863947, 0.7048297000000002, 140.0, 815, 328375, 465, 13.691151699999864
466, 2.0111012949709552, 21.691409518295004, 26.100245716084853, 0.7041236499999998, 210.0, 754, 329129, 466, 12.801816400000007
467, 9.170520919167908, 21.85669275017997, 26.542754511378504, 0.7036003000000002, 50.0, 409, 329538, 467, 6.926699499999813
468, 2.9213831389555707, 21.758223117887972, 26.23897524178028, 0.7028402500000003, 535.0, 1280, 330818, 468, 21.447343199999978
469, 4.526885958428765, 21.70931600044988, 26.16521363306527, 0.7019524, 135.0, 693, 331511, 469, 11.696210999999948
470, 3.115501121568658, 21.698728210504807, 26.15463872815742, 0.7013934999999999, 90.0, 549, 332060, 470, 9.329668500000025
471, 2.9208787071193463, 21.69840439565083, 26.14389233560957, 0.7007662000000001, 215.0, 845, 332905, 471, 14.23521269999992
472, 4.461217276763878, 21.71329863942221, 26.19965407874976, 0.7001037999999995, 150.0, 627, 333532, 472, 10.61690419999968
473, 3.09409417170846, 21.707766116653357, 26.120732681527322, 0.6995773, 30.0, 543, 334075, 473, 9.180171699999846
474, 6.754618595467566, 21.813170616987552, 26.385348469991712, 0.6990296499999998, 210.0, 674, 334749, 474, 11.39844499999981
475, 2.740904005629851, 21.71057251543042, 26.143405356866676, 0.6984415, 125.0, 633, 335382, 475, 10.753091600000062
476, 4.244229929931002, 21.76708344589045, 26.25452438166112, 0.6977921500000003, 190.0, 810, 336192, 476, 13.800272999999834
477, 2.746550901563487, 21.75436321894328, 26.19002542633941, 0.6970550500000003, 120.0, 828, 337020, 477, 13.985614899999746
478, 5.216595145663427, 21.72977549542663, 26.268718719482422, 0.6965150500000001, 55.0, 372, 337392, 478, 6.335204500000145
479, 2.0748652301168855, 21.67977193325241, 26.104671880688972, 0.6960362499999996, 115.0, 692, 338084, 479, 11.777854800000114
480, 3.7346889433861636, 21.731487243938172, 26.167118097244835, 0.6954125500000004, 130.0, 694, 338778, 480, 11.75076369999988
481, 5.01560878358374, 21.73939926907947, 26.26697251421079, 0.69482035, 75.0, 622, 339400, 481, 10.599426499999936
482, 3.3401682805805306, 21.730960755211157, 26.18960064301051, 0.6940864000000004, 305.0, 1009, 340409, 482, 17.20363950000001
483, 4.553342509178934, 21.760335485789962, 26.26981763853892, 0.6933294999999998, 110.0, 673, 341082, 483, 11.402710000000297
484, 1.7506892484280778, 21.67837633921145, 26.072721718989712, 0.6927413500000004, 105.0, 634, 341716, 484, 10.935077500000261
485, 3.2815229041083733, 21.65249012538365, 26.10476909948855, 0.6922355500000001, 45.0, 490, 342206, 485, 8.390658099999655
486, 7.332911728335692, 21.788033801053476, 26.34463338261157, 0.6917607999999995, 100.0, 565, 342771, 486, 9.734530000000177
487, 3.8506585382934393, 21.712758536026723, 26.12885082076492, 0.6912109000000003, 65.0, 657, 343428, 487, 11.265128699999877
488, 3.659590986188656, 21.72967078288396, 26.19598899781704, 0.69074245, 30.0, 384, 343812, 488, 6.645179399999961
489, 5.823046689046019, 21.740685850426534, 26.25030641970427, 0.6902694999999994, 105.0, 667, 344479, 489, 11.486766800000169
490, 4.16473214974006, 21.727560227711994, 26.21538063897027, 0.68956435, 215.0, 900, 345379, 490, 15.450655900000129
491, 1.9032154986161296, 21.700454797142275, 26.101086964776226, 0.6888672999999994, 95.0, 649, 346028, 491, 11.101970900000197
492, 3.6062154213587445, 21.624974528948467, 26.115127499898275, 0.6882512500000001, 180.0, 720, 346748, 492, 12.333110600000055
493, 2.244607854938843, 21.6868948761846, 26.084579204505598, 0.6876077499999997, 115.0, 710, 347458, 493, 12.216100899999674
494, 3.2600749429842137, 21.67643399190421, 26.13014333657544, 0.6869318500000002, 350.0, 792, 348250, 494, 13.60753029999978
495, 3.9644683126446814, 21.783192972804226, 26.244085517040517, 0.6862658499999997, 120.0, 688, 348938, 495, 11.859853200000089
496, 4.4225809633284605, 21.76287452260599, 26.260005768779845, 0.6856264000000003, 180.0, 733, 349671, 496, 12.70121969999991
497, 3.229685193259422, 22.054147687241368, 26.553285314829928, 0.6848037999999996, 320.0, 1095, 350766, 497, 18.92213730000003
498, 4.839859585700319, 22.119461482491964, 26.68550498895183, 0.6840046000000001, 105.0, 681, 351447, 498, 11.850170499999876
499, 4.566712810034023, 22.109980759111423, 26.735629766890145, 0.6835127499999998, 20.0, 412, 351859, 499, 7.19529620000003
500, 2.138909505155832, 22.08563927171144, 26.582330960683873, 0.6830668000000003, 135.0, 579, 352438, 500, 10.116370399999596
501, 4.661895144286104, 22.221833880400236, 26.79788377840225, 0.6825763, 155.0, 511, 352949, 501, 8.846515400000044
502, 2.1409832629752126, 22.17469691094898, 26.69773695866267, 0.6820439499999997, 125.0, 672, 353621, 502, 11.719722899999852
503, 1.9342742999272844, 22.162608763922943, 26.666637227579127, 0.6814481500000003, 130.0, 652, 354273, 503, 11.303181299999778
504, 3.758871818858539, 22.108652016524545, 26.637385931234995, 0.6808230999999999, 185.0, 737, 355010, 504, 12.980227200000172
505, 4.84732745309853, 22.172460089400637, 26.7646398748462, 0.6801971500000001, 120.0, 654, 355664, 505, 11.593350099999952
506, 3.841641353555566, 22.1474346351227, 26.674537210603265, 0.6794699500000001, 485.0, 962, 356626, 506, 16.765218200000163
507, 6.332557245640826, 22.156608160874598, 26.791122197507317, 0.6788575, 95.0, 399, 357025, 507, 7.0576538999998775
508, 4.967903396835292, 22.110934747106548, 26.682453986211996, 0.6784929999999998, 55.0, 411, 357436, 508, 7.282745500000146
509, 3.497408828342042, 22.11860378291331, 26.65079997575202, 0.6779772999999999, 380.0, 735, 358171, 509, 12.965767000000142
510, 3.002735411575103, 22.0783335271325, 26.619490827962164, 0.6774094000000005, 105.0, 527, 358698, 510, 9.220327999999881
511, 2.02381754534683, 22.11870831018207, 26.663474378914668, 0.6769765, 50.0, 435, 359133, 511, 7.699931399999969
512, 5.120498556040927, 22.110759657949306, 26.664819331616645, 0.6765026499999999, 105.0, 618, 359751, 512, 11.0166478000001
513, 3.3638382034180414, 22.289237372293837, 26.83722152539281, 0.6758222499999998, 245.0, 894, 360645, 513, 15.714925499999936
514, 5.8975064477274035, 22.40289388515929, 27.051679758812238, 0.6750478000000001, 175.0, 827, 361472, 514, 14.517732400000114
515, 1.9555050378764858, 22.358997050860456, 26.8617310152709, 0.6743809000000003, 210.0, 655, 362127, 515, 11.769823100000394
516, 2.0676650247726185, 22.377269920587185, 26.94749141199982, 0.6737833, 120.0, 673, 362800, 516, 11.990204599999743
517, 2.6823682736025916, 22.310895148383246, 26.839587077388057, 0.6731767, 150.0, 675, 363475, 517, 11.987502100000256
518, 4.234069288443334, 22.383629608154298, 27.021418638999418, 0.6725107000000003, 180.0, 805, 364280, 518, 14.391523900000266
519, 3.686516170842307, 22.379848156883604, 26.97031687600272, 0.6716759500000004, 340.0, 1050, 365330, 519, 18.70636390000027
520, 4.089014183601429, 22.392458879693194, 26.98531418911538, 0.6709293999999999, 155.0, 609, 365939, 520, 11.0427466000001
521, 4.296809598575535, 22.36669598069302, 27.009342676860758, 0.6702877, 225.0, 817, 366756, 521, 15.053717100000085
522, 3.8283203125727425, 22.43651841236995, 27.047398220152544, 0.66961585, 110.0, 676, 367432, 522, 11.105277199999819
523, 1.9439671892802228, 22.284363555171776, 26.85704382966384, 0.6690785499999998, 100.0, 518, 367950, 523, 8.59270830000014
524, 3.404758675987952, 22.36546489617305, 26.979486769200488, 0.66846115, 260.0, 854, 368804, 524, 14.16079260000015
525, 1.9034306792141515, 22.28244882656049, 26.773047459276416, 0.6677213499999994, 220.0, 790, 369594, 525, 13.214052900000297
526, 3.2947459029557122, 22.381685856245795, 26.932381494527856, 0.6670679500000001, 110.0, 662, 370256, 526, 10.912991500000317
527, 4.650903024304365, 22.316136882234073, 26.911070508362478, 0.6664379499999996, 275.0, 738, 370994, 527, 12.26233639999964
528, 1.9215290533805809, 22.206821375248097, 26.702407800278316, 0.6657310000000002, 235.0, 833, 371827, 528, 13.85997180000004
529, 3.981155028648348, 22.34765484608502, 26.92914483461722, 0.6649043499999994, 270.0, 1004, 372831, 529, 16.76900169999999
530, 2.117804770654702, 22.325902666364396, 26.91918859901009, 0.6642887500000002, 80.0, 364, 373195, 530, 6.205026999999973
531, 2.63080711057967, 22.249339947373617, 26.77643172603437, 0.6637114000000001, 195.0, 919, 374114, 531, 15.311209399999825
532, 4.922824052249838, 22.423921657417587, 27.05423294950626, 0.6630724000000001, 145.0, 501, 374615, 532, 8.322957599999881
533, 2.0020155005050726, 22.283901066485374, 26.813771037783372, 0.662563, 135.0, 631, 375246, 533, 10.710361700000249
534, 3.9958915689469534, 22.250295398066847, 26.82323799500884, 0.6618587499999997, 390.0, 934, 376180, 534, 15.767895099999805
535, 3.772231630459814, 22.32245736542143, 26.895606036013273, 0.6610910499999999, 135.0, 772, 376952, 535, 12.997540500000014
536, 4.277244903213625, 22.31247175356071, 26.87560609147723, 0.6604912000000003, 90.0, 561, 377513, 536, 9.448757800000294
537, 3.8014888072438935, 22.24986203710861, 26.79152146701155, 0.6599516500000001, 90.0, 638, 378151, 537, 10.82113819999995
538, 4.773434610850838, 22.284097300558546, 26.81951459433413, 0.6593544999999995, 165.0, 689, 378840, 538, 11.471256100000119
539, 4.411445545169775, 22.276138609208857, 26.84085849798207, 0.65866555, 180.0, 842, 379682, 539, 14.248242800000298
540, 3.728240635819993, 22.308990328810935, 26.87013074131899, 0.6579770499999995, 180.0, 688, 380370, 540, 11.724239899999702
541, 4.994604742180796, 22.318033164486966, 26.943538938249862, 0.6573808000000001, 115.0, 637, 381007, 541, 10.799890000000232
542, 2.641253208892571, 22.329012531027455, 26.853706259106534, 0.6567278499999996, 185.0, 814, 381821, 542, 13.861351200000172
543, 5.502658209459812, 22.425092787473364, 27.018520421234854, 0.6561145000000003, 50.0, 549, 382370, 543, 9.348973699999988
544, 3.8262185238765527, 22.38780824870315, 26.967857435688437, 0.6552023500000006, 365.0, 1478, 383848, 544, 25.10990479999964
545, 4.2348487939237165, 22.372711060959617, 26.993137964495904, 0.6539540499999997, 520.0, 1296, 385144, 545, 22.15872970000055
546, 4.647683910972414, 22.39461011167942, 26.97382333953609, 0.6529289500000003, 265.0, 982, 386126, 546, 16.606913800000257
547, 5.010311064684222, 22.4291474173255, 27.001863950364132, 0.6521698, 120.0, 705, 386831, 547, 12.089952899999844
548, 4.928952327708979, 22.396220566569895, 27.03014047595038, 0.65166625, 50.0, 414, 387245, 548, 7.23389429999952
549, 3.311528769072772, 22.394469497227433, 26.949206302661707, 0.6511163499999998, 215.0, 808, 388053, 549, 13.9293418999996
550, 8.699365828900843, 22.455020880150368, 27.17888639893983, 0.6505768, 40.0, 391, 388444, 550, 6.784085700000105
551, 3.5455534533015998, 22.38385077821257, 27.001990163829966, 0.6500174500000003, 150.0, 852, 389296, 551, 14.688939099999516
552, 5.104877613049436, 22.402675201366474, 26.990474013539103, 0.64935685, 110.0, 616, 389912, 552, 10.687951500000054
553, 2.0827458386889077, 22.426325217827216, 26.946360974878697, 0.64882225, 110.0, 572, 390484, 553, 9.935897500000465
554, 2.1302495760260722, 22.471855568073853, 27.01299842739991, 0.6482741499999997, 125.0, 646, 391130, 554, 11.21414199999981
555, 4.837967057811453, 22.461946383942948, 27.07877890201325, 0.64756045, 210.0, 940, 392070, 555, 16.25058010000066
556, 3.453011534832142, 22.43370257825407, 27.02259803416481, 0.6467607999999997, 215.0, 837, 392907, 556, 14.515945000000102
557, 4.246456665674878, 22.464335606934696, 27.080262540693447, 0.6458364999999998, 255.0, 1217, 394124, 557, 21.102044500000375
558, 1.9722396645568783, 22.487444735767212, 27.033635958304988, 0.6449833000000001, 210.0, 679, 394803, 558, 11.846924899999976
559, 4.38608475422572, 22.467161528232094, 27.0538537734824, 0.6442948000000003, 285.0, 851, 395654, 559, 14.806384700000308
560, 2.0155774318529067, 22.401289750265008, 26.955309108697747, 0.6432985000000002, 600.0, 1363, 397017, 560, 23.555523600000015
561, 6.792151537591481, 22.469338192804223, 27.12246691287334, 0.6425109999999999, 30.0, 387, 397404, 561, 6.7654150999997
562, 3.2756673769375944, 22.417862610798686, 27.003896234592716, 0.6418670499999998, 185.0, 1044, 398448, 562, 18.182570599999963
563, 5.126745582852529, 22.517240759614225, 27.12563776453852, 0.6411893499999998, 110.0, 462, 398910, 563, 8.069949499999893
564, 2.880198192954893, 22.4918817421551, 27.10072380126589, 0.6405287500000003, 300.0, 1006, 399916, 564, 17.73472270000002
565, 1.8885913756073398, 22.327785994024836, 26.85391946960898, 0.6397700499999995, 150.0, 680, 400596, 565, 12.030270599999312
566, 3.655099297725709, 22.353804418973834, 26.982077221261378, 0.6391751500000002, 95.0, 642, 401238, 566, 11.435755600000448
567, 2.979389769626114, 22.35360951213717, 26.85957963091772, 0.6385284999999998, 215.0, 795, 402033, 567, 14.384787399999368
568, 3.490120733732527, 22.389565734429794, 26.940694798122752, 0.6377747500000003, 190.0, 880, 402913, 568, 15.768191400000433
569, 2.2286412638820683, 22.29866985918721, 26.834608695735188, 0.6369507999999996, 320.0, 951, 403864, 569, 16.92998559999978
570, 3.3226736279286664, 22.32295254398795, 26.90389260474373, 0.6362780499999999, 20.0, 544, 404408, 570, 9.740967599999749
571, 2.7366958688232894, 22.35212480849114, 26.93991791243924, 0.6356916999999997, 170.0, 759, 405167, 571, 13.543445799999972
572, 1.8189140211255732, 22.252130482578018, 26.7296502389882, 0.6351841, 45.0, 369, 405536, 572, 6.623974000000089
573, 6.9406284883925595, 22.30784993515801, 26.988853057389406, 0.6347997999999999, 65.0, 485, 406021, 573, 8.630048899999565
574, 4.511648411719711, 22.294918964245568, 26.88429849571977, 0.6339947499999995, 315.0, 1304, 407325, 574, 23.018571400000837
575, 3.214523237066667, 22.300662405776333, 26.84675681450315, 0.6331411, 135.0, 593, 407918, 575, 10.74533220000012
576, 3.0255034498094884, 22.336789539523117, 26.89690823862832, 0.6325326999999997, 40.0, 759, 408677, 576, 13.6304726999997
577, 3.7686542145877713, 22.339282482420064, 26.912528924774705, 0.6318577000000001, 255.0, 741, 409418, 577, 13.08664349999981
578, 4.277665687056953, 22.372460076694782, 27.032035386551577, 0.6310260999999991, 375.0, 1107, 410525, 578, 19.615916000000652
579, 4.693704258981858, 22.443987997390185, 27.0861965932453, 0.6303205000000001, 40.0, 461, 410986, 579, 8.30252930000006
580, 2.849001637478375, 22.30273466208098, 26.833370532793765, 0.6297183999999999, 115.0, 877, 411863, 580, 15.828554699999586
581, 3.9397187574636976, 22.36290288820236, 26.939358232862354, 0.6290456500000001, 120.0, 618, 412481, 581, 11.186258200000339
582, 4.4295319271974325, 22.40492354411396, 27.02251193674471, 0.6284408499999995, 140.0, 726, 413207, 582, 13.084942700000283
583, 6.9797686591972505, 22.431516423517344, 27.073187949706096, 0.6279377499999999, 75.0, 392, 413599, 583, 7.038489700000355
584, 3.9074718615417283, 22.46565689777304, 27.051662541605943, 0.6274679500000001, 105.0, 652, 414251, 584, 11.779578799999399
585, 2.6497423133661604, 22.317585128858703, 26.901485573532234, 0.6268060000000001, 390.0, 819, 415070, 585, 14.925616300000002
586, 2.1440935857641095, 22.352255669061982, 26.866655825815307, 0.6261526000000002, 80.0, 633, 415703, 586, 11.56890629999998
587, 2.076433249350105, 22.38653027742429, 26.896386021061947, 0.6256283499999996, 85.0, 532, 416235, 587, 9.702437300000383
588, 3.669497420655085, 22.341790798583318, 26.945421151124716, 0.6252242499999999, 75.0, 366, 416601, 588, 6.61607290000029
589, 4.46891535133271, 22.401333939202942, 26.99435959051151, 0.6246050500000003, 225.0, 1010, 417611, 589, 18.19650200000069
590, 4.551385063436405, 22.376678272923105, 26.98133352488308, 0.6236857000000003, 275.0, 1033, 418644, 590, 18.88770299999942
591, 3.0114281757422456, 22.382264364865303, 26.930079796652844, 0.6229134999999997, 80.0, 683, 419327, 591, 12.477889499999947
592, 3.9046713671912445, 22.415131497880317, 26.990142710514316, 0.6221530000000001, 225.0, 1007, 420334, 592, 18.315222500000345
593, 5.592154461555852, 22.435577095625643, 27.08736795056128, 0.6214743999999998, 50.0, 501, 420835, 593, 9.258095799999865
594, 5.081569388450589, 22.437022949258488, 27.04035358627637, 0.62107615, 85.0, 384, 421219, 594, 7.118262699999832
595, 3.550727148208759, 22.460421647975053, 27.041234750956725, 0.6203079999999999, 335.0, 1323, 422542, 595, 24.213217900000018
596, 4.672293702506252, 22.434978947951617, 27.06367746056068, 0.6189152500000006, 555.0, 1772, 424314, 596, 32.46791350000058
597, 2.1103548963458314, 22.407573960900137, 26.98022986063668, 0.6177988000000002, 160.0, 709, 425023, 597, 13.118056900000738
598, 1.8525121219141383, 22.342731357628193, 26.87518983223069, 0.6173199999999998, 50.0, 355, 425378, 598, 6.571256500000345
599, 2.0028537841812346, 22.392127746116113, 26.914385042845748, 0.6168655000000002, 145.0, 655, 426033, 599, 12.191007999999783
600, 1.9798056650618465, 22.392655180703745, 26.930473791187392, 0.6162800500000001, 105.0, 646, 426679, 600, 11.95669910000015
601, 2.485141757699485, 22.40053653901148, 26.972215015455564, 0.61552315, 335.0, 1036, 427715, 601, 19.28864859999976
602, 2.594951141559211, 22.358852946382164, 26.90561637302812, 0.6147288999999998, 170.0, 729, 428444, 602, 13.495185200000378
603, 7.26094548230611, 22.434137656520043, 27.091765188145736, 0.6140764000000002, 110.0, 721, 429165, 603, 13.350378199999795
604, 2.0246621728778997, 22.38506619462343, 26.937047345170352, 0.6135112, 55.0, 535, 429700, 604, 10.048371099999713
605, 1.7993840821263185, 22.440553507622013, 27.02058517264757, 0.6129653499999995, 120.0, 678, 430378, 605, 12.697661100000005
606, 3.1772656927860345, 22.543223580433057, 27.133852329594195, 0.6123826, 150.0, 617, 430995, 606, 11.566646999999648
607, 3.350963650543879, 22.482749016304325, 27.170968683754527, 0.6118835499999999, 45.0, 492, 431487, 607, 9.192344199999752
608, 1.8086872951779174, 22.503786275675008, 27.071809667370694, 0.6114164499999998, 125.0, 546, 432033, 608, 10.262523800000054
609, 2.7429151569120584, 22.515406444072724, 27.092967491149903, 0.61081075, 165.0, 800, 432833, 609, 14.96707619999961
610, 4.531330899587773, 22.599719200228236, 27.26027041937917, 0.6100853499999996, 245.0, 812, 433645, 610, 15.225445099999888
611, 2.908772730849407, 22.523884288646556, 27.137464209662543, 0.6094162000000002, 185.0, 675, 434320, 611, 12.707067899999856
612, 3.079828883735118, 22.43479858327795, 27.034616569236473, 0.6088694499999996, 55.0, 540, 434860, 612, 10.20299420000083
613, 2.082379084316883, 22.554738193597025, 27.118764206639284, 0.6083641000000003, 110.0, 583, 435443, 613, 11.110705500000222
614, 2.0521782328978406, 22.46493782589783, 27.020801017032795, 0.6077435499999999, 295.0, 796, 436239, 614, 15.128733800000191
615, 3.7256620881067315, 22.56174095269992, 27.19943001548651, 0.60720805, 60.0, 394, 436633, 615, 7.490814099999625
616, 3.7216735687411027, 22.50502956841109, 27.129350550465578, 0.6065623000000001, 335.0, 1041, 437674, 616, 19.71725200000037
617, 2.720540749175208, 22.52618412562779, 27.078501926967075, 0.6057000999999999, 175.0, 875, 438549, 617, 16.62171799999942
618, 7.700022572853653, 22.573064730148907, 27.292486042939416, 0.6050741500000001, 105.0, 516, 439065, 618, 9.792133099999774
619, 1.983114227824321, 22.463712307493008, 26.97722107395315, 0.6046857999999998, 75.0, 347, 439412, 619, 6.700780199999826
620, 1.8352866419104499, 22.463560266637092, 27.010379432564353, 0.6042281500000003, 135.0, 670, 440082, 620, 12.827476500000557
621, 4.330593174661191, 22.44755317407194, 27.05313984239123, 0.6034253499999997, 275.0, 1114, 441196, 621, 21.0236117000004
622, 2.833104928671869, 22.4204018977151, 27.019741007107406, 0.6026225500000003, 165.0, 670, 441866, 622, 12.760616599999594
623, 4.38956942839961, 22.45365133328675, 27.06135887258193, 0.6019232499999998, 125.0, 884, 442750, 623, 16.794447799999944
624, 4.515269049319633, 22.452668094376563, 27.04010842744574, 0.6011933500000002, 125.0, 738, 443488, 624, 14.05807089999962
625, 3.894816685180495, 22.409299940574826, 26.974535796398253, 0.6005754999999998, 55.0, 635, 444123, 625, 12.0932815999995
626, 3.302943202709828, 22.418297228060272, 26.98911220619553, 0.5997425499999995, 240.0, 1216, 445339, 626, 23.114198499999475
627, 2.0786207774619916, 22.437613197298713, 26.997044196495644, 0.5989496499999994, 210.0, 546, 445885, 627, 10.377125699999851
628, 4.822120827400158, 22.435875580553958, 27.013324162731433, 0.5984083000000002, 110.0, 657, 446542, 628, 12.655611600000157
629, 3.166076890113794, 22.43009935017505, 27.002515197579378, 0.59783725, 110.0, 612, 447154, 629, 11.82063990000006
630, 2.341214558434193, 22.342405127756525, 26.90645024993203, 0.5973242499999999, 130.0, 528, 447682, 630, 10.252600599999823
631, 4.820890047816831, 22.41376808064628, 26.967118605661817, 0.59678335, 125.0, 674, 448356, 631, 12.964112999999998
632, 4.1582006346063, 22.399627463389795, 26.972982162443564, 0.5960511999999997, 245.0, 953, 449309, 632, 18.46743139999944
633, 5.936076047949951, 22.465940290767165, 27.04629949573254, 0.5953807, 40.0, 537, 449846, 633, 10.343365400000039
634, 4.18887696726192, 22.612349952925943, 27.218880012224492, 0.5947929999999997, 165.0, 769, 450615, 634, 15.023717099999885
635, 4.588285100324395, 22.60845347115529, 27.267528653314407, 0.5941306000000001, 390.0, 703, 451318, 635, 13.787395500000457
636, 3.266633959875446, 22.615773801378875, 27.241378967578594, 0.59336965, 330.0, 988, 452306, 636, 19.167580199999975
637, 3.545611959192719, 22.631888602294175, 27.225831452537985, 0.59255785, 240.0, 816, 453122, 637, 15.977834799999982
638, 2.858649956906447, 22.588099133223295, 27.208384899422526, 0.5917298499999992, 275.0, 1024, 454146, 638, 19.900063900000532
639, 3.2115743063390254, 22.668577412764233, 27.280069410800934, 0.5910530500000001, 105.0, 480, 454626, 639, 9.373026199999913
640, 1.9458362401749651, 22.631433349389297, 27.24186441225883, 0.5905562499999996, 95.0, 624, 455250, 640, 12.28756920000069
641, 1.9508861115547866, 22.659666743213773, 27.25036470059356, 0.5899771000000001, 150.0, 663, 455913, 641, 13.039098000000195
642, 4.076383045197337, 22.613143920898438, 27.26827168786365, 0.5893786, 375.0, 667, 456580, 642, 13.082507399999486
643, 2.9430937798087435, 22.614992542251954, 27.25338088042284, 0.5885019999999997, 370.0, 1281, 457861, 643, 25.03572989999975
644, 3.128440593085859, 22.6499577429781, 27.28328784253685, 0.5876564499999996, 35.0, 598, 458459, 644, 11.671629499999653
645, 6.967365801467768, 22.70371631222308, 27.43360673070259, 0.5872113999999999, 50.0, 391, 458850, 645, 7.679569100000663
646, 2.209516074943046, 22.662185469127838, 27.258251542136783, 0.5866574499999999, 130.0, 840, 459690, 646, 16.57052139999996
647, 3.118442102325159, 22.576444975185744, 27.177707305321327, 0.5860337499999999, 110.0, 546, 460236, 647, 10.791668599999866
648, 2.4167132370819533, 22.748538131177845, 27.354418104649707, 0.5855959000000001, 50.0, 427, 460663, 648, 8.487720899999658
649, 3.946709081103662, 22.56805528429976, 27.182367639684742, 0.5850738999999997, 125.0, 733, 461396, 649, 14.279091299999891
650, 5.108046547237176, 22.669349071839974, 27.347718377784357, 0.5843827000000003, 210.0, 803, 462199, 650, 15.88916859999972
651, 2.050753865309678, 22.589375427890207, 27.192865690983712, 0.5837121999999998, 125.0, 687, 462886, 651, 13.627312599999641
652, 3.1602646132697396, 22.656672481348306, 27.275879221724015, 0.5831663499999999, 80.0, 526, 463412, 652, 10.658779700000196
653, 1.9599131148318396, 22.62513284404967, 27.200724298188796, 0.5825903500000001, 185.0, 754, 464166, 653, 14.953582600000118
654, 2.0598923489850547, 22.600325185911995, 27.1760817527771, 0.5819990499999996, 75.0, 560, 464726, 654, 11.183245400000487
655, 3.1480191942948594, 22.615131546680193, 27.263640507719572, 0.5815076499999999, 50.0, 532, 465258, 655, 10.670764800000143
656, 4.222978431560253, 22.669898415518638, 27.348053610268185, 0.5809842999999998, 150.0, 631, 465889, 656, 12.56837489999998
657, 3.9518909667997058, 22.6090165777138, 27.274689406253742, 0.5800104999999999, 470.0, 1533, 467422, 657, 30.286476300000686
658, 5.5661661689898825, 22.606006020634872, 27.22828035123199, 0.5789683000000003, 185.0, 783, 468205, 658, 15.698003399999834
659, 2.16702685163382, 22.57893095541438, 27.146587573060202, 0.5784197500000001, 95.0, 436, 468641, 659, 8.85712599999988
660, 5.139484186751036, 22.623760858528044, 27.26119631408197, 0.5777789499999996, 270.0, 988, 469629, 660, 19.598601300000155
661, 4.183851176030332, 22.645679142772423, 27.297042254422287, 0.5769662500000001, 165.0, 818, 470447, 661, 16.394867500000146
662, 3.1841558606991236, 22.649214014290607, 27.251286555954252, 0.5760410500000002, 445.0, 1238, 471685, 662, 24.85479680000026
663, 5.176837113332303, 22.643109760182426, 27.26671562092827, 0.57531565, 25.0, 374, 472059, 663, 7.580275700000129
664, 2.0324288544924345, 22.599148520542055, 27.17811415769873, 0.5748746499999997, 120.0, 606, 472665, 664, 12.228269500000351
665, 2.159732142232339, 22.60541367845359, 27.192325476291625, 0.5744313999999997, 55.0, 379, 473044, 665, 7.69703059999938
666, 3.334429694645223, 22.632240116596222, 27.20147079229355, 0.5740304500000001, 85.0, 512, 473556, 666, 10.327384399999573
667, 2.0984535342709663, 22.651450365269717, 27.246239293481885, 0.57327625, 505.0, 1164, 474720, 667, 23.5089152999999
668, 4.381826377342012, 22.619259828523685, 27.27153079253154, 0.5723802999999998, 275.0, 827, 475547, 668, 16.73099269999966
669, 6.2377285729309815, 22.70929945514189, 27.420552271482443, 0.5715248500000001, 380.0, 1074, 476621, 669, 21.683742899999743
670, 6.503094004705931, 22.688883401050187, 27.360414605534654, 0.5707256499999994, 230.0, 702, 477323, 670, 14.295821499999875
671, 3.069476394304528, 22.638545562461402, 27.254805409259877, 0.5696568999999997, 755.0, 1673, 478996, 671, 33.73362319999978
672, 1.9728889518229424, 22.640795670086714, 27.219638833313695, 0.5687101, 55.0, 431, 479427, 672, 8.805700399999296
673, 4.057684328181599, 22.57697633638849, 27.144963531054405, 0.56836, 55.0, 347, 479774, 673, 7.229331100000309
674, 5.99027084942671, 22.660043112093, 27.3460252458198, 0.5679126999999996, 140.0, 647, 480421, 674, 13.298203100000137
675, 3.5056255453069958, 22.576566614854933, 27.176548626768458, 0.5672521, 415.0, 821, 481242, 675, 16.871410199999445
676, 3.31369065319698, 22.571859335652995, 27.164829632992312, 0.5664906999999995, 420.0, 871, 482113, 676, 17.744415799999842
677, 4.019182768101391, 22.589099089770723, 27.210904722689182, 0.5657918500000001, 135.0, 682, 482795, 677, 14.030276200000117
678, 3.9732097984264763, 22.551704891534786, 27.1466916464891, 0.56489185, 535.0, 1318, 484113, 678, 27.08605290000014
679, 4.841957901520976, 22.58698046454068, 27.21216066733174, 0.564103, 20.0, 435, 484548, 679, 8.969973199999913
680, 3.798639037322415, 22.60182788838511, 27.287640224332396, 0.5635760499999999, 155.0, 736, 485284, 680, 15.22358929999973
681, 5.881414692194317, 22.560568489586583, 27.1824457820612, 0.563104, 20.0, 313, 485597, 681, 6.458977299999788
682, 3.7628818100348194, 22.618108203704345, 27.24958210705436, 0.5627948500000001, 50.0, 374, 485971, 682, 7.769473000000289
683, 2.129952889528646, 22.59612536891814, 27.168255881853, 0.5622080499999996, 365.0, 930, 486901, 683, 19.37029430000075
684, 3.902776695173533, 22.615710649683624, 27.24521208842429, 0.5611455999999997, 545.0, 1431, 488332, 684, 29.508407100000113
685, 3.706280753531239, 22.611767293756657, 27.22841238195246, 0.5600066500000003, 320.0, 1100, 489432, 685, 22.776941799999804
686, 4.334889866496803, 22.556872393280518, 27.17747606944239, 0.5589208000000002, 455.0, 1313, 490745, 686, 27.10214889999952
687, 5.046579812004397, 22.519251713834358, 27.135536930671822, 0.5581458999999999, 110.0, 409, 491154, 687, 8.574418199999855
688, 3.0819239369801115, 22.525527005876814, 27.07690191432408, 0.5575681000000001, 130.0, 875, 492029, 688, 18.207159599999613
689, 3.246578056688187, 22.525682130465196, 27.146709728536223, 0.5568836499999996, 105.0, 646, 492675, 689, 13.452068300000064
690, 4.493430684216729, 22.563694255588988, 27.18385718076756, 0.5563711, 80.0, 493, 493168, 690, 10.32579369999985
691, 2.387496092750393, 22.46574635358201, 26.994073656416433, 0.5559746500000001, 25.0, 388, 493556, 691, 8.015100700000403
692, 5.154439371749054, 22.496799450943524, 27.11860274967711, 0.5555147499999998, 40.0, 634, 494190, 692, 13.332734600000549
693, 3.8399988559897613, 22.49489137861464, 27.09882117579223, 0.5550593500000001, 30.0, 378, 494568, 693, 8.021572300000116
694, 2.1176443298222027, 22.40049891629879, 26.99711387292219, 0.5546583999999999, 40.0, 513, 495081, 694, 10.980827999999747
695, 3.110278252901004, 22.51966632792348, 27.111807542688705, 0.5541903999999999, 120.0, 527, 495608, 695, 11.07609759999923
696, 5.372573118287188, 22.55839122646031, 27.161749051120747, 0.5537764, 90.0, 393, 496001, 696, 8.364343799999915
697, 4.738059511258407, 22.4782557480252, 27.115025368373566, 0.553303, 90.0, 659, 496660, 697, 13.903824299999542
698, 3.7699984918833986, 22.46565596907424, 27.06147864575802, 0.5525627499999995, 470.0, 986, 497646, 698, 20.920939999999973
699, 3.8167862792363927, 22.494919067510654, 27.08896021155238, 0.5513671000000008, 395.0, 1671, 499317, 699, 35.108901499999774
700, 2.1786137450847214, 22.583648688317457, 27.133736019512874, 0.5502295000000001, 170.0, 857, 500174, 700, 18.257701300000008
701, 2.3454863957564034, 22.68331946818034, 27.25855002848307, 0.5496751, 50.0, 375, 500549, 701, 7.9708591999997225
702, 5.2768632743439765, 22.811100647982105, 27.486061739898712, 0.5490370000000001, 195.0, 1043, 501592, 702, 22.2921922000005
703, 3.141201172492294, 22.74869923475312, 27.39926810559815, 0.5483277999999996, 210.0, 533, 502125, 703, 11.303834299999835
704, 1.8263029595997176, 22.6370437162807, 27.21414989687008, 0.5479047999999999, 60.0, 407, 502532, 704, 8.631327500000225
705, 1.9952412122277299, 22.681903684982146, 27.249570299399018, 0.5474989000000001, 105.0, 495, 503027, 705, 10.444355900000119
706, 5.714572600750828, 22.687333217162372, 27.330358803480898, 0.5468904999999995, 215.0, 857, 503884, 706, 18.316259700000046
707, 5.361742149517461, 22.74650345648919, 27.39114711668108, 0.5462474500000001, 180.0, 572, 504456, 707, 12.184972600000037
708, 2.7684448598615274, 22.707948433792833, 27.303563244710833, 0.5456547999999998, 145.0, 745, 505201, 708, 15.762741800000185
709, 5.411445690382497, 22.786443319846327, 27.451626139362965, 0.5451481, 30.0, 381, 505582, 709, 8.259495799999968
710, 7.17216412750738, 22.72045882633754, 27.444357261657714, 0.5448191500000001, 35.0, 350, 505932, 710, 7.541949600000407
711, 1.9358456123437726, 22.670452713317317, 27.23378218496776, 0.5444137, 25.0, 551, 506483, 711, 11.89261390000047
712, 3.949741589630905, 22.688793227547094, 27.313206908577367, 0.5439947500000001, 45.0, 380, 506863, 712, 8.210678399999779
713, 5.7379574168818115, 22.76698250847591, 27.47378851768729, 0.5435173000000001, 105.0, 681, 507544, 713, 14.702172100000098
714, 6.814365405891393, 22.795435637396736, 27.528151527610984, 0.5430443500000001, 115.0, 370, 507914, 714, 7.98332179999943
715, 5.042708480178591, 22.757011275693596, 27.483012960043297, 0.5426910999999996, 75.0, 415, 508329, 715, 8.92575829999987
716, 3.42065943076546, 22.776859959945302, 27.40570516852518, 0.5422303000000002, 90.0, 609, 508938, 716, 13.304478900000504
717, 4.045758216038881, 22.69156904711552, 27.31171452050648, 0.5416677999999999, 130.0, 641, 509579, 717, 13.828531600000133
718, 3.97464261557337, 22.760417594233957, 27.41952169728548, 0.5410998999999997, 110.0, 621, 510200, 718, 13.425840199999584
719, 2.9302079186667718, 22.959205379196465, 27.60625012991485, 0.5404055500000001, 165.0, 922, 511122, 719, 19.962430599999607
720, 1.8015227217425485, 22.84179618578999, 27.478798751403637, 0.5398299999999999, 30.0, 357, 511479, 720, 7.751905199999783
721, 3.8939585691033196, 22.976910416415024, 27.646845903251943, 0.5392837000000001, 195.0, 857, 512336, 721, 18.64243600000009
722, 3.454743016009981, 23.073906555175782, 27.73088992725719, 0.5386505499999997, 70.0, 550, 512886, 722, 12.060313900000438
723, 4.365262576829856, 22.938809504535513, 27.598506428536325, 0.5379179500000001, 155.0, 1078, 513964, 723, 23.343754700000318
724, 2.003221837298055, 22.910824464358825, 27.517808212857066, 0.5371709499999997, 130.0, 582, 514546, 724, 12.74259450000045
725, 1.9981684813262532, 22.9364494419784, 27.537243414268218, 0.5366588500000002, 240.0, 556, 515102, 725, 12.11026690000017
726, 5.602160355965121, 22.901590196046534, 27.619714372833744, 0.5361022000000001, 145.0, 681, 515783, 726, 14.832464999999502
727, 2.1421171226378144, 23.00463197266527, 27.70636122097523, 0.5356130499999999, 80.0, 406, 516189, 727, 8.967121499999848
728, 4.69126934594337, 22.961865557740065, 27.642745617999147, 0.5352264999999998, 85.0, 453, 516642, 728, 9.95932829999947
729, 3.238054366919716, 22.947773206429403, 27.654064358257855, 0.5348030500000002, 115.0, 488, 517130, 729, 10.698795500000415
730, 3.4674824674153277, 22.914483596903256, 27.58652231804283, 0.5341775499999996, 215.0, 902, 518032, 730, 19.670981100000063
731, 3.0870885637576704, 22.972623425644713, 27.650343158028342, 0.5334944500000002, 155.0, 616, 518648, 731, 13.323968099999547
732, 3.773005591056655, 22.90361322445816, 27.623012526651447, 0.5330570499999998, 65.0, 356, 519004, 732, 7.870275299999776
733, 6.0981352696070665, 22.892571233030633, 27.59384747702768, 0.5326209999999998, 115.0, 613, 519617, 733, 13.597016099999564
734, 3.8944717835356446, 23.036965010873836, 27.718835850453747, 0.5317372000000005, 525.0, 1351, 520968, 734, 29.68014099999982
735, 3.674484743633204, 23.073329318653453, 27.81870398858581, 0.5309510499999999, 45.0, 396, 521364, 735, 8.738723299999947
736, 3.122132470932102, 23.065574738374803, 27.751683093883372, 0.53045695, 125.0, 702, 522066, 736, 15.533989600000496
737, 5.661181002534271, 23.08823758438631, 27.856150392570015, 0.5298904, 60.0, 557, 522623, 737, 12.312958100000287
738, 5.213149122844305, 23.008325795398598, 27.760530608040945, 0.52936885, 50.0, 602, 523225, 738, 13.475329500000043
739, 4.191095075142458, 23.023878800494117, 27.726014872616943, 0.5287401999999997, 490.0, 795, 524020, 739, 17.582676799999717
740, 3.2064040095451496, 23.034914090651874, 27.72449346475823, 0.5279180500000001, 250.0, 1032, 525052, 740, 22.907318900000064
741, 2.0513457376776345, 22.945067210997344, 27.583571120263386, 0.5271075999999996, 275.0, 769, 525821, 741, 17.087351000000126
742, 5.215269464387823, 23.103331950173448, 27.84637853518054, 0.52658065, 105.0, 402, 526223, 742, 9.042954999999893
743, 3.2026008015475522, 23.07098501994286, 27.744489360738683, 0.5261081499999999, 140.0, 648, 526871, 743, 14.520990500000153
744, 1.857759992281596, 22.994198848461284, 27.636278234679125, 0.5256599500000001, 5.0, 348, 527219, 744, 7.801341899999898
745, 6.127773095046347, 23.157667692698674, 27.98071789971996, 0.5250844, 345.0, 931, 528150, 745, 20.73960790000001
746, 4.031761039786234, 23.136916909899032, 27.932441271744764, 0.5243882499999996, 105.0, 616, 528766, 746, 13.681015600000137
747, 3.846106248120467, 23.14446942138672, 27.88795346069336, 0.5239423, 35.0, 375, 529141, 747, 8.432294199999887
748, 4.4466328730357105, 23.17042621368258, 27.917351287691464, 0.5233168, 330.0, 1015, 530156, 748, 22.677064299999984
749, 2.8801502839771875, 23.89646973475674, 28.74165803473734, 0.5224285000000002, 225.0, 959, 531115, 749, 21.444900899999993
750, 6.032729551794058, 23.86481000676775, 28.837279018200036, 0.5217165999999998, 105.0, 623, 531738, 750, 14.01161989999946
751, 4.066395606051254, 23.883839593214148, 28.806794376934278, 0.52119145, 75.0, 544, 532282, 751, 12.272026399999959
752, 3.769859391255848, 23.898153202681893, 28.785587247931126, 0.5204687500000001, 370.0, 1062, 533344, 752, 23.667765899999722
753, 6.69447855964303, 23.884693183898925, 28.776474716880106, 0.51974335, 110.0, 550, 533894, 753, 12.659219699999994
754, 4.986680866624208, 23.977070285244018, 28.88652067939975, 0.5191948, 185.0, 669, 534563, 754, 15.039510000000519
755, 5.890046693400234, 23.84529632903542, 28.723599745139914, 0.5186786500000001, 120.0, 478, 535041, 755, 10.825135900000532
756, 4.167616243710614, 23.922873608587068, 28.817624172101223, 0.5180558499999999, 470.0, 906, 535947, 756, 20.427467200000137
757, 3.6826283312949717, 23.815859876594434, 28.623811265459032, 0.5173340499999995, 210.0, 698, 536645, 757, 15.89128399999936
758, 2.0456135355308653, 23.79111698150635, 28.612142634391784, 0.5168399499999999, 50.0, 400, 537045, 758, 9.153095499999836
759, 3.981256666384014, 23.839435403042426, 28.7033841200337, 0.5162513499999999, 135.0, 908, 537953, 759, 20.48128739999993
760, 3.4121507193944227, 23.91725434529105, 28.74333639947402, 0.5156128, 55.0, 511, 538464, 760, 11.654971199999636
761, 3.675663916034993, 23.856030956944952, 28.776622389766427, 0.5152078000000001, 70.0, 389, 538853, 761, 8.952403799999956
762, 1.8430025985104372, 23.862657169169058, 28.668219550412708, 0.5148442, 125.0, 419, 539272, 762, 9.618837200000598
763, 2.028716446649545, 23.81819423185576, 28.605873950759936, 0.5143613500000002, 125.0, 654, 539926, 763, 14.884931999999935
764, 2.6694088366269373, 23.82557289277093, 28.66070548760689, 0.51364225, 275.0, 944, 540870, 764, 21.48507189999964
765, 4.955104209353841, 23.916905537805913, 28.838324607277467, 0.51290515, 240.0, 694, 541564, 765, 15.828144099999918
766, 3.8887389944891404, 23.79796368478122, 28.684144793816333, 0.5124259000000001, 20.0, 371, 541935, 766, 8.685107000000244
767, 3.5831745751736053, 23.849548188433495, 28.71968423492196, 0.5118507999999996, 180.0, 907, 542842, 767, 20.67481819999921
768, 1.9252696984275783, 23.844670331764878, 28.661181588626263, 0.5110498, 270.0, 873, 543715, 768, 19.708081400000083
769, 3.5319103210999767, 23.86389417611111, 28.704137948461565, 0.5103108999999995, 200.0, 769, 544484, 769, 17.60794569999962
770, 4.518167660997534, 23.82299415617333, 28.664541199266118, 0.5094905500000001, 380.0, 1054, 545538, 770, 24.07559139999921
771, 3.461730123486636, 23.887874227489274, 28.798286474550874, 0.5085937000000004, 275.0, 939, 546477, 771, 21.508658100000503
772, 2.8841890658950433, 23.834771221334282, 28.659457499330696, 0.5078543499999999, 120.0, 704, 547181, 772, 16.197760500000186
773, 5.270507208899621, 23.80257169716295, 28.675962303806223, 0.5071807000000003, 155.0, 793, 547974, 773, 18.352769599999192
774, 4.064240075359495, 23.84399336705636, 28.687613776593754, 0.50653315, 95.0, 646, 548620, 774, 14.847044299999652
775, 1.9780305778241223, 23.791532511338392, 28.559553079527987, 0.5060755, 105.0, 371, 548991, 775, 8.644145600000229
776, 2.749543571971434, 23.783998161001303, 28.60134230348253, 0.5054720500000002, 350.0, 970, 549961, 776, 22.451474800000142
777, 8.370641539034816, 23.788486191303054, 28.703725371057587, 0.5047241499999996, 235.0, 692, 550653, 777, 15.982253500000297
778, 2.088001389644648, 23.703270128381398, 28.462701496325042, 0.5041904499999997, 115.0, 494, 551147, 778, 11.705801900000552
779, 2.627248272442772, 23.68003133162427, 28.479293497418716, 0.5034992499999998, 295.0, 1042, 552189, 779, 24.22335699999985
780, 4.990769300077643, 23.83712419412904, 28.746921282992236, 0.5026586500000001, 465.0, 826, 553015, 780, 19.336596900000586
781, 3.8796315895294846, 23.702989625782237, 28.470326762333094, 0.5019980499999999, 200.0, 642, 553657, 781, 14.870667800000774
782, 3.294034599068601, 23.73243977519616, 28.58398668186898, 0.5009959000000005, 470.0, 1585, 555242, 782, 36.67403360000026
783, 3.1704412055296634, 23.748658985434894, 28.550239674345463, 0.49998205, 150.0, 668, 555910, 783, 15.709753799999817
784, 3.3360313864659146, 23.694407749786052, 28.570721685250938, 0.4994704000000001, 25.0, 469, 556379, 784, 10.987014000000272
785, 3.8205783136281783, 23.769779828095352, 28.5793134258311, 0.4987535499999999, 485.0, 1124, 557503, 785, 26.331532800000787
786, 5.298993358403492, 23.820510291747066, 28.752502401606037, 0.49796739999999984, 75.0, 623, 558126, 786, 14.5800935999996
787, 2.771870381850267, 23.68181324005127, 28.47204886075746, 0.49733965000000024, 190.0, 772, 558898, 787, 18.032543099999202
788, 2.8595043262570585, 23.73510657352034, 28.52735544144805, 0.4965480999999998, 450.0, 987, 559885, 788, 23.25519230000009
789, 7.3625856034842165, 23.984444579652497, 28.933102196729333, 0.4957813000000001, 105.0, 717, 560602, 789, 16.87323390000074
790, 4.111445165458831, 24.04285241936682, 28.93318048721102, 0.4951665999999999, 80.0, 649, 561251, 790, 15.251988099999835
791, 2.401891958412498, 24.093250243832365, 28.938030728426845, 0.49465180000000003, 115.0, 495, 561746, 791, 11.688199400000485
792, 5.078881599649389, 24.095503759439538, 29.009556534398307, 0.4940416, 165.0, 861, 562607, 792, 20.343825200000538
793, 3.031872107148952, 24.108663909057327, 28.967062923990643, 0.4932765999999999, 395.0, 839, 563446, 793, 19.770810100000745
794, 5.218968352291913, 24.055420831637512, 28.999436904294715, 0.4925179, 220.0, 847, 564293, 794, 20.14004610000029
795, 3.4244361210054968, 24.075829243921973, 28.954305295979147, 0.49189105000000016, 30.0, 546, 564839, 795, 13.015283499999896
796, 3.882568430732673, 24.023502754306943, 28.892520692613388, 0.4910702499999998, 665.0, 1278, 566117, 796, 30.033160699999826
797, 5.169831139924577, 24.1570239218569, 29.037298900817778, 0.4901977000000001, 110.0, 661, 566778, 797, 15.719565099999272
798, 1.9225798703815746, 24.037525939941407, 28.864186534662355, 0.4897045, 50.0, 435, 567213, 798, 10.482574500000737
799, 3.3917173757065426, 24.046141489202327, 28.93840440576727, 0.48926124999999976, 105.0, 550, 567763, 799, 13.12320660000023
800, 2.0597851905657585, 24.04792939611228, 28.96259569374912, 0.4888269999999999, 20.0, 415, 568178, 800, 9.91329720000067
801, 2.6262739278368032, 24.072506868438886, 28.948206584347677, 0.48822489999999996, 525.0, 923, 569101, 801, 21.92453420000038
802, 4.135692587573714, 24.12317506582956, 29.06858265698786, 0.4876480000000001, 55.0, 359, 569460, 802, 8.473240199999964
803, 6.333029229541619, 24.29810800128513, 29.372412408192954, 0.48708145, 140.0, 900, 570360, 803, 21.510459199999787
804, 2.1191605723503493, 24.457612908404805, 29.39103108385335, 0.4865108499999998, 55.0, 368, 570728, 804, 8.812460899999678
805, 3.2142148686074234, 24.50430208767723, 29.477774515859878, 0.4858057000000001, 305.0, 1199, 571927, 805, 28.640946299999996
806, 3.991953833509992, 24.457216363589886, 29.426168071662545, 0.4847976999999999, 240.0, 1041, 572968, 806, 24.858680299999833
807, 1.7696285277683483, 24.357128685399104, 29.26726179022538, 0.4841155, 20.0, 475, 573443, 807, 11.51841289999993
808, 2.1325888338136743, 24.49973532566331, 29.427320491666258, 0.4837500999999999, 80.0, 337, 573780, 808, 8.176186400000006
809, 3.7293805695587783, 24.481469811638483, 29.45583000731983, 0.48328570000000015, 335.0, 695, 574475, 809, 16.650376399999914
810, 5.791255458185355, 24.456979205378346, 29.51154631750507, 0.4826791, 155.0, 653, 575128, 810, 16.43225490000077
811, 2.9685536285547474, 24.4318815626051, 29.385226525401617, 0.48210039999999993, 145.0, 633, 575761, 811, 15.544042399999853
812, 3.3441026610351354, 24.481241006960815, 29.45947784586689, 0.48154149999999996, 120.0, 609, 576370, 812, 14.685161599999446
813, 3.9848722157865577, 24.450770303373428, 29.430773971222784, 0.4809803499999998, 90.0, 638, 577008, 813, 15.479435399999602
814, 2.4074520860150757, 24.40730878280853, 29.343799141798524, 0.47995390000000004, 450.0, 1643, 578651, 814, 39.728219999999055
815, 4.31058582991897, 24.46545718986831, 29.42532001655259, 0.47883880000000006, 140.0, 835, 579486, 815, 20.293721400001232
816, 4.352143509636506, 24.801791664419138, 29.839695198509524, 0.4779752499999997, 405.0, 1084, 580570, 816, 26.289144899999883
817, 3.995870023569306, 25.13247446653222, 30.318504918523196, 0.4771661500000001, 110.0, 714, 581284, 817, 17.42829510000047
818, 4.035517846616674, 25.02912385993149, 30.12056298387414, 0.4765347999999997, 95.0, 689, 581973, 818, 16.946488399998998
819, 3.8321794408551124, 25.123362870195546, 30.234662051804722, 0.4759156, 185.0, 687, 582660, 819, 16.81404299999849
820, 2.9858165710215356, 25.037008540645527, 30.09775584761504, 0.4752531999999996, 415.0, 785, 583445, 820, 19.148344400000497
821, 3.4202064772835, 25.06939034163952, 30.12907088547945, 0.47466954999999983, 95.0, 512, 583957, 821, 12.551740600001722
822, 3.5484207640863312, 25.013514113998017, 30.07612364234964, 0.47400759999999975, 245.0, 959, 584916, 822, 23.45641550000073
823, 3.132608402555673, 25.12413291148959, 30.18860877124293, 0.47329075, 105.0, 634, 585550, 823, 15.60051150000072
824, 1.9390176236629486, 24.996994897062557, 30.00760312385747, 0.47282275, 35.0, 406, 585956, 824, 10.074718900001244
825, 4.194245674611417, 25.026676554536614, 30.14479978504099, 0.4723254999999997, 220.0, 699, 586655, 825, 17.096503900000243
826, 4.820182335822413, 25.080120574393774, 30.238572625809063, 0.4718138499999998, 45.0, 438, 587093, 826, 10.838284099998418
827, 5.76216721042269, 25.132537743984123, 30.26880619125149, 0.4714588, 85.0, 351, 587444, 827, 8.887998300000618
828, 3.4068027437374924, 25.060493640808396, 30.15269368550424, 0.47083059999999965, 230.0, 1045, 588489, 828, 27.5961800999994
829, 2.9258090086486126, 24.96416108632825, 30.031817822931558, 0.4700984500000001, 125.0, 582, 589071, 829, 14.966064199999892
830, 3.5040466184795074, 25.071059310516564, 30.173875410357155, 0.469369, 350.0, 1039, 590110, 830, 25.29329830000097
831, 4.855838061672646, 25.115484872755115, 30.234889810163896, 0.46849194999999993, 115.0, 910, 591020, 831, 22.499053699999422
832, 4.211546250310406, 25.125492525812405, 30.288770578868352, 0.46778095000000014, 170.0, 670, 591690, 832, 16.54403540000021
833, 4.9988006950736175, 25.20068849116662, 30.360284570289, 0.4670703999999998, 525.0, 909, 592599, 833, 22.33718520000002
834, 4.162027250711734, 25.20832152733436, 30.3337237402109, 0.46636885000000006, 110.0, 650, 593249, 834, 16.019655899999634
835, 3.522260411685213, 25.10198035371413, 30.178916686171785, 0.46588015, 35.0, 436, 593685, 835, 10.900367100000949
836, 6.218543728008136, 25.22268381444696, 30.36411198960371, 0.46538109999999966, 110.0, 673, 594358, 836, 16.774100999999064
837, 3.517505870847573, 25.170005243987287, 30.275692958549914, 0.46489555, 65.0, 406, 594764, 837, 10.15718089999973
838, 4.862056168879927, 25.164803104753346, 30.315323974804723, 0.46439650000000005, 160.0, 703, 595467, 838, 17.45688970000083
839, 2.9736911181926216, 25.04640653003594, 30.108899690360257, 0.4634519500000003, 670.0, 1396, 596863, 839, 34.636159300000145
840, 5.098613139853916, 25.114678808714878, 30.251791755314567, 0.4624155999999996, 475.0, 907, 597770, 840, 22.357066599999598
841, 4.135394163823167, 25.099375129926322, 30.206405837937158, 0.4617347500000001, 75.0, 606, 598376, 841, 15.34348399999908
842, 3.5714918288429622, 25.143312968937952, 30.273165575178975, 0.4610484999999997, 180.0, 919, 599295, 842, 22.976318099999844
843, 3.94090915106132, 25.213524713650557, 30.30964401137661, 0.4604751999999999, 85.0, 355, 599650, 843, 9.06244229999902
844, 3.4758103900679287, 25.147909408513545, 30.24839528169231, 0.4600692999999999, 105.0, 547, 600197, 844, 13.817152499999793
845, 5.903078654311149, 25.11922674630882, 30.29707558420648, 0.45947170000000015, 135.0, 781, 600978, 845, 19.63069710000127
846, 4.2545400251486525, 25.05553734456009, 30.13924969726366, 0.45870085, 210.0, 932, 601910, 846, 23.46864269999969
847, 3.5023418136346143, 25.017262039455115, 30.049924634027143, 0.4579007500000003, 245.0, 846, 602756, 847, 21.42225839999992
848, 5.13330021048162, 25.107473373413086, 30.19372797135543, 0.4569975999999996, 375.0, 1161, 603917, 848, 29.30837910000082
849, 6.0178185276542795, 25.124515536289813, 30.248334046092367, 0.45617320000000006, 130.0, 671, 604588, 849, 16.91616580000118
850, 5.0795687701975805, 25.103711030136868, 30.243202302514053, 0.45544689999999965, 275.0, 943, 605531, 850, 23.88281079999979
851, 3.434645594523628, 25.041116766227308, 30.098551691040512, 0.45479035, 35.0, 516, 606047, 851, 13.157607500001177
852, 5.574386274533255, 25.132700933443083, 30.23251897971947, 0.4543007499999999, 110.0, 572, 606619, 852, 14.385642900000676
853, 2.123975006617734, 25.04343686368224, 30.057832262028242, 0.453808, 115.0, 523, 607142, 853, 13.057690200001161
854, 3.586833974189664, 25.132810987505998, 30.235169517784787, 0.45305964999999987, 270.0, 1140, 608282, 854, 28.99317549999978
855, 4.698959999160417, 25.033462053100113, 30.070913329547896, 0.45231354999999995, 80.0, 518, 608800, 855, 13.229830300000685
856, 4.259848622627539, 25.021091920866382, 30.143906737403046, 0.45170515000000006, 195.0, 834, 609634, 856, 21.265331900000092
857, 5.515092104706207, 25.533049033076754, 30.769640788107715, 0.45092125000000033, 160.0, 908, 610542, 857, 23.0941270000003
858, 5.04528435161404, 25.850788193841538, 31.161107224894593, 0.4503241, 25.0, 419, 610961, 858, 10.859880499998326
859, 6.963255701256248, 25.90182335331755, 31.175284118172506, 0.44977779999999973, 300.0, 795, 611756, 859, 20.575805100001162
860, 6.336398359421675, 25.79139549667771, 31.067044550234133, 0.44922025, 30.0, 444, 612200, 860, 11.429693500000212
861, 2.9624194541996944, 25.89808441954232, 31.12997691670402, 0.4486086999999997, 250.0, 915, 613115, 861, 23.495653400001174
862, 7.758444441342932, 25.907669193419064, 31.275782197232463, 0.44789049999999986, 35.0, 681, 613796, 862, 17.44657179999922
863, 2.829138627755336, 25.862724896944485, 31.077568954076522, 0.4471452999999996, 260.0, 975, 614771, 863, 24.85548629999903
864, 2.3508455150184178, 25.742185971093555, 30.892195015357284, 0.4465364499999998, 90.0, 378, 615149, 864, 9.791773099999773
865, 6.180931601696575, 25.872221144560342, 31.165862962835675, 0.44607745, 155.0, 642, 615791, 865, 16.48774659999981
866, 3.7865322672895023, 25.78550784701393, 31.046142564501082, 0.44559955000000007, 155.0, 420, 616211, 866, 10.963625399999728
867, 3.806707028621951, 25.90778332719436, 31.144763263372276, 0.44503615, 160.0, 832, 617043, 867, 21.345752600000196
868, 4.105231978515179, 25.834474399809693, 31.08054884384874, 0.4444992999999999, 80.0, 361, 617404, 868, 9.352690100000473
869, 3.0337570259264157, 25.87337406215383, 31.08962849004945, 0.4440353500000001, 190.0, 670, 618074, 869, 17.549501800000144
870, 4.36632807950826, 25.961142800918232, 31.22115776049586, 0.44345755000000026, 200.0, 614, 618688, 870, 15.943609200001447
871, 3.317634086352151, 25.75769212564233, 31.049746664705445, 0.4430025999999998, 60.0, 397, 619085, 871, 10.284726699999737
872, 5.414356583425744, 25.946960681256297, 31.323135185705773, 0.4426390000000001, 80.0, 411, 619496, 872, 10.685217199999897
873, 3.9833060249346612, 26.072336074633476, 31.370581768177175, 0.44213814999999995, 185.0, 702, 620198, 873, 17.96088940000118
874, 3.2800744706764817, 26.546262913942336, 31.907910481095314, 0.4415342499999998, 85.0, 640, 620838, 874, 16.651897600000666
875, 6.386784796913465, 26.575881850508292, 32.03880730228148, 0.4409667999999999, 105.0, 621, 621459, 875, 16.039170300000478
876, 2.382527142027756, 26.63959507632565, 31.981694278469334, 0.44051409999999996, 50.0, 385, 621844, 876, 10.111605399999462
877, 2.2918379789336667, 26.551404031224074, 31.886023119540518, 0.44007174999999976, 75.0, 598, 622442, 877, 15.548160700000153
878, 3.1808403967145864, 26.550062537534874, 31.904263302384955, 0.43948855, 135.0, 698, 623140, 878, 18.23661340000035
879, 5.6236182991766706, 26.627968207845147, 32.06114058674506, 0.4389836499999999, 35.0, 424, 623564, 879, 11.03043450000041
880, 4.572330882538965, 26.565743101623667, 31.970035881191105, 0.43837705000000027, 210.0, 924, 624488, 880, 24.18607939999856
881, 5.313749146297277, 26.616367051637745, 32.073881547308474, 0.4375773999999999, 155.0, 853, 625341, 881, 22.319144200000665
882, 4.109573673605041, 26.56995195492729, 31.970559677775725, 0.43688800000000017, 120.0, 679, 626020, 882, 17.73611669999991
883, 4.0441689440315685, 26.551474615403677, 31.928041523094073, 0.43625215000000006, 155.0, 734, 626754, 883, 19.107956199999535
884, 3.977968205171753, 26.650905094171726, 32.05640664106897, 0.4355785000000003, 140.0, 763, 627517, 884, 20.01291879999917
885, 4.36113680808399, 26.589570952276897, 31.988146900111794, 0.43481395, 215.0, 936, 628453, 885, 24.59282069999972
886, 4.764513689847219, 26.572683133776227, 31.971264719963074, 0.4339391500000003, 245.0, 1008, 629461, 886, 26.549842200000057
887, 5.1975191415106154, 26.46378714996082, 31.816966585655248, 0.4330026999999996, 205.0, 1073, 630534, 887, 28.3551482999992
888, 2.1219790328442745, 26.228603097531057, 31.518773109178337, 0.43208019999999997, 305.0, 977, 631511, 888, 25.79306439999891
889, 3.7286599841439276, 26.280879121591614, 31.604498080426108, 0.4311131500000003, 380.0, 1172, 632683, 889, 30.669607100000576
890, 3.9761358603615973, 26.367195516474105, 31.647749227636, 0.43043274999999986, 60.0, 340, 633023, 890, 8.998019299999214
891, 3.0715362933334163, 26.302854281599803, 31.63694365819295, 0.4299449500000001, 70.0, 744, 633767, 891, 19.785581600001024
892, 5.2699245554091645, 26.319257602080196, 31.663519726174325, 0.429175, 285.0, 967, 634734, 892, 25.850572600000305
893, 4.0729469836799685, 26.32421988312916, 31.67217880166987, 0.42857245000000005, 25.0, 372, 635106, 893, 9.90649940000003
894, 2.1788858848416117, 26.24576936201616, 31.531452655004077, 0.4281327999999999, 135.0, 605, 635711, 894, 16.22978929999954
895, 3.214492768298516, 26.27046311034589, 31.55368210746453, 0.4276184499999998, 75.0, 538, 636249, 895, 14.400828399999227
896, 3.9886705294721105, 26.35422999173431, 31.696786873206253, 0.42690520000000026, 360.0, 1047, 637296, 896, 28.14836159999868
897, 3.0461147236025363, 26.286828142833475, 31.592017133537652, 0.42607134999999974, 155.0, 806, 638102, 897, 21.7953282999988
898, 4.953887509432706, 26.25590439189564, 31.63384800650857, 0.42521365000000005, 525.0, 1100, 639202, 898, 29.336879899999985
899, 8.519201232988248, 26.34644482099297, 31.87072151725249, 0.42439510000000014, 140.0, 719, 639921, 899, 19.100057800000286
900, 2.974950498732643, 26.180469830205123, 31.46072902266435, 0.4236143500000001, 175.0, 1016, 640937, 900, 27.109367900000507
901, 3.868693881470965, 26.189311255849535, 31.493852161817518, 0.42260455000000025, 495.0, 1228, 642165, 901, 32.66083069999877
902, 3.853195387468743, 26.133633428653383, 31.44823112294399, 0.4216968999999997, 205.0, 789, 642954, 902, 21.236213700000008
903, 4.968530075833365, 26.18069268949739, 31.506777457352523, 0.42093234999999996, 195.0, 910, 643864, 903, 24.559459200001584
904, 3.0370729085103965, 26.129367519896707, 31.438196902804904, 0.42015835, 140.0, 810, 644674, 904, 22.073563199999626
905, 2.942309621026489, 26.1262617988966, 31.383922277991452, 0.4194320500000001, 205.0, 804, 645478, 905, 21.59186529999897
906, 3.369986199903563, 26.197347291758362, 31.495853039020663, 0.4187827000000001, 155.0, 639, 646117, 906, 17.396645900000294
907, 4.944002866711832, 26.16001144431819, 31.518302303393448, 0.41819185, 160.0, 674, 646791, 907, 18.365575499999977
908, 2.1375064145620555, 26.13646375129834, 31.41007988513566, 0.41765859999999977, 130.0, 511, 647302, 908, 13.912621999999828
909, 2.683140021355466, 26.143280724756124, 31.41010562779671, 0.41693005000000016, 355.0, 1108, 648410, 909, 29.802169099999446
910, 4.185064504828852, 26.15470410651967, 31.465706313079988, 0.4159881999999998, 285.0, 985, 649395, 910, 26.731590100000176
911, 5.170982276452281, 26.224203101700112, 31.576527238495235, 0.4150112499999998, 335.0, 1186, 650581, 911, 32.26905439999973
912, 6.815578565001488, 26.280969258665127, 31.70760556286528, 0.4141827999999999, 175.0, 655, 651236, 912, 17.885094900000695
913, 2.146979906331663, 26.250991106033325, 31.52422963760116, 0.41357124999999983, 135.0, 704, 651940, 913, 19.353589999998803
914, 7.0862829243415035, 26.214724238961935, 31.582374840974808, 0.41302405, 160.0, 512, 652452, 914, 14.012043799999446
915, 2.186908522997454, 26.2922989060674, 31.567919321667784, 0.41246875000000016, 205.0, 722, 653174, 915, 19.752574000000095
916, 5.187866355587256, 26.256525850225167, 31.590474776314768, 0.411841, 210.0, 673, 653847, 916, 18.41254840000147
917, 7.168864913087723, 26.357615951326693, 31.786989824597722, 0.41118085000000004, 375.0, 794, 654641, 917, 21.712824099999125
918, 2.976375640865336, 26.309292164254696, 31.639409261392363, 0.41050629999999977, 165.0, 705, 655346, 918, 19.477392099999634
919, 3.2503170608904712, 26.21372327136386, 31.50099581821709, 0.40983580000000003, 130.0, 785, 656131, 919, 21.826047200000176
920, 2.09217895125284, 26.23670876653571, 31.50138531735069, 0.4091405499999997, 345.0, 760, 656891, 920, 20.938573199999155
921, 3.1039498465299964, 26.281057058428434, 31.615139361097853, 0.4084974999999999, 160.0, 669, 657560, 921, 18.505494199998793
922, 4.112204090807, 26.31138637049148, 31.678685087856344, 0.40774779999999966, 270.0, 997, 658557, 922, 27.482670399998824
923, 3.9617653815148706, 26.297488284795776, 31.643140588665755, 0.40712679999999973, 105.0, 383, 658940, 923, 10.621516299999712
924, 2.990334516905182, 26.211434947277034, 31.509842731124923, 0.4063478499999996, 485.0, 1348, 660288, 924, 37.225346200000786
925, 4.586076974755642, 25.85728980248507, 31.204112987973428, 0.40532635, 180.0, 922, 661210, 925, 25.754977800001143
926, 4.19270638133223, 25.810124686988626, 31.035457540976033, 0.4044952000000002, 215.0, 925, 662135, 926, 25.413910600000236
927, 3.174088972035664, 25.82148357372188, 31.04105074960782, 0.4038103, 30.0, 597, 662732, 927, 16.696825799999715
928, 3.8555563527314476, 25.863689090027016, 31.140659335601196, 0.4030255000000003, 275.0, 1147, 663879, 928, 31.592627099998936
929, 4.058530460125697, 25.858552023546018, 31.12120789022588, 0.4020269499999997, 185.0, 1072, 664951, 929, 29.602764899998874
930, 6.294538608818941, 25.91738983714133, 31.253169687941618, 0.40128085000000013, 55.0, 586, 665537, 930, 16.42588640000031
931, 5.386505809710853, 25.90551060048779, 31.1971098262461, 0.40083804999999983, 60.0, 398, 665935, 931, 11.21236669999962
932, 3.7324295637105336, 25.911565642091322, 31.138375307688126, 0.4002872500000002, 175.0, 826, 666761, 932, 23.03782130000036
933, 4.052566934477038, 25.89126007307821, 31.222361550402287, 0.3997647999999999, 55.0, 335, 667096, 933, 9.560332099999869
934, 4.374254864660439, 25.863121543343613, 31.125120789449582, 0.39921399999999957, 255.0, 889, 667985, 934, 24.874106100000063
935, 4.31146228849453, 25.91412641009364, 31.17539999006038, 0.39841299999999996, 190.0, 891, 668876, 935, 24.99783649999881
936, 2.341679619219298, 25.866246174891952, 31.05210028452203, 0.39779110000000006, 30.0, 491, 669367, 936, 13.738442900001246
937, 4.289447665680862, 25.92877434395455, 31.217284214784886, 0.39725379999999993, 105.0, 703, 670070, 937, 19.636261900001045
938, 3.305144882959992, 26.413554044298003, 31.77158298581699, 0.39664899999999986, 185.0, 641, 670711, 938, 18.289219700000103
939, 2.841703140816905, 26.44956776936849, 31.820685508034448, 0.39598930000000016, 130.0, 825, 671536, 939, 23.166857700000037
940, 5.717097436279374, 26.40440854578985, 31.83310958585292, 0.39532059999999986, 145.0, 661, 672197, 940, 18.488908700001048
941, 5.155545826201712, 26.30931565015003, 31.669842327483977, 0.3946667500000001, 130.0, 792, 672989, 941, 22.230071599999064
942, 3.6444763653877006, 26.31800182016986, 31.6308334901505, 0.3941047, 110.0, 457, 673446, 942, 12.803965499999322
943, 3.71300884376398, 26.383919137507437, 31.76977102068878, 0.3937320999999997, 35.0, 371, 673817, 943, 10.639977999999246
944, 2.4000975824612425, 26.314099830493593, 31.63964279193926, 0.39338560000000006, 50.0, 399, 674216, 944, 11.392501299998912
945, 7.639435071600687, 26.416941421112153, 31.85082305826543, 0.39291175, 135.0, 654, 674870, 945, 18.55518149999989
946, 3.9591624685379916, 26.434864653661098, 31.78299663574757, 0.39195414999999967, 540.0, 1474, 676344, 946, 41.29933390000042
947, 2.6627457026609704, 26.351492632131343, 31.66365381732948, 0.39081294999999955, 355.0, 1062, 677406, 947, 30.37178209999911
948, 1.9697578596362078, 26.33096213901744, 31.638501461814432, 0.3900902500000001, 65.0, 544, 677950, 948, 15.51802779999889
949, 2.0988205241648337, 26.295515851332592, 31.59343337554198, 0.3894710499999997, 210.0, 832, 678782, 949, 23.682672799999636
950, 5.048919691972209, 26.41323321271208, 31.832403922876985, 0.3888135999999999, 90.0, 629, 679411, 950, 17.81530019999991
951, 5.578091983029371, 26.76061256597986, 32.260786140878096, 0.38811339999999966, 165.0, 927, 680338, 951, 26.379676700000346
952, 3.5440767433379112, 27.39261517475561, 32.92410189835066, 0.38725974999999996, 265.0, 970, 681308, 952, 27.571071700000175
953, 4.392403379503546, 27.34018377223004, 32.90060299568262, 0.38642095000000004, 165.0, 894, 682202, 953, 25.582988399999522
954, 2.5404232352299796, 27.3612554507148, 32.858989162014836, 0.3857194, 135.0, 665, 682867, 954, 19.2193159999988
955, 5.201967947351595, 27.289081528005585, 32.8817670512306, 0.38511819999999997, 145.0, 671, 683538, 955, 19.12703909999982
956, 3.740107262044188, 27.38690713753173, 32.95051302325853, 0.3844378, 335.0, 841, 684379, 956, 24.143799299999955
957, 3.9268073406103436, 27.378110375868534, 32.938585487298205, 0.38355085, 375.0, 1130, 685509, 957, 32.281915199999276
958, 5.212449041050044, 27.302146950499903, 32.86560184606831, 0.38266704999999984, 125.0, 834, 686343, 958, 23.931042800000796
959, 3.565539793871343, 27.406195169448853, 32.930343145370486, 0.3818417500000001, 515.0, 1000, 687343, 959, 28.717807700000776
960, 4.2334914820954985, 27.30539594449495, 32.84965106562564, 0.38122074999999994, 70.0, 380, 687723, 960, 11.007623499999681
961, 5.412160347099141, 27.501987209274976, 33.14406553678761, 0.3808594, 80.0, 423, 688146, 961, 12.236647300000186
962, 3.5242607920481688, 27.300558796411828, 32.81262731552124, 0.38024245, 460.0, 948, 689094, 962, 27.42150799999945
963, 5.298077998750181, 27.4534122685352, 33.02677625345896, 0.37951705, 160.0, 664, 689758, 963, 19.196235800000068
964, 3.855894588745598, 27.224733640466418, 32.73976513998849, 0.37871425, 240.0, 1120, 690878, 964, 32.50982069999918
965, 3.17132278204022, 27.123408546743466, 32.61107735301173, 0.37797804999999995, 50.0, 516, 691394, 965, 15.016949400000158
966, 2.2829964389069093, 27.09779219157955, 32.53723331708365, 0.3773116, 495.0, 965, 692359, 966, 28.061107999999876
967, 4.832109215048173, 27.122348835187168, 32.64946069382634, 0.3763774000000003, 225.0, 1111, 693470, 967, 32.40728140000101
968, 3.7275441014287547, 27.1983302713392, 32.679438620363975, 0.3754827999999997, 185.0, 877, 694347, 968, 25.57616920000146
969, 4.633308932748891, 27.118536158920747, 32.62386703317341, 0.37459450000000005, 395.0, 1097, 695444, 969, 31.946449700000812
970, 5.796113837834713, 27.175353047715642, 32.72836395807191, 0.3739303, 70.0, 379, 695823, 970, 11.093799500000387
971, 4.457143635321886, 27.200262156399813, 32.718948075265594, 0.37337364999999995, 170.0, 858, 696681, 971, 25.12119519999942
972, 4.146365427927924, 27.13992015508672, 32.67587899655239, 0.37269099999999983, 175.0, 659, 697340, 972, 19.39220639999985
973, 5.712952174554375, 27.140150571125023, 32.68110054740497, 0.37180674999999996, 620.0, 1306, 698646, 973, 38.09258129999944
974, 2.935913167495842, 27.122982960531157, 32.57585543279779, 0.3708905500000001, 170.0, 730, 699376, 974, 21.51356990000022
975, 5.242875434852751, 27.107297699947793, 32.61760333184014, 0.3701881, 165.0, 831, 700207, 975, 24.539923099999214
976, 6.375392266328873, 26.947955753830477, 32.46216074521934, 0.3692624500000003, 315.0, 1226, 701433, 976, 36.12482869999985
977, 4.1452260495992155, 26.891795826709178, 32.35946454025629, 0.36842499999999984, 130.0, 635, 702068, 977, 18.825982700000168
978, 2.3625244291081113, 26.84883544396381, 32.23962970655791, 0.36796284999999995, 95.0, 392, 702460, 978, 11.874215900001218
979, 5.560082903684549, 26.89373657874812, 32.38016455905889, 0.36709794999999973, 390.0, 1530, 703990, 979, 45.03670760000023
980, 7.233702037113033, 26.944242919946547, 32.48613203660846, 0.36585279999999987, 365.0, 1237, 705227, 980, 36.4596419999998
981, 4.712658425957515, 26.874499937836884, 32.33867643697061, 0.36507699999999993, 90.0, 487, 705714, 981, 14.384078900000532
982, 6.72554008985061, 26.962910556519954, 32.491414094722714, 0.36454374999999994, 190.0, 698, 706412, 982, 20.759490200000073
983, 2.130211757082485, 26.89339794391265, 32.289022591821336, 0.3640006, 25.0, 509, 706921, 983, 15.14222829999926
984, 2.9192136853882475, 26.897150990092307, 32.29788678443744, 0.3633760000000001, 145.0, 879, 707800, 984, 26.15790299999935
985, 4.496324837164351, 26.88077138672765, 32.34788414757731, 0.36282609999999993, 35.0, 343, 708143, 985, 10.20968560000074
986, 7.211122131976527, 26.94511126743928, 32.460665475061184, 0.3622591000000001, 390.0, 917, 709060, 986, 28.24300740000035
987, 3.854520911157799, 26.916865391557625, 32.39215852432892, 0.3615251499999998, 125.0, 714, 709774, 987, 21.31486059999952
988, 4.9127163927284325, 26.879837812212234, 32.303699107421615, 0.36078580000000005, 420.0, 929, 710703, 988, 27.795682599999054
989, 2.869084282671181, 26.938960196627963, 32.41557721928454, 0.3599996499999998, 200.0, 818, 711521, 989, 24.474575599999298
990, 3.4794238641105517, 26.897666037203084, 32.32502945023354, 0.35940879999999986, 80.0, 495, 712016, 990, 14.9367256000005
991, 6.731480179226665, 26.957665042023162, 32.51024881334447, 0.35888454999999997, 150.0, 670, 712686, 991, 20.0741407000005
992, 3.2583654708075294, 26.83227979419301, 32.26082025176113, 0.35835130000000004, 70.0, 515, 713201, 992, 15.493938800000251
993, 3.7571447701977494, 26.947903998528968, 32.43380891170698, 0.35759574999999993, 420.0, 1164, 714365, 993, 34.97944049999933
994, 5.870968244948311, 26.9546928185259, 32.42989453552775, 0.35691625, 55.0, 346, 714711, 994, 10.360216499999297
995, 5.407123445428106, 26.91686446022174, 32.47111895703894, 0.3565890999999998, 35.0, 381, 715092, 995, 11.420074400000885
996, 2.853514456187998, 26.88666373699695, 32.32680218036358, 0.3560315499999999, 260.0, 858, 715950, 996, 25.871562000000267
997, 3.3095569509741933, 26.901458819996225, 32.3649799416282, 0.35539794999999996, 90.0, 550, 716500, 997, 16.693314400001327
998, 6.584431074840511, 26.94559081563961, 32.54774418259116, 0.3547684000000001, 215.0, 849, 717349, 998, 25.601549799999702
999, 3.620241324670155, 26.914895902665634, 32.37166132580634, 0.3539836000000002, 215.0, 895, 718244, 999, 27.176996399999553
1000, 5.559502275679281, 26.9671891098956, 32.48808110356994, 0.35317629999999994, 185.0, 899, 719143, 1000, 26.9654387999999
1001, 4.711130385886621, 26.948795984631126, 32.43087691720198, 0.3523271500000001, 235.0, 988, 720131, 1001, 30.06044060000022
1002, 4.653077840552491, 26.72788206446124, 32.189144942720056, 0.3515373999999999, 125.0, 767, 720898, 1002, 23.24065840000003
1003, 2.9198587258162174, 26.69818607240627, 32.12728072597773, 0.3505415499999999, 615.0, 1446, 722344, 1003, 43.80721090000043
1004, 3.3631708216795064, 26.73382515939475, 32.132517135016826, 0.3494242, 435.0, 1037, 723381, 1004, 31.55408669999997
1005, 3.614315928838261, 26.779343063507845, 32.24421431990325, 0.34842025000000015, 350.0, 1194, 724575, 1005, 36.198223500001404
1006, 4.525754243742406, 26.794405271762095, 32.2493231862326, 0.3475017999999998, 260.0, 847, 725422, 1006, 25.696292099999482
1007, 6.78988049587751, 26.79015552279461, 32.32264425955623, 0.34682184999999993, 110.0, 664, 726086, 1007, 20.406574299999193
1008, 2.0694791355165125, 26.76622230444857, 32.17924825070298, 0.34628050000000005, 60.0, 539, 726625, 1008, 16.524424200000794
1009, 3.7702691050109554, 26.729871938457595, 32.159993620691104, 0.34556005000000034, 350.0, 1062, 727687, 1009, 32.58172350000132
1010, 2.921091831242923, 26.64249063196762, 32.016889229663825, 0.3447563499999999, 155.0, 724, 728411, 1010, 22.0877074
1011, 2.3459661835085637, 26.748286963990015, 32.15804121191775, 0.34392340000000005, 450.0, 1127, 729538, 1011, 34.46502969999892
1012, 6.510872703304507, 26.70731459068976, 32.27101109847139, 0.3431831499999998, 110.0, 518, 730056, 1012, 16.17437769999924
1013, 2.4426876675827263, 26.574430553006454, 31.91883307219671, 0.34256665000000003, 245.0, 852, 730908, 1013, 26.128940300000977
1014, 3.427273404157579, 26.55132709681292, 31.922679860304303, 0.34195195, 50.0, 514, 731422, 1014, 15.967389199999161
1015, 3.7962640920896114, 26.563064671634287, 31.967843067971316, 0.3411599500000002, 330.0, 1246, 732668, 1015, 38.40689179999936
1016, 5.521668711934794, 26.511647559226827, 31.903290160158846, 0.3404300499999999, 15.0, 376, 733044, 1016, 11.621591600000102
1017, 5.12654249683601, 26.62250787588882, 32.0938697846964, 0.33983200000000013, 240.0, 953, 733997, 1017, 29.435227400001168
1018, 5.3385369679926304, 26.5967517618633, 31.98964707503843, 0.33905124999999986, 220.0, 782, 734779, 1018, 24.045008199998847
1019, 4.154925312858763, 26.53196330738675, 31.912661719474062, 0.3381341500000001, 385.0, 1256, 736035, 1019, 38.64199879999978
1020, 5.592297252628516, 26.600702162038004, 32.042639543554216, 0.33703480000000036, 355.0, 1187, 737222, 1020, 36.857503299999735
1021, 3.700805727271665, 26.614053038884872, 31.975740159241635, 0.33613974999999985, 140.0, 802, 738024, 1021, 25.153412800000297
1022, 3.3767538990014443, 26.58932175020084, 31.97946900155166, 0.33525999999999995, 260.0, 1153, 739177, 1022, 35.77570190000006
1023, 5.480689557564779, 26.575752376113584, 32.030707228298006, 0.3343186000000002, 130.0, 939, 740116, 1023, 29.269492000001264
1024, 2.304957873457008, 27.338013294008043, 32.83492322497898, 0.33373404999999995, 35.0, 360, 740476, 1024, 11.249552400000539
1025, 5.823938653772645, 27.441975135921325, 33.035896177262345, 0.3334266999999999, 40.0, 323, 740799, 1025, 10.084980499999801
1026, 4.9230538176306595, 27.342149688504268, 32.92483221013495, 0.33296409999999993, 170.0, 705, 741504, 1026, 22.267582599999514
1027, 4.542695529124574, 27.437251369622793, 33.007725484781155, 0.3323773000000001, 110.0, 599, 742103, 1027, 18.7568639000001
1028, 7.33273710431505, 27.44300788590888, 33.068737997060396, 0.3317864499999999, 345.0, 714, 742817, 1028, 22.41419769999993
1029, 3.0171367823233566, 27.35848726573123, 32.86527268697501, 0.33102820000000005, 245.0, 971, 743788, 1029, 30.42728949999946
1030, 2.459130705544775, 27.38539074572567, 32.86953555578473, 0.33035635000000013, 25.0, 522, 744310, 1030, 16.332913700000063
1031, 6.681303535860422, 27.464284418291992, 33.10854296219478, 0.3296228499999999, 385.0, 1108, 745418, 1031, 35.00504180000098
1032, 4.606536886355872, 27.427914056795647, 32.954410901538516, 0.3286391500000002, 300.0, 1078, 746496, 1032, 33.926005199999054
1033, 6.896914207136915, 27.41001901196548, 33.00674192595545, 0.3279844, 55.0, 377, 746873, 1033, 12.06097679999948
1034, 2.3130677657845977, 27.333956722901245, 32.831048403944926, 0.32762214999999995, 40.0, 428, 747301, 1034, 13.221706799999083
1035, 4.031918419886436, 27.41772441294656, 32.994165599879935, 0.3271280499999999, 155.0, 670, 747971, 1035, 21.00690819999909
1036, 7.586811187896836, 27.442120839431652, 33.16844659440973, 0.3263859999999998, 160.0, 979, 748950, 1036, 32.253015199999936
1037, 3.252139738672191, 27.369525341760543, 32.915903622195835, 0.3256430499999999, 60.0, 672, 749622, 1037, 21.185218200000236
1038, 4.1534095782592395, 27.486118693299016, 33.10450607830126, 0.32505579999999995, 80.0, 633, 750255, 1038, 20.077305299999352
1039, 4.420419126135881, 27.688306012678375, 33.341053264563165, 0.3243007000000001, 215.0, 1045, 751300, 1039, 32.580294100000174
1040, 4.535323197051857, 27.698090471975757, 33.3505089693764, 0.3233237499999997, 600.0, 1126, 752426, 1040, 35.78289869999935
1041, 3.117360994864065, 27.704631934409132, 33.30800819396973, 0.32241115, 345.0, 902, 753328, 1041, 28.577902400000312
1042, 4.477706814640288, 27.666432861345644, 33.29522099806986, 0.32161330000000005, 160.0, 871, 754199, 1042, 27.69740020000063
1043, 5.213744817696074, 27.73612987574409, 33.35836579378913, 0.32091534999999993, 90.0, 680, 754879, 1043, 21.784734700000627
1044, 3.520583134391927, 27.688406575471163, 33.28231455758214, 0.32037894999999994, 40.0, 512, 755391, 1044, 16.36665780000112
1045, 4.2001301003231415, 27.7470317675913, 33.40439904302144, 0.3198358, 175.0, 695, 756086, 1045, 22.037420000000566
1046, 5.04334960690731, 27.734045224489222, 33.40194259173628, 0.3191504499999999, 395.0, 828, 756914, 1046, 26.42781830000058
1047, 4.168007281356493, 27.80498170021408, 33.46050418122257, 0.31849389999999994, 155.0, 631, 757545, 1047, 19.991273499999807
1048, 4.514497148514508, 27.683664739900312, 33.3228991176542, 0.3177212499999998, 270.0, 1086, 758631, 1048, 34.92530179999994
1049, 4.783230846176236, 27.669218167607088, 33.263705657579884, 0.3168703000000001, 195.0, 805, 759436, 1049, 25.64215999999942
1050, 4.94940173078621, 27.72794309644436, 33.3786201153085, 0.3162961, 90.0, 471, 759907, 1050, 15.019291599999633
1051, 4.772839656233944, 27.90867002794658, 33.60274043651896, 0.3157407999999999, 215.0, 763, 760670, 1051, 24.638496400000804
1052, 2.616490026803788, 27.906696403348768, 33.52045503661439, 0.31486464999999986, 500.0, 1184, 761854, 1052, 38.06970469999942
1053, 4.212530552844206, 27.96072765350342, 33.62068925403413, 0.3138593499999999, 450.0, 1050, 762904, 1053, 33.44237140000041
1054, 4.315245133619339, 27.85326517123384, 33.54981272517683, 0.3129643, 300.0, 939, 763843, 1054, 30.280270100000052
1055, 6.747534775178966, 27.92000734659692, 33.6303075553613, 0.3122118999999998, 60.0, 733, 764576, 1055, 23.661423800000193
1056, 3.9576506344090867, 27.790317605120705, 33.46394184052789, 0.31153734999999994, 255.0, 766, 765342, 1056, 24.383602800000517
1057, 6.411284859328684, 27.86223461111283, 33.569440037401165, 0.3108479499999999, 150.0, 766, 766108, 1057, 24.844997500000318
1058, 5.043200316530457, 27.89430274173712, 33.55943281027921, 0.30993805, 545.0, 1256, 767364, 1058, 40.38705090000076
1059, 2.087599439089935, 27.84602204958598, 33.42886404430165, 0.3091892499999999, 75.0, 408, 767772, 1059, 13.365004700001009
1060, 3.222720683681965, 27.92753070373535, 33.5700038848877, 0.3087243999999999, 165.0, 625, 768397, 1060, 20.21798090000084
1061, 3.767694029549313, 27.85254964781045, 33.53322690043284, 0.30826225, 110.0, 402, 768799, 1061, 13.215180400000463
1062, 2.1169739252624984, 27.80746754316183, 33.40376311082106, 0.3078005500000001, 155.0, 624, 769423, 1062, 20.3233352999996
1063, 6.46124110922881, 27.906909378916627, 33.59818928830537, 0.3072974499999998, 75.0, 494, 769917, 1063, 16.120632000000114
1064, 5.437798971608184, 28.317052079735248, 34.07207992265997, 0.3067290999999999, 165.0, 769, 770686, 1064, 25.52683799999977
1065, 4.5456214953272776, 28.283875925427942, 34.02020262976608, 0.3060126999999998, 190.0, 823, 771509, 1065, 26.93067180000071
1066, 3.9522453805982245, 28.243999098563084, 33.97141742560254, 0.3053484999999999, 170.0, 653, 772162, 1066, 21.281607400000212
1067, 3.992008502837835, 28.38740808024551, 34.14397189978397, 0.30475765, 210.0, 660, 772822, 1067, 21.393000300000494
1068, 2.726415934560656, 28.287966716162085, 34.021188619185466, 0.3039975999999999, 300.0, 1029, 773851, 1068, 33.536630099999456
1069, 4.385519018378474, 28.336121133729524, 34.13009690459258, 0.30298375, 515.0, 1224, 775075, 1069, 40.11171120000108
1070, 5.743390390310208, 28.38142172744154, 34.155599359693475, 0.30203020000000014, 105.0, 895, 775970, 1070, 29.712363299999197
1071, 4.066010960610937, 28.37849289658218, 34.115532931500034, 0.30133089999999996, 105.0, 659, 776629, 1071, 21.75495250000131
1072, 2.331162298214873, 28.297055497797725, 34.005909645789124, 0.30082600000000004, 50.0, 463, 777092, 1072, 15.388144499998816
1073, 3.8187241956193962, 28.333242577113463, 34.113581019840886, 0.3002972499999999, 95.0, 712, 777804, 1073, 23.590049199998248
1074, 5.856318613601058, 28.388900973698863, 34.22970877608208, 0.2996483499999999, 100.0, 730, 778534, 1074, 24.090015399999174
1075, 3.85905253877785, 28.36668227219782, 34.116329463990795, 0.29878435, 400.0, 1190, 779724, 1075, 38.718934500000614
1076, 4.424969885754986, 28.518312071151094, 34.346001575373805, 0.29771335000000027, 440.0, 1190, 780914, 1076, 38.89285299999938
1077, 6.262828805115063, 28.570817757196235, 34.42972934619654, 0.2965460499999999, 305.0, 1404, 782318, 1077, 45.999980000000505
1078, 6.254700325991287, 28.698932960385182, 34.57557422450331, 0.29563975, 95.0, 610, 782928, 1078, 20.042911399999866
1079, 5.431259481067007, 28.7363039889893, 34.59302978082137, 0.29508805, 40.0, 616, 783544, 1079, 20.401415300000735
1080, 2.342697938649488, 28.644206213248, 34.35975221015173, 0.29464299999999993, 25.0, 373, 783917, 1080, 12.261568500000067
1081, 6.608839215920118, 28.60917438361211, 34.449011668960026, 0.29408679999999987, 120.0, 863, 784780, 1081, 28.717302500001097
1082, 4.460340829673997, 28.53832030204272, 34.29843855088282, 0.29346534999999996, 35.0, 518, 785298, 1082, 17.377799299998514
1083, 2.0217709942671007, 28.50263781606415, 34.222048334297, 0.2929042, 180.0, 729, 786027, 1083, 24.35320370000045
1084, 6.0634017633507025, 28.667270740866662, 34.523119407892224, 0.29228815, 125.0, 640, 786667, 1084, 21.12080210000022
1085, 3.0682523001797097, 28.549123477798176, 34.32219111454951, 0.29168830000000007, 165.0, 693, 787360, 1085, 23.024350700001378
1086, 2.8134060498817948, 28.56279657053393, 34.32234132456225, 0.29108619999999985, 145.0, 645, 788005, 1086, 21.51307479999923
1087, 3.419232350303347, 28.681461689431156, 34.477122445621404, 0.2905083999999998, 25.0, 639, 788644, 1087, 21.32895129999997
1088, 5.580695880944541, 28.615712842497224, 34.521655361826824, 0.2898149499999998, 315.0, 902, 789546, 1088, 30.108067199998914
1089, 5.755219466368254, 28.7111610266517, 34.59859906454725, 0.28889200000000004, 265.0, 1149, 790695, 1089, 38.279089899999235
1090, 6.686911528863939, 28.706977347650472, 34.54821188492183, 0.2880707500000001, 145.0, 676, 791371, 1090, 22.747774700001173
1091, 4.114203621394872, 28.590847354693555, 34.37129210397561, 0.28759959999999996, 75.0, 371, 791742, 1091, 12.343125500001406
1092, 3.4329934307773198, 28.81114903328911, 34.61681737218584, 0.28720584999999993, 95.0, 504, 792246, 1092, 16.90235010000106
1093, 5.998975652214396, 28.70816858475643, 34.57147950235224, 0.2866852000000001, 240.0, 653, 792899, 1093, 22.071563999999853
1094, 3.478038506977486, 28.666916452894462, 34.483975055280666, 0.28593100000000005, 270.0, 1023, 793922, 1094, 34.43392870000025
1095, 3.2727023757595037, 28.730012033666885, 34.54464322896231, 0.28516825, 160.0, 672, 794594, 1095, 22.62363329999971
1096, 4.234834901742497, 28.74928935968651, 34.6244697728247, 0.28448425, 105.0, 848, 795442, 1096, 28.571820500001195
1097, 4.766380567157614, 28.74270696501801, 34.61074657440186, 0.28379214999999997, 90.0, 690, 796132, 1097, 23.44053679999888
1098, 3.814640719980345, 28.74052517970632, 34.591558079898185, 0.28316935000000004, 185.0, 694, 796826, 1098, 23.369026500000473
1099, 4.7623729043852245, 28.70087792139235, 34.517739614488605, 0.2824084000000001, 230.0, 997, 797823, 1099, 33.53095089999988
1100, 4.292581743539012, 28.785903879441978, 34.6432751456756, 0.28132299999999966, 290.0, 1415, 799238, 1100, 47.757455400000254
1101, 4.615721367299557, 28.82246432210885, 34.70516036912507, 0.28045675, 95.0, 510, 799748, 1101, 17.413201199999094
1102, 4.78738386850972, 29.20839756932752, 35.15649623010772, 0.2798879499999999, 240.0, 754, 800502, 1102, 25.28943470000013
1103, 3.988297813987782, 29.422645766479746, 35.380706862713595, 0.27890154999999994, 290.0, 1438, 801940, 1103, 48.47821269999986
1104, 4.4450570416549295, 29.496381456153827, 35.53651215147577, 0.2778471999999999, 130.0, 905, 802845, 1104, 31.020202300000165
1105, 4.260455633363416, 29.40792397529848, 35.38108079151441, 0.2771888499999999, 115.0, 558, 803403, 1105, 18.97917250000137
1106, 3.8313319235407945, 29.287347819010417, 35.218356468894264, 0.2765664999999999, 210.0, 825, 804228, 1106, 28.340405799999644
1107, 5.198372309496908, 29.440808894417504, 35.427700545571064, 0.27589824999999996, 95.0, 660, 804888, 1107, 22.502479000000676
1108, 3.2009352355468565, 29.37652358078375, 35.299423546519705, 0.2753245, 75.0, 615, 805503, 1108, 21.336705100000472
1109, 4.921101851419531, 29.37154289199852, 35.40988896668762, 0.2747476000000001, 110.0, 667, 806170, 1109, 22.924190899999303
1110, 3.1264106906120235, 29.38710181516435, 35.34529098864057, 0.27413649999999995, 185.0, 691, 806861, 1110, 23.84523270000136
1111, 4.60668899011053, 29.3671207330764, 35.32616967795214, 0.2733841000000001, 175.0, 981, 807842, 1111, 33.680121999999756
1112, 4.907340813120846, 29.408035397289744, 35.42992414938852, 0.27271900000000004, 125.0, 497, 808339, 1112, 16.919830900000306
1113, 4.32121792799089, 29.406925872293456, 35.395715512727435, 0.27214479999999996, 205.0, 779, 809118, 1113, 26.908185099999173
1114, 3.5772245406315775, 29.410990687985052, 35.34504328693469, 0.27155619999999986, 135.0, 529, 809647, 1114, 18.30569110000033
1115, 4.178606922933182, 29.34793885086858, 35.330435489499294, 0.2710085499999999, 115.0, 688, 810335, 1115, 23.769645799999125
1116, 4.4366015997416905, 29.3110344803449, 35.24967296146652, 0.27032814999999993, 490.0, 824, 811159, 1116, 28.367299999999886
1117, 2.999630882907051, 29.29876316531835, 35.2327884044391, 0.26948845, 440.0, 1042, 812201, 1117, 36.069588600001225
1118, 4.120486502893067, 29.24299850463867, 35.197712202329896, 0.26868654999999975, 185.0, 740, 812941, 1118, 25.80183550000038
1119, 2.3160485011171286, 29.257502451077315, 35.14186451334349, 0.2681938, 55.0, 355, 813296, 1119, 12.13265870000032
1120, 4.319728767926869, 29.214090968785662, 35.15186882631354, 0.2677537000000001, 95.0, 623, 813919, 1120, 21.62381070000083
1121, 5.255130783880393, 29.25335066735577, 35.175544754827655, 0.2669923, 430.0, 1069, 814988, 1121, 36.97543839999889
1122, 5.942432067174738, 29.32112109611883, 35.30339556504241, 0.26596629999999977, 520.0, 1211, 816199, 1122, 42.140075599998454
1123, 2.979697223661615, 29.184631666005085, 35.04089466341966, 0.26510859999999997, 120.0, 695, 816894, 1123, 24.389160400000037
1124, 3.2470699639979355, 29.23399429321289, 35.15430100719381, 0.2644335999999998, 250.0, 805, 817699, 1124, 27.923599700001432
1125, 4.087142161200895, 29.22171666983402, 35.11151287194454, 0.2637743499999998, 180.0, 660, 818359, 1125, 22.721440900000744
1126, 4.185399136786962, 29.204975456954365, 35.12483636213271, 0.2630700999999998, 330.0, 905, 819264, 1126, 31.575837299998966
1127, 2.469061154151881, 29.251453834718088, 35.1090286980943, 0.2623649499999998, 45.0, 662, 819926, 1127, 24.186667699999816
1128, 5.471484579278428, 29.610167269650184, 35.665431637066625, 0.26161164999999986, 410.0, 1012, 820938, 1128, 35.520858599998974
1129, 3.775849340698554, 29.574050384187757, 35.54627537640447, 0.2607859, 200.0, 823, 821761, 1129, 28.811422599999787
1130, 4.925434532105376, 29.623434871708582, 35.71366340742199, 0.2601212499999999, 110.0, 654, 822415, 1130, 22.499679200000173
1131, 3.9748353739710556, 29.65145738323366, 35.64862077371797, 0.25928109999999993, 455.0, 1213, 823628, 1131, 42.3987773000008
1132, 2.297263406874175, 29.649062380484224, 35.60472321617229, 0.2584342, 80.0, 669, 824297, 1132, 23.197494899999583
1133, 3.986597394123874, 29.687988918746576, 35.73433751108833, 0.2579662, 85.0, 371, 824668, 1133, 13.158948300000702
1134, 4.557060620888084, 29.647224190100182, 35.6684852186239, 0.25741764999999983, 230.0, 848, 825516, 1134, 29.745903400000316
1135, 3.662808156010672, 29.56885490345369, 35.53662987512541, 0.25655995, 315.0, 1058, 826574, 1135, 37.429196999999476
1136, 3.4475094210618, 29.531584568589043, 35.493885081941364, 0.25579540000000006, 110.0, 641, 827215, 1136, 22.51920220000102
1137, 4.3268893812461915, 29.652480883844966, 35.68731615872219, 0.25508935, 180.0, 928, 828143, 1137, 33.01717480000116
1138, 2.9264995609291, 29.642016126235422, 35.646171455987336, 0.25430230000000004, 425.0, 821, 828964, 1138, 29.12650070000018
1139, 3.826315202087213, 29.57929286394884, 35.57786272083289, 0.25338294999999983, 645.0, 1222, 830186, 1139, 43.40437919999931
1140, 4.276288162746924, 29.54212416260868, 35.5310130046801, 0.25235964999999994, 425.0, 1052, 831238, 1140, 37.0683939999999
1141, 2.2968632093684827, 29.488016203396736, 35.40313124843819, 0.2515996, 135.0, 637, 831875, 1141, 22.71745870000086
1142, 3.2814690251344754, 29.574222116334745, 35.53485177749706, 0.2508382000000001, 585.0, 1055, 832930, 1142, 37.750309500001094
1143, 3.6613524248669163, 29.60042323679775, 35.53737999721127, 0.2501190999999999, 60.0, 543, 833473, 1143, 19.627298500001416
1144, 5.136991197973897, 29.60127960670383, 35.678818037833324, 0.24944680000000008, 240.0, 951, 834424, 1144, 33.72875009999916
1145, 5.384923182454273, 29.60400105085677, 35.59561647012073, 0.2486377, 135.0, 847, 835271, 1145, 30.052000699999553
1146, 5.480586043807567, 29.525470807238023, 35.48282483153021, 0.24797665, 115.0, 622, 835893, 1146, 22.285786099999314
1147, 2.2423954901905847, 29.56174813986211, 35.48663148926375, 0.24741910000000006, 80.0, 617, 836510, 1147, 22.117841499999486
1148, 6.0554866277736075, 29.60251072008316, 35.63449618152288, 0.24674725000000003, 315.0, 876, 837386, 1148, 31.210762200000318
1149, 5.602476808280854, 29.605701114207413, 35.58144546839101, 0.24592690000000003, 510.0, 947, 838333, 1149, 33.92528300000049
1150, 3.8301079578856205, 29.598357018004073, 35.58726437142555, 0.24507774999999996, 265.0, 940, 839273, 1150, 34.31876699999884
1151, 4.571334166227206, 29.66556127852191, 35.67538669272187, 0.2443978, 145.0, 571, 839844, 1151, 20.477090899999894
1152, 4.536272735481221, 29.64778186744702, 35.63884165275894, 0.2438515, 160.0, 643, 840487, 1152, 23.06350080000084
1153, 4.031833397982449, 29.601735100957562, 35.62074552639365, 0.24310539999999997, 525.0, 1015, 841502, 1153, 36.41881520000061
1154, 4.321603215712508, 29.660557743348527, 35.64817229184237, 0.24216354999999992, 355.0, 1078, 842580, 1154, 38.88335559999905
1155, 2.3925542244254943, 29.612771818372938, 35.56931670217803, 0.24145569999999997, 110.0, 495, 843075, 1155, 17.88482290000138
1156, 3.7939892631758303, 29.618408107989605, 35.615049916752355, 0.24086304999999997, 475.0, 822, 843897, 1156, 29.807350200000656
1157, 3.017468449810886, 29.625614987479317, 35.59336252090259, 0.24007194999999992, 175.0, 936, 844833, 1157, 33.81191769999896
1158, 5.867568388265722, 29.71578125673182, 35.76563929838293, 0.23926824999999988, 210.0, 850, 845683, 1158, 30.49985099999867
1159, 2.4072470089146334, 29.644335448587896, 35.62061507695713, 0.23853744999999985, 90.0, 774, 846457, 1159, 28.063166799998726
1160, 3.131675393033175, 29.665100474416473, 35.65843550233357, 0.23786109999999985, 100.0, 729, 847186, 1160, 26.61812219999956
1161, 3.6668765274249964, 29.63208873574504, 35.632167357236604, 0.2370898, 360.0, 985, 848171, 1161, 35.71512430000075
1162, 5.2197096856481275, 29.738684752509972, 35.79275765024526, 0.2360264500000001, 380.0, 1378, 849549, 1162, 49.90128050000021
1163, 4.452561647490341, 29.638901465065587, 35.69527043715441, 0.23517729999999998, 30.0, 509, 850058, 1163, 18.506356199999573
1164, 4.470970433127756, 29.698318501313526, 35.724674367242386, 0.23468904999999993, 140.0, 576, 850634, 1164, 21.084036399999604
1165, 6.649924438014592, 29.832247499523472, 35.95918533918199, 0.23404195000000005, 210.0, 862, 851496, 1165, 31.484822099999292
1166, 4.263963470966727, 29.689383546805676, 35.7172664736524, 0.23347179999999995, 20.0, 405, 851901, 1166, 14.900006800002302
1167, 4.775032205493225, 29.81271142793118, 35.80612938659744, 0.2329286499999999, 95.0, 802, 852703, 1167, 29.367190799999662
1168, 4.089945191911999, 29.81221466652083, 35.86155730065087, 0.23221719999999985, 100.0, 779, 853482, 1168, 28.56184629999916
1169, 6.865459024851375, 29.880357316896028, 36.00679184408749, 0.23168304999999997, 15.0, 408, 853890, 1169, 15.075227099998301
1170, 3.899712814481758, 29.75145333136013, 35.765553768441144, 0.2309841999999999, 185.0, 1145, 855035, 1170, 42.02995709999959
1171, 7.556922832171228, 29.816142907372132, 35.84573638630423, 0.2300482, 280.0, 935, 855970, 1171, 34.30649999999878
1172, 4.191448500018057, 29.79752856334538, 35.83926281022148, 0.22918734999999993, 155.0, 978, 856948, 1172, 36.02615860000151
1173, 3.652430188713234, 29.761237519742778, 35.7680098169834, 0.2283733, 455.0, 831, 857779, 1173, 30.732008300001326
1174, 4.850345990897373, 29.743397465968677, 35.79001511161795, 0.22762539999999998, 445.0, 831, 858610, 1174, 30.73015690000102
1175, 4.762774434178557, 29.77205789869077, 35.820609218977694, 0.2266736499999998, 475.0, 1284, 859894, 1175, 47.27161129999877
1176, 4.630041334115415, 29.808060356878464, 35.87025486291279, 0.2256076, 195.0, 1085, 860979, 1176, 40.033393000001524
1177, 4.583499852410593, 29.827665680163616, 35.86998319142574, 0.2245865499999999, 390.0, 1184, 862163, 1177, 43.974510199997894
1178, 3.8989191331498003, 29.81410019153809, 35.86469149196109, 0.22350834999999988, 320.0, 1212, 863375, 1178, 45.27824139999939
1179, 5.63156378611597, 29.846063511056375, 35.95906626611986, 0.22261239999999993, 120.0, 779, 864154, 1179, 28.877066699998977
1180, 3.242520220679085, 29.808747830034115, 35.835844339967586, 0.22173264999999986, 150.0, 1176, 865330, 1180, 43.97175690000222
1181, 9.196827706527264, 29.93134676581398, 36.079504910637354, 0.22103514999999996, 20.0, 374, 865704, 1181, 14.176557200000389
1182, 5.274091822933827, 29.898465592397283, 35.96017891033742, 0.2205685, 210.0, 663, 866367, 1182, 24.832143700001325
1183, 10.132257632391397, 29.88645801987759, 36.12515290645414, 0.22005729999999998, 90.0, 473, 866840, 1183, 17.54121750000195
1184, 4.387558443249666, 29.923390111231935, 35.97551055931989, 0.21926710000000008, 290.0, 1283, 868123, 1184, 48.05166019999888
1185, 5.484251039757366, 29.875718270197954, 35.969796523009194, 0.21832614999999997, 115.0, 808, 868931, 1185, 30.330128000001423
1186, 2.3222250985655704, 29.839452105803105, 35.83115022408489, 0.21752109999999986, 240.0, 981, 869912, 1186, 36.784865500001615
1187, 6.61753061239283, 29.472767923593842, 35.47764463155138, 0.21674529999999984, 105.0, 743, 870655, 1187, 27.789562699999806
1188, 2.4710068379683556, 29.255192086988107, 35.16185721633576, 0.21612384999999995, 145.0, 638, 871293, 1188, 24.17326949999915
1189, 3.5153527422374267, 29.330923657980023, 35.26182495437053, 0.21554694999999996, 130.0, 644, 871937, 1189, 24.265763999999763
1190, 3.5213089431066646, 29.281201750407288, 35.213489245012475, 0.2147823999999999, 425.0, 1055, 872992, 1190, 39.60405670000182
1191, 3.934047119808068, 29.18465043148051, 35.086401347545426, 0.21414159999999993, 60.0, 369, 873361, 1191, 13.935898399999132
1192, 4.3515289362691085, 29.249339305806988, 35.20420984180583, 0.21341709999999997, 515.0, 1241, 874602, 1192, 46.88706789999924
1193, 3.6558354364206105, 29.373495583367863, 35.313644004204406, 0.21225249999999996, 465.0, 1347, 875949, 1193, 50.830481599998166
1194, 2.3813905033497855, 29.262894219618577, 35.17680126703703, 0.21141234999999997, 50.0, 520, 876469, 1194, 19.76594710000063
1195, 3.8729162686319896, 29.26965898233694, 35.23883109548431, 0.21079225, 215.0, 858, 877327, 1195, 32.55652399999963
1196, 3.9909750872037626, 29.233475796588056, 35.17299795770026, 0.21023289999999997, 50.0, 385, 877712, 1196, 14.757471999997506
1197, 3.1638464167129334, 29.222394995911177, 35.11082049303277, 0.2097500499999999, 115.0, 688, 878400, 1197, 26.010642900000676
1198, 5.454707633044325, 29.327477841111904, 35.30951539661993, 0.20890675, 655.0, 1186, 879586, 1198, 44.858644200001436
1199, 5.6541457417480485, 29.271930294172137, 35.22017031189398, 0.20805579999999999, 115.0, 705, 880291, 1199, 26.91685580000194
1200, 5.065429517659922, 29.2855711420985, 35.26532907180892, 0.207415, 145.0, 719, 881010, 1200, 27.493570999999065
1201, 2.081873496129577, 29.234339674313862, 35.11685117653438, 0.20678904999999992, 100.0, 672, 881682, 1201, 25.635263099997246
1202, 5.828666727502568, 29.237433154408524, 35.17837604133623, 0.20608074999999998, 305.0, 902, 882584, 1202, 33.788393499999074
1203, 3.802411943110392, 29.24491264527304, 35.149175014412194, 0.20526444999999996, 225.0, 912, 883496, 1203, 34.55106919999889
1204, 3.6465848825191602, 29.262613266772842, 35.15784105160719, 0.20465199999999992, 65.0, 449, 883945, 1204, 17.26138130000254
1205, 5.152497918662761, 29.2486443643498, 35.154975021375094, 0.20391309999999988, 470.0, 1193, 885138, 1205, 44.999018599999545
1206, 3.1411003693629103, 29.22461661131715, 35.13668485564975, 0.20305089999999998, 255.0, 723, 885861, 1206, 27.84985239999878
1207, 3.805393249163158, 29.29762341672142, 35.257048372187604, 0.20232325, 220.0, 894, 886755, 1207, 34.11219330000313
1208, 3.7173843597513394, 29.238796436698905, 35.17745046284673, 0.20149299999999995, 285.0, 951, 887706, 1208, 36.43432400000165
1209, 3.956306900564559, 29.202144490191216, 35.12652100049532, 0.20076084999999996, 140.0, 676, 888382, 1209, 26.271080799997435
1210, 3.8657012183690873, 29.218597658536847, 35.18030678702263, 0.20028249999999992, 15.0, 387, 888769, 1210, 15.007257999997819
1211, 4.684499806246415, 29.28102966597238, 35.23565891459392, 0.19958499999999996, 385.0, 1163, 889932, 1211, 44.56743849999839
1212, 7.272438798852303, 29.20197990455819, 35.167608155677065, 0.19861389999999993, 300.0, 995, 890927, 1212, 38.22891570000138
1213, 2.480079824812651, 29.24839218697601, 35.13551771166973, 0.19788309999999995, 105.0, 629, 891556, 1213, 24.30813980000312
1214, 3.406818885066104, 29.22124092696143, 35.14802087135002, 0.1971608499999999, 220.0, 976, 892532, 1214, 37.68162870000015
1215, 3.1681537126322685, 29.262837703411396, 35.15028750275264, 0.19635894999999987, 190.0, 806, 893338, 1215, 31.570576999998593
1216, 5.301657530944794, 29.264469440593277, 35.28592007659202, 0.19568664999999988, 90.0, 688, 894026, 1216, 26.744183000002522
1217, 4.4566663789591345, 29.26520254934719, 35.21010018436149, 0.19496484999999988, 225.0, 916, 894942, 1217, 35.47218179999982
1218, 4.978881274753694, 29.22400922120385, 35.13036747347132, 0.19413324999999987, 495.0, 932, 895874, 1218, 36.073307299997396
1219, 8.450964584552368, 29.298751225465026, 35.24668782051739, 0.19338219999999998, 125.0, 737, 896611, 1219, 28.670239400002174
1220, 4.424188943178516, 29.245278688616818, 35.17208921181044, 0.19263069999999996, 220.0, 933, 897544, 1220, 36.27830470000117
1221, 4.499548290280496, 29.28135843891517, 35.21021447375168, 0.19183374999999997, 250.0, 838, 898382, 1221, 32.8044876999993
1222, 4.724175144981494, 29.263100493489254, 35.218957007685795, 0.19067454999999997, 420.0, 1738, 900120, 1222, 67.62264640000285
1223, 4.99908392058194, 29.324343929017736, 35.34878854029993, 0.1896723999999999, 75.0, 489, 900609, 1223, 19.42306489999828
1224, 3.1122953467782897, 29.19768421634747, 35.08311696386641, 0.18909909999999996, 135.0, 785, 901394, 1224, 30.553422500001034
1225, 3.6031987517699973, 29.402886465951042, 35.33156236044534, 0.18829539999999995, 215.0, 1001, 902395, 1225, 39.09426710000116
1226, 4.043322927356578, 29.4866953389846, 35.460826723062375, 0.18767979999999998, 90.0, 367, 902762, 1226, 14.455425800002558
1227, 3.422108484149882, 29.384504130392365, 35.367903570695354, 0.18721764999999993, 150.0, 660, 903422, 1227, 25.79282830000011
1228, 3.8052788597086202, 29.398302338340066, 35.36103532059862, 0.18669294999999994, 80.0, 506, 903928, 1228, 20.06575299999895
1229, 3.398237491080387, 29.324470891618656, 35.28585067005825, 0.18616959999999996, 165.0, 657, 904585, 1229, 25.984664099996735
1230, 2.285686959038701, 29.292193071268905, 35.18484647453631, 0.1854379, 265.0, 969, 905554, 1230, 38.30206840000028
1231, 5.991293074758122, 29.455526447508543, 35.45517649576234, 0.18459774999999992, 315.0, 898, 906452, 1231, 35.417488899998716
1232, 3.9152649183129293, 29.384396726434883, 35.343884732734644, 0.18381744999999994, 210.0, 836, 907288, 1232, 33.279361199998675
1233, 5.390913430070123, 29.503649599411908, 35.50904920479405, 0.18293634999999986, 355.0, 1122, 908410, 1233, 43.61548109999785
1234, 6.205758158333283, 29.31407403393602, 35.33440577017294, 0.18219834999999993, 65.0, 518, 908928, 1234, 20.665364799999224
1235, 4.204938616988988, 29.338849471280568, 35.27970232410491, 0.18167814999999993, 200.0, 638, 909566, 1235, 25.317202199999883
1236, 8.602629403276381, 29.673982610666616, 35.72425614934943, 0.18103239999999993, 95.0, 797, 910363, 1236, 31.88875619999817
1237, 3.4846374745873905, 29.837339374581344, 35.83119551844388, 0.18019089999999988, 200.0, 1073, 911436, 1237, 42.54790579999826
1238, 6.836602661451001, 30.014630707698082, 36.153827858920124, 0.17925580000000002, 665.0, 1005, 912441, 1238, 40.04613249999966
1239, 3.4864701835239367, 29.909071883930658, 35.95121420915508, 0.17834499999999995, 400.0, 1019, 913460, 1239, 40.23068169999897
1240, 4.2846962694659245, 29.941551456203708, 35.9931873624975, 0.17760925, 135.0, 616, 914076, 1240, 24.298143199997867
1241, 3.9566268248570777, 29.929186666609326, 35.99852716168519, 0.17678439999999992, 385.0, 1217, 915293, 1241, 48.081958199996734
1242, 6.392155778356785, 29.970590827661916, 36.106751070985005, 0.17574625, 290.0, 1090, 916383, 1242, 44.698597400001745
1243, 5.660955465510915, 29.982739268023927, 36.04603416924267, 0.1750203999999999, 25.0, 523, 916906, 1243, 20.845085899996775
1244, 3.2359044057391855, 29.911045247098826, 35.901571747160304, 0.17447679999999993, 155.0, 685, 917591, 1244, 27.597394199998234
1245, 3.4308286632434846, 29.942644857683167, 36.048748438311975, 0.17386749999999987, 200.0, 669, 918260, 1245, 26.74069860000236
1246, 4.329610711086226, 29.93532616068203, 36.006539341798025, 0.17327934999999997, 185.0, 638, 918898, 1246, 25.71755520000079
1247, 5.103593111838416, 29.94480661245493, 36.02047168637568, 0.17268219999999998, 150.0, 689, 919587, 1247, 27.71075639999981
1248, 3.2438273211138964, 29.854743789060272, 35.90485912100242, 0.1717556499999999, 510.0, 1370, 920957, 1248, 54.830068900002516
1249, 4.4095605688683435, 29.752129704376745, 35.81281528637327, 0.17061714999999997, 490.0, 1160, 922117, 1249, 46.30280339999808
1250, 4.960665497768285, 29.819377463439416, 35.87445963388202, 0.16978195, 205.0, 696, 922813, 1250, 28.332492300000013
1251, 4.497871460918725, 29.792749463414854, 35.85436430738016, 0.16917534999999997, 135.0, 652, 923465, 1251, 26.326856299998326
1252, 4.984101162150631, 29.775053272957788, 35.8387456746361, 0.16856784999999996, 105.0, 698, 924163, 1252, 28.227514899997914
1253, 5.121621473297634, 29.767563732141465, 35.81597126806843, 0.16795539999999992, 140.0, 663, 924826, 1253, 26.815312200000335
1254, 4.204456287581584, 29.799522687614214, 35.82918799879179, 0.16723044999999997, 430.0, 948, 925774, 1254, 38.305257600000914
1255, 5.233873482990539, 29.774512284377526, 35.860111578579605, 0.16660809999999998, 40.0, 435, 926209, 1255, 17.794245900000533
1256, 5.386297103048254, 29.85365837763326, 35.96678024618787, 0.16613919999999993, 155.0, 607, 926816, 1256, 24.45491519999996
1257, 5.3511510297859255, 29.780594000382855, 35.81955932790583, 0.16537104999999994, 525.0, 1100, 927916, 1257, 44.53106480000133
1258, 2.8244727531446667, 29.775276190947938, 35.78283648974952, 0.1642509999999999, 310.0, 1389, 929305, 1258, 56.592409699998825
1259, 5.478365652799793, 29.749262855545712, 35.80670436787456, 0.16319484999999997, 420.0, 958, 930263, 1259, 38.503639500002464
1260, 3.547672190943604, 29.552767183795666, 35.538889311144686, 0.16233444999999994, 175.0, 954, 931217, 1260, 38.64311739999903
1261, 4.836188876988043, 29.50352342296365, 35.494262191794355, 0.16159149999999994, 125.0, 697, 931914, 1261, 28.316929399999935
1262, 8.289210190150511, 29.637549030206696, 35.74339912025516, 0.16080129999999995, 280.0, 1059, 932973, 1262, 43.18202139999994
1263, 7.1376665525528935, 29.65337654852098, 35.69669069974653, 0.15987834999999986, 300.0, 992, 933965, 1263, 40.39669059999869
1264, 2.5257201749965237, 29.435913114782092, 35.34179726440199, 0.15919389999999994, 75.0, 529, 934494, 1264, 21.830191500001092
1265, 4.165932045309085, 29.58449217706239, 35.58896473253977, 0.15867954999999995, 155.0, 614, 935108, 1265, 25.22025560000111
1266, 5.917956005114628, 29.57517474071089, 35.62125951621427, 0.1578429999999999, 200.0, 1245, 936353, 1266, 50.840110499997536
1267, 4.296918513896791, 29.55465298232499, 35.54808423502462, 0.15663924999999998, 340.0, 1430, 937783, 1267, 58.64029270000174
1268, 7.287341597819165, 29.4487293974994, 35.464847501989915, 0.1558314999999999, 35.0, 365, 938148, 1268, 15.27713059999951
1269, 5.61041773799126, 29.51084167709279, 35.51246665053649, 0.15518709999999997, 145.0, 1067, 939215, 1269, 44.00165399999969
1270, 2.322002197451451, 29.373587923351995, 35.27241187289829, 0.1545080499999999, 100.0, 442, 939657, 1270, 18.03093920000174
1271, 2.435476214236238, 29.40489908693885, 35.31040426195503, 0.15398784999999995, 135.0, 714, 940371, 1271, 29.322086799998942
1272, 5.5692152964120565, 29.30267496629195, 35.33691912564365, 0.15317154999999993, 265.0, 1100, 941471, 1272, 45.82722189999913
1273, 5.573086275892086, 29.339951220451457, 35.331975832027986, 0.15207084999999992, 235.0, 1346, 942817, 1273, 55.49842279999939
1274, 6.82491418187385, 29.402174102119776, 35.45556550896686, 0.15094764999999996, 170.0, 1150, 943967, 1274, 47.48781229999804
1275, 4.209638511649514, 29.282898066561227, 35.21667112440071, 0.15002784999999988, 300.0, 894, 944861, 1275, 36.962178500001755
1276, 3.0083616973485374, 29.3312617975035, 35.23942391898524, 0.14933799999999992, 110.0, 639, 945500, 1276, 26.529217899998912
1277, 5.0523307265409665, 29.372111979009247, 35.34080448170991, 0.1486287999999999, 195.0, 937, 946437, 1277, 38.847142700000404
1278, 6.179552006719161, 29.310914970864324, 35.309131827100316, 0.14763295, 335.0, 1276, 947713, 1278, 53.12852280000152
1279, 3.2670353689117118, 29.355549438620063, 35.27247772695129, 0.14677164999999995, 160.0, 638, 948351, 1279, 26.529490999997506
1280, 2.899188599321055, 29.32172289105244, 35.24438736691961, 0.14605659999999995, 420.0, 951, 949302, 1280, 39.53904269999839
1281, 3.9608684818164224, 29.414558880869155, 35.3875267017053, 0.14533659999999993, 210.0, 649, 949951, 1281, 27.081658700000844
1282, 4.378273718939586, 30.6314959526062, 36.82842299721458, 0.14474754999999995, 225.0, 660, 950611, 1282, 27.81370489999972
1283, 4.062978287102186, 30.735819314655505, 37.042251352678264, 0.1442966499999999, 50.0, 342, 950953, 1283, 14.429348399997252
1284, 9.325282293283406, 30.79141607764047, 37.05953367861955, 0.14398164999999996, 90.0, 358, 951311, 1284, 15.070157300000574
1285, 5.259417584218592, 30.733880779006718, 36.9615592956543, 0.1433907999999999, 125.0, 955, 952266, 1285, 40.042017299998406
1286, 5.976467842396331, 30.637630512403405, 36.90147292832822, 0.14249529999999994, 285.0, 1035, 953301, 1286, 43.16782720000265
1287, 7.038477693742607, 30.70846500992775, 37.001043831308685, 0.14168394999999998, 225.0, 768, 954069, 1287, 32.24498859999949
1288, 4.456193197480958, 30.61212407592705, 36.82983736237291, 0.1409373999999999, 205.0, 891, 954960, 1288, 37.06340849999833
1289, 7.8545606383174595, 30.709758889399563, 37.011120121306575, 0.13993300000000003, 450.0, 1341, 956301, 1289, 56.453235799999675
1290, 5.458429399099979, 30.635653871569193, 36.88888000057106, 0.13904289999999997, 25.0, 637, 956938, 1290, 26.722493099998246
1291, 5.98506704736365, 30.768611495860302, 37.04035611117843, 0.1384479999999999, 160.0, 685, 957623, 1291, 29.049307999997836
1292, 6.995196097128871, 30.688025011417544, 36.891695891133594, 0.13784229999999995, 165.0, 661, 958284, 1292, 27.87854629999856
1293, 7.299001265967832, 30.776941045911457, 37.02975498063856, 0.13725369999999984, 105.0, 647, 958931, 1293, 27.30547200000001
1294, 3.9869356547465333, 30.726745431587037, 36.90783686591064, 0.1366416999999999, 125.0, 713, 959644, 1294, 30.158045799998945
1295, 4.3932928292556115, 30.729366041352687, 36.950185999290575, 0.13590999999999992, 170.0, 913, 960557, 1295, 38.57718709999972
1296, 4.772869613172481, 30.848875381493492, 37.11279867297021, 0.13492134999999997, 215.0, 1284, 961841, 1296, 54.25411570000142
1297, 4.328714921764015, 30.870250137732615, 37.122672862801096, 0.13388409999999984, 345.0, 1021, 962862, 1297, 43.24581059999764
1298, 4.890508841991993, 30.857185475230573, 37.15066191662474, 0.1326699999999999, 255.0, 1677, 964539, 1298, 71.12764969999989
1299, 3.7386363606936466, 30.836225139383536, 37.091120260481524, 0.13140999999999994, 255.0, 1123, 965662, 1299, 47.60465320000003
1300, 4.741796615030941, 30.917870943965948, 37.13112398734176, 0.13043934999999993, 175.0, 1034, 966696, 1300, 43.99899320000259
1301, 4.7092878126693005, 30.8838738191475, 37.15221678354208, 0.12974229999999995, 100.0, 515, 967211, 1301, 21.7493003999989
1302, 5.875783972304495, 30.840824585313335, 37.1379365282301, 0.12912084999999993, 380.0, 866, 968077, 1302, 37.09526610000103
1303, 6.397438892272904, 30.852002181258857, 37.11326302734076, 0.12836394999999995, 155.0, 816, 968893, 1303, 34.70954889999848
1304, 4.491052549512314, 30.798379730879727, 37.04818873669892, 0.12774519999999998, 50.0, 559, 969452, 1304, 23.989670099999785
1305, 5.823031176386163, 30.87524070102784, 37.14438956124442, 0.12725109999999995, 160.0, 539, 969991, 1305, 23.079353099998116
1306, 7.834796316475625, 30.962606187079363, 37.28449430526442, 0.1266552999999999, 245.0, 785, 970776, 1306, 33.5242290999995
1307, 4.175758711183683, 31.039015737680288, 37.335057961879635, 0.12586329999999993, 310.0, 975, 971751, 1307, 41.9191458000023
1308, 6.165486318006944, 31.04320267523719, 37.35942014772794, 0.12506409999999993, 160.0, 801, 972552, 1308, 34.37444809999943
1309, 4.871201928254244, 31.026454177982682, 37.321582206402596, 0.12426849999999995, 290.0, 967, 973519, 1309, 41.77056989999983
1310, 6.950051227987373, 31.15410099059437, 37.531696981770864, 0.12325914999999997, 580.0, 1276, 974795, 1310, 54.885512600001675
1311, 4.86215101513155, 31.099460420761517, 37.428995178345055, 0.12234834999999994, 210.0, 748, 975543, 1311, 32.36591229999976
1312, 5.393555093406743, 31.05888521333743, 37.35765506045119, 0.12170979999999995, 50.0, 671, 976214, 1312, 28.760741499998403
1313, 5.088501412593895, 31.095759509839077, 37.46994636954481, 0.12098979999999991, 125.0, 929, 977143, 1313, 40.08799790000194
1314, 6.984839574985352, 31.088903733795764, 37.47442335988961, 0.12034224999999991, 120.0, 510, 977653, 1314, 22.08063949999996
1315, 3.7544321951485866, 31.087182001830225, 37.43493674783146, 0.11991384999999996, 135.0, 442, 978095, 1315, 19.233303799999703
1316, 5.221093553118408, 31.0532286932439, 37.36642157589948, 0.1194233499999999, 165.0, 648, 978743, 1316, 28.353074300001026
1317, 4.268513589210988, 30.934838530528975, 37.208623621837205, 0.11883294999999995, 130.0, 664, 979407, 1317, 28.878887400001986
1318, 2.4879133219161416, 31.05081417895995, 37.26418771127331, 0.11829744999999992, 65.0, 526, 979933, 1318, 22.816124000000855
1319, 4.5309463857415375, 31.30185110743058, 37.68380869264716, 0.11753064999999993, 335.0, 1178, 981111, 1319, 51.22050810000292
1320, 4.075626003473563, 31.40531567042779, 37.7913584564995, 0.11659869999999996, 510.0, 893, 982004, 1320, 38.66257469999982
1321, 4.848550995291003, 31.344510870998345, 37.67295468154463, 0.11573334999999994, 385.0, 1030, 983034, 1321, 44.90921639999942
1322, 5.126544943680206, 31.266313395192547, 37.58996204406984, 0.11504664999999992, 160.0, 496, 983530, 1322, 21.5737979000005
1323, 2.8772719596953436, 31.31772361742451, 37.641053176350155, 0.1142919999999999, 520.0, 1181, 984711, 1323, 51.67980510000052
1324, 5.046107286384896, 31.41458051101021, 37.854382639345914, 0.11334654999999992, 300.0, 920, 985631, 1324, 40.04977890000009
1325, 5.630781477430282, 31.37945788203718, 37.82960292097098, 0.11265084999999994, 60.0, 626, 986257, 1325, 27.288784200001828
1326, 4.147562141236348, 31.309113845243353, 37.624455189227604, 0.11189709999999994, 340.0, 1049, 987306, 1326, 45.76672959999996
1327, 5.157982013181716, 31.349710510340238, 37.7648105216667, 0.11110689999999991, 185.0, 707, 988013, 1327, 31.574986299998272
1328, 3.0562267496220525, 31.280501374275453, 37.60157064622448, 0.11043999999999994, 160.0, 775, 988788, 1328, 33.997968600000604
1329, 4.30372239698114, 31.274479927027283, 37.562552810645144, 0.10980279999999992, 65.0, 641, 989429, 1329, 28.292436499999894
1330, 5.117583748033986, 31.837214304413042, 38.358533238640575, 0.10909944999999995, 205.0, 922, 990351, 1330, 40.457863100000395
1331, 4.274170458447802, 32.84963436336308, 39.464907610547414, 0.10847979999999989, 70.0, 455, 990806, 1331, 19.993623500002286
1332, 5.571502323702552, 32.73059964131632, 39.40221492852449, 0.1078313499999999, 205.0, 986, 991792, 1332, 43.14701419999983
1333, 7.160652330497632, 32.744080045201756, 39.45285961506245, 0.10708794999999993, 60.0, 666, 992458, 1333, 29.607237899999745
1334, 5.839761097503293, 32.78829877190349, 39.46740479929341, 0.10620054999999991, 580.0, 1306, 993764, 1334, 57.49156850000145
1335, 5.149090120895698, 32.72878469448117, 39.40374402414885, 0.10498194999999999, 470.0, 1402, 995166, 1335, 61.71438019999914
1336, 2.306350933944666, 32.72032766854891, 39.280582354145665, 0.10414179999999992, 65.0, 465, 995631, 1336, 20.89102719999937
1337, 4.364151426386833, 32.88692821960449, 39.580601354980466, 0.10365129999999992, 95.0, 625, 996256, 1337, 27.843219800000952
1338, 7.010410895892473, 32.86218398779481, 39.57181334375736, 0.10283274999999992, 535.0, 1194, 997450, 1338, 53.22415859999819
1339, 7.235764880559497, 32.735686250271335, 39.38297761255695, 0.10184904999999993, 185.0, 992, 998442, 1339, 44.15146129999994
1340, 4.642718278638412, 32.82337285699566, 39.42730293918498, 0.1011096999999999, 85.0, 651, 999093, 1340, 29.08107519999976
