,loss,mae,mean_q,mean_eps,episode_reward,nb_episode_steps,nb_steps,episode,duration
0,0,0,0,0,115.0,549,549,0,1.1033860000000004
1, 0, 0, 0, 0, 50.0, 403, 952, 1, 0.812540199999999
2, 0, 0, 0, 0, 120.0, 732, 1684, 2, 1.4938544
3, 0, 0, 0, 0, 75.0, 518, 2202, 3, 1.1306899000000001
4, 0, 0, 0, 0, 80.0, 496, 2698, 4, 1.172525499999999
5, 0, 0, 0, 0, 135.0, 676, 3374, 5, 1.3724710000000009
6, 0, 0, 0, 0, 30.0, 527, 3901, 6, 1.2105887000000006
7, 0, 0, 0, 0, 120.0, 744, 4645, 7, 2.054708699999999
8, 0, 0, 0, 0, 110.0, 735, 5380, 8, 2.0590708000000006
9, 0, 0, 0, 0, 210.0, 663, 6043, 9, 1.4179765000000017
10, 0, 0, 0, 0, 35.0, 589, 6632, 10, 1.3872006
11, 0, 0, 0, 0, 125.0, 597, 7229, 11, 2.0801884999999984
12, 0, 0, 0, 0, 120.0, 636, 7865, 12, 1.7857373999999986
13, 0, 0, 0, 0, 465.0, 1018, 8883, 13, 2.2101827000000007
14, 0, 0, 0, 0, 30.0, 400, 9283, 14, 0.8946015000000003
15, 0, 0, 0, 0, 335.0, 1078, 10361, 15, 2.2612819
16, 0, 0, 0, 0, 80.0, 501, 10862, 16, 1.1638490000000061
17, 0, 0, 0, 0, 95.0, 671, 11533, 17, 1.618540699999997
18, 0, 0, 0, 0, 135.0, 628, 12161, 18, 1.3835505000000055
19, 0, 0, 0, 0, 135.0, 672, 12833, 19, 1.4370891999999955
20, 0, 0, 0, 0, 30.0, 383, 13216, 20, 0.8619059999999976
21, 0, 0, 0, 0, 245.0, 942, 14158, 21, 2.448613100000003
22, 0, 0, 0, 0, 75.0, 551, 14709, 22, 1.2106835999999959
23, 0, 0, 0, 0, 65.0, 363, 15072, 23, 0.8166459000000046
24, 0, 0, 0, 0, 225.0, 834, 15906, 24, 1.9384004000000061
25, 0, 0, 0, 0, 75.0, 507, 16413, 25, 1.1110651999999988
26, 0, 0, 0, 0, 120.0, 650, 17063, 26, 1.5313298999999958
27, 0, 0, 0, 0, 180.0, 623, 17686, 27, 1.6534130999999945
28, 0, 0, 0, 0, 110.0, 637, 18323, 28, 1.7402203000000043
29, 0, 0, 0, 0, 110.0, 701, 19024, 29, 1.6687440000000038
30, 0, 0, 0, 0, 390.0, 1248, 20272, 30, 2.666474699999995
31, 0, 0, 0, 0, 380.0, 1218, 21490, 31, 2.4368624999999966
32, 0, 0, 0, 0, 315.0, 910, 22400, 32, 1.9635060999999965
33, 0, 0, 0, 0, 240.0, 1108, 23508, 33, 2.4485446999999994
34, 0, 0, 0, 0, 30.0, 532, 24040, 34, 1.1968105999999992
35, 0, 0, 0, 0, 30.0, 569, 24609, 35, 1.3193432999999999
36, 0, 0, 0, 0, 110.0, 619, 25228, 36, 1.4456514000000027
37, 0, 0, 0, 0, 120.0, 630, 25858, 37, 1.3406990999999948
38, 0, 0, 0, 0, 185.0, 683, 26541, 38, 1.4543153000000046
39, 0, 0, 0, 0, 75.0, 646, 27187, 39, 1.3127037999999942
40, 0, 0, 0, 0, 55.0, 387, 27574, 40, 0.7832551000000052
41, 0, 0, 0, 0, 110.0, 704, 28278, 41, 1.3830942000000022
42, 0, 0, 0, 0, 490.0, 1157, 29435, 42, 2.2244403999999918
43, 0, 0, 0, 0, 75.0, 478, 29913, 43, 0.9588305999999989
44, 0, 0, 0, 0, 50.0, 386, 30299, 44, 0.774966500000005
45, 0, 0, 0, 0, 260.0, 910, 31209, 45, 1.7784764999999965
46, 0, 0, 0, 0, 105.0, 677, 31886, 46, 1.3502685999999926
47, 0, 0, 0, 0, 80.0, 609, 32495, 47, 1.1816649999999953
48, 0, 0, 0, 0, 450.0, 948, 33443, 48, 1.891270199999994
49, 0, 0, 0, 0, 155.0, 700, 34143, 49, 1.3949157999999926
50, 0, 0, 0, 0, 120.0, 653, 34796, 50, 1.2691568999999987
51, 0, 0, 0, 0, 50.0, 661, 35457, 51, 1.2804689999999965
52, 0, 0, 0, 0, 105.0, 586, 36043, 52, 1.165075200000004
53, 0, 0, 0, 0, 355.0, 767, 36810, 53, 1.5084382000000005
54, 0, 0, 0, 0, 135.0, 808, 37618, 54, 1.5487526999999943
55, 0, 0, 0, 0, 210.0, 922, 38540, 55, 1.86096169999999
56, 0, 0, 0, 0, 5.0, 484, 39024, 56, 0.9770567000000057
57, 0, 0, 0, 0, 210.0, 919, 39943, 57, 1.8444113999999985
58, 0, 0, 0, 0, 75.0, 380, 40323, 58, 0.7811623000000054
59, 0, 0, 0, 0, 135.0, 677, 41000, 59, 1.3323675999999978
60, 0, 0, 0, 0, 125.0, 845, 41845, 60, 1.7322623000000021
61, 0, 0, 0, 0, 155.0, 680, 42525, 61, 1.6476307000000077
62, 0, 0, 0, 0, 80.0, 377, 42902, 62, 0.8222904
63, 0, 0, 0, 0, 315.0, 1082, 43984, 63, 2.3607543000000106
64, 0, 0, 0, 0, 230.0, 1179, 45163, 64, 2.4905746999999963
65, 0, 0, 0, 0, 120.0, 648, 45811, 65, 1.4123473000000075
66, 0, 0, 0, 0, 120.0, 727, 46538, 66, 1.5277566000000036
67, 0, 0, 0, 0, 170.0, 759, 47297, 67, 1.5979248999999953
68, 0, 0, 0, 0, 125.0, 530, 47827, 68, 1.143929199999988
69, 0, 0, 0, 0, 120.0, 661, 48488, 69, 1.40676169999999
70, 0, 0, 0, 0, 155.0, 938, 49426, 70, 2.072216400000002
71, 0, 0, 0, 0, 130.0, 771, 50197, 71, 1.6437415999999985
72, 0, 0, 0, 0, 75.0, 420, 50617, 72, 0.9253391000000022
73, 0, 0, 0, 0, 135.0, 653, 51270, 73, 1.4329952999999875
74, 0, 0, 0, 0, 50.0, 590, 51860, 74, 1.3001404999999977
75, 0, 0, 0, 0, 140.0, 752, 52612, 75, 1.6981157999999965
76, 0, 0, 0, 0, 110.0, 641, 53253, 76, 1.4226785000000035
77, 0, 0, 0, 0, 215.0, 912, 54165, 77, 1.9277337999999986
78, 0, 0, 0, 0, 210.0, 822, 54987, 78, 1.7326454000000098
79, 0, 0, 0, 0, 120.0, 644, 55631, 79, 1.3607869999999878
80, 0, 0, 0, 0, 415.0, 1112, 56743, 80, 2.3568621000000007
81, 0, 0, 0, 0, 155.0, 799, 57542, 81, 1.7023492000000147
82, 0, 0, 0, 0, 210.0, 616, 58158, 82, 1.3242472999999961
83, 0, 0, 0, 0, 210.0, 805, 58963, 83, 1.7448196999999936
84, 0, 0, 0, 0, 155.0, 811, 59774, 84, 1.7094100999999853
85, 0, 0, 0, 0, 50.0, 598, 60372, 85, 1.2805323000000044
86, 0, 0, 0, 0, 180.0, 795, 61167, 86, 1.6646248000000128
87, 0, 0, 0, 0, 140.0, 913, 62080, 87, 2.050298099999992
88, 0, 0, 0, 0, 410.0, 874, 62954, 88, 1.8814714000000095
89, 0, 0, 0, 0, 145.0, 776, 63730, 89, 1.6417134000000146
90, 0, 0, 0, 0, 185.0, 796, 64526, 90, 1.7601264000000185
91, 0, 0, 0, 0, 75.0, 435, 64961, 91, 0.9512805999999898
92, 0, 0, 0, 0, 155.0, 744, 65705, 92, 1.5798580000000015
93, 0, 0, 0, 0, 30.0, 386, 66091, 93, 0.8784701000000155
94, 0, 0, 0, 0, 50.0, 516, 66607, 94, 1.1597292000000152
95, 0, 0, 0, 0, 130.0, 575, 67182, 95, 1.2721990000000005
96, 0, 0, 0, 0, 120.0, 796, 67978, 96, 1.7420151000000033
97, 0, 0, 0, 0, 110.0, 699, 68677, 97, 1.4983669000000077
98, 0, 0, 0, 0, 75.0, 536, 69213, 98, 1.1456756000000041
99, 0, 0, 0, 0, 160.0, 1102, 70315, 99, 2.4766528999999764
100, 0, 0, 0, 0, 235.0, 1095, 71410, 100, 2.3488657999999987
101, 0, 0, 0, 0, 105.0, 732, 72142, 101, 1.5915020999999854
102, 0, 0, 0, 0, 55.0, 524, 72666, 102, 1.102719900000011
103, 0, 0, 0, 0, 105.0, 625, 73291, 103, 1.3664770999999973
104, 0, 0, 0, 0, 135.0, 756, 74047, 104, 1.5979347999999902
105, 0, 0, 0, 0, 65.0, 468, 74515, 105, 0.9934906999999953
106, 0, 0, 0, 0, 90.0, 470, 74985, 106, 0.9907038999999997
107, 0, 0, 0, 0, 155.0, 811, 75796, 107, 1.7106621000000075
108, 0, 0, 0, 0, 105.0, 733, 76529, 108, 1.5892219999999782
109, 0, 0, 0, 0, 485.0, 1022, 77551, 109, 2.191669200000007
110, 0, 0, 0, 0, 225.0, 914, 78465, 110, 1.956009100000017
111, 0, 0, 0, 0, 185.0, 994, 79459, 111, 2.2131602000000044
112, 0, 0, 0, 0, 155.0, 677, 80136, 112, 1.4670464000000152
113, 0, 0, 0, 0, 110.0, 677, 80813, 113, 1.4735768000000178
114, 0, 0, 0, 0, 220.0, 970, 81783, 114, 2.0463515000000143
115, 0, 0, 0, 0, 180.0, 796, 82579, 115, 1.6858088999999836
116, 0, 0, 0, 0, 150.0, 836, 83415, 116, 1.7885494000000222
117, 0, 0, 0, 0, 380.0, 863, 84278, 117, 1.858547499999986
118, 0, 0, 0, 0, 445.0, 988, 85266, 118, 2.1226463999999794
119, 0, 0, 0, 0, 110.0, 780, 86046, 119, 1.6775180999999861
120, 0, 0, 0, 0, 110.0, 662, 86708, 120, 1.427141799999987
121, 0, 0, 0, 0, 110.0, 700, 87408, 121, 1.5366406999999924
122, 0, 0, 0, 0, 135.0, 683, 88091, 122, 2.26757649999999
123, 0, 0, 0, 0, 285.0, 1017, 89108, 123, 2.346989800000017
124, 0, 0, 0, 0, 150.0, 725, 89833, 124, 1.9780418999999938
125, 0, 0, 0, 0, 170.0, 855, 90688, 125, 1.831891100000007
126, 0, 0, 0, 0, 110.0, 681, 91369, 126, 1.3863703999999757
127, 0, 0, 0, 0, 105.0, 668, 92037, 127, 1.4078412000000071
128, 0, 0, 0, 0, 210.0, 742, 92779, 128, 1.5079714999999965
129, 0, 0, 0, 0, 110.0, 634, 93413, 129, 1.302936499999987
130, 0, 0, 0, 0, 20.0, 600, 94013, 130, 1.5248859000000152
131, 0, 0, 0, 0, 135.0, 1183, 95196, 131, 2.8932616000000166
132, 0, 0, 0, 0, 120.0, 672, 95868, 132, 1.4740912999999978
133, 0, 0, 0, 0, 225.0, 838, 96706, 133, 1.7845767000000023
134, 0, 0, 0, 0, 50.0, 450, 97156, 134, 0.9570764000000054
135, 0, 0, 0, 0, 210.0, 856, 98012, 135, 1.8111974999999916
136, 0, 0, 0, 0, 50.0, 622, 98634, 136, 1.4396004999999832
137, 0, 0, 0, 0, 180.0, 830, 99464, 137, 1.7721064999999783
138, 115.92051601409912, 30.295204802563315, 44.17733321273536, 0.8197938999999997, 180.0, 765, 100229, 138, 3.540857100000011
139, 58.27974449211443, 29.622782229033994, 38.77462462841625, 0.8189497000000003, 120.0, 710, 100939, 139, 6.551607799999999
140, 46.21342356581437, 29.56732888389052, 37.38282437910114, 0.8179003000000001, 120.0, 456, 101395, 140, 4.721766500000001
141, 44.38761742073193, 29.45215854310153, 36.786305143122085, 0.8170794999999997, 65.0, 456, 101851, 141, 4.5765214000000185
142, 39.766684238386595, 29.545412568485034, 36.90075686251047, 0.8160876999999999, 160.0, 646, 102497, 142, 6.140214799999995
143, 39.336114299159334, 29.32278697488569, 36.25887040590879, 0.8144955999999998, 365.0, 1123, 103620, 143, 11.860751800000003
144, 45.052843019620056, 29.366579250697672, 36.25966846159775, 0.8131150000000001, 60.0, 411, 104031, 144, 4.333273899999995
145, 33.831076789530485, 29.23758739150752, 35.84380496849529, 0.8120278000000002, 180.0, 797, 104828, 145, 8.205853100000013
146, 35.33179308977077, 29.281436340897173, 35.777580606369746, 0.8104600000000006, 270.0, 945, 105773, 146, 11.060596299999986
147, 35.03506031995097, 29.25597454757287, 35.58115105401902, 0.8089290999999998, 210.0, 756, 106529, 147, 8.14789490000004
148, 35.06397857164082, 29.280949422705028, 35.647259256617744, 0.8078041000000001, 70.0, 494, 107023, 148, 4.769789800000012
149, 35.02103819465637, 29.269892230987548, 35.69372745132446, 0.8069095000000001, 65.0, 500, 107523, 149, 4.848485700000026
150, 40.739281522962784, 29.198031870524087, 35.47959911770291, 0.8058519999999997, 120.0, 675, 108198, 150, 6.10748000000001
151, 30.502012422680856, 29.285265964269637, 35.537376672029495, 0.8046685, 105.0, 640, 108838, 151, 5.777170700000056
152, 35.060201719609275, 29.286699040144818, 35.54442220239596, 0.8037019000000001, 55.0, 434, 109272, 152, 4.144309899999996
153, 31.80675740038946, 29.228177461330063, 35.369804575579806, 0.8026983999999998, 120.0, 681, 109953, 153, 6.753953800000033
154, 28.105133649298693, 29.190224945699214, 35.3510584375347, 0.8017371999999997, 80.0, 387, 110340, 154, 3.6572771000000444
155, 21.73768037134777, 29.023177520088527, 35.167677739664946, 0.8006023, 120.0, 874, 111214, 155, 8.578178100000002
156, 19.16033388761231, 28.890684961499563, 35.04554024187971, 0.7991218000000003, 155.0, 771, 111985, 156, 8.112263700000028
157, 16.758480180843243, 28.92458479631986, 35.14241314066231, 0.7977772000000001, 210.0, 723, 112708, 157, 7.488882100000012
158, 18.864917640399216, 28.836909702845983, 34.992654425159735, 0.7964083000000004, 410.0, 798, 113506, 158, 7.9797766000000365
159, 17.015156468011174, 28.81858407722792, 34.95626316959835, 0.7945704999999994, 325.0, 1244, 114750, 159, 12.634959299999991
160, 18.461118863627817, 28.904364145494746, 35.14859711941594, 0.7928623000000001, 155.0, 654, 115404, 160, 6.743971500000043
161, 15.967810845227433, 28.830517523798044, 34.89628699984713, 0.7916922999999996, 100.0, 646, 116050, 161, 6.748138100000006
162, 15.565778931320425, 28.885999494354405, 34.96343325431343, 0.7905825999999999, 15.0, 587, 116637, 162, 6.007208900000023
163, 14.733190609984202, 28.901478171675173, 35.00785986234064, 0.7893972999999999, 140.0, 730, 117367, 163, 7.6817682999999874
164, 16.93689326717429, 28.775052588824266, 34.997275336510874, 0.7881490000000002, 135.0, 657, 118024, 164, 7.732363200000009
165, 14.302835577656786, 28.844106503497766, 35.03297354182381, 0.7870951000000004, 50.0, 514, 118538, 165, 5.765879799999993
166, 15.68824787724097, 28.843577694419203, 34.89297828295373, 0.7860888999999996, 135.0, 604, 119142, 166, 6.219288699999993
167, 19.461914293495834, 28.9791071429793, 35.083638282671366, 0.7848226000000001, 355.0, 803, 119945, 167, 8.423519499999998
168, 14.975501998721395, 28.204081005128195, 33.980315193437406, 0.7831269999999994, 410.0, 1081, 121026, 168, 11.652960699999994
169, 9.893901459961516, 28.043673361368064, 33.91109905263585, 0.7813234000000001, 365.0, 923, 121949, 169, 10.544623400000035
170, 9.819589480211215, 28.098037155449827, 33.903116564295985, 0.7797565000000004, 205.0, 818, 122767, 170, 10.007956199999967
171, 10.856875267527084, 28.214697669806775, 34.14459568732854, 0.7782796000000002, 420.0, 823, 123590, 171, 9.241404100000011
172, 9.837353423194608, 28.205855130458225, 34.046752163983776, 0.7762969000000008, 225.0, 1380, 124970, 172, 15.218891000000042
173, 12.243813557174585, 28.29358979663112, 34.19575203744127, 0.7742161000000001, 190.0, 932, 125902, 173, 10.049298599999986
174, 10.318491295435543, 28.276323051952378, 34.16430969460389, 0.7727590000000004, 125.0, 687, 126589, 174, 8.229209099999991
175, 16.308761995707826, 28.22234415890548, 34.27696874458802, 0.7717752999999998, 90.0, 406, 126995, 175, 4.391352999999981
176, 9.241252091037085, 28.073083387662287, 33.8908059433715, 0.7708843, 45.0, 584, 127579, 176, 6.61994999999996
177, 7.887854459115965, 28.169630446301156, 33.99771803746651, 0.7697772999999999, 160.0, 646, 128225, 177, 6.943786499999987
178, 11.57616974056447, 28.289742607580845, 34.14028345042762, 0.7687225000000003, 75.0, 526, 128751, 178, 5.651378300000033
179, 9.45576059046318, 28.267578509709384, 34.13191440404094, 0.7674013000000001, 135.0, 942, 129693, 179, 11.168716399999994
180, 12.841352147279055, 28.624895832698385, 34.55602467169743, 0.7658685999999999, 165.0, 761, 130454, 180, 9.735753799999998
181, 14.125014155335222, 28.704400990491997, 34.63041140082424, 0.7644502000000001, 180.0, 815, 131269, 181, 9.475016100000062
182, 13.710022309637251, 28.715787007443975, 34.65686171877701, 0.7630047999999999, 155.0, 791, 132060, 182, 8.915161399999988
183, 14.380519286357995, 28.77521505644827, 34.711662530610056, 0.7615504000000002, 160.0, 825, 132885, 183, 9.10435510000002
184, 13.443674080083943, 28.86928158505154, 34.76202116439592, 0.7601446000000003, 110.0, 737, 133622, 184, 8.545238600000062
185, 14.134100281623176, 28.762598861825072, 34.61167930593689, 0.7587460000000003, 180.0, 817, 134439, 185, 9.24098749999996
186, 15.288735008912806, 28.862060751899445, 34.79071280389345, 0.7571818000000005, 225.0, 921, 135360, 186, 10.209276000000045
187, 16.18921393380129, 28.632978333207898, 34.48758810803406, 0.7557544, 105.0, 665, 136025, 187, 7.255598099999929
188, 13.721340474606906, 28.70838682043698, 34.63641182835777, 0.7541992000000008, 285.0, 1063, 137088, 188, 11.696231600000033
189, 15.055210783133068, 28.616210577250452, 34.50534477332585, 0.7525468, 135.0, 773, 137861, 189, 8.205676700000026
190, 15.82078363821488, 28.708653109942297, 34.55103229182635, 0.7513867, 105.0, 516, 138377, 190, 5.632139000000052
191, 14.970547669127507, 28.76343811829078, 34.5224640308903, 0.7502131000000002, 140.0, 788, 139165, 191, 8.419442499999946
192, 16.856846012833262, 28.706467038751068, 34.67447163949164, 0.7489945000000001, 105.0, 566, 139731, 192, 6.060322499999984
193, 10.42585611539393, 29.268026317716178, 35.29540314268104, 0.747883, 155.0, 669, 140400, 193, 7.459456199999977
194, 8.159471281893968, 29.401974595742782, 35.34489134483531, 0.7469262999999999, 50.0, 394, 140794, 194, 4.347465599999964
195, 8.981934725888868, 29.527063756587218, 35.59747292763463, 0.7458040000000005, 410.0, 853, 141647, 195, 9.936891399999922
196, 8.325262549260204, 29.54480769528812, 35.55519182365733, 0.7444053999999998, 80.0, 701, 142348, 196, 8.048249699999928
197, 8.572452313836564, 29.4613064928607, 35.471078905514524, 0.7431994000000002, 130.0, 639, 142987, 197, 6.800019299999917
198, 10.467952088628497, 29.55364979117257, 35.61921531459264, 0.7418368000000002, 230.0, 875, 143862, 198, 9.696335099999942
199, 8.41857584998132, 29.615693524634548, 35.7073492602356, 0.7402690000000004, 190.0, 867, 144729, 199, 9.746379199999978
200, 9.661797283162848, 29.541603607043886, 35.571092859346265, 0.7388731000000002, 110.0, 684, 145413, 200, 7.624259099999904
201, 8.632556683574048, 29.43168733007621, 35.51508381728726, 0.7379137000000002, 80.0, 382, 145795, 201, 4.7821967999999515
202, 9.69231282517426, 29.56071437176009, 35.707400377890224, 0.7369713999999998, 120.0, 665, 146460, 202, 8.246918800000003
203, 8.939216801077848, 29.584437934672774, 35.62323115067782, 0.7356276999999997, 180.0, 828, 147288, 203, 9.446051199999943
204, 9.37699799480427, 29.620393560976837, 35.74438460481809, 0.7341139000000001, 150.0, 854, 148142, 204, 9.296371600000043
205, 13.351379810874143, 29.622911809095697, 35.73365704835351, 0.7327422999999998, 55.0, 670, 148812, 205, 7.248944100000017
206, 8.838510016575363, 29.651855375416755, 35.71896158646759, 0.731422, 135.0, 797, 149609, 206, 8.563081500000067
207, 8.51976007392621, 29.905379460321218, 36.0065847347133, 0.7299450999999997, 180.0, 844, 150453, 207, 9.128408000000036
208, 8.68612820113247, 29.99985563393795, 36.16596686117577, 0.7287102999999999, 75.0, 528, 150981, 208, 5.304172599999902
209, 6.385874345862894, 29.854874528569283, 35.973934546363154, 0.7274844999999999, 210.0, 834, 151815, 209, 8.598455700000045
210, 5.8856936688563835, 29.957045220440218, 36.076718981962024, 0.7261543, 110.0, 644, 152459, 210, 6.708790399999998
211, 9.093565030350485, 30.0059748678717, 36.206586086113035, 0.7246314999999999, 290.0, 1048, 153507, 211, 11.449137999999948
212, 8.012704999052405, 30.05308684003324, 36.23679607279979, 0.7229485000000001, 210.0, 822, 154329, 212, 9.432982400000014
213, 7.294109169947038, 29.990123635471456, 36.1973506389278, 0.7214814999999997, 210.0, 808, 155137, 213, 9.099237200000061
214, 6.006593774416728, 30.03081717652951, 36.07126463625483, 0.7203033999999999, 85.0, 501, 155638, 214, 5.801469900000029
215, 8.363743159838231, 30.066760723867386, 36.28872757795089, 0.7192783000000001, 155.0, 638, 156276, 215, 7.153525400000035
216, 6.692764664959649, 29.900545788847882, 36.08031091482743, 0.7183729000000001, 30.0, 368, 156644, 216, 4.262419399999999
217, 5.627724148426706, 29.936665136039363, 36.04239182669128, 0.7175404, 120.0, 557, 157201, 217, 6.4265223999999534
218, 6.3511520181275625, 29.976061618177198, 36.10875196577627, 0.7163281000000001, 135.0, 790, 157991, 218, 9.186682000000019
219, 7.110699566588587, 30.06377658424442, 36.21400137964239, 0.7150852000000001, 110.0, 591, 158582, 219, 7.40788299999997
220, 8.059982921627368, 30.029102830412967, 36.254608739236865, 0.7133940999999998, 670.0, 1288, 159870, 220, 16.42627159999995
221, 7.742495008004018, 29.144886771033487, 35.218804661883354, 0.7115679999999999, 105.0, 741, 160611, 221, 9.042805799999996
222, 5.332300595032475, 29.005944645594038, 34.90275203361713, 0.7102206999999997, 120.0, 756, 161367, 222, 9.152620800000022
223, 7.455385624041303, 29.07141522354066, 35.0973968033374, 0.70885, 320.0, 767, 162134, 223, 9.186340799999925
224, 7.294445476789345, 28.942516698651406, 34.97071114615879, 0.7075593999999998, 115.0, 667, 162801, 224, 7.807159200000001
225, 5.174574339486035, 28.931468151412023, 34.851108354708984, 0.7060672000000002, 290.0, 991, 163792, 225, 12.381338400000004
226, 6.380573471172436, 28.862995101310112, 34.83637422613195, 0.7048423, 80.0, 370, 164162, 226, 4.81382450000001
227, 6.129683433258497, 28.954652741444853, 34.97234436830047, 0.7036282000000007, 260.0, 979, 165141, 227, 11.937991599999918
228, 5.641682179811938, 28.922035642452652, 34.81488249693123, 0.7021657, 120.0, 646, 165787, 228, 7.996465100000023
229, 7.672851229968824, 28.9281452692043, 34.919554169415036, 0.7009687000000001, 110.0, 684, 166471, 229, 8.519614400000023
230, 5.591265516703758, 28.86923444523747, 34.79826170493183, 0.6998860000000002, 60.0, 519, 166990, 230, 6.14671229999999
231, 7.315097931713712, 29.0204767503949, 35.00677343422682, 0.6988482999999996, 105.0, 634, 167624, 231, 8.091746899999976
232, 7.271193928076226, 28.947200941808017, 34.931781440105254, 0.6979069000000002, 60.0, 412, 168036, 232, 5.178605599999969
233, 4.9435348948074616, 28.86918786941395, 34.789536575302556, 0.69661, 235.0, 1029, 169065, 233, 12.695281000000023
234, 5.562836051537779, 28.949912750075015, 34.878484319583535, 0.6949530999999999, 155.0, 812, 169877, 234, 10.384174899999948
235, 5.6040087875899145, 29.05740001678467, 35.04909780614516, 0.6934572999999996, 210.0, 850, 170727, 235, 10.907274400000006
236, 6.397904538025903, 29.10236309061003, 35.115328380717564, 0.6919686999999999, 210.0, 804, 171531, 236, 9.957794199999853
237, 5.517203913343255, 28.98705820697927, 34.92714309462305, 0.6904989999999996, 410.0, 829, 172360, 237, 10.236944800000174
238, 5.734417435347316, 29.039222556424427, 35.01292532955308, 0.6893794000000001, 20.0, 415, 172775, 238, 5.25780090000012
239, 3.807808713540772, 29.15040178859935, 35.12724427615895, 0.6882103000000002, 400.0, 884, 173659, 239, 10.833186699999942
240, 3.8648850707307694, 29.103473508925664, 35.05857002016098, 0.6868476999999998, 105.0, 630, 174289, 240, 8.231553799999801
241, 7.491467514651359, 29.087624882457344, 35.14730497224253, 0.6858136000000004, 65.0, 519, 174808, 241, 7.091532700000016
242, 5.887031384968726, 29.123961740820675, 35.09679886461431, 0.6846795999999998, 135.0, 741, 175549, 242, 9.12316880000003
243, 3.5111283170059324, 29.055077880620956, 34.97362828850746, 0.6834366999999997, 140.0, 640, 176189, 243, 8.14966800000002
244, 6.042890714952251, 29.128159447030708, 35.10109879420354, 0.6815502999999997, 285.0, 1456, 177645, 244, 18.664833099999896
245, 7.606611245472095, 29.054497443425706, 35.01573538203667, 0.6796072, 105.0, 703, 178348, 245, 8.780200100000002
246, 5.104944492828742, 29.123390881730238, 35.140371862027806, 0.6783570999999999, 105.0, 686, 179034, 246, 8.45433369999978
247, 5.224840360088936, 29.0793385302286, 35.002920200474456, 0.6773599000000002, 50.0, 422, 179456, 247, 5.9217378999999255
248, 3.835400637367068, 28.99310302734375, 34.942405743570724, 0.6762195999999996, 210.0, 845, 180301, 248, 11.129470099999935
249, 4.622479977207138, 28.80021781116337, 34.75505363476741, 0.6749046999999997, 90.0, 616, 180917, 249, 8.002294699999993
250, 5.953747135509144, 28.678098752570875, 34.624099005496866, 0.6736077999999995, 210.0, 825, 181742, 250, 10.669135600000118
251, 3.765067481081183, 28.607421485263128, 34.40865759362377, 0.6722838999999997, 180.0, 646, 182388, 251, 7.8362161000000015
252, 6.685033483118374, 28.829332561966794, 34.76497914035868, 0.6711229, 180.0, 644, 183032, 252, 7.836839199999986
253, 5.285864945536568, 28.746511761347453, 34.65993451390948, 0.6697873000000001, 215.0, 840, 183872, 253, 11.059155400000009
254, 5.112463477626914, 28.712067588391406, 34.67828214575458, 0.6683193999999999, 185.0, 791, 184663, 254, 11.274637499999926
255, 7.598412936950316, 28.59915765126546, 34.575782241717064, 0.6669487, 210.0, 732, 185395, 255, 9.559132699999964
256, 5.673210522517219, 28.786422100213482, 34.7421855902123, 0.6655861, 335.0, 782, 186177, 256, 10.175253600000133
257, 4.594715531523598, 28.731335219258977, 34.64466130901918, 0.664309, 45.0, 637, 186814, 257, 8.358648099999982
258, 5.937376622884692, 28.81101047837889, 34.74713509113758, 0.6631813000000003, 135.0, 616, 187430, 258, 8.15161369999987
259, 6.874236878223031, 28.771112821852626, 34.772070457899595, 0.6617863, 210.0, 934, 188364, 259, 12.702548300000217
260, 3.3980243241171872, 28.692661843077264, 34.530372638374345, 0.6605794, 35.0, 407, 188771, 260, 5.578139299999975
261, 6.087468142482904, 28.798268620330507, 34.74853177589945, 0.6594858999999997, 135.0, 808, 189579, 261, 10.843889399999853
262, 5.352505124857029, 28.39234528541565, 34.251074409484865, 0.6578946999999999, 225.0, 960, 190539, 262, 12.723491899999999
263, 7.182086521429373, 28.0809717332064, 33.947069385757295, 0.6556348000000004, 525.0, 1551, 192090, 263, 20.203318599999875
264, 6.308549440700926, 28.121128767180565, 33.94475949661446, 0.6530158000000004, 460.0, 1359, 193449, 264, 19.23992999999996
265, 5.939179260548593, 27.93125115075739, 33.683641728041934, 0.6511977999999998, 105.0, 661, 194110, 265, 9.027954900000168
266, 6.908408114269038, 28.072617353059783, 33.83133092154784, 0.6498882999999998, 155.0, 794, 194904, 266, 10.943348600000036
267, 7.8026198370807665, 28.033220339547558, 33.8586769433191, 0.6482871999999996, 200.0, 985, 195889, 267, 13.251955100000032
268, 3.905384919445864, 28.05090817837706, 33.83194942315725, 0.6459939999999996, 290.0, 1563, 197452, 268, 21.078278800000135
269, 4.11075030257937, 27.913714536269207, 33.63073222080569, 0.6438664000000001, 135.0, 801, 198253, 269, 10.762370300000157
270, 6.417338219955564, 27.986922159194947, 33.74594351291657, 0.6424254999999998, 180.0, 800, 199053, 270, 11.640139899999895
271, 4.7870729766840485, 27.98010623774099, 33.75633841419452, 0.6409657000000001, 135.0, 822, 199875, 271, 10.863934299999983
272, 3.4892814917746087, 28.231943389296976, 33.973545719699786, 0.6397416999999996, 50.0, 538, 200413, 272, 7.396573100000069
273, 5.279792074416135, 28.39635669980061, 34.23804138333557, 0.6388912, 65.0, 407, 200820, 273, 5.781635700000152
274, 5.16979835832841, 28.39462724288422, 34.29754519779538, 0.6379156000000002, 105.0, 677, 201497, 274, 9.4569477
275, 5.249808274092475, 28.49430692133479, 34.41743414064977, 0.6366187000000001, 110.0, 764, 202261, 275, 10.291007499999978
276, 4.1396267588468305, 28.464348671284128, 34.2937153856805, 0.6352543, 110.0, 752, 203013, 276, 12.775511800000004
277, 4.782016914175904, 28.37270683620287, 34.261616626684216, 0.6339564999999999, 105.0, 690, 203703, 277, 9.855572600000187
278, 4.967008673750012, 28.44482794502713, 34.28884590856287, 0.6326559999999999, 140.0, 755, 204458, 278, 10.444502100000136
279, 5.091715450558211, 28.535738879152575, 34.470989290710605, 0.6316245999999999, 75.0, 391, 204849, 279, 5.702083099999982
280, 4.933437916255931, 28.326875575725108, 34.14583798154115, 0.6305607999999999, 110.0, 791, 205640, 280, 11.721666700000014
281, 3.9891743734564886, 28.427014503786996, 34.283977611942134, 0.6290686, 195.0, 867, 206507, 281, 12.655711800000063
282, 6.282320474904598, 28.542387427864494, 34.41227521552022, 0.627715, 110.0, 637, 207144, 282, 8.989427200000137
283, 6.427240780510363, 28.4946254832404, 34.42890515781584, 0.6265369, 105.0, 672, 207816, 283, 9.656452199999876
284, 6.056803152892008, 28.583428492386375, 34.47356899389239, 0.6251797000000004, 210.0, 836, 208652, 284, 12.05613510000012
285, 3.571304417699933, 28.502358859677393, 34.285763674216874, 0.6240520000000002, 80.0, 417, 209069, 285, 6.2251986999999644
286, 7.669294879506952, 28.64344803441447, 34.57068226157159, 0.6228315999999994, 260.0, 939, 210008, 286, 14.130632200000036
287, 5.80547811454944, 29.014155821035835, 34.96181950678352, 0.6215148999999996, 120.0, 524, 210532, 287, 7.652665200000001
288, 5.249804626517055, 28.98627206121798, 34.88095069114136, 0.6204556, 125.0, 653, 211185, 288, 9.522731099999874
289, 4.308132132546763, 29.049682524146103, 34.96464028635794, 0.6193882000000002, 45.0, 533, 211718, 289, 7.510234500000024
290, 3.4153869086083413, 29.03960622894213, 34.91895529475525, 0.6185386, 75.0, 411, 212129, 290, 6.266338800000085
291, 4.186251508153004, 29.09352255788978, 35.09527579137092, 0.6174234999999999, 410.0, 828, 212957, 291, 12.329086699999834
292, 6.035311759833537, 29.049197743024838, 35.076183436501175, 0.6159033999999999, 120.0, 861, 213818, 292, 12.60607129999994
293, 5.588772699851351, 29.01890844659707, 35.109252905108264, 0.6144300999999999, 135.0, 776, 214594, 293, 11.568018299999949
294, 4.247472805631059, 29.03360550085509, 34.97404398737222, 0.6129964, 380.0, 817, 215411, 294, 12.370167999999921
295, 5.901360019207001, 29.08318321609497, 35.114986724853516, 0.6118110999999999, 50.0, 500, 215911, 295, 7.369830399999955
296, 4.096559666498693, 29.044022434485885, 35.01156256441585, 0.6107598999999999, 135.0, 668, 216579, 296, 10.331368800000064
297, 5.068704466890213, 29.13448434595372, 35.26586966863131, 0.60958, 145.0, 643, 217222, 297, 10.140439100000094
298, 4.004193740357332, 29.078197927345943, 35.06874756619499, 0.6082696000000002, 165.0, 813, 218035, 298, 12.423528199999964
299, 4.566370210477284, 29.002807619420928, 34.99468570012399, 0.6067693000000001, 170.0, 854, 218889, 299, 13.183788699999923
300, 3.1085941351572925, 29.050396964519837, 35.020942383174656, 0.6054319, 125.0, 632, 219521, 300, 9.594680599999947
301, 7.111241795722095, 28.866789176546295, 34.87006625909915, 0.6042367000000002, 155.0, 696, 220217, 301, 10.769733599999881
302, 7.35896707280558, 28.677728596728404, 34.69655859118957, 0.6028165000000001, 290.0, 882, 221099, 302, 14.146622900000011
303, 7.521735448848743, 28.56638556443728, 34.58048308262458, 0.6010867, 300.0, 1040, 222139, 303, 15.698152899999968
304, 4.587281951825369, 28.608077010063276, 34.392063920356364, 0.5997564999999999, 110.0, 438, 222577, 304, 6.468086900000117
305, 4.735051085902195, 28.473028242821787, 34.36583975748299, 0.5986738000000001, 165.0, 765, 223342, 305, 12.121833400000014
306, 5.222790873160223, 28.57310373969319, 34.44283646062176, 0.5973976000000001, 110.0, 653, 223995, 306, 9.591477599999962
307, 4.890466471135539, 28.532576602220846, 34.393055739596505, 0.5961231999999999, 140.0, 763, 224758, 307, 11.649939399999994
308, 8.752956903038978, 28.615956655851715, 34.594601238812054, 0.5948370999999997, 115.0, 666, 225424, 308, 11.063764799999944
309, 4.925517145651259, 28.65861127141412, 34.62308793895402, 0.5935167999999998, 150.0, 801, 226225, 309, 12.906116699999984
310, 3.966167109981644, 28.589288277338547, 34.44116927481986, 0.5919300999999997, 210.0, 962, 227187, 310, 15.246227900000122
311, 6.4900234044382445, 28.598029106541684, 34.4478952809384, 0.5907222999999999, 30.0, 380, 227567, 311, 5.855227300000024
312, 4.862669293649254, 28.55940174981874, 34.42184766862887, 0.5895171999999999, 150.0, 959, 228526, 312, 14.881457599999976
313, 5.665637651778231, 28.608852538852325, 34.528342165566016, 0.587674, 185.0, 1089, 229615, 313, 18.39769339999998
314, 3.1870528916292757, 28.53389660562402, 34.350896678632786, 0.5863761999999999, 65.0, 353, 229968, 314, 5.606080499999962
315, 4.4945714525320115, 29.521577159871736, 35.57769695055269, 0.5857102000000001, 55.0, 387, 230355, 315, 6.1700534999999945
316, 5.858837348451041, 29.548495395728242, 35.61484864961596, 0.5847040000000001, 140.0, 731, 231086, 316, 11.796121399999947
317, 4.451792601123844, 29.507577992388125, 35.59307572317675, 0.5831901999999998, 240.0, 951, 232037, 317, 14.694024900000159
318, 3.977847771443437, 29.480278397661685, 35.46116916503484, 0.5816836000000003, 105.0, 723, 232760, 318, 11.760491900000034
319, 5.097481367849109, 29.47405034571021, 35.454618524435645, 0.5806918000000002, 50.0, 379, 233139, 319, 6.397981600000094
320, 4.497178337768198, 29.564115469861115, 35.698993496889166, 0.5795937999999998, 360.0, 841, 233980, 320, 13.764022000000068
321, 4.194175370299637, 29.359068769905434, 35.39045218526818, 0.5782996, 75.0, 597, 234577, 321, 9.761875700000019
322, 7.124121884745781, 29.539857671718405, 35.65001747439606, 0.5773168000000001, 80.0, 495, 235072, 322, 8.101169199999958
323, 2.8553329139403556, 29.390448457029855, 35.360880760297384, 0.5760829000000001, 210.0, 876, 235948, 323, 14.003865399999995
324, 3.0557457370722694, 29.32271109346406, 35.29874713694946, 0.5745664000000003, 140.0, 809, 236757, 324, 12.895274400000062
325, 6.313759949323563, 29.462719961585645, 35.57604062225058, 0.5732569000000002, 130.0, 646, 237403, 325, 10.689059399999906
326, 5.635345162332919, 29.457621364386934, 35.53525644433197, 0.5721768999999999, 65.0, 554, 237957, 326, 8.961534699999902
327, 4.05039270562785, 29.479771606904222, 35.49632315384714, 0.5710797999999997, 105.0, 665, 238622, 327, 10.39901800000007
328, 3.111185059126001, 29.451343432068825, 35.41808711737394, 0.5700205, 105.0, 512, 239134, 328, 7.527720999999929
329, 4.393234606071185, 29.43598925454927, 35.44383881225951, 0.5688064, 135.0, 837, 239971, 329, 12.802358400000003
330, 4.220154696551677, 30.407564914529093, 36.65266251152542, 0.5671665999999999, 520.0, 985, 240956, 330, 15.502693200000067
331, 6.913341296673344, 30.398777462585628, 36.65251873529446, 0.5656644999999999, 135.0, 684, 241640, 331, 11.146726599999965
332, 6.872403128200627, 30.449443330269876, 36.760278257715086, 0.5644072, 135.0, 713, 242353, 332, 11.624263999999812
333, 4.850500743400288, 30.461546816059656, 36.702798641044154, 0.5631885999999999, 105.0, 641, 242994, 333, 10.661657300000115
334, 9.769394824250117, 30.505258970420453, 37.21488888703245, 0.5622895, 45.0, 358, 243352, 334, 5.592829400000028
335, 3.1380485761239663, 30.449843045347226, 36.637674419331994, 0.5612427999999997, 170.0, 805, 244157, 335, 13.126502600000094
336, 9.43022207915783, 30.5298111541043, 36.99720672254909, 0.5599728999999999, 85.0, 606, 244763, 336, 10.361320599999999
337, 4.283198952910924, 30.39527372228037, 36.61157143470084, 0.5585184999999997, 260.0, 1010, 245773, 337, 17.483534800000143
338, 3.915251044757304, 30.411908585785934, 36.66788820174547, 0.5568832, 160.0, 807, 246580, 338, 14.08625370000027
339, 6.8262429584331175, 30.52554540829924, 36.812666834274694, 0.5555430999999997, 105.0, 682, 247262, 339, 12.077245799999673
340, 4.084500210983318, 30.383830659560736, 36.57499812215731, 0.5541147999999999, 215.0, 905, 248167, 340, 15.872297899999921
341, 6.683965678846315, 30.474620902446365, 36.786035895654045, 0.5529502, 75.0, 389, 248556, 341, 6.644284400000288
342, 6.276783757217419, 30.517401996025672, 36.81787002270038, 0.5518981000000001, 60.0, 780, 249336, 342, 13.57008259999975
343, 3.798563815212525, 30.45984676906041, 36.67152622767857, 0.5505724, 210.0, 693, 250029, 343, 9.942994399999861
344, 4.081934413157011, 31.11211039607686, 37.46652114982892, 0.5493502000000002, 125.0, 665, 250694, 344, 11.178516899999977
345, 8.755605808460446, 31.223745894964672, 37.7094342937294, 0.5480668000000003, 170.0, 761, 251455, 345, 14.815442800000255
346, 6.040169122803139, 31.153652360021947, 37.55948408076941, 0.5464873000000002, 240.0, 994, 252449, 346, 14.688525799999752
347, 5.188543877360367, 31.098897062029156, 37.47365756716047, 0.5448367, 210.0, 840, 253289, 347, 11.920976800000062
348, 2.8946259736523525, 30.917747518518468, 37.24400356837681, 0.5437531, 15.0, 364, 253653, 348, 5.251594999999725
349, 4.2460330108214075, 31.107420761205073, 37.4741012549073, 0.5425731999999999, 270.0, 947, 254600, 349, 14.26139880000028
350, 3.4265003567407146, 31.182296101691314, 37.55039379267403, 0.5409064000000001, 225.0, 905, 255505, 350, 12.864509500000167
351, 6.4065327823427385, 31.170798403572967, 37.62800363829299, 0.5394853000000002, 110.0, 674, 256179, 351, 10.366557100000136
352, 3.53764196288658, 31.133408599483232, 37.518190910408784, 0.5379886000000003, 455.0, 989, 257168, 352, 13.260307099999864
353, 2.998290045912029, 31.14714335667268, 37.501578316433736, 0.5366269, 110.0, 524, 257692, 353, 7.7169128999998975
354, 6.118738146474858, 31.180713401049147, 37.62553904418161, 0.5354551000000001, 155.0, 778, 258470, 354, 11.55493179999985
355, 4.683915203201756, 31.260567716424248, 37.64889462629755, 0.5340358000000001, 180.0, 799, 259269, 355, 11.15471669999988
356, 7.802698494334966, 31.190227759387298, 37.69419316559217, 0.5329539999999998, 10.0, 403, 259672, 356, 5.554320799999914
357, 4.853169133540586, 31.044275118780476, 37.377308395061085, 0.5319567999999999, 105.0, 705, 260377, 357, 9.957416400000056
358, 5.531440075978918, 30.825389757096392, 37.10740722500303, 0.5307499000000001, 260.0, 636, 261013, 358, 8.654478099999778
359, 5.910576057819813, 30.889284045744017, 37.298202620448976, 0.5295934, 105.0, 649, 261662, 359, 8.789026199999626
360, 10.543325690853903, 30.928172409534454, 37.52675606923945, 0.5285197, 50.0, 544, 262206, 360, 7.755981899999824
361, 3.975633510343304, 30.888655927212753, 37.200960968734584, 0.5274171999999997, 115.0, 681, 262887, 361, 9.276359899999989
362, 7.969254001343456, 30.94901101967229, 37.32109189594934, 0.526231, 110.0, 637, 263524, 362, 8.692214700000022
363, 4.76667105184957, 30.899122543805184, 37.15973159014168, 0.5250735999999999, 110.0, 649, 264173, 363, 8.869068100000277
364, 9.99339875661865, 30.97297394362258, 37.498191447869914, 0.5237461, 230.0, 826, 264999, 364, 11.231972999999925
365, 5.303014909792691, 30.971140830516816, 37.28296918869019, 0.5222827, 160.0, 800, 265799, 365, 11.03757110000015
366, 6.891470692647868, 31.0814546361027, 37.49868267702769, 0.5209651000000001, 185.0, 664, 266463, 366, 9.099162500000148
367, 2.7613178573893227, 31.01704918149034, 37.26547087138007, 0.5199976, 50.0, 411, 266874, 367, 5.974141700000018
368, 2.8388884745999774, 30.872969832743866, 37.134194573821574, 0.5190174999999998, 110.0, 678, 267552, 368, 9.633048600000166
369, 5.125491640218929, 31.015471416661814, 37.353581591176855, 0.5174416, 320.0, 1073, 268625, 369, 14.768283399999746
370, 5.675768002332497, 31.152918622714584, 37.57491525314706, 0.5159997999999999, 80.0, 529, 269154, 370, 7.381195800000114
371, 3.784175301904862, 31.06439963414119, 37.3474359189547, 0.5149386999999997, 140.0, 650, 269804, 371, 9.009521700000278
372, 4.571785538555414, 30.542647207994275, 36.794115254952324, 0.5133879999999997, 515.0, 1073, 270877, 372, 15.034265799999957
373, 5.723065375278365, 30.47010493073559, 36.76692840499659, 0.5117940999999998, 130.0, 698, 271575, 373, 9.952100900000005
374, 4.409329262040897, 30.377489295574502, 36.661437743300695, 0.5107735, 50.0, 436, 272011, 374, 6.130153800000244
375, 6.406060376871263, 30.50178035852969, 36.77121478535007, 0.5100579999999998, 50.0, 359, 272370, 375, 5.107185599999866
376, 4.753911921830728, 30.488391022933158, 36.74716209668165, 0.5091192999999998, 105.0, 684, 273054, 376, 9.808584800000062
377, 4.105537506766044, 30.535486712822546, 36.73697993571942, 0.5080357, 90.0, 520, 273574, 377, 7.367667900000015
378, 4.711249668605732, 30.46696271458065, 36.70793932326811, 0.5069998, 135.0, 631, 274205, 378, 8.932995299999675
379, 5.178490894794464, 30.47578984069824, 36.76750172615051, 0.5055319, 320.0, 1000, 275205, 379, 14.17283290000023
380, 7.529350800916702, 30.522501210115838, 36.82426355768512, 0.5040028000000001, 155.0, 699, 275904, 380, 10.028540799999973
381, 2.789543656996735, 30.500219588694364, 36.6680084363274, 0.5027113, 105.0, 736, 276640, 381, 10.560089500000231
382, 4.413887761755192, 30.543287609993143, 36.80003840669673, 0.5016259, 100.0, 470, 277110, 382, 7.2604982000002565
383, 2.219059924836512, 30.58476016130397, 36.824823530893475, 0.5008626999999998, 65.0, 378, 277488, 383, 5.423475199999757
384, 5.237764190253897, 30.460324513732324, 36.71412358591422, 0.49986639999999993, 90.0, 729, 278217, 384, 10.414439399999992
385, 8.48269233599125, 30.57655613821817, 36.94855057843197, 0.4986891999999999, 120.0, 579, 278796, 385, 8.192533299999923
386, 7.644870666800928, 30.54023452481227, 36.84626013841202, 0.49720330000000024, 320.0, 1072, 279868, 386, 14.800331200000073
387, 3.107247180007398, 30.684846754074098, 36.901153306961056, 0.4958784999999999, 105.0, 400, 280268, 387, 5.780010099999799
388, 2.633869496945047, 30.398181230308367, 36.527295002624065, 0.49490199999999995, 135.0, 685, 280953, 388, 9.834437900000012
389, 4.4848266083954105, 30.519676004515755, 36.7348996480306, 0.49363749999999956, 160.0, 720, 281673, 389, 10.050356499999907
390, 6.589035773517813, 30.65700473560123, 36.98549902908445, 0.4925323, 110.0, 508, 282181, 390, 7.186953999999787
391, 5.397402196117337, 30.52682756242298, 36.812535838475306, 0.4916214999999999, 80.0, 504, 282685, 391, 7.149738499999785
392, 2.7693461275199796, 30.578231045657105, 36.78739036745427, 0.49046410000000024, 150.0, 782, 283467, 392, 11.052648699999736
393, 5.044261752208695, 30.604882806539536, 36.84854387640953, 0.4891843000000001, 120.0, 640, 284107, 393, 8.949509500000204
394, 6.14958662982217, 30.650309901552152, 36.945141961731885, 0.48825369999999985, 85.0, 394, 284501, 394, 5.631859299999633
395, 4.069008447621221, 30.557849398216952, 36.80770751340656, 0.48699099999999984, 440.0, 1009, 285510, 395, 14.39947230000007
396, 4.5099796183246506, 30.55980435927137, 36.849061546051246, 0.48545739999999993, 105.0, 695, 286205, 396, 9.941920400000072
397, 7.413536927214375, 30.73517039604723, 37.08673064766563, 0.4841271999999998, 225.0, 783, 286988, 397, 11.227344899999935
398, 3.435388603128528, 30.523345341614636, 36.72085026429163, 0.4826628999999997, 225.0, 844, 287832, 398, 11.989430900000116
399, 6.21826778842231, 30.72971325567213, 37.01788737410206, 0.4813722999999999, 105.0, 590, 288422, 399, 8.436151900000368
400, 6.771960273570156, 30.689296130067813, 37.021821089560945, 0.4801167999999999, 355.0, 805, 289227, 400, 11.65303139999969
401, 4.562156455648928, 30.666770600781, 36.9658134499776, 0.47904309999999994, 50.0, 388, 289615, 401, 5.892298999999639
402, 4.117636457239627, 30.60352290939607, 36.88799603287256, 0.4779972999999998, 170.0, 774, 290389, 402, 11.236077999999907
403, 4.125497494449561, 30.54478926823057, 36.78302196634227, 0.47690919999999987, 110.0, 435, 290824, 403, 6.2895550999996885
404, 4.3459541532562005, 30.54511312983144, 36.796764474418296, 0.4758012999999998, 400.0, 796, 291620, 404, 11.52593539999998
405, 4.770878876703254, 30.62176760168805, 36.91002072530172, 0.4744846, 120.0, 667, 292287, 405, 9.644667200000185
406, 4.733199835912875, 30.644234384012503, 36.938663139677885, 0.4732686999999999, 140.0, 684, 292971, 406, 10.038806999999906
407, 4.505416880936293, 30.620010070121104, 36.92949965377162, 0.4722489999999999, 45.0, 449, 293420, 407, 6.466753499999868
408, 4.168657796519269, 30.632695539411145, 36.886435681163604, 0.4713570999999998, 90.0, 542, 293962, 408, 8.087235999999848
409, 5.346894218932529, 30.60965775039052, 36.883833627045405, 0.47022759999999997, 120.0, 713, 294675, 409, 10.95939780000026
410, 4.169061803263635, 30.62966585638535, 36.88195711164618, 0.4688695, 190.0, 796, 295471, 410, 11.777574100000038
411, 3.81299463665839, 30.533872685189973, 36.777653360097425, 0.46751589999999993, 155.0, 708, 296179, 411, 10.309600099999898
412, 3.725329094334328, 30.63830679982997, 36.88883868158828, 0.4663225000000001, 175.0, 618, 296797, 412, 9.041271000000052
413, 4.954566133400185, 30.52351523130134, 36.84209921257347, 0.4653901000000001, 35.0, 418, 297215, 413, 6.216462400000182
414, 3.7296184210982135, 30.705016144067358, 36.99098507267101, 0.46414449999999996, 210.0, 966, 298181, 414, 14.47631420000016
415, 2.608813867888228, 30.414042442378015, 36.61765315550258, 0.46290879999999995, 45.0, 407, 298588, 415, 6.269309199999952
416, 4.053860083698554, 30.37884676008296, 36.57085525182853, 0.46206369999999997, 90.0, 532, 299120, 416, 7.715991900000063
417, 3.4899364344680763, 30.64251302002342, 36.920854890422454, 0.46101970000000014, 90.0, 628, 299748, 417, 9.046035899999879
418, 4.1377386492833, 30.409617350350807, 36.663519672229526, 0.4591378000000004, 440.0, 1463, 301211, 418, 20.791631600000073
419, 4.533981302582691, 30.240060863434703, 36.481707930940935, 0.45725049999999984, 120.0, 634, 301845, 419, 9.11090329999979
420, 4.672055207101479, 30.277032621067725, 36.443296973690664, 0.4560931000000001, 110.0, 652, 302497, 420, 9.374816200000168
421, 3.139323952321959, 30.34643810574371, 36.51936998461733, 0.4551427, 55.0, 404, 302901, 421, 6.582662199999959
422, 8.457411739731107, 30.321381924838423, 36.686002698718994, 0.45414730000000003, 155.0, 702, 303603, 422, 10.13066949999984
423, 5.811418634799489, 30.355794391297458, 36.55802913464998, 0.4522329999999999, 610.0, 1425, 305028, 423, 20.430074100000184
424, 5.010957731346485, 30.30291284257165, 36.42086003226857, 0.4503123999999999, 155.0, 709, 305737, 424, 10.251492800000051
425, 3.8433341428384162, 30.319060082413497, 36.486613696656974, 0.4490920000000001, 80.0, 647, 306384, 425, 9.303557700000056
426, 6.452442270362009, 30.26828721315244, 36.53091868838749, 0.44804349999999993, 125.0, 518, 306902, 426, 7.508554900000036
427, 4.4895253112782605, 30.290435426131538, 36.45981742195461, 0.44726679999999985, 35.0, 345, 307247, 427, 5.405729899999642
428, 2.6441948309468764, 30.270317390921036, 36.43827009584977, 0.44639739999999994, 155.0, 621, 307868, 428, 9.897605300000123
429, 4.886409027394001, 30.436802936344233, 36.73613456737411, 0.44523279999999993, 365.0, 673, 308541, 429, 10.36302760000035
430, 3.594565847469735, 30.363232044358327, 36.54368436546523, 0.44375859999999995, 285.0, 965, 309506, 430, 14.979736799999955
431, 2.598824065974048, 30.251919829900363, 36.396869061729326, 0.4423041999999999, 120.0, 651, 310157, 431, 10.097542800000156
432, 6.5991824317796555, 30.308171032924278, 36.57414519366096, 0.4412592999999999, 60.0, 510, 310667, 432, 7.834359100000256
433, 4.689997850904295, 30.257280753441485, 36.449573968904254, 0.4400902, 160.0, 789, 311456, 433, 12.428896500000064
434, 9.658679696932325, 30.296666062499394, 36.54070728292536, 0.4390174, 70.0, 403, 311859, 434, 6.308814800000164
435, 3.703680678194935, 30.28342556697066, 36.49435328704787, 0.4380687999999999, 155.0, 651, 312510, 435, 10.212049200000365
436, 4.569344600809211, 30.185920996151584, 36.37277976834044, 0.43686549999999996, 155.0, 686, 313196, 436, 10.637371599999824
437, 4.801073373289117, 30.27672877087689, 36.47447468290393, 0.43571170000000015, 110.0, 596, 313792, 437, 9.455364200000076
438, 7.0800007822861275, 30.370655212402344, 36.608732070922855, 0.4346352999999999, 80.0, 600, 314392, 438, 9.398259799999778
439, 2.5621655828986607, 30.27296002435346, 36.41627205652548, 0.43346079999999987, 115.0, 705, 315097, 439, 10.971819800000048
440, 7.674002180008289, 30.309008162312605, 36.68818268836739, 0.43233220000000006, 120.0, 549, 315646, 440, 8.96250229999987
441, 5.310741620131465, 30.259764912364247, 36.440885753421995, 0.43134669999999986, 85.0, 546, 316192, 441, 8.458909800000129
442, 3.84710957936779, 30.204010887298278, 36.3584249728692, 0.4299535000000002, 215.0, 1002, 317194, 442, 15.73390339999969
443, 4.270487635747383, 30.23377682535272, 36.3887490583721, 0.42819669999999993, 225.0, 950, 318144, 443, 14.967531300000246
444, 2.5769850020791276, 30.246521330468447, 36.39606575671537, 0.42697719999999983, 80.0, 405, 318549, 444, 6.375613899999735
445, 6.165605997753905, 30.348427669038163, 36.63486237221576, 0.4257667000000002, 190.0, 940, 319489, 445, 15.296407199999976
446, 3.6302165579298364, 30.19311553212185, 36.31798988000318, 0.4243384000000001, 60.0, 647, 320136, 446, 10.419778699999824
447, 5.685838987537582, 29.97330887325039, 36.19061664309664, 0.42317469999999996, 150.0, 646, 320782, 447, 10.220896599999833
448, 3.201661100688178, 29.912893510071328, 35.974527395723875, 0.4216582, 170.0, 1039, 321821, 448, 16.437621900000067
449, 5.388011958907434, 29.97253687159087, 36.135627448371174, 0.4198654, 340.0, 953, 322774, 449, 15.164601199999652
450, 5.950101088908115, 29.969850450236507, 36.06189350573064, 0.41864499999999993, 30.0, 403, 323177, 450, 6.519372499999918
451, 4.671664500837178, 29.85215530691221, 35.99291930974916, 0.41770179999999985, 80.0, 645, 323822, 451, 10.556450400000358
452, 5.413354859937255, 29.92072387633285, 36.10961826448518, 0.4162356999999999, 255.0, 984, 324806, 452, 15.742213600000014
453, 5.903084758253474, 30.06325300116288, 36.24209512007864, 0.4144951000000002, 225.0, 950, 325756, 453, 15.182898099999875
454, 5.095406078752849, 30.054740223757236, 36.222646045401824, 0.4130334999999999, 110.0, 674, 326430, 454, 10.853454799999781
455, 5.763092469970097, 29.98466274942473, 36.096795296634404, 0.41180680000000003, 110.0, 689, 327119, 455, 11.166398700000173
456, 8.98797211317455, 30.02029566596536, 36.23449276194853, 0.41080419999999984, 75.0, 425, 327544, 456, 7.286362199999985
457, 3.3055362305681832, 30.044729543315245, 36.17752651450257, 0.40902310000000014, 470.0, 1554, 329098, 457, 25.362281899999743
458, 4.6265328181655025, 29.981986813948296, 36.14314035783734, 0.40706020000000004, 130.0, 627, 329725, 458, 10.156501200000093
459, 3.8377339544501083, 29.999357731646093, 36.10129354543207, 0.4060296999999999, 110.0, 518, 330243, 459, 8.389235000000099
460, 4.711162222601599, 30.121968707564168, 36.324713771976086, 0.4044412, 405.0, 1247, 331490, 460, 20.615974599999845
461, 7.7115366815704185, 30.24403539683721, 36.54182694317544, 0.40299039999999986, 105.0, 365, 331855, 461, 5.954631699999936
462, 2.5999209766423768, 30.225160489316846, 36.372653221172065, 0.4023324999999999, 10.0, 366, 332221, 462, 5.99433689999978
463, 2.576257371409917, 30.013432079778056, 36.10294098235573, 0.40157289999999984, 175.0, 478, 332699, 463, 7.892873000000236
464, 5.459031730482778, 30.140462792192842, 36.36431978793824, 0.3999249999999999, 525.0, 1353, 334052, 464, 22.123527300000205
465, 2.4551538945881877, 30.15038533263154, 36.266129883567054, 0.3978882999999999, 195.0, 910, 334962, 465, 14.816730500000176
466, 4.19492827591764, 30.07597757035845, 36.19784687313996, 0.39604600000000006, 240.0, 1137, 336099, 466, 18.969331499999953
467, 3.8266465108614294, 30.16908333111257, 36.311631019126644, 0.3942558999999999, 210.0, 852, 336951, 467, 13.961059100000057
468, 3.6684002263280444, 30.12981186157618, 36.31772131797595, 0.3929275, 180.0, 624, 337575, 468, 10.433375399999932
469, 3.438048079957881, 30.053026831074124, 36.19973593102392, 0.39151809999999987, 130.0, 942, 338517, 469, 15.584355999999843
470, 4.755443343460191, 30.159042281632082, 36.33331711890158, 0.39008890000000007, 105.0, 646, 339163, 470, 10.83809360000032
471, 3.295201333348458, 30.125559598811336, 36.25832480611335, 0.38875239999999994, 215.0, 839, 340002, 471, 13.995269999999891
472, 3.7325467891941133, 30.349123497777338, 36.50166271644951, 0.3873268, 110.0, 745, 340747, 472, 12.47940490000019
473, 2.545187892762149, 30.2118404084522, 36.33732338495969, 0.38589939999999995, 190.0, 841, 341588, 473, 14.079507399999784
474, 5.768850134379192, 30.313622118577424, 36.58434013235723, 0.3845134, 105.0, 699, 342287, 474, 11.73212840000042
475, 4.837535000695123, 30.300488732231987, 36.48274305386013, 0.3828717999999998, 295.0, 1125, 343412, 475, 19.13902519999965
476, 3.3259476087081143, 30.27910895109482, 36.43566510375117, 0.3811564, 135.0, 781, 344193, 476, 13.090218899999854
477, 4.155523575900893, 30.20483179242199, 36.33574316763753, 0.37976589999999993, 110.0, 764, 344957, 477, 12.754411299999902
478, 2.4868770562518727, 30.20366292225231, 36.340795564131305, 0.37784080000000003, 385.0, 1375, 346332, 478, 23.726928999999927
479, 3.6111565293698247, 30.22087511303463, 36.40046592236257, 0.37598319999999996, 180.0, 689, 347021, 479, 12.228032199999689
480, 7.745840059430277, 30.48574894872205, 36.944576086352924, 0.37502379999999996, 75.0, 377, 347398, 480, 6.3400353000001815
481, 3.1511268030154973, 30.2345702315684, 36.392417282540976, 0.37392940000000013, 190.0, 839, 348237, 481, 14.12440020000031
482, 3.460690574286434, 30.33645678269828, 36.527724786493984, 0.37256409999999995, 80.0, 678, 348915, 482, 11.48428739999963
483, 5.496753146742612, 30.32072355194317, 36.65750111927838, 0.3713446, 120.0, 677, 349592, 483, 11.527874500000053
484, 4.341036031123439, 30.38252981628631, 36.54158330920687, 0.3702195999999999, 80.0, 573, 350165, 484, 9.800510300000042
485, 4.985976284264393, 30.499807289411436, 36.76834644821455, 0.3687498999999998, 515.0, 1060, 351225, 485, 18.669025799999872
486, 3.542026729934735, 30.543709576590537, 36.74749847247022, 0.3672135999999999, 115.0, 647, 351872, 486, 11.115376600000218
487, 4.133410027297605, 30.56629447891217, 36.844077038163896, 0.3658815999999999, 215.0, 833, 352705, 487, 14.239023999999972
488, 4.156090225618461, 30.487874545393318, 36.72487086065884, 0.36447939999999984, 150.0, 725, 353430, 488, 12.56058989999974
489, 3.0842125957044364, 30.468944982887425, 36.67575649709009, 0.3628602999999999, 460.0, 1074, 354504, 489, 18.63040409999985
490, 6.236056488603066, 30.628902155999274, 36.919189761828825, 0.36142659999999993, 65.0, 519, 355023, 490, 8.840389100000266
491, 3.4461210359270393, 30.534793569401177, 36.75132642281877, 0.3603195999999999, 20.0, 711, 355734, 491, 12.032126500000231
492, 4.161827215155506, 30.5528242510298, 36.80115270096323, 0.3590172999999999, 360.0, 736, 356470, 492, 12.481378400000267
493, 5.016692344683494, 30.49173517091211, 36.71849429874459, 0.357913, 75.0, 491, 356961, 493, 8.37047629999961
494, 3.168192513303125, 30.547592374785193, 36.753859141777305, 0.3566359, 225.0, 928, 357889, 494, 15.635042700000213
495, 5.134852572847372, 30.496328984183826, 36.72192795249237, 0.3551742999999999, 45.0, 696, 358585, 495, 12.212300400000004
496, 3.168015306703692, 30.667249277430432, 36.93237449344395, 0.35393319999999995, 80.0, 683, 359268, 496, 11.620671499999844
497, 3.989693661327245, 30.493646746776143, 36.7348316380235, 0.35298910000000006, 80.0, 366, 359634, 497, 6.232598500000222
498, 6.69514073856211, 30.684700847631877, 36.956184334992976, 0.3521008, 140.0, 621, 360255, 498, 10.600611299999855
499, 7.388525871062279, 30.669700888061524, 36.985612573242186, 0.3509794, 130.0, 625, 360880, 499, 10.648003100000096
500, 3.689534542344456, 30.68831839805611, 36.94670922130876, 0.34955559999999997, 360.0, 957, 361837, 500, 16.44006279999985
501, 7.160647751228644, 30.737604103466072, 37.08694322982637, 0.3483307, 70.0, 404, 362241, 501, 7.615122100000008
502, 2.8645170972694323, 30.780642564990853, 37.15315472566629, 0.34761159999999997, 55.0, 395, 362636, 502, 7.014003599999796
503, 3.8475319671778734, 30.716396127948325, 36.95447398324049, 0.3467844999999999, 135.0, 524, 363160, 503, 9.71666230000028
504, 2.2618060763655365, 30.703779718150262, 36.92318754610808, 0.3458161, 75.0, 552, 363712, 504, 11.065778899999714
505, 5.067321893046884, 30.694116649873973, 37.05303410512303, 0.34469199999999994, 155.0, 697, 364409, 505, 14.085015399999975
506, 3.6703829677742825, 30.734844093992, 37.00251575938442, 0.34355169999999996, 120.0, 570, 364979, 506, 11.50302309999961
507, 7.213420592204613, 30.751391514609843, 37.1727515557233, 0.34242669999999986, 115.0, 680, 365659, 507, 14.334834199999932
508, 4.121047375771832, 30.789967174459647, 37.08315509828987, 0.3410829999999999, 210.0, 813, 366472, 508, 15.478369099999782
509, 5.696034808545058, 30.803161945865956, 37.113315642826144, 0.3391038999999999, 345.0, 1386, 367858, 509, 24.732342300000255
510, 6.225021570009514, 30.82415927590676, 37.25714459465545, 0.33692949999999994, 380.0, 1030, 368888, 510, 18.372165499999937
511, 5.61849684888497, 30.766095569133757, 37.0887807559967, 0.3352824999999999, 145.0, 800, 369688, 511, 13.930495600000086
512, 5.640770787667043, 30.604020586665374, 36.87445093711711, 0.3338380000000001, 100.0, 805, 370493, 512, 14.250090499999715
513, 4.238813759948998, 30.41763577947463, 36.6391147313263, 0.33261040000000014, 70.0, 559, 371052, 513, 9.863105699999778
514, 5.301742209770561, 30.42982825542467, 36.72735017025632, 0.33170949999999993, 110.0, 442, 371494, 514, 7.803699900000083
515, 4.4361636120273875, 30.404112979947403, 36.62011647914906, 0.33078339999999984, 105.0, 587, 372081, 515, 10.271584800000255
516, 7.500225475650747, 30.49761250008285, 36.81332363514159, 0.3296584, 105.0, 663, 372744, 516, 12.268535100000008
517, 6.323374619834634, 30.54460747270699, 36.85826364386991, 0.32861349999999984, 30.0, 498, 373242, 517, 8.890289299999495
518, 5.402353184721723, 30.42921309447007, 36.71775678920907, 0.3276316, 90.0, 593, 373835, 518, 10.53020640000068
519, 3.535896876383904, 30.47622895172469, 36.68967464660164, 0.32584150000000006, 360.0, 1396, 375231, 519, 24.703958399999465
520, 5.42679131517906, 30.450382521331225, 36.697798433533144, 0.3239487999999999, 60.0, 707, 375938, 520, 12.7858997000003
521, 6.237812601894392, 30.39207965714016, 36.64589711684215, 0.3224592999999998, 430.0, 948, 376886, 521, 17.224451100000806
522, 5.481674220346048, 30.53605364611049, 36.75169975029494, 0.32100489999999987, 140.0, 668, 377554, 522, 11.904080500000418
523, 2.2207169692320536, 30.62114447119826, 36.819147268600624, 0.31997080000000006, 5.0, 481, 378035, 523, 8.725806600000396
524, 4.18248781457048, 30.487175514630955, 36.72859988005265, 0.319186, 35.0, 391, 378426, 524, 7.0625616999996055
525, 3.25376867727532, 30.481960009137467, 36.66954203749398, 0.3182787999999999, 80.0, 617, 379043, 525, 11.254237099999955
526, 3.5601024874391696, 30.431432442990015, 36.6460724965863, 0.31723479999999993, 105.0, 543, 379586, 526, 10.024082500000077
527, 5.763962319113639, 30.368035463130283, 36.64562841764186, 0.31556979999999973, 260.0, 1307, 380893, 527, 24.013892599999963
528, 2.3834521429848112, 30.22288761250784, 36.31978094263161, 0.3137796999999999, 135.0, 682, 381575, 528, 12.28608450000047
529, 2.722429411121909, 30.490084793858188, 36.6596551928345, 0.3127006, 70.0, 517, 382092, 529, 9.669363500000145
530, 5.8951162816773, 30.23550260839328, 36.44782012079803, 0.3119158, 85.0, 355, 382447, 530, 6.506390100000317
531, 3.5051034791436217, 30.313614697800467, 36.516489787375626, 0.31098519999999996, 150.0, 679, 383126, 531, 12.915513299999475
532, 2.664121508499251, 30.200720781975605, 36.32719675023505, 0.31003569999999997, 60.0, 376, 383502, 532, 7.227359099999376
533, 4.6300650556945495, 30.361788893049688, 36.578058851448596, 0.3082842999999999, 400.0, 1570, 385072, 533, 29.501577500000167
534, 2.276351975773444, 30.332038844166455, 36.47562136184572, 0.3065302, 25.0, 379, 385451, 534, 7.438282500000241
535, 4.103485671760038, 30.273327444874962, 36.45094009332879, 0.30587949999999997, 20.0, 344, 385795, 535, 6.8251452000004065
536, 2.393090485007594, 30.226008130757084, 36.357874309556166, 0.3047310999999999, 215.0, 932, 386727, 536, 17.627162099999623
537, 5.3501365600504736, 30.415313060041786, 36.660878488291864, 0.30327129999999997, 110.0, 690, 387417, 537, 12.735904299999675
538, 2.4886215580616167, 30.33630425002047, 36.484422336509844, 0.3018988, 155.0, 835, 388252, 538, 15.371979200000169
539, 6.091371383239141, 30.331264904159273, 36.625471363524476, 0.3005460999999999, 95.0, 668, 388920, 539, 12.28342900000007
540, 2.8540310849777506, 30.367853009751073, 36.52687385816614, 0.29909169999999996, 230.0, 948, 389868, 540, 17.57975979999992
541, 3.7654346543034634, 30.596958773301623, 36.84914649891465, 0.2971881999999998, 515.0, 1167, 391035, 541, 21.8790285999994
542, 2.8231826167905805, 30.48341152324012, 36.68496939198888, 0.2954142999999999, 145.0, 804, 391839, 542, 14.898445100000572
543, 10.931814113794356, 30.643834130075955, 37.03853770710478, 0.29415429999999987, 165.0, 596, 392435, 543, 11.159843699999328
544, 3.3042090169319485, 30.58530879867411, 36.79300657611027, 0.2931364, 110.0, 535, 392970, 544, 10.009520600000542
545, 3.943822872260383, 30.535013836282523, 36.800686174106104, 0.2923075, 55.0, 386, 393356, 545, 7.455970700000762
546, 3.3566061562741245, 30.55007199887876, 36.78245084974501, 0.2913525999999999, 150.0, 675, 394031, 546, 12.647861999999805
547, 4.890077873386491, 30.652940817419424, 36.90398795713178, 0.2897758000000001, 305.0, 1077, 395108, 547, 20.070194099999753
548, 2.43823842768057, 30.575780230732235, 36.786120440427176, 0.2882386, 155.0, 631, 395739, 548, 11.816630799999984
549, 3.331472386089834, 30.54364250503297, 36.78921216476154, 0.2870488, 185.0, 691, 396430, 549, 12.957967399999688
550, 5.899068271255017, 30.58253547298415, 36.916931949566504, 0.28579599999999994, 280.0, 701, 397131, 550, 13.738807800000359
551, 4.417421683622231, 30.52055589208063, 36.73194149905031, 0.28487890000000005, 35.0, 318, 397449, 551, 6.029302900000403
552, 3.4740655671518583, 30.565728001340606, 36.785073703562716, 0.28398429999999997, 160.0, 676, 398125, 552, 12.730513299999984
553, 2.348137108747941, 30.691282046791216, 36.9389034849819, 0.2830257999999999, 30.0, 389, 398514, 553, 7.369506699999874
554, 2.22578550310242, 30.55360569065754, 36.75971707453658, 0.2819943999999999, 210.0, 757, 399271, 554, 14.621958599999743
555, 3.202412746846676, 30.61948978629418, 36.86753833960302, 0.2804436999999999, 195.0, 966, 400237, 555, 18.70363460000044
556, 5.937179733351884, 30.901682494050366, 37.29333262726412, 0.27872469999999994, 230.0, 944, 401181, 556, 18.037810200000422
557, 6.484096374075421, 30.90948869003508, 37.2026560454242, 0.2771631999999999, 210.0, 791, 401972, 557, 15.046187399999326
558, 5.12019395680534, 30.914398696168057, 37.26265673959437, 0.2756250999999999, 230.0, 918, 402890, 558, 17.95557800000006
559, 5.01168303030963, 30.88736789927763, 37.13434054804783, 0.2743398999999999, 85.0, 510, 403400, 559, 9.847498500000256
560, 6.915424860981728, 31.01397443263651, 37.40409483875302, 0.27325539999999987, 105.0, 695, 404095, 560, 13.750393199999962
561, 3.9337144161905013, 30.9867950090798, 37.31172949267972, 0.2717929, 240.0, 930, 405025, 561, 17.847623800000292
562, 3.888598344567339, 30.87871850612944, 37.184651575679275, 0.26993890000000004, 440.0, 1130, 406155, 562, 21.797985700000027
563, 3.794803617427656, 30.877029768667235, 37.16946841712426, 0.2682297999999999, 225.0, 769, 406924, 563, 15.047496500000307
564, 4.51616556865267, 30.889579632218627, 37.20984492758567, 0.26639109999999977, 230.0, 1274, 408198, 564, 24.762624299999516
565, 7.126943458614932, 30.902623452183125, 37.23818688352278, 0.2645001999999999, 305.0, 827, 409025, 565, 16.177173500000208
566, 2.236524774562277, 30.84037475755857, 37.06856134155545, 0.26335179999999986, 20.0, 449, 409474, 566, 8.790053999999145
567, 4.074270743989583, 31.257438679675122, 37.64643462832435, 0.2621754999999999, 235.0, 858, 410332, 567, 16.937202299999626
568, 4.722303573318281, 31.864519307765292, 38.38212573047732, 0.2607111999999999, 215.0, 769, 411101, 568, 15.106120499999633
569, 3.3940263737014607, 31.889556388634478, 38.38618992381013, 0.25939629999999997, 130.0, 692, 411793, 569, 13.521484099999725
570, 5.688612367342601, 31.85446220938654, 38.40277235033608, 0.2573893, 540.0, 1538, 413331, 570, 29.871929799999634
571, 3.8821809672708834, 31.772439904473906, 38.30852383286206, 0.2556433, 75.0, 402, 413733, 571, 8.683737000000292
572, 4.412130984388719, 31.869179692238, 38.33808225279401, 0.2547162999999999, 110.0, 628, 414361, 572, 12.41902250000021
573, 5.274791322778187, 32.014873239090804, 38.5884590046792, 0.2534787999999999, 165.0, 747, 415108, 573, 14.951010500000848
574, 3.0608519249885666, 31.7347645061208, 38.14927267450135, 0.25187859999999995, 225.0, 1031, 416139, 574, 20.407656100000167
575, 4.692917234621894, 31.877652025533084, 38.32662824436279, 0.2501209, 175.0, 922, 417061, 575, 18.72599799999989
576, 4.110956145150737, 31.849962634601813, 38.303602843449035, 0.24897789999999995, 30.0, 348, 417409, 576, 6.922716600000058
577, 5.899866249697605, 31.888038420311993, 38.44639003928955, 0.24784209999999998, 155.0, 914, 418323, 577, 18.226408399999855
578, 6.020116749329329, 31.69993095455573, 38.18901331691223, 0.24642369999999986, 145.0, 662, 418985, 578, 13.076045499999964
579, 4.461846868409845, 31.80758859360754, 38.32111042112559, 0.24498729999999996, 140.0, 934, 419919, 579, 18.724026899999444
580, 4.245832828602877, 31.849650838001665, 38.349146440804724, 0.24339969999999997, 115.0, 830, 420749, 580, 17.033875400000397
581, 5.174698505820171, 31.819588450642375, 38.318988347097765, 0.24168250000000002, 240.0, 1078, 421827, 581, 21.388993200000186
582, 3.2666326335632783, 31.78803745980888, 38.27115434944912, 0.23957289999999978, 480.0, 1266, 423093, 582, 25.613134199999877
583, 4.4961343508409115, 31.91507757162746, 38.404212489481644, 0.2379357999999999, 120.0, 553, 423646, 583, 11.914918200000102
584, 4.954077815879031, 31.76335989149277, 38.311499234646725, 0.23680089999999984, 125.0, 708, 424354, 584, 14.363628799999788
585, 4.367990244278068, 31.757326943339827, 38.20615138532428, 0.23489920000000006, 345.0, 1405, 425759, 585, 28.31500169999981
586, 3.9170203040031573, 31.75265946525794, 38.21026198680584, 0.2328858999999999, 225.0, 832, 426591, 586, 17.43874659999983
587, 2.225783713572607, 31.716316020394874, 38.13582249889224, 0.23167989999999994, 70.0, 508, 427099, 587, 10.641158100000212
588, 5.533483057081881, 31.828868170277325, 38.36734983913804, 0.23063049999999988, 135.0, 658, 427757, 588, 13.521880199999941
589, 3.9811444171622736, 31.738622422693442, 38.19003057766075, 0.22928859999999993, 125.0, 833, 428590, 589, 17.154179799999838
590, 3.340782746883, 31.745852932649502, 38.19372039346134, 0.22777389999999995, 215.0, 850, 429440, 590, 18.255634399999508
591, 3.9101943617455652, 31.586228501945904, 38.039121486763634, 0.2262177999999999, 215.0, 879, 430319, 591, 18.204769799999667
592, 5.252257312299765, 31.559419631958008, 38.016687345504764, 0.22459869999999996, 260.0, 920, 431239, 592, 18.901869600000282
593, 3.761437398582174, 31.543557557223135, 37.97396128871985, 0.22248820000000008, 620.0, 1425, 432664, 593, 29.503163599999425
594, 5.227403422682373, 31.535963033040364, 37.987143444485135, 0.2205981999999999, 120.0, 675, 433339, 594, 14.133136600000398
595, 5.993737130462291, 31.561621719232484, 38.06328399487714, 0.2193463, 210.0, 716, 434055, 595, 14.57969200000025
596, 4.655641607779682, 31.530988763435953, 38.01740148465552, 0.21769929999999993, 490.0, 1114, 435169, 596, 22.63984359999995
597, 3.6963187511353817, 31.486794668622128, 37.90561099018815, 0.2158029999999999, 290.0, 993, 436162, 597, 20.512416900000062
598, 3.5304205977822667, 31.52849062707062, 37.99258060944386, 0.21445299999999998, 5.0, 507, 436669, 598, 10.472030000000814
599, 2.203536932743513, 31.423028253408578, 37.75954904409555, 0.2134116999999999, 110.0, 650, 437319, 599, 13.491288400000485
600, 2.4278740564357557, 31.48403412419827, 37.87582248320514, 0.2123686, 85.0, 509, 437828, 600, 10.608570499999587
601, 7.7709656170744825, 31.484261200393455, 38.0088541832523, 0.21159999999999995, 20.0, 345, 438173, 601, 7.256990799999585
602, 4.098708534820995, 31.51556647792881, 37.95678695794089, 0.21033729999999995, 280.0, 1058, 439231, 602, 22.24581709999984
603, 3.477267217480888, 31.583005248175727, 37.9948546939426, 0.20873709999999998, 150.0, 720, 439951, 603, 17.188460399999713
604, 4.358200894583364, 31.475541663207526, 37.90336712239101, 0.20694969999999993, 365.0, 1266, 441217, 604, 26.937708100000236
605, 4.414482021938622, 31.45813068545242, 37.89865760630612, 0.20481579999999996, 330.0, 1105, 442322, 605, 23.548747600000752
606, 4.921007882671657, 31.374883681122437, 37.8216704852041, 0.20323719999999995, 105.0, 649, 442971, 606, 13.739539299999706
607, 3.7195145717881517, 31.312114243189036, 37.70967353305967, 0.20139939999999998, 345.0, 1393, 444364, 607, 29.735572000000502
608, 6.475256794790589, 31.46674869114879, 37.97107851854753, 0.19959309999999997, 125.0, 614, 444978, 608, 13.115727300000799
609, 4.639780453565651, 31.43117684396515, 37.863890766681145, 0.19826739999999993, 195.0, 859, 445837, 609, 18.79395409999961
610, 4.377045794486027, 31.423734616309737, 37.85553968159309, 0.1966114, 200.0, 981, 446818, 610, 20.998378299999786
611, 3.1147464941064995, 31.37353490634137, 37.75434478219733, 0.19513089999999997, 150.0, 664, 447482, 611, 14.385126600000149
612, 5.47059166756345, 31.4909486444985, 37.96165782277177, 0.19361079999999992, 200.0, 1025, 448507, 612, 21.89843269999983
613, 2.1169561188494956, 31.400076117667126, 37.745906633969334, 0.1919521, 245.0, 818, 449325, 613, 17.957914200000232
614, 7.227563879361986, 31.52711872083951, 38.03344423159034, 0.1904022999999999, 135.0, 904, 450229, 614, 19.44859819999965
615, 2.450993322050309, 31.918566786093155, 38.35687884542139, 0.18905679999999994, 115.0, 591, 450820, 615, 12.857966999999917
616, 3.2244070633011455, 32.0114612748637, 38.508119278405545, 0.18791649999999996, 180.0, 676, 451496, 616, 14.55707639999946
617, 4.625249537317434, 31.96994087553244, 38.49076718888524, 0.1865269, 285.0, 868, 452364, 617, 19.102459100000488
618, 3.148564533989751, 32.0009945001495, 38.615591809990704, 0.18542529999999988, 35.0, 356, 452720, 618, 8.024791000000732
619, 5.092856793237018, 31.954681866906682, 38.49979246678374, 0.18450279999999994, 110.0, 669, 453389, 619, 14.368554900000163
620, 3.8020643016592186, 31.89956277875758, 38.370672159527075, 0.18353889999999998, 35.0, 402, 453791, 620, 8.737995600000431
621, 3.4703574132337596, 32.01168938438491, 38.519668848882134, 0.18254079999999995, 90.0, 707, 454498, 621, 15.720676099999764
622, 5.59288401806259, 31.991929097218556, 38.55774240808802, 0.18100539999999996, 355.0, 999, 455497, 622, 21.686892400000033
623, 5.329084103683678, 31.99025821912317, 38.54509465541523, 0.17934849999999994, 210.0, 842, 456339, 623, 18.42557080000006
624, 2.960027363648694, 31.903253430566608, 38.348085881578825, 0.1779300999999999, 115.0, 734, 457073, 624, 16.057131300000037
625, 5.041861670251742, 32.02162070289523, 38.62354372414905, 0.17642079999999988, 185.0, 943, 458016, 625, 20.878130399999463
626, 2.549839121606988, 31.962406706474198, 38.421151464757784, 0.17525259999999993, 75.0, 355, 458371, 626, 7.886551399999917
627, 5.7206921676859785, 32.01044751338534, 38.59130492904083, 0.1742463999999999, 135.0, 763, 459134, 627, 16.146403900000223
628, 5.842271759810037, 32.100108715082634, 38.73768053202176, 0.17274429999999993, 190.0, 906, 460040, 628, 20.18698669999958
629, 4.543596326945776, 32.42622623464494, 39.03511298682055, 0.1711072, 185.0, 913, 460953, 629, 20.295873899999606
630, 4.205123017481445, 32.46087130522117, 39.080691362038635, 0.1693728999999999, 185.0, 1014, 461967, 630, 23.496586299999763
631, 2.32040930588315, 32.383359516450085, 38.90597755821952, 0.16784379999999993, 130.0, 685, 462652, 631, 15.290664500000275
632, 3.4403243457549664, 32.40733159641495, 39.01653822234999, 0.1662084999999999, 460.0, 1132, 463784, 632, 24.986916799999562
633, 3.593831483523051, 32.33714574632191, 38.90455046154204, 0.16481169999999995, 35.0, 420, 464204, 633, 9.379205400000501
634, 2.2584732125686817, 32.45391405688714, 39.02178386822978, 0.1636947999999999, 220.0, 821, 465025, 634, 18.407920699999522
635, 5.105348219962955, 32.5208880318229, 39.1943031592583, 0.16233399999999992, 90.0, 691, 465716, 635, 16.14696669999921
636, 5.0980455283773, 32.45377913348751, 39.026630105493275, 0.16112079999999995, 110.0, 657, 466373, 636, 15.5898373
637, 3.044769949340078, 32.49659998504755, 39.12810903159, 0.15982119999999997, 185.0, 787, 467160, 637, 19.332507500000247
638, 4.397943948885278, 32.459004515600164, 39.09494587473443, 0.1580157999999999, 405.0, 1219, 468379, 638, 29.162003499999628
639, 6.263121917251563, 32.61837387691431, 39.362312407865055, 0.15635259999999995, 105.0, 629, 469008, 639, 13.788823300000331
640, 3.5918600587337686, 32.46022156014545, 39.02959598853574, 0.15486309999999995, 520.0, 1026, 470034, 640, 22.293224799999734
641, 3.3011813316809513, 32.901489901954065, 39.58098545873763, 0.15284439999999994, 430.0, 1217, 471251, 641, 26.702510400000392
642, 4.976154124765079, 33.02641735197623, 39.76120879579697, 0.15089589999999994, 185.0, 948, 472199, 642, 21.02128360000006
643, 9.354159382345482, 33.14558290997202, 40.015559739641006, 0.14969979999999997, 40.0, 381, 472580, 643, 8.36545500000011
644, 4.648073534005218, 32.978033440907794, 39.71627522362603, 0.14854689999999995, 510.0, 900, 473480, 644, 19.987381200000527
645, 8.536353549156088, 32.97320871371384, 39.781735203234234, 0.14726619999999999, 55.0, 523, 474003, 645, 11.598858199999995
646, 3.9008653928412897, 32.90039133358891, 39.57206317175244, 0.14611959999999988, 355.0, 751, 474754, 646, 16.535745000000134
647, 8.455925334711385, 33.055400448310664, 39.85658674782854, 0.1448901999999999, 105.0, 615, 475369, 647, 13.632593799999995
648, 3.5489760286635184, 32.85758230145536, 39.55995208002821, 0.1438524999999999, 55.0, 538, 475907, 648, 11.928229799999826
649, 5.069979340850877, 32.91260665869983, 39.6029774305381, 0.14249439999999994, 165.0, 971, 476878, 649, 22.776856899999984
650, 5.997507653676328, 33.03132900056385, 39.82613990057082, 0.14114799999999994, 110.0, 525, 477403, 650, 12.753673300000628
651, 4.10101505045129, 32.920501081983026, 39.61835611108039, 0.1396981, 205.0, 1086, 478489, 651, 26.235164600000644
652, 3.806880026915329, 32.994109768187904, 39.720896443433276, 0.13795659999999996, 140.0, 849, 479338, 652, 20.578440999999657
653, 5.7365072045061325, 33.071533075968425, 39.820912816789416, 0.1368684999999999, 55.0, 360, 479698, 653, 8.747495900000104
654, 3.922013575832049, 32.88848245008936, 39.621540103168606, 0.13582899999999992, 155.0, 795, 480493, 654, 19.21113939999941
655, 4.894383483149452, 32.83575248422319, 39.51851775093167, 0.13395339999999994, 520.0, 1289, 481782, 655, 32.230879800000366
656, 3.9147642549846093, 32.88317383072265, 39.57391891383283, 0.13207959999999985, 215.0, 793, 482575, 656, 19.39771539999947
657, 4.5926388567988425, 33.016903839249544, 39.766870871834136, 0.13086909999999993, 95.0, 552, 483127, 657, 13.606628300000011
658, 3.831703839749447, 32.93421002908389, 39.646833607407864, 0.12960369999999996, 210.0, 854, 483981, 658, 21.167004599999927
659, 3.1246188581723886, 32.85256797339529, 39.50611646304577, 0.12810429999999995, 210.0, 812, 484793, 659, 20.483180600000196
660, 5.084053173793101, 32.881355462876044, 39.61347765064521, 0.12676329999999994, 125.0, 678, 485471, 660, 16.521789200000057
661, 3.460255761732762, 32.775434173744124, 39.41434124742133, 0.12555279999999994, 110.0, 667, 486138, 661, 16.675566199999594
662, 4.237688781660231, 32.84341008218048, 39.55362339458807, 0.12460059999999991, 70.0, 391, 486529, 662, 9.769965200000115
663, 3.5705129585291386, 32.89566718057693, 39.57268545737115, 0.12373929999999995, 50.0, 566, 487095, 663, 14.611910900000112
664, 4.923123793473726, 32.91550982511496, 39.653118341180345, 0.12251889999999989, 180.0, 790, 487885, 664, 19.466532800000095
665, 3.6670259765106374, 32.89898097342339, 39.5895946820577, 0.12081429999999996, 195.0, 1104, 488989, 665, 27.323680100000274
666, 6.388369263095014, 33.04559691392384, 39.824661734621614, 0.11937699999999997, 45.0, 493, 489482, 666, 12.823048799999924
667, 4.811044840584238, 32.824031323310464, 39.53445915118266, 0.11800809999999988, 230.0, 1028, 490510, 667, 25.747988500000247
668, 5.225458678049015, 32.77316452852978, 39.43579318268582, 0.1164681999999999, 120.0, 683, 491193, 668, 17.1704093999997
669, 5.150122106677907, 32.79301041434793, 39.48912911695592, 0.11524149999999993, 170.0, 680, 491873, 669, 17.35966069999995
670, 5.537669786838641, 32.72351314947472, 39.478302286278385, 0.11390499999999992, 165.0, 805, 492678, 670, 20.066582800000106
671, 3.241728843205005, 32.75068980162998, 39.373256047566734, 0.1117494999999999, 480.0, 1590, 494268, 671, 39.623781999999665
672, 3.7933398753356857, 32.68027845865641, 39.29956705447955, 0.10919529999999991, 340.0, 1248, 495516, 672, 32.142492899999525
673, 2.1711639677914083, 32.691855179429545, 39.29980871412489, 0.1076346999999999, 45.0, 486, 496002, 673, 12.302208199999768
674, 3.8952818126745625, 32.68841988827701, 39.36274550890139, 0.10681389999999993, 75.0, 426, 496428, 674, 10.736167000000023
675, 3.7513689574885962, 32.712415464355374, 39.35463334905537, 0.10527039999999994, 465.0, 1289, 497717, 675, 32.99043249999977
676, 4.431044353366924, 32.735668975342094, 39.42342014007756, 0.10337859999999996, 205.0, 813, 498530, 676, 20.431727000000137
677, 3.144318348676949, 32.633682473675236, 39.270625376439355, 0.10199169999999995, 110.0, 728, 499258, 677, 18.522421499999837
678, 3.518661006168528, 33.299442866356856, 40.085719252355815, 0.10044261855485975, 245.0, 1121, 500379, 678, 29.199529800000164
679, 4.6337721513377295, 34.22292257452386, 41.20882621705198, 0.09999999999999912, 260.0, 891, 501270, 679, 22.489252100000158
680, 3.621211436438276, 34.15575909472365, 41.089831175908415, 0.10000000000000088, 155.0, 503, 501773, 680, 12.825069399999848
681, 4.661337679979398, 34.247056620413325, 41.25724189049973, 0.09999999999999735, 640.0, 1411, 503184, 681, 36.57391699999971
682, 4.147178374721874, 34.19185073054622, 41.14341053238571, 0.10000000000000045, 215.0, 698, 503882, 682, 18.118002199999864
683, 2.2053725718836152, 34.30883668079849, 41.24246081044851, 0.10000000000000087, 125.0, 484, 504366, 683, 12.527392699999837
684, 5.715680581331253, 34.2751885250882, 41.279179427000855, 0.09999999999999817, 640.0, 1110, 505476, 684, 29.156209800000397
685, 2.3512247045803223, 34.236775443812085, 41.20138139785475, 0.10000000000000099, 145.0, 628, 506104, 685, 16.14565179999954
686, 4.44124303609839, 34.25545170860833, 41.28463040633601, 0.10000000000000099, 120.0, 633, 506737, 686, 16.461909399999968
687, 4.277667821831274, 34.30226552638086, 41.280523518569595, 0.09999999999999794, 300.0, 1179, 507916, 687, 31.358129700000063
688, 6.094228382256746, 34.230462960337604, 41.19796467813467, 0.10000000000000063, 195.0, 677, 508593, 688, 17.540142200000446
689, 5.243080455318025, 34.2599044388813, 41.24441100541666, 0.10000000000000081, 110.0, 659, 509252, 689, 18.67201909999949
690, 3.2388939545913176, 34.22568140042472, 41.13738084876019, 0.09999999999999995, 155.0, 759, 510011, 690, 20.81133250000039
691, 5.62956380743659, 34.19525413201462, 41.225243709669414, 0.09999999999999869, 560.0, 979, 510990, 691, 25.352478599999813
692, 4.423348182386631, 34.01630739327093, 40.96676993876468, 0.09999999999999795, 535.0, 1177, 512167, 692, 32.180690799999866
693, 4.248622779376232, 34.025945652166065, 40.91279632523215, 0.10000000000000064, 115.0, 676, 512843, 693, 17.6864943999999
694, 4.226434538454461, 34.019893174205755, 40.943015733897255, 0.10000000000000046, 120.0, 695, 513538, 694, 17.980242399999952
695, 3.2318134359362474, 33.98986157035359, 40.89610098386572, 0.09999999999999781, 280.0, 1221, 514759, 695, 32.52641540000059
696, 2.369489430198594, 34.059682164873394, 40.96241594748522, 0.10000000000000071, 75.0, 378, 515137, 696, 10.041413300000386
697, 2.474359690458339, 34.03219486176607, 40.92921805698897, 0.09999999999999949, 185.0, 827, 515964, 697, 21.771127399999386
698, 4.057445166388732, 33.984115500724755, 40.922109214423216, 0.10000000000000071, 80.0, 382, 516346, 698, 10.059782499999528
699, 2.1229971414836855, 33.99494777555051, 40.83411810709082, 0.10000000000000069, 75.0, 368, 516714, 699, 9.980617299999722
700, 3.852868639759101, 34.064105819302355, 41.020080243239754, 0.09999999999999805, 365.0, 1145, 517859, 700, 30.368857700000262
701, 5.294527013098829, 34.124956744553565, 41.187193541547614, 0.10000000000000055, 130.0, 687, 518546, 701, 18.23321399999986
702, 2.4050184861162287, 34.125919074796684, 41.0139919173246, 0.09999999999999915, 300.0, 885, 519431, 702, 23.7673949
703, 7.022704856283071, 34.22985440578187, 41.255388985410264, 0.09999999999999944, 520.0, 836, 520267, 703, 22.156801799999812
704, 3.8619470890174363, 34.26407525259689, 41.222006728529266, 0.10000000000000067, 75.0, 358, 520625, 704, 9.65033829999993
705, 5.886693053271459, 34.34534478421632, 41.40155972538289, 0.10000000000000031, 45.0, 713, 521338, 705, 19.020080999999664
706, 4.730437782548723, 34.33703676381506, 41.32185821246384, 0.09999999999999967, 150.0, 798, 522136, 706, 21.754187999999886
707, 4.991249912291292, 34.33753385543823, 41.35071227058532, 0.09999999999999772, 375.0, 1260, 523396, 707, 33.53632629999993
708, 4.906444872580517, 34.27422070596246, 41.259642398868955, 0.09999999999999988, 150.0, 769, 524165, 708, 21.088030699999763
709, 3.2746711663815673, 34.2711264246461, 41.234041340778326, 0.10000000000000049, 145.0, 692, 524857, 709, 18.472346100000323
710, 5.774355037094992, 34.59249987687601, 41.698221465205904, 0.10000000000000073, 50.0, 391, 525248, 710, 10.515494899999794
711, 3.73571789713649, 34.30899617083661, 41.3143574008694, 0.10000000000000071, 70.0, 385, 525633, 711, 10.364264099999673
712, 4.6603890207999115, 34.48019135319175, 41.47579826133838, 0.09999999999999874, 240.0, 966, 526599, 712, 26.54957319999994
713, 3.0955307589093253, 34.329513236657895, 41.325261528812234, 0.1000000000000007, 150.0, 670, 527269, 713, 18.32000639999933
714, 3.784874593748137, 34.4406794570767, 41.436987886634505, 0.09999999999999917, 290.0, 881, 528150, 714, 23.812519599999177
715, 3.099399482252086, 34.434693431354944, 41.42093316123123, 0.0999999999999988, 320.0, 955, 529105, 715, 26.206802499999867
716, 6.086106389993243, 34.51967431715638, 41.586018152945904, 0.09999999999999945, 185.0, 834, 529939, 716, 22.64552089999961
717, 4.269344971464067, 34.84843962533133, 41.94928947560516, 0.09999999999999823, 220.0, 1092, 531031, 717, 29.825026499999694
718, 5.562218643111608, 34.8266063986755, 41.92810800598889, 0.10000000000000084, 305.0, 656, 531687, 718, 18.122370000000046
719, 5.200835634074526, 34.889036854996846, 42.04594954388083, 0.09999999999999887, 245.0, 939, 532626, 719, 25.40143900000021
720, 5.217257486044625, 34.93709689952709, 42.035565986162354, 0.10000000000000075, 75.0, 405, 533031, 720, 11.02628679999998
721, 9.899934415848984, 34.90509019846342, 42.35470903754568, 0.10000000000000067, 45.0, 357, 533388, 721, 9.992258700000093
722, 4.8408554014799305, 34.89872134139997, 42.07096977188849, 0.09999999999999937, 170.0, 847, 534235, 722, 23.60084790000019
723, 4.6129410040750845, 34.89931527964448, 42.00578634069648, 0.09999999999999726, 305.0, 1457, 535692, 723, 41.35945530000026
724, 5.761496138814788, 34.87122006089039, 42.03256382349778, 0.09999999999999803, 270.0, 1151, 536843, 724, 43.60257199999978
725, 6.40317669374577, 34.99729282525437, 42.132316724389, 0.10000000000000063, 35.0, 339, 537182, 725, 10.457369800000379
726, 4.682923196466108, 34.869301827639376, 41.95983106737694, 0.09999999999999921, 170.0, 873, 538055, 726, 30.729723399999784
727, 4.469695527273449, 34.90948800050496, 42.028397456935195, 0.09999999999999899, 260.0, 915, 538970, 727, 25.663046799999393
728, 5.814502076024101, 34.86522768518608, 42.039399840757376, 0.10000000000000098, 85.0, 609, 539579, 728, 19.69635240000025
729, 4.470046163977304, 34.84551216783501, 41.907845348189205, 0.0999999999999993, 160.0, 858, 540437, 729, 27.915261900000587
730, 4.939788750947947, 34.87859308007229, 41.94741650311595, 0.10000000000000088, 125.0, 502, 540939, 730, 15.353493900000103
731, 5.580360382513382, 34.786684554144244, 41.874680146476294, 0.09999999999999837, 260.0, 1057, 541996, 731, 32.73057280000012
732, 4.187996015161359, 34.70166245895941, 41.75576727730887, 0.10000000000000067, 35.0, 357, 542353, 732, 12.306974500000251
733, 3.4353689124395035, 34.70350527620601, 41.7311641955804, 0.10000000000000071, 135.0, 668, 543021, 733, 18.56602750000002
734, 6.764731897569721, 34.80343108006417, 41.96741115160225, 0.10000000000000021, 135.0, 726, 543747, 734, 18.451014100000066
735, 4.8610848984849735, 34.73745010856568, 41.80769704983929, 0.10000000000000099, 95.0, 635, 544382, 735, 18.12576100000024
736, 5.091189836024899, 34.7794245400212, 41.89879995584488, 0.1000000000000004, 125.0, 704, 545086, 736, 24.0432923999997
737, 4.0211472791128715, 34.90205222390973, 41.99703491234216, 0.09999999999999759, 470.0, 1311, 546397, 737, 47.03988079999999
738, 4.912356487405015, 34.76003378486985, 41.85485245509701, 0.10000000000000092, 115.0, 543, 546940, 738, 15.675486799999817
739, 3.9373983144581355, 34.91469290561138, 41.997884840756456, 0.0999999999999969, 545.0, 1667, 548607, 739, 49.33618100000058
740, 3.9327185892858987, 34.906267733014495, 42.004067490220734, 0.09999999999999909, 185.0, 895, 549502, 740, 25.61939220000022
741, 4.15545838939177, 34.7899257763012, 41.92432606052708, 0.09999999999999894, 165.0, 925, 550427, 741, 27.051028300000326
742, 4.7018949595403, 34.94862748991768, 42.07465942850653, 0.09999999999999767, 330.0, 1272, 551699, 742, 36.12933019999946
743, 2.6538598641377535, 34.75706051234581, 41.775145101375514, 0.09999999999999945, 195.0, 833, 552532, 743, 28.601799000000028
744, 4.251635399284621, 34.76617075539575, 41.85924381575561, 0.10000000000000075, 100.0, 406, 552938, 744, 13.95681119999972
745, 6.113844975455613, 34.88304081315415, 42.0041642000304, 0.09999999999999996, 155.0, 758, 553696, 745, 23.753814699999566
746, 6.363595278590813, 34.93455645347676, 42.11112239520128, 0.09999999999999933, 155.0, 853, 554549, 746, 25.658842000000732
747, 3.238637309987098, 34.846526214631936, 41.932419821367425, 0.09999999999999885, 290.0, 944, 555493, 747, 30.97502969999914
748, 2.6460838646618363, 34.731616629767665, 41.834214987214075, 0.10000000000000073, 80.0, 388, 555881, 748, 13.530692300000737
749, 4.519723485337988, 34.87532907278359, 41.97958875189022, 0.09999999999999795, 145.0, 1176, 557057, 749, 37.48264829999971
750, 3.1471463208130053, 34.78286259098566, 41.80853818972711, 0.09999999999999955, 170.0, 818, 557875, 750, 23.82232159999876
751, 5.69926309545099, 34.90221885869533, 42.048056284586586, 0.10000000000000075, 35.0, 405, 558280, 751, 10.792825799999264
752, 3.347098205009953, 34.91222351065038, 42.01255960384144, 0.09999999999999946, 365.0, 831, 559111, 752, 21.957028799999534
753, 2.5467660008105044, 34.78675014414686, 41.84959652615062, 0.10000000000000098, 85.0, 611, 559722, 753, 16.5474368999985
754, 5.898773394305732, 34.946853525403974, 42.08969036323669, 0.09999999999999791, 260.0, 1189, 560911, 754, 31.14911729999949
755, 3.6322022319662026, 35.084677770246365, 42.217176837444, 0.09999999999999706, 325.0, 1559, 562470, 755, 42.703568599999926
756, 2.413342864019322, 34.93322365832669, 42.01528891040934, 0.10000000000000087, 105.0, 491, 562961, 756, 13.622215599998526
757, 3.694975308856496, 35.02680909123402, 42.172323865185454, 0.09999999999999848, 265.0, 1028, 563989, 757, 28.939899300001343
758, 3.201157365478878, 35.07086526087629, 42.18132987836512, 0.09999999999999866, 225.0, 984, 564973, 758, 27.71421399999963
759, 3.2827351967846417, 34.95173238903041, 42.02732258042856, 0.0999999999999993, 195.0, 859, 565832, 759, 24.28497090000019
760, 6.012587357421784, 35.14765273084413, 42.373279300728754, 0.09999999999999724, 375.0, 1465, 567297, 760, 41.75574020000022
761, 4.149443237032365, 35.02687347832076, 42.139569473266604, 0.09999999999999824, 245.0, 1090, 568387, 761, 29.22633550000137
762, 5.265482681679324, 35.052689416485215, 42.209339819494836, 0.10000000000000087, 110.0, 653, 569040, 762, 18.20491580000089
763, 2.350441733316618, 35.008397096358, 42.04909267665455, 0.10000000000000099, 170.0, 636, 569676, 763, 17.745628900000156
764, 7.228685881830752, 35.17147846698761, 42.460532636642455, 0.10000000000000074, 70.0, 400, 570076, 764, 11.363846400001421
765, 4.743851534262564, 35.05368830981491, 42.23886826731982, 0.09999999999999831, 570.0, 1069, 571145, 765, 30.77570469999955
766, 2.691242623059079, 34.982892816066745, 42.06814707279205, 0.09999999999999966, 210.0, 800, 571945, 766, 22.42921000000024
767, 3.288321865942003, 35.04081855151588, 42.16285199052978, 0.10000000000000078, 145.0, 662, 572607, 767, 19.131276900001467
768, 5.87732125941826, 35.06344169326451, 42.25590918167778, 0.09999999999999896, 145.0, 920, 573527, 768, 27.932307900000524
769, 6.252729338554744, 35.043307881155414, 42.1905294235595, 0.10000000000000071, 75.0, 668, 574195, 769, 19.086144299999432
770, 2.4568789382791443, 35.04087511900884, 42.13463043002313, 0.09999999999999885, 160.0, 942, 575137, 770, 26.82829529999981
771, 2.4853760709594237, 35.05779001967021, 42.14060426651572, 0.10000000000000064, 10.0, 347, 575484, 771, 10.514368000000104
772, 4.119272225756537, 35.074508984305645, 42.21148743716153, 0.0999999999999982, 140.0, 1100, 576584, 772, 31.470252600000094
773, 7.278427304417798, 35.156380231934364, 42.39318753252126, 0.09999999999999971, 110.0, 792, 577376, 773, 22.66174089999913
774, 2.300329242611215, 35.044441646999786, 42.13703811887711, 0.10000000000000099, 130.0, 630, 578006, 774, 18.651200099999187
775, 5.185473400228422, 35.06344746171142, 42.210377621136125, 0.09999999999999816, 180.0, 1112, 579118, 775, 32.03512079999928
776, 2.4415780204422597, 35.118708937380795, 42.24067625305462, 0.100000000000001, 145.0, 639, 579757, 776, 18.9954891999987
777, 3.6984153889183307, 34.952914073324614, 42.0446654947395, 0.10000000000000096, 90.0, 585, 580342, 777, 17.50119799999993
778, 4.314609901514609, 34.89494510425562, 42.03659300580508, 0.10000000000000078, 150.0, 661, 581003, 778, 19.37921129999995
779, 3.399114145921624, 35.02291925679082, 42.13658666196077, 0.10000000000000052, 70.0, 690, 581693, 779, 19.797302899998613
780, 4.5428643483612055, 35.04207046669033, 42.17595869796557, 0.09999999999999931, 410.0, 857, 582550, 780, 25.74297420000039
781, 4.134784924671238, 35.12701489012918, 42.28489053461941, 0.10000000000000019, 160.0, 729, 583279, 781, 21.160928199999034
782, 3.7252372534218288, 35.06508406866165, 42.21997096470424, 0.0999999999999984, 310.0, 1050, 584329, 782, 30.904508999999962
783, 5.414250398786629, 35.00588025710162, 42.173150796329274, 0.09999999999999935, 195.0, 850, 585179, 783, 24.685714299999745
784, 4.137787712001681, 35.08851799330859, 42.21627301075419, 0.09999999999999822, 330.0, 1098, 586277, 784, 32.707579500000065
785, 4.731142248186522, 35.06350602018619, 42.236674494943216, 0.09999999999999944, 155.0, 835, 587112, 785, 24.91973589999907
786, 2.4963074536592353, 35.09538657244514, 42.14726172054515, 0.1000000000000009, 35.0, 510, 587622, 786, 14.963981099999728
787, 6.534168571421975, 35.083487671299984, 42.32325588828639, 0.09999999999999881, 450.0, 950, 588572, 787, 28.408168099998875
788, 5.398280938831474, 35.04296441511674, 42.20449056324077, 0.09999999999999708, 490.0, 1551, 590123, 788, 45.436516499999925
789, 7.205847186007304, 34.852016381919384, 42.045958288013935, 0.1000000000000009, 90.0, 512, 590635, 789, 15.431873400000768
790, 2.274520308768097, 34.8681648396502, 41.920327978167464, 0.0999999999999993, 145.0, 859, 591494, 790, 25.463749800001096
791, 2.4520311823525986, 34.926697495695834, 41.97204125144265, 0.10000000000000071, 35.0, 385, 591879, 791, 11.41135629999917
792, 3.506109914299059, 34.82229769801024, 41.910518739566164, 0.09999999999999867, 250.0, 981, 592860, 792, 29.70848920000026
793, 3.463966207567351, 34.92054414456607, 42.0381968153035, 0.10000000000000088, 85.0, 652, 593512, 793, 20.46145979999892
794, 4.030535192224481, 34.82755279093281, 41.93827839972268, 0.09999999999999934, 190.0, 852, 594364, 794, 25.29792230000021
795, 5.711011226282551, 34.95057188889076, 42.09037788983049, 0.09999999999999801, 245.0, 1160, 595524, 795, 34.612676500000816
796, 3.132767851296238, 34.906327190203115, 42.00844093916525, 0.1000000000000006, 185.0, 681, 596205, 796, 21.43708610000067
797, 7.613428989143083, 34.96236146517265, 42.089595699184656, 0.09999999999999995, 170.0, 759, 596964, 797, 26.19788940000035
798, 5.495683678913925, 34.962684315826934, 42.121605576337394, 0.09999999999999723, 475.0, 1475, 598439, 798, 45.10864050000055
799, 3.4344240577377816, 34.888086154268315, 41.97919367415659, 0.10000000000000027, 165.0, 718, 599157, 799, 22.14567370000077
800, 3.788524105187105, 34.98247271091004, 42.053476585888006, 0.0999999999999996, 155.0, 809, 599966, 800, 24.394661300000735
801, 7.224407848313738, 34.706875560115186, 41.822457948639766, 0.0999999999999989, 400.0, 934, 600900, 801, 28.068676400000186
802, 2.4275734907270765, 34.337687262528235, 41.24235081158096, 0.10000000000000094, 75.0, 556, 601456, 802, 17.110993099999178
803, 4.142224630424133, 34.53394226519325, 41.55740182575793, 0.09999999999999822, 215.0, 1097, 602553, 803, 32.510144500000024
804, 2.374358430317127, 34.39232496650754, 41.328702960266575, 0.10000000000000074, 40.0, 397, 602950, 804, 11.957955700001548
805, 4.666807643566057, 34.445132004122954, 41.45834742642243, 0.09999999999999827, 430.0, 1081, 604031, 805, 32.781381200000396
806, 4.2811172343369375, 34.5488423154386, 41.5838042491509, 0.09999999999999871, 230.0, 973, 605004, 806, 29.159479799998735
807, 6.168541038380796, 34.58490320426136, 41.66597674959269, 0.0999999999999979, 275.0, 1194, 606198, 807, 36.54604540000037
808, 4.320860713893314, 34.477217375707205, 41.506528092346926, 0.09999999999999774, 580.0, 1249, 607447, 808, 37.346766300001036
809, 3.0777068912918986, 34.53093192573951, 41.565866309344685, 0.10000000000000044, 125.0, 699, 608146, 809, 21.955256299999746
810, 4.395691279176617, 34.60514020547852, 41.609885621926345, 0.09999999999999766, 680.0, 1282, 609428, 810, 39.33576080000057
811, 6.362849286840268, 34.53161612269717, 41.60624422976131, 0.09999999999999812, 230.0, 1124, 610552, 811, 35.074723699999595
812, 3.745821889960536, 34.55967647054211, 41.55354351558318, 0.10000000000000084, 100.0, 467, 611019, 812, 14.268442900000082
813, 5.5323431415522855, 34.61052785378685, 41.668899573470796, 0.10000000000000098, 160.0, 613, 611632, 813, 18.8342414000017
814, 4.882886783012494, 34.63405289180205, 41.73313902778986, 0.10000000000000009, 185.0, 741, 612373, 814, 23.340591199999835
815, 3.8648644409070383, 34.44383309700427, 41.35980658544852, 0.10000000000000064, 50.0, 349, 612722, 815, 10.96526350000022
816, 3.394909863212334, 34.63822467951304, 41.682644234194775, 0.10000000000000044, 125.0, 699, 613421, 816, 21.677634400000898
817, 3.7764427883680476, 34.595358510109, 41.62536015910736, 0.09999999999999865, 275.0, 989, 614410, 817, 30.59862459999931
818, 4.341071501117158, 34.607323701601594, 41.67445231021914, 0.09999999999999716, 440.0, 1507, 615917, 818, 46.73825680000118
819, 4.422442873650935, 34.57327748740592, 41.650154124934495, 0.09999999999999849, 175.0, 1025, 616942, 819, 31.635442700000567
820, 4.478357729848051, 34.62091305165598, 41.64832026736397, 0.09999999999999869, 280.0, 977, 617919, 820, 29.94660929999918
821, 4.528774630727274, 34.55680687079722, 41.60296754655576, 0.09999999999999884, 255.0, 946, 618865, 821, 29.755473999999595
822, 3.4425994481995024, 34.60457958763201, 41.60846699593182, 0.10000000000000057, 125.0, 683, 619548, 822, 21.390057499998875
823, 3.0984131265775305, 34.5868162856624, 41.604791479357054, 0.09999999999999958, 185.0, 813, 620361, 823, 25.865404100000887
824, 4.203304948902586, 34.68305978423813, 41.729586231134434, 0.10000000000000038, 150.0, 706, 621067, 824, 21.928042699999423
825, 3.0876937732100487, 34.61936042708677, 41.65051993986998, 0.09999999999999971, 395.0, 793, 621860, 825, 24.835834600000453
826, 5.328284247039471, 34.67695557815522, 41.82965827778301, 0.1000000000000009, 115.0, 513, 622373, 826, 16.411186600000292
827, 5.377363751393262, 34.62053216490776, 41.6728130844748, 0.09999999999999772, 295.0, 1256, 623629, 827, 39.03064170000107
828, 7.121637572847207, 34.70284045360368, 41.893759707342866, 0.09999999999999842, 290.0, 1042, 624671, 828, 32.95410080000147
829, 3.8289925243553458, 34.59118858648806, 41.589457346468556, 0.10000000000000073, 100.0, 392, 625063, 829, 12.257009000000835
830, 2.5074875714232236, 34.562714652059626, 41.5353761059241, 0.10000000000000091, 160.0, 519, 625582, 830, 16.391501199999766
831, 3.4595132862243494, 34.72774643954552, 41.77587203074821, 0.1000000000000009, 10.0, 506, 626088, 831, 15.326192499998797
832, 4.079074204213568, 34.576874153997814, 41.59397363602284, 0.09999999999999974, 160.0, 789, 626877, 832, 27.662058300000353
833, 6.394102304065764, 34.62029953898749, 41.75813505467603, 0.1000000000000009, 125.0, 511, 627388, 833, 21.32157730000108
834, 4.543746886504357, 34.58924951025187, 41.62188085717467, 0.09999999999999878, 160.0, 957, 628345, 834, 33.15332039999885
835, 4.751187791913114, 34.59376006160222, 41.71395405979021, 0.10000000000000038, 145.0, 705, 629050, 835, 23.76033240000106
836, 6.059323983819246, 34.6879702584688, 41.778279160344326, 0.10000000000000053, 95.0, 688, 629738, 836, 22.35695709999891
837, 2.6712633176651224, 34.231000834585025, 41.15608947450752, 0.09999999999999998, 160.0, 755, 630493, 837, 23.91811240000061
838, 5.534288848246183, 34.15799150554412, 41.14228364087026, 0.10000000000000085, 125.0, 654, 631147, 838, 21.50575140000001
839, 6.392182806557908, 34.20163788433414, 41.20466097953439, 0.10000000000000099, 110.0, 619, 631766, 839, 20.6827519999988
840, 2.265392988920212, 34.141363645086486, 41.027442951591645, 0.10000000000000073, 40.0, 392, 632158, 840, 13.753175300000294
841, 6.458583342034351, 34.063264595070464, 41.025511121991926, 0.09999999999999974, 120.0, 788, 632946, 841, 26.2163017999992
842, 4.362012850825529, 34.066007515850465, 41.03240021415379, 0.10000000000000099, 150.0, 621, 633567, 842, 23.66346479999993
843, 8.583785185237023, 34.24088156108304, 41.26416622174131, 0.10000000000000099, 100.0, 622, 634189, 843, 22.451267800001006
844, 6.917409100410712, 34.10428051356852, 41.11230044956625, 0.10000000000000056, 205.0, 685, 634874, 844, 23.40353630000027
845, 3.944330784108898, 34.1166532498377, 41.049826874621886, 0.09999999999999801, 335.0, 1159, 636033, 845, 45.286642299999585
846, 6.38530105557935, 34.19960583776307, 41.16034629656586, 0.09999999999999774, 295.0, 1247, 637280, 846, 50.000525900000866
847, 3.41052066671411, 34.07476195802339, 40.9630354009747, 0.10000000000000099, 60.0, 627, 637907, 847, 24.514883499999996
848, 2.201040994567889, 34.034211881779974, 40.88910535858507, 0.09999999999999881, 250.0, 951, 638858, 848, 37.54760410000017
849, 3.2667088665045974, 34.01656163590295, 40.90572830608913, 0.10000000000000069, 110.0, 672, 639530, 849, 26.94523560000016
850, 4.236060153889603, 34.04091630583285, 41.02092787107764, 0.10000000000000059, 145.0, 682, 640212, 850, 26.03428300000087
851, 3.7287831325243173, 34.137193875435074, 41.024249093145386, 0.10000000000000084, 130.0, 468, 640680, 851, 19.330802200000107
852, 4.258332371692869, 34.19009245377553, 41.17814665202853, 0.10000000000000074, 55.0, 395, 641075, 852, 16.68552649999947
853, 6.115190869414074, 34.12557305424286, 41.09748998374484, 0.09999999999999824, 190.0, 1091, 642166, 853, 42.511425299999246
854, 4.51975933419582, 34.13903476317071, 41.04445033727469, 0.09999999999999933, 275.0, 853, 643019, 854, 32.250371500000256
855, 5.253980930601912, 34.154475522041324, 41.129730890478406, 0.09999999999999813, 305.0, 1120, 644139, 855, 43.49970960000064
856, 3.2444565393660794, 34.0885710658634, 40.98121921238361, 0.09999999999999737, 670.0, 1407, 645546, 856, 56.18102360000012
857, 3.40546390497265, 34.0801624063173, 41.01254766357959, 0.10000000000000059, 160.0, 682, 646228, 857, 27.231734900000447
858, 4.22036534724937, 34.090633089085394, 41.02974009974396, 0.10000000000000067, 105.0, 673, 646901, 858, 30.249384500000815
859, 5.944894260802498, 34.147611843737536, 41.09266710392007, 0.09999999999999928, 285.0, 862, 647763, 859, 26.957667000000583
860, 5.827670812330352, 34.10072779257355, 41.1254307776966, 0.10000000000000092, 40.0, 539, 648302, 860, 16.643476799999917
861, 4.667576188103973, 34.014045637639626, 40.92445041011647, 0.10000000000000087, 35.0, 491, 648793, 861, 15.112137899999652
862, 4.118111498491213, 34.24551746140748, 41.20071430011955, 0.10000000000000055, 160.0, 687, 649480, 862, 22.145765199999005
863, 7.698914865093201, 34.16303277902471, 41.15750256658994, 0.09999999999999887, 250.0, 941, 650421, 863, 29.57445370000096
864, 5.510701946980247, 34.066184601885205, 41.03532313962355, 0.0999999999999981, 330.0, 1128, 651549, 864, 35.214410399999906
865, 4.558655936803136, 34.13635841932165, 41.06570355903168, 0.09999999999999924, 175.0, 868, 652417, 865, 26.803810700001122
866, 3.605190681626763, 34.0094986737259, 40.939152903673126, 0.10000000000000087, 15.0, 492, 652909, 866, 16.987148899999738
867, 3.330599522373065, 34.26911623166251, 41.21267660688261, 0.10000000000000096, 110.0, 589, 653498, 867, 21.973204899999473
868, 8.816689904877352, 34.22523535150506, 41.3147257250854, 0.09999999999999969, 170.0, 797, 654295, 868, 28.17354239999986
869, 5.756552103295731, 33.9885999295919, 40.89279396557774, 0.09999999999999738, 665.0, 1402, 655697, 869, 49.26906909999889
870, 2.184987310427858, 33.98663314911256, 40.85559097198119, 0.09999999999999946, 210.0, 830, 656527, 870, 29.95986389999962
871, 4.082302849311729, 34.003397097498734, 40.935641845560966, 0.10000000000000096, 90.0, 644, 657171, 871, 23.0335529999993
872, 4.741017793797848, 34.13677488054548, 41.144698897844115, 0.1000000000000009, 125.0, 518, 657689, 872, 18.36677419999978
873, 5.025058181131728, 34.12748888430705, 41.09528029783991, 0.0999999999999984, 280.0, 1048, 658737, 873, 36.88620509999964
874, 3.6947391103725042, 34.1120153504975, 41.025102249456914, 0.10000000000000087, 55.0, 490, 659227, 874, 17.169605499999307
875, 2.4386419835536515, 33.92945435250452, 40.79808780019597, 0.1000000000000009, 90.0, 516, 659743, 875, 18.29295160000038
876, 5.081361100724057, 34.17690578897439, 41.175859853918524, 0.09999999999999815, 265.0, 1118, 660861, 876, 42.57355319999988
877, 4.361397085604584, 34.25984622971521, 41.25811799974705, 0.09999999999999885, 330.0, 942, 661803, 877, 32.96743730000162
878, 6.386361476962418, 34.28232486052354, 41.32904332749387, 0.10000000000000081, 185.0, 658, 662461, 878, 22.540260199999466
879, 5.408193958171221, 34.15618397730478, 41.07444816494581, 0.10000000000000096, 80.0, 644, 663105, 879, 22.29940650000026
880, 2.4328212817594155, 34.225433187969664, 41.11763294672562, 0.10000000000000035, 275.0, 708, 663813, 880, 23.69764530000066
881, 3.2415314524034535, 34.310871701255486, 41.30085424943404, 0.100000000000001, 155.0, 638, 664451, 881, 21.60095950000141
882, 2.2889003502549947, 34.106175044523084, 41.00016591024295, 0.09999999999999898, 210.0, 918, 665369, 882, 31.626828899999964
883, 4.792684799797243, 34.31731191813517, 41.322462459262326, 0.10000000000000094, 135.0, 556, 665925, 883, 18.956654300000082
884, 3.5472529897587353, 34.36316201072069, 41.36937823185631, 0.10000000000000085, 35.0, 477, 666402, 884, 19.490837499999543
885, 4.092924012890402, 34.27989383359779, 41.24534217159011, 0.10000000000000052, 90.0, 689, 667091, 885, 27.807766699999775
886, 4.317660878134396, 34.24787362364727, 41.22462189567031, 0.10000000000000098, 145.0, 613, 667704, 886, 22.852349400000094
887, 5.776745947402812, 34.22011030322603, 41.242492715782845, 0.0999999999999984, 465.0, 1049, 668753, 887, 37.6832198000011
888, 7.132039029196356, 34.320178950916635, 41.36599065607244, 0.1000000000000008, 110.0, 660, 669413, 888, 22.75079420000111
889, 4.98338903521503, 34.102385771901986, 41.06891636625894, 0.09999999999999856, 330.0, 1007, 670420, 889, 35.83913519999987
890, 3.47510213149578, 33.824392235539044, 40.69833670524051, 0.10000000000000098, 130.0, 642, 671062, 890, 22.042544600000838
891, 5.128469214893353, 33.82167440411569, 40.74424369045641, 0.10000000000000073, 180.0, 667, 671729, 891, 23.107569499999954
892, 2.9846301604249237, 33.855472923020635, 40.67654726969876, 0.09999999999999931, 145.0, 857, 672586, 892, 29.59148019999884
893, 2.4600380899909453, 33.971432237993945, 40.80681914124041, 0.10000000000000067, 110.0, 362, 672948, 893, 12.233087500000693
894, 5.064103522760497, 33.93613936499009, 40.89063153753938, 0.0999999999999994, 160.0, 842, 673790, 894, 29.442497600000934
895, 5.43268722892366, 33.85918267349538, 40.80803128825658, 0.099999999999997, 635.0, 1601, 675391, 895, 58.49557900000036
896, 4.718225073223969, 33.83491026140609, 40.71912657719738, 0.09999999999999835, 310.0, 1060, 676451, 896, 36.59829109999919
897, 5.224400321555137, 33.848697717285155, 40.747920587158205, 0.10000000000000099, 65.0, 625, 677076, 897, 21.553581600001053
898, 2.2627990391797725, 33.81881950513451, 40.599799650749276, 0.10000000000000095, 120.0, 565, 677641, 898, 19.96364790000007
899, 8.954138482796557, 33.962195260592665, 40.89950797725832, 0.10000000000000073, 160.0, 667, 678308, 899, 23.24024830000053
900, 4.178070739068719, 33.86835362825049, 40.748750347688976, 0.10000000000000075, 110.0, 664, 678972, 900, 23.008152500000506
901, 3.80079489339547, 33.83134625676166, 40.70795055067683, 0.09999999999999946, 175.0, 830, 679802, 901, 29.210786200001166
902, 4.140180284668204, 34.249729235746855, 41.202237649637574, 0.10000000000000024, 185.0, 722, 680524, 902, 25.14882469999975
903, 4.444736115452164, 34.41990255653312, 41.39263233569784, 0.10000000000000085, 130.0, 654, 681178, 903, 23.23183869999957
904, 3.9122926861816287, 34.28907378286892, 41.263753901921575, 0.10000000000000045, 75.0, 698, 681876, 904, 24.47161539999979
905, 5.006490692435104, 34.477138836525796, 41.520928561075515, 0.0999999999999987, 205.0, 974, 682850, 905, 34.14819709999938
906, 6.12713941227306, 34.44754900632205, 41.46936346200796, 0.1000000000000003, 155.0, 715, 683565, 906, 24.87074070000017
907, 3.043321926367199, 34.298425201905765, 41.23930020652779, 0.0999999999999986, 335.0, 997, 684562, 907, 35.42174510000041
908, 3.671988403512605, 34.44328891236579, 41.40227768481077, 0.09999999999999862, 260.0, 995, 685557, 908, 34.834055699999226
909, 3.590831693232529, 34.28800456354937, 41.214518351817695, 0.1000000000000009, 80.0, 508, 686065, 909, 17.95269619999999
910, 3.9167264215648174, 34.415995632073816, 41.39597343053573, 0.10000000000000073, 65.0, 390, 686455, 910, 14.004886599999736
911, 4.546946119423622, 34.38955601996418, 41.39718270387274, 0.10000000000000094, 65.0, 558, 687013, 911, 20.25742949999949
912, 3.3548664555665813, 34.312129824208455, 41.262097945923884, 0.09999999999999833, 375.0, 1067, 688080, 912, 37.60834280000017
913, 2.9189572295197443, 34.33376818543367, 41.27964173766558, 0.09999999999999845, 320.0, 1033, 689113, 913, 35.78899269999965
914, 4.261666270569562, 34.19555311871506, 41.15489919437385, 0.0999999999999981, 250.0, 1127, 690240, 914, 37.80875150000065
915, 5.343464670907752, 33.525720353814386, 40.369769667646416, 0.09999999999999955, 195.0, 818, 691058, 915, 27.21940369999902
916, 3.7706824343942813, 33.540993400071386, 40.34544055452072, 0.10000000000000087, 30.0, 486, 691544, 916, 16.11639060000016
917, 2.8940335245378597, 33.45228283616561, 40.202040029477466, 0.0999999999999977, 215.0, 1264, 692808, 917, 42.32518059999893
918, 3.3438327396955816, 33.3683677091034, 40.15952689625392, 0.10000000000000098, 75.0, 642, 693450, 918, 21.31815270000152
919, 4.450572094522286, 33.552388025238635, 40.390092007040856, 0.09999999999999871, 185.0, 971, 694421, 919, 36.648048900000504
920, 5.678080494458723, 33.578240172553606, 40.4436352453159, 0.0999999999999984, 165.0, 1048, 695469, 920, 39.465641400000095
921, 2.335163836961701, 33.53281711396717, 40.27288361322312, 0.10000000000000091, 120.0, 525, 695994, 921, 20.42167590000099
922, 4.8846173953373455, 33.48905890751811, 40.33680036970713, 0.1000000000000009, 110.0, 515, 696509, 922, 19.471205300000292
923, 3.4562363993512872, 33.62690733025759, 40.4640441556427, 0.10000000000000091, 110.0, 519, 697028, 923, 20.2716791999992
924, 4.729196946982037, 33.55493053294711, 40.389836187946166, 0.0999999999999986, 240.0, 997, 698025, 924, 37.78500299999905
925, 4.431511557956761, 33.443744279130264, 40.252389431489824, 0.09999999999999871, 185.0, 973, 698998, 925, 36.784010900000794
926, 3.2504624716491195, 33.51032947651618, 40.31106562109037, 0.10000000000000088, 155.0, 651, 699649, 926, 24.26656770000045
927, 8.85057120581115, 33.42092803044973, 40.24739336120296, 0.10000000000000074, 50.0, 394, 700043, 927, 14.902773499999967
928, 7.626709419744707, 33.62796958797104, 40.63642757459165, 0.09999999999999874, 310.0, 967, 701010, 928, 36.82523120000042
929, 5.541330045923079, 33.59836334508605, 40.430721167269844, 0.09999999999999773, 555.0, 1253, 702263, 929, 47.29336289999992
930, 3.893533362099264, 33.53691445121282, 40.35378990092861, 0.09999999999999883, 430.0, 948, 703211, 930, 36.55113960000017
931, 3.5054800523230214, 33.47611753952893, 40.21905860309962, 0.10000000000000096, 85.0, 581, 703792, 931, 22.09990959999959
932, 2.3229384291446245, 33.57094558738963, 40.32412499098975, 0.09999999999999865, 260.0, 989, 704781, 932, 37.77626439999949
933, 4.258198124564746, 33.66186258091646, 40.520460656109975, 0.10000000000000063, 65.0, 340, 705121, 933, 13.06888280000021
934, 3.6907549548033476, 33.578471962526784, 40.37017720002136, 0.10000000000000095, 140.0, 567, 705688, 934, 21.465526399999362
935, 5.407560505423574, 33.59991834368757, 40.460614427443474, 0.0999999999999972, 410.0, 1488, 707176, 935, 56.93715870000051
936, 5.565874732213513, 33.61397155450315, 40.49961757173344, 0.09999999999999977, 150.0, 784, 707960, 936, 30.047254900000553
937, 8.26923717320075, 33.53094360407661, 40.45407157084521, 0.10000000000000092, 125.0, 544, 708504, 937, 21.063204699999915
938, 4.829198476683103, 33.58546514907501, 40.377370251420075, 0.09999999999999955, 190.0, 818, 709322, 938, 31.509048199999597
939, 4.052679327283822, 33.51198734110923, 40.35368966337425, 0.10000000000000074, 80.0, 398, 709720, 939, 15.365360299998429
940, 4.2177998153627785, 33.12858719388068, 39.856474315256314, 0.09999999999999845, 165.0, 1035, 710755, 940, 39.996091299999534
941, 9.770830501596283, 32.85695081757688, 39.62127541323916, 0.10000000000000091, 90.0, 529, 711284, 941, 20.91456509999989
942, 4.265406863273759, 32.85269166991027, 39.572323484030385, 0.10000000000000057, 225.0, 684, 711968, 942, 26.502288699999554
943, 4.694779475905648, 33.06004950579475, 39.76589357819544, 0.10000000000000067, 105.0, 357, 712325, 943, 15.418540099999518
944, 4.295158961734937, 32.84233959390538, 39.496202225188725, 0.10000000000000099, 80.0, 634, 712959, 944, 25.708856500001275
945, 7.102709285350071, 33.02387941992751, 39.82053731212445, 0.09999999999999727, 555.0, 1451, 714410, 945, 64.57524279999961
946, 4.365681295331556, 32.950030738060626, 39.61687530144275, 0.10000000000000085, 135.0, 654, 715064, 946, 32.95430739999938
947, 6.1828259694746155, 33.05399847370428, 39.857166331057876, 0.0999999999999994, 215.0, 842, 715906, 947, 36.492462299998806
948, 3.1171733501208694, 32.93399590091221, 39.605270195545614, 0.09999999999999834, 360.0, 1063, 716969, 948, 65.39074090000031
949, 4.206813122515239, 33.06036648403999, 39.814005585356135, 0.10000000000000028, 135.0, 716, 717685, 949, 51.52669290000085
950, 7.0944166430330515, 33.0034830639934, 39.73947983457331, 0.09999999999999788, 305.0, 1197, 718882, 950, 65.12545109999883
951, 4.035819478352361, 32.97247416574975, 39.682718213771054, 0.0999999999999971, 420.0, 1539, 720421, 951, 79.23094520000086
952, 5.220080515674569, 32.793562044663865, 39.44935842687433, 0.0999999999999982, 260.0, 1100, 721521, 952, 57.644339199998285
953, 5.549162039661608, 32.847787273631376, 39.53742404585125, 0.10000000000000096, 90.0, 595, 722116, 953, 32.187677100000656
954, 4.892038124222176, 32.865687481869514, 39.56722524571152, 0.09999999999999867, 360.0, 983, 723099, 954, 53.345976299999165
955, 4.466851856247762, 32.78496381416224, 39.48318475963499, 0.09999999999999794, 220.0, 1183, 724282, 955, 64.39225319999969
956, 7.504902146649447, 32.94906791394277, 39.7301992375216, 0.09999999999999945, 400.0, 834, 725116, 956, 44.39171890000034
957, 2.4233249838502084, 32.824098935601306, 39.45895472465203, 0.10000000000000057, 145.0, 684, 725800, 957, 36.36168019999968
958, 4.219952946161951, 32.8214895262973, 39.547802111210714, 0.10000000000000085, 200.0, 655, 726455, 958, 34.8191536000013
959, 4.957748696609683, 32.8724692015717, 39.58413649406986, 0.0999999999999968, 415.0, 1725, 728180, 959, 92.71616619999986
960, 6.109682486138561, 32.8137352177591, 39.59049695910829, 0.10000000000000091, 65.0, 528, 728708, 960, 27.489815299999464
961, 3.927268165472655, 32.86490024985448, 39.529393216590606, 0.09999999999999942, 215.0, 838, 729546, 961, 51.99993660000109
962, 2.385938006136117, 32.81293420050164, 39.41663637749311, 0.1000000000000007, 20.0, 373, 729919, 962, 22.266384900000048
963, 7.957154338194894, 33.47843881442292, 40.415547109802155, 0.10000000000000057, 145.0, 683, 730602, 963, 40.75674309999886
964, 5.5051160687317395, 33.66943246931306, 40.59387127541747, 0.0999999999999988, 325.0, 955, 731557, 964, 60.44079679999959
965, 3.158457723481521, 33.56342748083367, 40.38629830552884, 0.10000000000000081, 125.0, 659, 732216, 965, 38.84356959999968
966, 4.798288517784521, 33.69320597878365, 40.56069303004322, 0.09999999999999852, 290.0, 1017, 733233, 966, 59.62990110000101
967, 3.333079986131485, 33.6990868436159, 40.540496954952715, 0.09999999999999822, 505.0, 1096, 734329, 967, 63.80833619999976
968, 3.5725062992339947, 33.540088998638325, 40.339583159136836, 0.09999999999999816, 315.0, 1111, 735440, 968, 137.87479510000048
969, 3.4514703940148608, 33.675066907478104, 40.50761572519938, 0.09999999999999756, 310.0, 1320, 736760, 969, 188.4383698999991
970, 3.3262175577536723, 33.76718805851549, 40.59855976743561, 0.10000000000000099, 170.0, 627, 737387, 970, 98.04139880000002
971, 7.413846915702181, 33.897418543297476, 40.88487247256782, 0.10000000000000099, 45.0, 635, 738022, 971, 88.0848107999991
972, 4.39103750752987, 33.61140449252256, 40.39648074707575, 0.10000000000000066, 50.0, 674, 738696, 972, 116.08107319999908
973, 7.609381042845868, 33.74910052413852, 40.66912318663769, 0.0999999999999993, 210.0, 859, 739555, 973, 55.465765500001
974, 3.848272676565004, 33.77709440881393, 40.63109500327807, 0.09999999999999754, 285.0, 1335, 740890, 974, 55.43632409999918
975, 3.5723011330817966, 33.64322832855479, 40.4337790651742, 0.09999999999999941, 160.0, 839, 741729, 975, 34.57582840000032
976, 4.961233895657392, 33.78343048680331, 40.73815107528277, 0.10000000000000091, 5.0, 522, 742251, 976, 20.99595269999918
977, 5.397562554108023, 33.78896368294192, 40.62812253469821, 0.09999999999999869, 360.0, 977, 743228, 977, 40.04448930000035
978, 4.343545804376758, 33.70047849132901, 40.65581832613264, 0.10000000000000062, 25.0, 336, 743564, 978, 13.564166399999522
979, 4.839439315772524, 33.74771707198199, 40.689722962472956, 0.0999999999999985, 305.0, 1020, 744584, 979, 42.229836700000305
980, 6.1810574958424365, 33.68764465697511, 40.513454651975344, 0.09999999999999944, 220.0, 835, 745419, 980, 33.984949399999095
981, 5.4783233762496995, 33.750664421490264, 40.59433740661258, 0.09999999999999856, 140.0, 1008, 746427, 981, 49.30907590000061
982, 3.902613041350747, 33.6408384258073, 40.46017336871627, 0.09999999999999902, 145.0, 909, 747336, 982, 122.75021860000015
983, 4.391373391064743, 33.72222679981115, 40.588577971517566, 0.09999999999999913, 265.0, 887, 748223, 983, 143.32114789999832
984, 3.4481217790421823, 33.755078429626906, 40.58499741588565, 0.10000000000000046, 105.0, 695, 748918, 984, 106.90551519999826
985, 5.414615482589057, 33.72268138090913, 40.6058637379955, 0.09999999999999817, 290.0, 1109, 750027, 985, 63.345074199998635
986, 4.063659479893992, 33.3813539734277, 40.20233294787005, 0.10000000000000073, 50.0, 391, 750418, 986, 28.584661500000948
987, 4.733224031792299, 33.57090588904716, 40.39142142115413, 0.1000000000000001, 125.0, 740, 751158, 987, 35.58102600000166
988, 2.1009314785889117, 33.58721967653043, 40.34011498489821, 0.10000000000000049, 140.0, 692, 751850, 988, 28.870038799999747
989, 3.679362423785191, 33.66625227785872, 40.51471277378567, 0.0999999999999973, 705.0, 1441, 753291, 989, 62.336118199998964
990, 6.2863584921048705, 33.62878671573226, 40.5406158471563, 0.10000000000000099, 130.0, 628, 753919, 990, 27.675745900000038
991, 3.822835344986204, 33.62703175755925, 40.43277798276959, 0.0999999999999993, 125.0, 858, 754777, 991, 37.50766659999863
992, 4.5647863662497885, 33.74575910517239, 40.62691314207679, 0.0999999999999989, 490.0, 935, 755712, 992, 41.32794510000167
993, 6.160142952472643, 33.60587341193866, 40.51111658426156, 0.10000000000000074, 185.0, 665, 756377, 993, 28.082764899998438
994, 5.201289611983823, 33.6469568356429, 40.472876985474386, 0.09999999999999697, 720.0, 1616, 757993, 994, 69.09674710000036
995, 2.332976899604491, 33.596126185022364, 40.34230331392054, 0.10000000000000091, 135.0, 529, 758522, 995, 23.221116900000197
996, 3.517145917360915, 33.594079816318605, 40.3854914058007, 0.09999999999999841, 215.0, 1046, 759568, 996, 45.6144392999995
997, 4.803662831616428, 33.88313327809429, 40.76435357606222, 0.09999999999999755, 380.0, 1327, 760895, 997, 57.57948970000143
998, 2.4165003978349597, 34.14860985775497, 41.039305779241744, 0.10000000000000059, 145.0, 682, 761577, 998, 29.90294240000003
999, 5.672892607930009, 34.068087469790946, 41.03880902010398, 0.09999999999999952, 200.0, 821, 762398, 999, 35.348809099999926
1000, 5.285559947316122, 34.234653648820895, 41.20068801953955, 0.10000000000000099, 215.0, 618, 763016, 1000, 27.56891159999941
1001, 5.4589085537696285, 34.13112769401901, 41.07802583651576, 0.09999999999999849, 285.0, 1023, 764039, 1001, 49.39407139999821
1002, 4.436670273065913, 34.01155885430269, 40.92086317372877, 0.10000000000000063, 50.0, 344, 764383, 1002, 15.163545600000361
1003, 4.738604151360657, 34.122813538692455, 41.04460703075734, 0.09999999999999815, 270.0, 1115, 765498, 1003, 47.933677799999714
1004, 3.037531777708218, 34.022974355543894, 40.921949408559065, 0.0999999999999981, 370.0, 1129, 766627, 1004, 50.61056219999955
1005, 3.5902524306891843, 34.04278603787552, 40.93021763901766, 0.1000000000000009, 80.0, 514, 767141, 1005, 22.436319500000536
1006, 5.836123795473804, 34.18386326973296, 41.17044262194124, 0.09999999999999913, 145.0, 889, 768030, 1006, 38.28051129999949
1007, 5.139194677383075, 34.11279613917858, 41.04419437228287, 0.0999999999999987, 210.0, 974, 769004, 1007, 42.56452420000278
1008, 4.226350757040476, 34.10620361729672, 41.066971953542605, 0.09999999999999881, 185.0, 950, 769954, 1008, 41.524354699999094
1009, 4.443321070503443, 34.323377356529235, 41.29395179271698, 0.09999999999999966, 200.0, 800, 770754, 1009, 35.30186070000127
1010, 4.228839912433477, 34.43162935321787, 41.396409643783976, 0.09999999999999815, 400.0, 1118, 771872, 1010, 50.32263800000146
1011, 4.826543309537952, 34.40375630528655, 41.45103966137187, 0.0999999999999974, 800.0, 1393, 773265, 1011, 62.26618090000193
1012, 4.425133157880894, 34.444799686098904, 41.37828797111102, 0.10000000000000087, 65.0, 653, 773918, 1012, 29.094229300000734
1013, 4.551803249652072, 34.29185669773309, 41.25730377019838, 0.10000000000000095, 130.0, 645, 774563, 1013, 28.814434699997946
1014, 3.0443869059424524, 34.43640090056444, 41.36761668139676, 0.09999999999999913, 260.0, 887, 775450, 1014, 38.95974639999986
1015, 5.7015657001716455, 34.43946767851364, 41.50699996061103, 0.09999999999999928, 205.0, 860, 776310, 1015, 38.66680080000151
1016, 4.274623004342651, 34.42541035300209, 41.40481746196747, 0.10000000000000069, 140.0, 672, 776982, 1016, 29.529341700002988
1017, 6.030375701733296, 34.45917147213651, 41.536718287067664, 0.10000000000000062, 175.0, 679, 777661, 1017, 30.66940919999979
1018, 3.6648848362590956, 34.49834202384027, 41.4764404333732, 0.09999999999999845, 385.0, 1035, 778696, 1018, 46.70251030000145
1019, 3.372891410042469, 34.38923141077945, 41.32037186586767, 0.10000000000000074, 120.0, 665, 779361, 1019, 30.722356399997807
1020, 4.611053971892074, 34.38984382788709, 41.39032589587148, 0.09999999999999763, 470.0, 1293, 780654, 1020, 58.76383150000038
1021, 3.7024180275026106, 34.36456944328208, 41.35847449406786, 0.09999999999999898, 235.0, 916, 781570, 1021, 48.067759400000796
1022, 4.60486312227554, 34.33900289775944, 41.31859638081307, 0.09999999999999945, 210.0, 833, 782403, 1022, 36.91467710000143
1023, 2.4515079300599933, 34.18085215815124, 41.07130236665079, 0.09999999999999937, 165.0, 847, 783250, 1023, 36.95932730000277
1024, 4.149781309281686, 34.256262437661945, 41.19299186334911, 0.10000000000000064, 50.0, 349, 783599, 1024, 15.498411000000488
1025, 5.319197209026569, 34.2725755810301, 41.25351986168942, 0.09999999999999823, 295.0, 1092, 784691, 1025, 49.122433600001386
1026, 5.806614440080901, 34.26429974876637, 41.30420093869538, 0.09999999999999898, 165.0, 916, 785607, 1026, 43.61163719999968
1027, 4.485879904253344, 34.201286248091996, 41.13591793898878, 0.09999999999999892, 370.0, 928, 786535, 1027, 40.987504400000034
1028, 4.3581242343580975, 34.41283570110193, 41.4113847224811, 0.09999999999999766, 180.0, 1281, 787816, 1028, 56.61614929999996
1029, 2.5278015320535996, 34.434315874048686, 41.339643427345294, 0.10000000000000077, 60.0, 411, 788227, 1029, 18.579665000001114
1030, 6.292926663262838, 34.30917813678339, 41.29605955925269, 0.09999999999999958, 180.0, 814, 789041, 1030, 37.98956519999774
1031, 3.673721541910397, 34.3152434143123, 41.232875505788556, 0.09999999999999828, 265.0, 1079, 790120, 1031, 44.489798800001154
1032, 4.714584262627694, 34.9254081690753, 42.06253293708519, 0.09999999999999927, 175.0, 864, 790984, 1032, 38.1029223000005
1033, 3.43943101815258, 34.80673748824828, 41.840624986574134, 0.0999999999999976, 630.0, 1307, 792291, 1033, 58.06915049999952
1034, 5.308983850923962, 34.862384971506074, 41.938570085367466, 0.09999999999999917, 140.0, 881, 793172, 1034, 34.893729199997324
1035, 4.9582142449234645, 34.78045942093515, 41.86178508990912, 0.09999999999999974, 145.0, 788, 793960, 1035, 34.51253480000014
1036, 5.991246521879696, 34.80304854083213, 41.901822195148554, 0.0999999999999982, 210.0, 1099, 795059, 1036, 44.565039900000556
1037, 4.393453637643864, 34.88642558248419, 41.99376409028706, 0.09999999999999881, 235.0, 950, 796009, 1037, 39.858084999999846
1038, 4.3150516220245185, 34.93094437437899, 42.02079528219559, 0.09999999999999824, 260.0, 1088, 797097, 1038, 51.502025899997534
1039, 4.255292314173078, 34.91890994559089, 42.01697977189537, 0.10000000000000046, 115.0, 695, 797792, 1039, 33.46429089999947
1040, 2.229847926470837, 34.86939940914031, 41.9125477717473, 0.10000000000000075, 60.0, 403, 798195, 1040, 16.668908999999985
1041, 5.742862849640871, 34.86800334571911, 41.98553385427409, 0.09999999999999883, 215.0, 947, 799142, 1041, 44.381457900002715
1042, 6.493431608855166, 35.00648348672049, 42.146817332566386, 0.09999999999999741, 375.0, 1386, 800528, 1042, 56.12488780000058
1043, 3.441222211114968, 35.292065514190284, 42.41973672214942, 0.09999999999999973, 175.0, 790, 801318, 1043, 31.74782630000118
1044, 3.700440496467054, 35.367745471000674, 42.55296568870544, 0.10000000000000074, 90.0, 400, 801718, 1044, 15.656597100001818
1045, 4.210498372713725, 35.13535059652021, 42.26407309501402, 0.1000000000000007, 70.0, 372, 802090, 1045, 15.651589299999614
1046, 4.467905457567618, 35.32147777241319, 42.53228386380999, 0.09999999999999844, 250.0, 1038, 803128, 1046, 40.97281809999913
1047, 5.148697322771257, 35.159960570043445, 42.30212733988859, 0.09999999999999781, 315.0, 1225, 804353, 1047, 48.0407755999986
1048, 2.3180906483309065, 35.19196283056381, 42.290595825682296, 0.1000000000000007, 30.0, 376, 804729, 1048, 15.2860354000004
1049, 4.0717735552866205, 35.08180404462313, 42.214921248586556, 0.10000000000000071, 35.0, 380, 805109, 1049, 15.729460000002291
1050, 5.6161306724996765, 35.2654394449846, 42.444039092257015, 0.09999999999999766, 480.0, 1284, 806393, 1050, 53.14802350000173
1051, 5.181532497984842, 35.233604407962694, 42.44499797299278, 0.10000000000000081, 155.0, 658, 807051, 1051, 27.212873700002092
1052, 2.507825611807595, 35.253401188910765, 42.41810653783098, 0.10000000000000099, 195.0, 632, 807683, 1052, 25.61097310000332
1053, 4.0421620309352875, 35.22600825245301, 42.38361498908079, 0.09999999999999921, 240.0, 873, 808556, 1053, 39.43591709999964
1054, 2.7703435453199923, 35.210563638845386, 42.28923092138299, 0.10000000000000084, 85.0, 458, 809014, 1054, 21.167166000002908
1055, 3.563111516031763, 35.28318193070725, 42.46535676481061, 0.10000000000000094, 155.0, 554, 809568, 1055, 27.427869700000883
1056, 6.63730194957918, 35.19081448215807, 42.39566231078128, 0.10000000000000099, 85.0, 627, 810195, 1056, 29.15605979999964
1057, 5.207298931513254, 35.18361770659979, 42.38144702648035, 0.09999999999999853, 270.0, 1014, 811209, 1057, 43.100754700000834
1058, 5.21536143515852, 35.28353368045208, 42.44767628071991, 0.099999999999999, 375.0, 911, 812120, 1058, 38.577361999999994
1059, 3.9819834818804845, 35.30512805338259, 42.479855925948534, 0.09999999999999927, 175.0, 864, 812984, 1059, 35.57713209999929
1060, 5.311287467663779, 35.1727825866026, 42.322823788137995, 0.1000000000000006, 30.0, 680, 813664, 1060, 32.19849989999784
1061, 5.267795142776687, 35.16645004547818, 42.33443860604729, 0.09999999999999808, 230.0, 1136, 814800, 1061, 53.8652019000001
1062, 5.352531950454473, 35.047829165901106, 42.20871996984917, 0.10000000000000062, 150.0, 679, 815479, 1062, 32.002212399998825
1063, 4.031208227818634, 35.06246418947809, 42.15133306464286, 0.09999999999999892, 335.0, 929, 816408, 1063, 42.01632450000034
1064, 3.585255023680235, 35.04037229324642, 42.180565557981794, 0.10000000000000098, 80.0, 608, 817016, 1064, 26.540520500002458
1065, 4.173516424587446, 35.07079415516339, 42.20281964695587, 0.09999999999999828, 285.0, 1076, 818092, 1065, 45.060979099998804
1066, 2.5911687592618495, 35.237968885673666, 42.33977831234722, 0.10000000000000099, 180.0, 636, 818728, 1066, 27.01832640000066
1067, 7.658992302596569, 35.11415613810221, 42.24217533365886, 0.1000000000000007, 65.0, 375, 819103, 1067, 15.454112600000371
1068, 2.738047771965425, 35.05333601283276, 42.135338766743814, 0.10000000000000099, 55.0, 635, 819738, 1068, 28.51272759999847
1069, 5.314959986828635, 35.41370401539254, 42.661866180921706, 0.10000000000000071, 115.0, 669, 820407, 1069, 31.6876912000007
1070, 4.97348206939702, 35.710911569232216, 42.99907142700317, 0.0999999999999986, 375.0, 998, 821405, 1070, 46.041717100000824
1071, 6.284791053110419, 35.817004449862985, 43.105705490005896, 0.10000000000000028, 155.0, 717, 822122, 1071, 31.93157549999887
1072, 4.614211466601993, 35.63052200453825, 42.87668616441252, 0.10000000000000069, 130.0, 671, 822793, 1072, 34.15162100000089
1073, 3.855774218622706, 35.71574956104231, 42.95938454077407, 0.09999999999999842, 390.0, 1041, 823834, 1073, 48.74538499999835
1074, 4.670233489733559, 35.67355885632679, 42.96081823298198, 0.09999999999999949, 465.0, 826, 824660, 1074, 34.49123639999743
1075, 5.4219871012366845, 35.62056762174612, 42.82211025815336, 0.10000000000000066, 115.0, 674, 825334, 1075, 28.65383959999963
1076, 5.791029900529959, 35.900515326618276, 43.25085578231626, 0.10000000000000077, 110.0, 411, 825745, 1076, 16.75314399999843
1077, 2.585979648972329, 35.519096493127925, 42.66638110526166, 0.10000000000000075, 40.0, 402, 826147, 1077, 16.82760049999706
1078, 2.3940072333732365, 35.673846518292144, 42.881009784399296, 0.09999999999999956, 160.0, 816, 826963, 1078, 36.100681100000656
1079, 5.3617245886968155, 35.85809561324446, 43.18884622234188, 0.10000000000000082, 110.0, 657, 827620, 1079, 27.8599484999977
1080, 4.497508504180403, 35.632437358928634, 42.87471862382527, 0.10000000000000099, 75.0, 632, 828252, 1080, 29.18227150000166
1081, 3.3963478648981598, 35.59162260160122, 42.79077244551935, 0.0999999999999999, 190.0, 766, 829018, 1081, 33.460815899998124
1082, 4.113895873139671, 35.75728274063325, 43.029197204433544, 0.0999999999999998, 140.0, 781, 829799, 1082, 33.106416499998886
1083, 5.360573240613515, 35.59546070605253, 42.88074989093792, 0.10000000000000063, 120.0, 678, 830477, 1083, 31.779901800000516
1084, 6.292986097606031, 35.548889469358855, 42.8107230953177, 0.09999999999999835, 390.0, 1061, 831538, 1084, 46.6605281000011
1085, 2.786049279663712, 35.718519520759585, 42.94640539169311, 0.10000000000000074, 55.0, 400, 831938, 1085, 17.506437000000005
1086, 3.3274111797678994, 35.60951144405902, 42.82685559495051, 0.09999999999999891, 415.0, 931, 832869, 1086, 40.79654440000013
1087, 4.696549988021485, 35.69450037573346, 42.95749090680172, 0.09999999999999887, 315.0, 939, 833808, 1087, 47.057732600002055
1088, 4.349142009785546, 35.63424433951391, 42.86071124072289, 0.0999999999999984, 410.0, 1047, 834855, 1088, 43.82367389999854
1089, 3.8866269801196736, 35.68924997795739, 42.98092584105523, 0.0999999999999997, 145.0, 794, 835649, 1089, 33.07383839999966
1090, 5.102175136409219, 35.68153391038218, 42.919941622211084, 0.09999999999999777, 555.0, 1240, 836889, 1090, 52.203707900000154
1091, 3.7861708731681873, 35.71725578503731, 42.96204295231746, 0.0999999999999987, 275.0, 975, 837864, 1091, 40.31386550000025
1092, 4.173260036954837, 35.58548503639424, 42.84652796768208, 0.09999999999999973, 215.0, 791, 838655, 1092, 34.367941900000005
1093, 5.810037088386353, 35.748763648116885, 43.049269439977245, 0.09999999999999992, 210.0, 763, 839418, 1093, 31.20619699999952
1094, 3.680997840254223, 35.80167610821557, 43.01958498528032, 0.09999999999999766, 600.0, 1285, 840703, 1094, 54.64815069999895
1095, 4.659072059971615, 35.901079522290274, 43.196958990004454, 0.09999999999999847, 190.0, 1030, 841733, 1095, 43.558492100000876
1096, 5.384194283370268, 35.816442047465934, 43.090538791309704, 0.0999999999999982, 290.0, 1100, 842833, 1096, 47.31718460000047
1097, 2.493124100343249, 35.77757956406166, 42.989436594645184, 0.09999999999999923, 275.0, 870, 843703, 1097, 36.557107699998596
1098, 4.3472691088572315, 35.977396375283426, 43.281444137397855, 0.1000000000000008, 40.0, 435, 844138, 1098, 18.045674199998757
1099, 5.872044543383633, 36.02721764729285, 43.34662429649792, 0.0999999999999988, 280.0, 955, 845093, 1099, 41.81032469999991
1100, 4.305235365671771, 35.90148600593942, 43.22609012523356, 0.09999999999999933, 375.0, 854, 845947, 1100, 36.02791200000138
1101, 2.5056444808481353, 35.77592916258633, 43.014475381883045, 0.10000000000000092, 110.0, 539, 846486, 1101, 22.656215899998642
1102, 3.8521524039657393, 35.79192894215179, 43.034463066086026, 0.09999999999999853, 510.0, 1014, 847500, 1102, 44.865282099999604
1103, 8.955633930963272, 35.98704214087423, 43.364212243641276, 0.09999999999999819, 265.0, 1103, 848603, 1103, 46.32527689999915
1104, 4.372927808793932, 35.899329506251526, 43.1474089286211, 0.09999999999999819, 250.0, 1106, 849709, 1104, 49.97995019999871
1105, 4.736086853145673, 35.29759800627806, 42.46617509061512, 0.10000000000000063, 205.0, 677, 850386, 1105, 28.92049120000229
1106, 3.5279232868868293, 35.018114150654185, 42.07942385818019, 0.1000000000000008, 210.0, 660, 851046, 1106, 28.38060039999982
1107, 3.9368697897155585, 35.01002284265115, 42.08612986779764, 0.10000000000000094, 65.0, 563, 851609, 1107, 24.349700599999778
1108, 4.9766342434813, 35.10568499845617, 42.25643516989315, 0.1000000000000009, 105.0, 510, 852119, 1108, 21.36967200000072
1109, 5.737136293025244, 35.0568731352232, 42.21276125599322, 0.09999999999999953, 240.0, 819, 852938, 1109, 34.96773530000064
1110, 5.743895920665465, 34.966382925087046, 42.101681825156525, 0.09999999999999831, 230.0, 1070, 854008, 1110, 45.04107859999931
1111, 3.559322511057201, 34.97853662760213, 42.02402731423371, 0.10000000000000042, 105.0, 701, 854709, 1111, 30.321355200001562
1112, 3.665208186397014, 34.96070488271951, 42.04099104080834, 0.10000000000000024, 165.0, 722, 855431, 1112, 31.91274820000035
1113, 2.7115003013372423, 34.98394650573731, 42.012073950195315, 0.10000000000000099, 150.0, 625, 856056, 1113, 28.246065200000885
1114, 6.03820832905569, 34.97333080012624, 42.03088388210389, 0.10000000000000069, 75.0, 369, 856425, 1114, 15.837938500000746
1115, 5.018801970430363, 35.0574089050293, 42.239400006517954, 0.0999999999999996, 195.0, 810, 857235, 1115, 36.575975600000675
1116, 2.5782842437426248, 34.99252312357833, 42.05487860702887, 0.10000000000000087, 105.0, 492, 857727, 1116, 20.74453859999994
1117, 4.490757875883208, 34.8683260916763, 41.931457130496966, 0.09999999999999835, 230.0, 1059, 858786, 1117, 46.13224099999934
1118, 4.5897590337801395, 35.04288974626164, 42.15929064704377, 0.09999999999999892, 195.0, 927, 859713, 1118, 39.03291220000028
1119, 5.555204507139898, 35.1824639222084, 42.30822491977872, 0.10000000000000027, 110.0, 718, 860431, 1119, 31.29568400000062
1120, 5.681196916067019, 35.371219714094956, 42.69649886154547, 0.10000000000000077, 30.0, 410, 860841, 1120, 17.751008800001728
1121, 6.073054153415068, 35.35041579030442, 42.520800868331676, 0.10000000000000096, 65.0, 587, 861428, 1121, 26.15233139999691
1122, 6.61694472129886, 35.44068946181339, 42.62171452917468, 0.09999999999999865, 285.0, 987, 862415, 1122, 42.91657699999996
1123, 5.753465322561042, 35.25758731975112, 42.3842874127765, 0.09999999999999928, 220.0, 860, 863275, 1123, 37.78058090000195
1124, 6.361279172434224, 35.358857639230415, 42.58280397044669, 0.10000000000000046, 150.0, 695, 863970, 1124, 29.960515899998427
1125, 4.879474520659408, 35.22904446033331, 42.37274122543824, 0.09999999999999774, 590.0, 1248, 865218, 1125, 54.431622699998115
1126, 5.6230937397468, 35.305015107124085, 42.48337389423001, 0.09999999999999777, 550.0, 1240, 866458, 1126, 53.72961569999825
1127, 3.685014582739562, 35.21912140839527, 42.32662892846025, 0.10000000000000035, 345.0, 709, 867167, 1127, 30.930101699999796
1128, 8.591817050368237, 35.456738739562546, 42.7401578752257, 0.10000000000000094, 105.0, 556, 867723, 1128, 24.496417800000927
1129, 6.150264275360566, 35.303938047702495, 42.478974555088925, 0.10000000000000091, 105.0, 520, 868243, 1129, 23.320488399996975
1130, 6.5429831263792115, 35.33264059314555, 42.47227528160072, 0.10000000000000078, 125.0, 662, 868905, 1130, 29.476400799998373
1131, 5.606788981765035, 35.321057150099016, 42.500617224072656, 0.10000000000000099, 180.0, 630, 869535, 1131, 28.8389602999996
1132, 4.348063291849497, 35.644162287477585, 42.87007401158901, 0.10000000000000016, 180.0, 732, 870267, 1132, 32.03261829999974
1133, 7.325593430581527, 36.32851958567123, 43.750744316916126, 0.09999999999999806, 230.0, 1142, 871409, 1133, 49.58116010000231
1134, 3.6686763995321545, 36.17841480413132, 43.48753106833915, 0.09999999999999938, 225.0, 845, 872254, 1134, 41.298575699998764
1135, 4.597448997891666, 36.19983167335635, 43.51988079508797, 0.10000000000000016, 165.0, 732, 872986, 1135, 34.07227079999939
1136, 7.780863976656641, 36.39388154587656, 43.747496011122216, 0.10000000000000099, 115.0, 636, 873622, 1136, 28.149681200000487
1137, 3.327758836029921, 36.18710438786527, 43.49656116680369, 0.09999999999999964, 165.0, 803, 874425, 1137, 35.12276080000083
1138, 4.575025806469577, 36.17721881978432, 43.55791873148043, 0.0999999999999985, 275.0, 1022, 875447, 1138, 53.29490649999934
1139, 4.328796928757943, 36.348680050845076, 43.75068823335135, 0.10000000000000074, 110.0, 394, 875841, 1139, 22.422136600001977
1140, 4.4182752087989945, 36.15575544226984, 43.44966631587248, 0.09999999999999963, 190.0, 805, 876646, 1140, 39.78228680000029
1141, 3.5650201941739166, 36.2614988783775, 43.6102151553541, 0.09999999999999906, 135.0, 902, 877548, 1141, 47.21023449999848
1142, 5.70582708133996, 36.20912680007119, 43.548895537398245, 0.10000000000000085, 180.0, 655, 878203, 1142, 32.79294079999818
1143, 4.719096197996561, 36.19683245139393, 43.62324218827535, 0.09999999999999866, 255.0, 984, 879187, 1143, 49.83565449999878
1144, 3.284615032404926, 36.27744223322957, 43.62158519630955, 0.09999999999999777, 500.0, 1239, 880426, 1144, 67.51524350000182
1145, 2.7823148060083804, 36.20093029633632, 43.512024324530095, 0.10000000000000095, 45.0, 574, 881000, 1145, 25.390145199999097
1146, 5.583802040319803, 36.37324347884156, 43.774651976518854, 0.10000000000000053, 80.0, 688, 881688, 1146, 30.471221600000717
1147, 4.777754867347184, 36.247531408216894, 43.61397547256656, 0.09999999999999759, 565.0, 1312, 883000, 1147, 57.25588889999926
1148, 3.8019790588212863, 36.316599345415746, 43.69228957484832, 0.10000000000000055, 95.0, 686, 883686, 1148, 30.71526730000187
1149, 4.1371555662297395, 36.35994753496201, 43.7828606098225, 0.09999999999999762, 280.0, 1299, 884985, 1149, 63.92647329999818
1150, 7.577574758212777, 36.3416389465332, 43.809993009929414, 0.10000000000000074, 75.0, 395, 885380, 1150, 20.330562800001644
1151, 8.437728581067061, 36.45494971676248, 43.939366311634586, 0.09999999999999815, 290.0, 1118, 886498, 1151, 59.8053250999983
1152, 4.6975348128740535, 36.25857048680583, 43.620607220319165, 0.09999999999999858, 295.0, 1004, 887502, 1152, 53.295453499998985
1153, 4.270175888133674, 36.25809607790885, 43.618111809582906, 0.09999999999999781, 430.0, 1221, 888723, 1153, 63.16217649999817
1154, 4.558533081826859, 36.248408934227506, 43.56317301083328, 0.09999999999999834, 145.0, 1064, 889787, 1154, 54.881526699999085
1155, 6.893058263574998, 36.471088784886156, 43.91829472939799, 0.10000000000000099, 145.0, 635, 890422, 1155, 33.09102460000213
1156, 2.8449908181131756, 36.53285144225896, 43.85181577024404, 0.10000000000000057, 60.0, 684, 891106, 1156, 35.92745329999889
1157, 3.1463770221782292, 36.57272743679466, 43.960689292528244, 0.09999999999999712, 515.0, 1528, 892634, 1157, 79.77452339999945
1158, 6.037458469548564, 36.42132618821512, 43.912953936959816, 0.10000000000000099, 75.0, 635, 893269, 1158, 33.878246899999795
1159, 4.100064614098774, 36.646644334270526, 44.08485929280111, 0.10000000000000096, 95.0, 584, 893853, 1159, 30.31619530000171
1160, 4.612312673529709, 36.56675625468923, 43.9561752330385, 0.09999999999999742, 370.0, 1381, 895234, 1160, 72.23916439999812
1161, 6.282544974885096, 36.51359567886744, 43.92382702188954, 0.10000000000000041, 125.0, 702, 895936, 1161, 36.97055370000089
1162, 4.877385334058531, 36.418446925708224, 43.83443370546613, 0.10000000000000094, 125.0, 560, 896496, 1162, 29.243692799998826
1163, 5.387702726215297, 36.56512574653405, 43.992357033525586, 0.09999999999999844, 360.0, 1038, 897534, 1163, 54.47025439999925
1164, 5.311202141228487, 36.481447634165065, 43.93890274854089, 0.1000000000000009, 90.0, 511, 898045, 1164, 26.710115300000325
1165, 2.89514675501872, 36.435651231695104, 43.783733008820334, 0.10000000000000092, 125.0, 648, 898693, 1165, 34.331308299999364
1166, 2.6852420894384386, 36.36291807861328, 43.70403018798828, 0.10000000000000099, 105.0, 625, 899318, 1166, 32.56144100000165
1167, 5.13462116572652, 36.47476225978109, 43.908815827520726, 0.09999999999999819, 330.0, 1105, 900423, 1167, 58.16375010000047
1168, 5.629767839584549, 36.429070959965735, 43.8553495781911, 0.09999999999999805, 320.0, 1145, 901568, 1168, 60.50475319999896
1169, 4.225843212006059, 36.34864162992677, 43.69558285158626, 0.09999999999999779, 315.0, 1233, 902801, 1169, 65.09920280000006
1170, 2.7478922204607716, 36.385379426577025, 43.6912092055464, 0.10000000000000081, 155.0, 659, 903460, 1170, 35.24081830000068
1171, 3.714173554093855, 36.43505312358944, 43.83215695595874, 0.09999999999999772, 430.0, 1257, 904717, 1171, 67.8122992000026
1172, 4.777767688263117, 36.285838522562166, 43.681939919789635, 0.09999999999999866, 180.0, 984, 905701, 1172, 52.32664730000033
1173, 4.889453852412638, 36.52011192579074, 43.91863192561085, 0.10000000000000059, 165.0, 682, 906383, 1173, 36.11954350000087
1174, 5.5850912259136285, 36.438767034283615, 43.84137145121386, 0.10000000000000085, 125.0, 471, 906854, 1174, 25.08845350000047
1175, 2.695938979691398, 36.393296139795076, 43.74342566316233, 0.10000000000000099, 115.0, 636, 907490, 1175, 33.552693000001454
1176, 4.190360917000974, 36.44324907792353, 43.85164760910304, 0.09999999999999905, 135.0, 904, 908394, 1176, 48.3916001999969
1177, 4.604178461808446, 36.43634783594232, 43.818883411655484, 0.09999999999999763, 370.0, 1292, 909686, 1177, 68.85075589999906
1178, 4.543106675353828, 36.31113079766542, 43.7573773399901, 0.10000000000000067, 75.0, 362, 910048, 1178, 19.118465700001252
1179, 2.708468961097845, 35.631417295946186, 42.84020185560044, 0.09999999999999833, 305.0, 1066, 911114, 1179, 56.88355059999958
1180, 6.886288788245033, 35.74350331958971, 43.142443359622106, 0.10000000000000088, 100.0, 494, 911608, 1180, 27.11897780000072
1181, 7.782421555157392, 35.77618501859232, 43.078818814400556, 0.10000000000000098, 120.0, 613, 912221, 1181, 32.3520815999982
1182, 4.224758548371475, 35.697813895047474, 42.91800183347424, 0.09999999999999978, 115.0, 782, 913003, 1182, 42.42344679999951
1183, 3.898967186773865, 35.65103694767628, 42.90922765268863, 0.09999999999999847, 225.0, 1030, 914033, 1183, 55.28565989999697
1184, 4.541534094601615, 35.707410665658806, 42.924593705397385, 0.10000000000000066, 55.0, 351, 914384, 1184, 18.79217719999724
1185, 4.7315876208769305, 35.74238004117399, 42.95246560998865, 0.09999999999999894, 320.0, 925, 915309, 1185, 50.341433000001416
1186, 4.334553890664296, 35.71415187416014, 42.95421106435591, 0.09999999999999783, 590.0, 1218, 916527, 1186, 65.56330389999857
1187, 5.631428350639694, 35.77040891553841, 43.09395763920803, 0.09999999999999956, 230.0, 816, 917343, 1187, 44.135547199999564
1188, 7.141087363500952, 35.757894532182625, 43.11407237546756, 0.10000000000000096, 250.0, 589, 917932, 1188, 32.14274109999678
1189, 4.608866686481922, 35.69845236974958, 42.95506036589824, 0.0999999999999969, 480.0, 1663, 919595, 1189, 90.26856000000043
1190, 5.020198975340768, 35.81946102625418, 43.044534604934626, 0.09999999999999805, 270.0, 1145, 920740, 1190, 62.35049470000013
1191, 5.554603724162173, 36.062817233839844, 43.451974226758374, 0.10000000000000098, 285.0, 612, 921352, 1191, 33.167589900000166
1192, 2.794009736079412, 36.06849809487661, 43.33125059803327, 0.10000000000000071, 50.0, 384, 921736, 1192, 20.977436999997735
1193, 5.5223544716242365, 35.95366645130244, 43.24374837225134, 0.1000000000000004, 125.0, 704, 922440, 1193, 38.11342019999938
1194, 2.387343024140523, 35.901956247400356, 43.20829230414496, 0.10000000000000075, 120.0, 405, 922845, 1194, 21.90049480000016
1195, 5.694184960837783, 35.90028368516006, 43.254425957917896, 0.09999999999999919, 250.0, 877, 923722, 1195, 48.07709660000182
1196, 3.4853140528483664, 35.94383498183662, 43.22434304656422, 0.09999999999999955, 175.0, 817, 924539, 1196, 44.24070879999999
1197, 4.663539243443671, 35.93465933847496, 43.2446679045714, 0.10000000000000044, 155.0, 699, 925238, 1197, 38.521216499997536
1198, 2.628800401507422, 35.966336590375086, 43.24770523781, 0.09999999999999984, 175.0, 774, 926012, 1198, 42.73172500000146
1199, 6.674490033717895, 35.940140123720525, 43.302984652695834, 0.09999999999999763, 345.0, 1296, 927308, 1199, 70.99234109999816
1200, 3.709007344962867, 35.98135535879483, 43.25564820641761, 0.10000000000000099, 110.0, 631, 927939, 1200, 34.41296049999801
1201, 3.596215662705561, 35.95930722540688, 43.26367036821534, 0.09999999999999896, 430.0, 919, 928858, 1201, 50.63364990000264
1202, 7.408750066392687, 36.05544377893091, 43.42999027069821, 0.09999999999999858, 280.0, 1004, 929862, 1202, 55.532339299999876
1203, 5.015922638784142, 35.64603701504794, 42.866949408581895, 0.09999999999999798, 450.0, 1166, 931028, 1203, 64.71073690000048
1204, 6.238061131677169, 35.76016575919721, 43.04885568764851, 0.09999999999999899, 80.0, 914, 931942, 1204, 50.85044790000029
1205, 6.502765119038677, 35.690201054173386, 43.00079214325584, 0.09999999999999787, 180.0, 1205, 933147, 1205, 66.79052009999941
1206, 4.839078054457869, 35.57414841191858, 42.784387651285435, 0.09999999999999917, 215.0, 881, 934028, 1206, 48.586113999997906
1207, 2.5004600536741624, 35.55988028016809, 42.69794809001766, 0.10000000000000069, 75.0, 365, 934393, 1207, 20.865080199997465
1208, 5.05961019135103, 35.7095649570372, 42.97069788863019, 0.09999999999999849, 300.0, 1025, 935418, 1208, 56.69523669999762
1209, 2.4841501650582885, 35.59013591353426, 42.74074608517676, 0.10000000000000073, 105.0, 388, 935806, 1209, 21.566634599999816
1210, 5.266593506757761, 35.55070057267952, 42.784968786136766, 0.09999999999999762, 110.0, 1298, 937104, 1210, 71.89454810000097
1211, 6.670736701902131, 35.670754834348934, 42.947215315156384, 0.09999999999999959, 105.0, 812, 937916, 1211, 45.50242200000139
1212, 5.196464535557278, 35.655228540656935, 42.9384547931768, 0.09999999999999762, 440.0, 1299, 939215, 1212, 72.13972269999795
1213, 5.458797397249275, 35.57421300252279, 42.79060123019748, 0.09999999999999906, 170.0, 900, 940115, 1213, 50.27621799999906
1214, 5.593676533486016, 34.529130140940346, 41.53406874994232, 0.099999999999998, 305.0, 1164, 941279, 1214, 65.44160190000184
1215, 5.731443848082653, 34.528527256892275, 41.607645744910606, 0.1000000000000009, 110.0, 650, 941929, 1215, 36.08767290000105
1216, 6.339656804651022, 34.51231100463867, 41.61648503112793, 0.10000000000000088, 75.0, 500, 942429, 1216, 28.837787200001912
1217, 5.000520600183151, 34.5279191155258, 41.5517788113134, 0.09999999999999798, 240.0, 1167, 943596, 1217, 65.82857220000005
1218, 2.692642031237483, 34.4794035166502, 41.41805357933045, 0.100000000000001, 105.0, 640, 944236, 1218, 35.83688410000104
1219, 5.346313970830623, 34.55981734771412, 41.59219786049663, 0.10000000000000087, 35.0, 483, 944719, 1219, 27.7438633999991
1220, 5.522348404526711, 34.37207730513352, 41.37102794353778, 0.1000000000000009, 135.0, 650, 945369, 1220, 35.99129429999812
1221, 3.8116799301329727, 34.48015340975974, 41.471199235303544, 0.0999999999999977, 335.0, 1261, 946630, 1221, 70.26684870000099
1222, 7.877094948014547, 34.56325305524722, 41.823040836541225, 0.1000000000000009, 85.0, 516, 947146, 1222, 29.659177899997303
1223, 4.509500528751819, 34.36774052544863, 41.35358480855721, 0.09999999999999848, 240.0, 1029, 948175, 1223, 59.92828139999983
1224, 7.395700159161179, 34.52988501937301, 41.6981793834545, 0.10000000000000066, 130.0, 675, 948850, 1224, 37.83674919999976
1225, 4.98503446455723, 34.558145445364495, 41.530296919080946, 0.0999999999999996, 215.0, 810, 949660, 1225, 45.835114699999394
1226, 2.753944039065609, 34.30840590519425, 41.18973081173327, 0.10000000000000078, 75.0, 427, 950087, 1226, 24.018433400000504
1227, 3.889549180865288, 34.4380768137723, 41.39971656857735, 0.10000000000000087, 340.0, 653, 950740, 1227, 37.06211909999911
1228, 4.709144619955199, 34.4263199538042, 41.45972733331004, 0.10000000000000098, 155.0, 601, 951341, 1228, 33.96129089999886
1229, 6.433925763453527, 34.36555891139533, 41.36636802714358, 0.1000000000000007, 105.0, 372, 951713, 1229, 21.193867599999066
1230, 5.8862885994332865, 34.45173308363507, 41.46901991680275, 0.09999999999999742, 230.0, 1379, 953092, 1230, 77.00765069999761
1231, 5.993805345214315, 34.398690640977, 41.384836046191324, 0.09999999999999795, 470.0, 1177, 954269, 1231, 56.581941199998255
1232, 9.266060788874272, 34.52526828342014, 41.66505941885489, 0.10000000000000066, 165.0, 675, 954944, 1232, 32.28026680000039
1233, 3.4465296019064753, 34.3334699655834, 41.237373753597865, 0.09999999999999995, 145.0, 760, 955704, 1233, 36.877852699999494
1234, 6.682226245738056, 34.56030829591994, 41.6086353817098, 0.1000000000000009, 80.0, 511, 956215, 1234, 24.452790199997253
1235, 4.538633669083266, 34.377270508467944, 41.400036887204934, 0.10000000000000096, 130.0, 582, 956797, 1235, 28.318359599998075
1236, 4.299844692976339, 34.40167747466376, 41.36976982657201, 0.10000000000000014, 120.0, 734, 957531, 1236, 34.919813199998316
1237, 6.834568458577482, 34.56025668818776, 41.62134834382592, 0.09999999999999953, 240.0, 820, 958351, 1237, 39.77954580000005
1238, 6.241996671692624, 34.446623935235934, 41.46168620043462, 0.09999999999999816, 465.0, 1111, 959462, 1238, 53.853201400001126
1239, 6.607270128968794, 34.485203203572404, 41.53290006082342, 0.10000000000000077, 115.0, 663, 960125, 1239, 31.811884400001873
1240, 6.191387623174577, 34.85103073981655, 41.978532223958744, 0.09999999999999969, 130.0, 797, 960922, 1240, 38.7060616000017
1241, 4.616632729045542, 34.8740485975306, 41.95577211833217, 0.09999999999999865, 420.0, 989, 961911, 1241, 48.479074999999284
1242, 6.144866223921434, 35.01982798286564, 42.18627380033883, 0.09999999999999905, 85.0, 905, 962816, 1242, 43.62216629999966
1243, 5.628624908465276, 34.83448080936496, 41.88652200950421, 0.09999999999999945, 240.0, 834, 963650, 1243, 40.5574252999977
1244, 2.905130826978696, 34.925243976562825, 41.95493879293075, 0.10000000000000071, 35.0, 379, 964029, 1244, 18.372639599998365
1245, 6.087500862958954, 34.92500351206788, 42.0709214412508, 0.09999999999999981, 190.0, 779, 964808, 1245, 38.35202769999887
1246, 3.664574019533156, 34.94278549330778, 41.979389111082526, 0.10000000000000069, 185.0, 671, 965479, 1246, 32.2655416000016
1247, 2.942044628394694, 34.8447825841311, 41.848360692040394, 0.10000000000000035, 115.0, 708, 966187, 1247, 35.50182540000242
1248, 5.926519532715088, 34.92611854284712, 42.106141807963546, 0.0999999999999995, 305.0, 824, 967011, 1248, 40.230984399997396
1249, 4.786541422951785, 35.0361955022402, 42.15732035322654, 0.0999999999999974, 435.0, 1396, 968407, 1249, 68.54035640000075
1250, 4.807516577164417, 35.02440380051364, 42.14039271320872, 0.09999999999999891, 375.0, 931, 969338, 1250, 45.68226810000124
1251, 5.2707734049063895, 35.00581660763971, 42.08932314717711, 0.09999999999999959, 250.0, 812, 970150, 1251, 40.19070300000021
1252, 3.6775307933161985, 35.03307703272036, 42.131341945848476, 0.09999999999999953, 425.0, 819, 970969, 1252, 40.067417600002955
1253, 5.876442018890903, 35.04250759208289, 42.21493664483955, 0.10000000000000056, 105.0, 685, 971654, 1253, 34.32961630000136
1254, 6.018815451453151, 35.23027440524153, 42.43858580268645, 0.09999999999999895, 335.0, 922, 972576, 1254, 45.876041200001055
1255, 3.7924321786198205, 35.080219849054814, 42.17195901773555, 0.09999999999999744, 330.0, 1374, 973950, 1255, 67.72742660000222
1256, 4.374373427447789, 35.173305015087976, 42.31288563801431, 0.10000000000000094, 135.0, 561, 974511, 1256, 27.305412599998817
1257, 9.345955075216047, 35.19730479446883, 42.41419286039687, 0.10000000000000087, 55.0, 485, 974996, 1257, 23.974098599999706
1258, 9.388506308148386, 35.13123063834852, 42.369455937339545, 0.10000000000000098, 180.0, 601, 975597, 1258, 29.68750049999653
1259, 5.432313259150745, 34.92196280673782, 41.982440388033176, 0.09999999999999837, 330.0, 1055, 976652, 1259, 52.11085610000009
1260, 4.062868989825417, 35.01820088643449, 42.098616434589594, 0.10000000000000035, 370.0, 709, 977361, 1260, 34.63703430000169
1261, 2.9015684393146084, 35.13163907540277, 42.19461122160337, 0.10000000000000095, 100.0, 579, 977940, 1261, 29.075311100001272
1262, 4.786998092553314, 34.888728383146685, 41.95383123115257, 0.10000000000000092, 195.0, 648, 978588, 1262, 31.6129265999989
1263, 5.730318616854612, 35.11574616088418, 42.251832252042206, 0.09999999999999643, 975.0, 2039, 980627, 1263, 101.45707779999793
1264, 5.342958301947308, 35.21338407960656, 42.376845111585645, 0.1000000000000009, 20.0, 511, 981138, 1264, 25.269508500001393
1265, 5.060845779163354, 34.95081247144243, 42.04581989045618, 0.09999999999999945, 245.0, 833, 981971, 1265, 41.88109489999988
1266, 5.366542807262805, 35.03325594796075, 42.17938319085136, 0.09999999999999856, 275.0, 1008, 982979, 1266, 50.44984939999995
1267, 4.809189721033908, 35.113542437553406, 42.23960555791855, 0.100000000000001, 195.0, 640, 983619, 1267, 31.828602800000226
1268, 3.9341773670048092, 34.96163603910215, 42.02110970855519, 0.10000000000000099, 110.0, 628, 984247, 1268, 31.892257499999687
1269, 5.159016208120905, 34.99727816476696, 42.15097879082096, 0.09999999999999809, 570.0, 1135, 985382, 1269, 56.527186999999685
1270, 4.385847300651428, 35.04746309531787, 42.14589831849251, 0.09999999999999949, 210.0, 827, 986209, 1270, 41.80407479999849
1271, 4.501332954374991, 34.96732258254009, 42.070140074525874, 0.10000000000000081, 110.0, 659, 986868, 1271, 32.968078299996705
1272, 5.6341034821758225, 35.098387956382034, 42.24013747220015, 0.09999999999999858, 170.0, 1005, 987873, 1272, 49.87368719999722
1273, 3.553975743683728, 35.05194782299413, 42.110559828037395, 0.09999999999999959, 165.0, 811, 988684, 1273, 40.666281400001026
1274, 4.707033819663144, 35.08609473676002, 42.23950372456918, 0.10000000000000075, 110.0, 407, 989091, 1274, 20.196714800000336
1275, 6.4031223655550304, 35.01857931851698, 42.10577067660514, 0.1000000000000007, 50.0, 371, 989462, 1275, 19.46694170000046
1276, 3.8275762943854423, 34.89379837480896, 41.95444997151693, 0.10000000000000071, 105.0, 669, 990131, 1276, 33.67838149999807
1277, 6.075029014524733, 34.84442165490838, 41.98423906788621, 0.0999999999999988, 210.0, 953, 991084, 1277, 48.189118600002985
1278, 4.5204269754150035, 34.78231969475746, 41.835489294745706, 0.1000000000000004, 190.0, 704, 991788, 1278, 35.442071400000714
1279, 6.294267183846926, 34.75572376374807, 41.85147819766215, 0.09999999999999741, 405.0, 1389, 993177, 1279, 70.07563969999683
1280, 6.127033826886074, 34.784461720580076, 41.85471118914736, 0.10000000000000099, 145.0, 622, 993799, 1280, 31.296027699998376
1281, 5.794535969169482, 34.70967895745585, 41.720832509400076, 0.10000000000000012, 115.0, 738, 994537, 1281, 37.645780700000614
1282, 6.657149286923792, 34.758072873858055, 41.84578108051944, 0.0999999999999982, 205.0, 1102, 995639, 1282, 55.78840729999865
1283, 4.384999044229627, 34.77206895329246, 41.8052355093785, 0.09999999999999999, 155.0, 753, 996392, 1283, 37.87084369999866
1284, 4.020897037203455, 34.76237841342071, 41.84494016536329, 0.09999999999999809, 470.0, 1134, 997526, 1284, 57.40550190000067
1285, 7.850837793135079, 35.00016017966487, 42.15138480884319, 0.1000000000000009, 50.0, 507, 998033, 1285, 25.90553870000076
1286, 5.652754268677845, 34.732593913858196, 41.83835943676448, 0.09999999999999752, 390.0, 1339, 999372, 1286, 68.53101669999887
1287, 4.713977683270942, 34.6990117916482, 41.767034067583914, 0.10000000000000064, 75.0, 346, 999718, 1287, 18.54528289999871
