,loss,mae,mean_q,mean_eps,episode_reward,nb_episode_steps,nb_steps,episode,duration
0,0,0,0,0,215.0,833,833,0,1.6877643000000004
1, 0, 0, 0, 0, 135.0, 649, 1482, 1, 1.3531012000000002
2, 0, 0, 0, 0, 125.0, 782, 2264, 2, 1.6345882000000014
3, 0, 0, 0, 0, 165.0, 681, 2945, 3, 1.3930977000000002
4, 0, 0, 0, 0, 105.0, 379, 3324, 4, 0.8391821999999998
5, 0, 0, 0, 0, 30.0, 611, 3935, 5, 1.2855436000000005
6, 0, 0, 0, 0, 135.0, 654, 4589, 6, 1.4163940999999998
7, 0, 0, 0, 0, 110.0, 665, 5254, 7, 1.3888080999999985
8, 0, 0, 0, 0, 110.0, 621, 5875, 8, 1.294845900000002
9, 0, 0, 0, 0, 210.0, 822, 6697, 9, 1.704986599999998
10, 0, 0, 0, 0, 125.0, 419, 7116, 10, 0.8621030999999988
11, 0, 0, 0, 0, 75.0, 625, 7741, 11, 1.2551305
12, 0, 0, 0, 0, 300.0, 985, 8726, 12, 1.9690721999999994
13, 0, 0, 0, 0, 195.0, 781, 9507, 13, 1.6742887999999994
14, 0, 0, 0, 0, 240.0, 929, 10436, 14, 1.8890071000000006
15, 0, 0, 0, 0, 170.0, 872, 11308, 15, 1.7753695999999977
16, 0, 0, 0, 0, 135.0, 741, 12049, 16, 1.585123699999997
17, 0, 0, 0, 0, 155.0, 693, 12742, 17, 1.4255260000000014
18, 0, 0, 0, 0, 150.0, 623, 13365, 18, 1.2893936000000004
19, 0, 0, 0, 0, 150.0, 757, 14122, 19, 1.5817298999999991
20, 0, 0, 0, 0, 80.0, 463, 14585, 20, 1.0135950000000022
21, 0, 0, 0, 0, 165.0, 775, 15360, 21, 1.5598998000000037
22, 0, 0, 0, 0, 110.0, 663, 16023, 22, 1.369563399999997
23, 0, 0, 0, 0, 180.0, 813, 16836, 23, 1.7388197000000005
24, 0, 0, 0, 0, 445.0, 1136, 17972, 24, 2.291962500000004
25, 0, 0, 0, 0, 150.0, 839, 18811, 25, 1.7179074000000014
26, 0, 0, 0, 0, 90.0, 611, 19422, 26, 1.3419694999999976
27, 0, 0, 0, 0, 135.0, 647, 20069, 27, 1.3151280000000014
28, 0, 0, 0, 0, 40.0, 386, 20455, 28, 0.7984998000000019
29, 0, 0, 0, 0, 120.0, 867, 21322, 29, 1.7519285999999994
30, 0, 0, 0, 0, 55.0, 377, 21699, 30, 0.8309412000000052
31, 0, 0, 0, 0, 80.0, 701, 22400, 31, 1.4780778000000012
32, 0, 0, 0, 0, 170.0, 845, 23245, 32, 1.7553677999999948
33, 0, 0, 0, 0, 250.0, 912, 24157, 33, 1.8603120999999945
34, 0, 0, 0, 0, 80.0, 536, 24693, 34, 1.1572834999999984
35, 0, 0, 0, 0, 105.0, 383, 25076, 35, 0.8199635000000001
36, 0, 0, 0, 0, 130.0, 677, 25753, 36, 1.4053426000000044
37, 0, 0, 0, 0, 105.0, 704, 26457, 37, 1.4504392999999993
38, 0, 0, 0, 0, 135.0, 645, 27102, 38, 1.3725767000000033
39, 0, 0, 0, 0, 55.0, 533, 27635, 39, 1.1265071000000049
40, 0, 0, 0, 0, 100.0, 631, 28266, 40, 1.2925241000000014
41, 0, 0, 0, 0, 210.0, 1324, 29590, 41, 2.7008710000000065
42, 0, 0, 0, 0, 135.0, 635, 30225, 42, 1.3079158999999976
43, 0, 0, 0, 0, 105.0, 527, 30752, 43, 1.0976321999999925
44, 0, 0, 0, 0, 105.0, 655, 31407, 44, 1.3550042000000104
45, 0, 0, 0, 0, 460.0, 1583, 32990, 45, 3.186977200000001
46, 0, 0, 0, 0, 55.0, 630, 33620, 46, 1.3078742999999946
47, 0, 0, 0, 0, 120.0, 621, 34241, 47, 1.3072910000000064
48, 0, 0, 0, 0, 180.0, 685, 34926, 48, 1.4797286999999955
49, 0, 0, 0, 0, 155.0, 781, 35707, 49, 1.563812200000001
50, 0, 0, 0, 0, 80.0, 614, 36321, 50, 1.267703300000008
51, 0, 0, 0, 0, 155.0, 766, 37087, 51, 1.6326540999999963
52, 0, 0, 0, 0, 65.0, 470, 37557, 52, 0.9676101000000017
53, 0, 0, 0, 0, 155.0, 646, 38203, 53, 1.327547800000005
54, 0, 0, 0, 0, 95.0, 625, 38828, 54, 1.293481099999994
55, 0, 0, 0, 0, 125.0, 692, 39520, 55, 1.4892071999999956
56, 0, 0, 0, 0, 215.0, 788, 40308, 56, 1.6155322999999981
57, 0, 0, 0, 0, 110.0, 649, 40957, 57, 1.337538600000002
58, 0, 0, 0, 0, 145.0, 789, 41746, 58, 1.6402173999999974
59, 0, 0, 0, 0, 210.0, 743, 42489, 59, 1.5742256000000054
60, 0, 0, 0, 0, 110.0, 569, 43058, 60, 1.1606346000000087
61, 0, 0, 0, 0, 215.0, 824, 43882, 61, 1.7030867
62, 0, 0, 0, 0, 240.0, 1555, 45437, 62, 3.145792099999994
63, 0, 0, 0, 0, 410.0, 1435, 46872, 63, 2.839240799999999
64, 0, 0, 0, 0, 240.0, 955, 47827, 64, 1.9752570999999932
65, 0, 0, 0, 0, 60.0, 392, 48219, 65, 0.824234699999991
66, 0, 0, 0, 0, 30.0, 612, 48831, 66, 1.2576369000000085
67, 0, 0, 0, 0, 50.0, 594, 49425, 67, 1.2525227999999942
68, 0, 0, 0, 0, 75.0, 614, 50039, 68, 1.326757200000003
69, 0, 0, 0, 0, 180.0, 691, 50730, 69, 1.4088409999999953
70, 0, 0, 0, 0, 120.0, 648, 51378, 70, 1.349697099999986
71, 0, 0, 0, 0, 90.0, 593, 51971, 71, 1.2736445999999972
72, 0, 0, 0, 0, 210.0, 796, 52767, 72, 1.6468342000000007
73, 0, 0, 0, 0, 225.0, 980, 53747, 73, 1.992539899999997
74, 0, 0, 0, 0, 290.0, 1414, 55161, 74, 2.8798716000000013
75, 0, 0, 0, 0, 215.0, 668, 55829, 75, 1.3600434000000092
76, 0, 0, 0, 0, 355.0, 795, 56624, 76, 1.6169665999999978
77, 0, 0, 0, 0, 105.0, 600, 57224, 77, 1.331600899999998
78, 0, 0, 0, 0, 125.0, 809, 58033, 78, 1.6737088
79, 0, 0, 0, 0, 230.0, 943, 58976, 79, 1.8847916999999939
80, 0, 0, 0, 0, 110.0, 666, 59642, 80, 1.4424214999999947
81, 0, 0, 0, 0, 105.0, 648, 60290, 81, 1.3302281999999934
82, 0, 0, 0, 0, 125.0, 735, 61025, 82, 1.5131872000000044
83, 0, 0, 0, 0, 185.0, 781, 61806, 83, 1.6138316999999915
84, 0, 0, 0, 0, 95.0, 451, 62257, 84, 0.9973364999999887
85, 0, 0, 0, 0, 180.0, 861, 63118, 85, 1.7681302000000017
86, 0, 0, 0, 0, 410.0, 829, 63947, 86, 1.643921999999975
87, 0, 0, 0, 0, 180.0, 824, 64771, 87, 1.7572319999999877
88, 0, 0, 0, 0, 155.0, 794, 65565, 88, 1.6315462000000025
89, 0, 0, 0, 0, 265.0, 881, 66446, 89, 1.7984553000000005
90, 0, 0, 0, 0, 135.0, 791, 67237, 90, 1.671262299999995
91, 0, 0, 0, 0, 240.0, 1397, 68634, 91, 2.7584656000000223
92, 0, 0, 0, 0, 155.0, 770, 69404, 92, 1.5827936999999963
93, 0, 0, 0, 0, 245.0, 1005, 70409, 93, 2.069509299999993
94, 0, 0, 0, 0, 80.0, 627, 71036, 94, 1.272336600000017
95, 0, 0, 0, 0, 125.0, 546, 71582, 95, 1.1203358999999864
96, 0, 0, 0, 0, 135.0, 819, 72401, 96, 1.7613615999999865
97, 0, 0, 0, 0, 105.0, 644, 73045, 97, 1.3264824999999973
98, 0, 0, 0, 0, 180.0, 886, 73931, 98, 1.7855638999999996
99, 0, 0, 0, 0, 10.0, 639, 74570, 99, 1.3317771000000107
100, 0, 0, 0, 0, 50.0, 384, 74954, 100, 0.8813342999999918
101, 0, 0, 0, 0, 105.0, 671, 75625, 101, 1.411729400000013
102, 0, 0, 0, 0, 110.0, 715, 76340, 102, 1.4522302999999965
103, 0, 0, 0, 0, 215.0, 1166, 77506, 103, 2.5027556999999945
104, 0, 0, 0, 0, 210.0, 828, 78334, 104, 1.66970409999999
105, 0, 0, 0, 0, 180.0, 804, 79138, 105, 1.6511008999999888
106, 0, 0, 0, 0, 55.0, 403, 79541, 106, 0.8367474000000072
107, 0, 0, 0, 0, 120.0, 519, 80060, 107, 1.1285933000000057
108, 0, 0, 0, 0, 210.0, 736, 80796, 108, 1.4634909000000107
109, 0, 0, 0, 0, 120.0, 726, 81522, 109, 1.4620185999999933
110, 0, 0, 0, 0, 120.0, 770, 82292, 110, 1.5962013000000184
111, 0, 0, 0, 0, 50.0, 383, 82675, 111, 0.874399000000011
112, 0, 0, 0, 0, 185.0, 806, 83481, 112, 1.6614217999999994
113, 0, 0, 0, 0, 75.0, 618, 84099, 113, 1.429526299999992
114, 0, 0, 0, 0, 50.0, 409, 84508, 114, 0.8756301999999891
115, 0, 0, 0, 0, 105.0, 625, 85133, 115, 1.3430424999999957
116, 0, 0, 0, 0, 55.0, 602, 85735, 116, 1.3140209999999968
117, 0, 0, 0, 0, 165.0, 788, 86523, 117, 1.690253800000022
118, 0, 0, 0, 0, 180.0, 809, 87332, 118, 1.7984674999999868
119, 0, 0, 0, 0, 410.0, 824, 88156, 119, 1.7546230000000094
120, 0, 0, 0, 0, 255.0, 954, 89110, 120, 1.9904690999999843
121, 0, 0, 0, 0, 120.0, 766, 89876, 121, 1.6105136000000186
122, 0, 0, 0, 0, 315.0, 1340, 91216, 122, 2.820161899999988
123, 0, 0, 0, 0, 120.0, 677, 91893, 123, 1.4188294000000212
124, 0, 0, 0, 0, 120.0, 700, 92593, 124, 1.507401399999992
125, 0, 0, 0, 0, 355.0, 783, 93376, 125, 1.666227699999979
126, 0, 0, 0, 0, 90.0, 580, 93956, 126, 1.2518752000000006
127, 0, 0, 0, 0, 340.0, 760, 94716, 127, 1.627935100000002
128, 0, 0, 0, 0, 110.0, 683, 95399, 128, 1.4643053000000066
129, 0, 0, 0, 0, 135.0, 757, 96156, 129, 1.649788299999983
130, 0, 0, 0, 0, 180.0, 770, 96926, 130, 1.665511600000002
131, 0, 0, 0, 0, 210.0, 850, 97776, 131, 1.7495092999999997
132, 0, 0, 0, 0, 355.0, 831, 98607, 132, 1.7259940000000142
133, 0, 0, 0, 0, 210.0, 820, 99427, 133, 1.7076630999999907
134, 11.553703470308273, 9.112795798504939, 13.40393108618064, 0.8199442000000001, 105.0, 635, 100062, 134, 2.2170675999999787
135, 4.822172581738439, 8.96587952827585, 11.323456517581281, 0.8193673000000004, 120.0, 580, 100642, 135, 5.550914299999988
136, 8.189523486576416, 8.94848952230378, 11.152235864647684, 0.8178238, 410.0, 1135, 101777, 136, 10.855612699999995
137, 4.991950865422399, 8.940771997467545, 10.851499879064638, 0.8162578000000001, 125.0, 605, 102382, 137, 5.835673200000002
138, 4.844152409887914, 8.888810477166805, 10.816788746875787, 0.8151409000000004, 80.0, 636, 103018, 138, 6.1294805
139, 5.911949801567363, 8.963825690431678, 10.883822934019252, 0.8133408999999997, 415.0, 1364, 104382, 139, 13.035738399999985
140, 4.603810092855673, 8.91745883206852, 10.82059262854154, 0.8115642999999998, 80.0, 610, 104992, 140, 5.743306500000017
141, 6.724446868896484, 8.926076918798136, 10.81756000248253, 0.8103808000000001, 155.0, 705, 105697, 141, 6.875107400000047
142, 8.823348845114374, 8.956431809200602, 10.85998152714626, 0.8090398, 180.0, 785, 106482, 142, 7.631731800000011
143, 7.3587621227203615, 8.940653015417881, 10.85959010105209, 0.8078815, 60.0, 502, 106984, 143, 4.880404199999987
144, 3.651046626752531, 8.94095708484381, 10.766470087078256, 0.8067907000000001, 195.0, 710, 107694, 144, 6.938428299999998
145, 3.8852764179511947, 8.92599112721777, 10.706495027527144, 0.8055784, 135.0, 637, 108331, 145, 6.135743200000036
146, 4.467789812960847, 8.904126457851701, 10.733611734844835, 0.8042724999999998, 195.0, 814, 109145, 146, 7.9707712000000015
147, 5.251980343439283, 8.934418599390925, 10.72448478708012, 0.8031699999999998, 65.0, 411, 109556, 147, 4.051713100000029
148, 5.358717920130595, 9.246777288854723, 11.196885450732042, 0.8018182000000008, 225.0, 1091, 110647, 148, 10.568973200000016
149, 6.05843853172685, 9.465840557783535, 11.496814046204927, 0.7998741999999993, 285.0, 1069, 111716, 149, 10.449825299999986
150, 3.4203766775270044, 9.439454835228178, 11.432295024655271, 0.7982938000000002, 185.0, 687, 112403, 150, 6.76954070000005
151, 4.380782870249055, 9.419847527722727, 11.41716790949923, 0.7970751999999998, 135.0, 667, 113070, 151, 6.5298181
152, 5.133569936614391, 9.439584436495442, 11.468237604976686, 0.7960392999999998, 80.0, 484, 113554, 152, 4.802646600000003
153, 3.2272852498248517, 9.420433682321713, 11.452174924067315, 0.7950600999999999, 80.0, 604, 114158, 153, 5.9993208999999865
154, 4.069967632307045, 9.432109204097767, 11.435372665746888, 0.7941547000000004, 65.0, 402, 114560, 154, 3.853233400000022
155, 7.499067375190714, 9.468956902686585, 11.576679237852705, 0.7933698999999999, 60.0, 470, 115030, 155, 4.684961200000032
156, 3.4641410932855674, 9.387045426590227, 11.37738364249978, 0.7925788, 50.0, 409, 115439, 156, 4.058151600000031
157, 3.7344300912887074, 9.399477230145914, 11.396853354594898, 0.791839, 65.0, 413, 115852, 157, 4.107546300000024
158, 3.8517194168526987, 9.455053218646345, 11.445302990708015, 0.7906231000000006, 590.0, 938, 116790, 158, 9.260331199999996
159, 4.237272762702818, 9.435834253877616, 11.453722584367311, 0.7891515999999998, 160.0, 697, 117487, 159, 6.906652699999995
160, 3.598426994152323, 9.382231561107748, 11.371720221479968, 0.7877638000000002, 240.0, 845, 118332, 160, 8.420094300000017
161, 4.936853206880259, 9.419368736453658, 11.457632841850543, 0.7861383999999997, 450.0, 961, 119293, 161, 9.617807999999968
162, 3.5948655888411327, 9.45021024249521, 11.451217429302229, 0.7847748999999998, 80.0, 554, 119847, 162, 5.532632700000022
163, 4.193048561191619, 9.442732532720019, 11.420510988877599, 0.7839153999999999, 110.0, 401, 120248, 163, 4.046973800000046
164, 4.5529886253444625, 9.433773020007191, 11.412430880414568, 0.7829758000000001, 110.0, 643, 120891, 164, 6.449723600000027
165, 5.818361223307976, 9.455566518335228, 11.523185198050571, 0.7819452999999998, 45.0, 502, 121393, 165, 5.082899599999962
166, 4.852506327087501, 9.439364651599563, 11.444291436528585, 0.7810452999999999, 35.0, 498, 121891, 166, 5.046737399999984
167, 6.081559423708899, 9.453085394383884, 11.449687997148452, 0.7799869000000004, 135.0, 678, 122569, 167, 6.775026200000013
168, 6.275456087133983, 9.446941767266665, 11.448682070698977, 0.7786774, 125.0, 777, 123346, 168, 7.8330826000000116
169, 5.259268208564899, 9.432107639469857, 11.44186228700289, 0.7774317999999998, 155.0, 607, 123953, 169, 6.1176064
170, 3.6742908425239973, 9.44838921938946, 11.414846964626038, 0.7756966, 345.0, 1321, 125274, 170, 13.197192700000016
171, 2.092274519403502, 9.38511333701699, 11.3301009226698, 0.7738534, 210.0, 727, 126001, 171, 7.387086699999998
172, 3.433359256402983, 9.42159715365152, 11.398312016537314, 0.7727032, 35.0, 551, 126552, 172, 5.666828100000032
173, 5.156692352697307, 9.424641909295184, 11.404260607833036, 0.7714594, 405.0, 831, 127383, 173, 8.37487699999997
174, 6.530355935121018, 9.48357181245468, 11.474537095773533, 0.7697503000000001, 190.0, 1068, 128451, 174, 10.956113700000003
175, 3.601584860511657, 9.42080383214182, 11.35433053374967, 0.7679962000000002, 280.0, 881, 129332, 175, 8.964353700000004
176, 3.401900515383768, 9.5053262956189, 11.482424632694116, 0.7661898999999993, 380.0, 1126, 130458, 176, 11.385762599999964
177, 3.858667129688725, 9.633860145296369, 11.645572801512115, 0.7642945000000001, 430.0, 980, 131438, 177, 10.103741200000059
178, 3.7135738095929547, 9.63073009686943, 11.66166689974148, 0.7626592000000004, 135.0, 837, 132275, 178, 8.549720399999956
179, 2.7028059441318932, 9.664971576130366, 11.62887049201029, 0.7614585999999999, 35.0, 497, 132772, 179, 5.17002100000002
180, 3.22674726413427, 9.619574166162844, 11.595752578948188, 0.7601724999999999, 300.0, 932, 133704, 180, 9.652870300000018
181, 3.4594115832526433, 9.604248435873734, 11.641165174935994, 0.7589233000000002, 110.0, 456, 134160, 181, 4.695188500000086
182, 5.4335818892374395, 9.645121582916804, 11.6575206480329, 0.7576056999999994, 225.0, 1008, 135168, 182, 10.296313499999997
183, 2.268717159326671, 9.605628101765609, 11.536160637350644, 0.7560559000000002, 120.0, 714, 135882, 183, 7.41244770000003
184, 7.133126051893535, 9.682816396902606, 11.749675284286388, 0.7550415999999999, 110.0, 413, 136295, 184, 4.346111500000006
185, 2.8834112954693043, 9.603698973805844, 11.562766137262898, 0.7538410000000002, 300.0, 921, 137216, 185, 9.597412300000087
186, 3.7773358862917377, 9.632916575257884, 11.642621181895898, 0.7522965999999995, 100.0, 795, 138011, 186, 8.201220899999953
187, 4.38614972410638, 9.628234328483293, 11.611351261587016, 0.7507, 380.0, 979, 138990, 187, 10.255349900000056
188, 2.0393449846329044, 9.583417110797265, 11.51401763379732, 0.7494795999999998, 90.0, 377, 139367, 188, 3.987890400000083
189, 2.208420391064529, 9.590221948423075, 11.560271580406175, 0.7486695999999999, 65.0, 523, 139890, 189, 5.511450400000058
190, 4.6261966796732406, 9.803766877235862, 11.897550875921471, 0.7475428000000005, 210.0, 729, 140619, 190, 7.658849199999963
191, 1.882617244961221, 9.812852965618099, 11.853454380431586, 0.7462801000000001, 135.0, 674, 141293, 191, 7.128813400000013
192, 1.9950832866676402, 9.826632561308614, 11.892839431762695, 0.7453531, 35.0, 356, 141649, 192, 3.7931989999999587
193, 4.530072644252111, 9.893348090227912, 11.961233836903292, 0.7442676999999998, 260.0, 850, 142499, 193, 9.018353400000024
194, 1.9364658187753356, 9.861334974995724, 11.991731771962897, 0.7431481, 45.0, 394, 142893, 194, 4.211586000000011
195, 1.9863396211116164, 9.820560514031946, 11.837376366864454, 0.7421941, 120.0, 666, 143559, 195, 6.988374099999987
196, 3.165347543683836, 9.877922627966159, 11.922860776956913, 0.7410087999999997, 135.0, 651, 144210, 196, 6.9338107999999465
197, 5.463913046201375, 9.865905171295381, 12.016726456723124, 0.7396596999999999, 220.0, 848, 145058, 197, 9.055901200000108
198, 8.251936441571113, 9.899052319937194, 12.03968602616266, 0.7383528999999996, 15.0, 604, 145662, 198, 6.331606400000055
199, 4.894739452638761, 9.894794686837814, 11.981395280032148, 0.7373854000000001, 55.0, 471, 146133, 199, 5.087191599999983
200, 2.046158363584871, 9.866822296616721, 11.883943604884175, 0.7363243000000004, 80.0, 708, 146841, 200, 7.604016300000012
201, 3.9318337037074556, 9.873905334241229, 11.965244467747826, 0.734797, 135.0, 989, 147830, 201, 10.630440599999929
202, 3.2857109000325444, 9.847511270396426, 11.913851368595177, 0.7330122999999998, 350.0, 994, 148824, 202, 10.573663099999976
203, 2.531387355055317, 9.829593324118834, 11.880291902291615, 0.7312474000000002, 190.0, 967, 149791, 203, 10.394603899999993
204, 3.7340850996483903, 9.930815690649679, 12.022675361342102, 0.7296696999999996, 125.0, 786, 150577, 204, 8.49876770000003
205, 1.8422409726106852, 9.942007453832248, 11.977883607250149, 0.7281658, 190.0, 885, 151462, 205, 9.614767000000029
206, 5.5532917553888135, 9.998182487701143, 12.180755295209437, 0.7265646999999997, 200.0, 894, 152356, 206, 9.723857099999918
207, 3.564488480860683, 9.959285780604407, 12.013442979104981, 0.7253938000000001, 30.0, 407, 152763, 207, 4.41850050000005
208, 3.4844551666324297, 9.985258537915445, 12.029852414323438, 0.7241346999999995, 305.0, 992, 153755, 208, 10.779957500000023
209, 2.5990772801749045, 9.950782180736537, 11.997199761131345, 0.7224112, 180.0, 923, 154678, 209, 10.105316199999947
210, 2.6646413999669094, 9.942125378771031, 11.988485016721361, 0.7209036999999998, 210.0, 752, 155430, 210, 8.09850999999992
211, 3.463147017037361, 9.972987511901504, 12.054933017910693, 0.7194448000000002, 235.0, 869, 156299, 211, 9.59449820000009
212, 3.7125369989386026, 9.982500446575314, 12.053070037724586, 0.7180183000000003, 115.0, 716, 157015, 212, 7.876722900000004
213, 1.7778354334907653, 9.941030446077004, 11.936993190569755, 0.7170228999999999, 60.0, 390, 157405, 213, 4.24485709999999
214, 1.847667413056561, 9.946382025198632, 11.983131707688852, 0.7160662, 130.0, 673, 158078, 214, 7.417748899999992
215, 7.256139577487889, 10.044756078201791, 12.183036742003068, 0.7151292999999999, 75.0, 368, 158446, 215, 4.099894500000005
216, 3.4828847409498813, 9.99317819999926, 12.05637382738518, 0.7143525999999999, 10.0, 495, 158941, 216, 5.426439099999925
217, 5.997142323310817, 9.992361422507994, 12.114759454419536, 0.7133490999999998, 175.0, 620, 159561, 217, 6.8271085000000085
218, 2.787325500029657, 10.005755649990506, 12.116435654534234, 0.7117786000000006, 315.0, 1125, 160686, 218, 12.35638419999998
219, 1.593560439413157, 10.017889724521462, 12.065166347398671, 0.7102755999999998, 120.0, 545, 161231, 219, 6.089184799999998
220, 3.1697498841484073, 10.099708257966741, 12.19640354441989, 0.7092199, 105.0, 628, 161859, 220, 6.988707399999953
221, 3.6098293952482856, 10.073339423870994, 12.222859134374293, 0.7077384999999999, 525.0, 1018, 162877, 221, 11.242290499999967
222, 3.7711361672984833, 10.075854456102526, 12.195859907074926, 0.7059565000000001, 195.0, 962, 163839, 222, 10.75204450000001
223, 2.4472939069561725, 10.031625947396847, 12.110370679711172, 0.7043643999999996, 150.0, 807, 164646, 223, 8.972058599999968
224, 3.2848222237864606, 10.024040299967716, 12.13099146391216, 0.7032960999999999, 80.0, 380, 165026, 224, 4.291357800000014
225, 3.7544045767553174, 10.104119971946433, 12.20117785923841, 0.7023223000000001, 185.0, 702, 165728, 225, 7.845242600000006
226, 4.047020036915217, 10.09064651814169, 12.228482279491725, 0.7008346000000005, 210.0, 951, 166679, 226, 10.59539929999994
227, 3.388555171086537, 10.087361026368413, 12.139322992152593, 0.6991713999999998, 305.0, 897, 167576, 227, 10.037778600000024
228, 3.7213351749149814, 10.095726971723595, 12.193503423612945, 0.6980113000000001, 50.0, 392, 167968, 228, 4.481394900000055
229, 5.725587716977139, 10.08075057997287, 12.22510650667172, 0.6969169000000003, 425.0, 824, 168792, 229, 9.329656600000021
230, 3.580385329027506, 10.07057112423494, 12.139479290355336, 0.6955021000000005, 185.0, 748, 169540, 230, 8.376253700000007
231, 4.157080775508745, 10.082340778988618, 12.188702109484266, 0.6942583000000002, 65.0, 634, 170174, 231, 7.147334099999966
232, 6.024112240435069, 10.058255467445228, 12.165884238139839, 0.6931224999999999, 155.0, 628, 170802, 232, 7.115888700000028
233, 1.9365985462451496, 10.03166673389183, 12.092089904746429, 0.6922027000000001, 55.0, 394, 171196, 233, 4.518577800000003
234, 2.8972692258070443, 10.022078011745593, 12.061653242462056, 0.6913099000000001, 145.0, 598, 171794, 234, 6.761874499999976
235, 3.6764214731049574, 10.018906064441422, 12.129139564499157, 0.6898564, 340.0, 1017, 172811, 235, 11.563817599999993
236, 5.333545357912178, 10.017763907352855, 12.126042258842535, 0.6886287999999999, 55.0, 347, 173158, 236, 3.9823238000000174
237, 4.15819425479162, 10.028946810227664, 12.104099054387547, 0.6878115999999999, 50.0, 561, 173719, 237, 6.380554800000027
238, 3.1953008442114177, 10.012979419822367, 12.086448510487875, 0.6864643000000001, 285.0, 936, 174655, 238, 10.737462800000003
239, 5.0908742216519185, 9.986551178826225, 12.103056727515327, 0.6852979000000001, 35.0, 360, 175015, 239, 4.170810099999926
240, 4.005692675755314, 10.020663263080838, 12.116810438516257, 0.6844591000000003, 70.0, 572, 175587, 240, 6.516725800000017
241, 4.8708330287755786, 10.033782086649401, 12.131993006127432, 0.6832161999999999, 355.0, 809, 176396, 241, 9.302120500000001
242, 4.902192096198984, 10.07592757615506, 12.263944252803809, 0.6818967999999997, 50.0, 657, 177053, 242, 7.543635699999982
243, 5.369387959583076, 10.066465418855293, 12.219045714292157, 0.6806781999999999, 110.0, 697, 177750, 243, 8.104473600000006
244, 3.244276712977826, 10.019549687703451, 12.128127346402735, 0.6792489999999995, 330.0, 891, 178641, 244, 10.34449440000003
245, 4.459811196133618, 10.023850883473319, 12.136658191680908, 0.6777972999999997, 170.0, 722, 179363, 245, 8.303876700000046
246, 2.1534320398564106, 10.062666855681057, 12.155824038167351, 0.6760206999999995, 300.0, 1252, 180615, 246, 14.3603078000001
247, 4.054519376832157, 10.167970636441776, 12.28371750283201, 0.6743602000000002, 105.0, 593, 181208, 247, 6.897050799999988
248, 2.471282472851693, 10.155981142392505, 12.267482882442293, 0.6729742, 305.0, 947, 182155, 248, 11.032237799999848
249, 4.600387131748526, 10.185049272481368, 12.316214810854222, 0.6712614999999998, 255.0, 956, 183111, 249, 11.100148199999921
250, 4.5236056226025445, 10.145280786320171, 12.296906874243136, 0.6695875000000001, 190.0, 904, 184015, 250, 10.585395099999914
251, 3.233648097347732, 10.155355867408744, 12.248310441669227, 0.6679485999999996, 255.0, 917, 184932, 251, 10.624533400000018
252, 6.445740116871472, 10.260505679350869, 12.640623516335433, 0.6665661999999997, 165.0, 619, 185551, 252, 7.265717499999937
253, 3.338502276702377, 10.160006310175923, 12.230637355915551, 0.6652674999999998, 195.0, 824, 186375, 253, 9.641172900000129
254, 3.034218024485316, 10.159990002528778, 12.206527930339664, 0.6640858, 20.0, 489, 186864, 254, 5.845795299999963
255, 4.171021852316589, 10.18128224843621, 12.302059201377771, 0.6631516000000002, 85.0, 549, 187413, 255, 6.4409729000001334
256, 3.246933193653385, 10.161430462364578, 12.255588814659902, 0.6614299000000005, 245.0, 1364, 188777, 256, 16.07104000000004
257, 4.908282728297984, 10.115784657830224, 12.230447965509752, 0.6598657, 35.0, 374, 189151, 257, 4.457466600000089
258, 1.7783476455499663, 10.129236993213627, 12.19252508406671, 0.6588586000000003, 160.0, 745, 189896, 258, 8.76237789999982
259, 1.7529082448790212, 10.166808705515676, 12.25504644071901, 0.6578416, 100.0, 385, 190281, 259, 4.584611199999927
260, 3.359147649942222, 10.240462802647015, 12.441353839536381, 0.6567939999999998, 200.0, 779, 191060, 260, 9.294370399999934
261, 1.7305220655681801, 10.200227467545316, 12.281627043950593, 0.6554790999999998, 115.0, 682, 191742, 261, 8.072711700000127
262, 3.3739540580109777, 10.17892403494228, 12.29550714655356, 0.6545485, 35.0, 352, 192094, 262, 4.26399860000015
263, 2.2509151633754865, 10.22061787851599, 12.384652954063668, 0.6536880999999999, 110.0, 604, 192698, 263, 7.2617159999999785
264, 5.563876423834148, 10.27803174761749, 12.557164896530605, 0.6528105999999999, 55.0, 371, 193069, 264, 4.435929100000067
265, 2.942764043998049, 10.22561820283228, 12.34674166854547, 0.6520357000000001, 105.0, 490, 193559, 265, 5.888682199999948
266, 4.719893685025276, 10.239731031220133, 12.373596578109556, 0.6510042999999998, 105.0, 656, 194215, 266, 7.904000500000166
267, 3.5836632465800013, 10.234309160358274, 12.329967315534724, 0.6497721999999997, 130.0, 713, 194928, 267, 8.57926469999984
268, 4.182099493428192, 10.226391065774207, 12.373840609660446, 0.6486543999999999, 50.0, 529, 195457, 268, 6.453938200000039
269, 5.87181048882344, 10.278267404084565, 12.57884988220789, 0.6478435, 30.0, 372, 195829, 269, 4.53042430000005
270, 2.3155211142595187, 10.195540887137682, 12.306259614249498, 0.6467157999999998, 225.0, 881, 196710, 270, 10.551018399999975
271, 3.31696536361781, 10.232933168102084, 12.362585784788442, 0.6452010999999999, 180.0, 802, 197512, 271, 9.736586799999941
272, 5.018785714847346, 10.22863397216797, 12.381540835062662, 0.6438043000000001, 160.0, 750, 198262, 272, 9.035539599999993
273, 3.3148344428489853, 10.22736968780099, 12.380586367295567, 0.6424074999999998, 205.0, 802, 199064, 273, 9.832865100000163
274, 1.755709315467533, 10.212583057283709, 12.311412646995205, 0.640855, 220.0, 923, 199987, 274, 11.204103400000122
275, 6.534217675993809, 10.643721855746788, 12.962413958937812, 0.6394474000000002, 140.0, 641, 200628, 275, 7.828881100000217
276, 2.083400574483477, 10.619188413085103, 12.878484495035112, 0.6382125999999999, 135.0, 731, 201359, 276, 8.978665200000023
277, 3.51942544998457, 10.645059468876964, 12.871812388531435, 0.6369147999999999, 215.0, 711, 202070, 277, 8.760198499999888
278, 3.6073918502945244, 10.607992155096504, 12.868976984131201, 0.6354738999999999, 405.0, 890, 202960, 278, 10.864649099999951
279, 3.268305396217461, 10.621410481730857, 12.844062771733755, 0.6339286, 90.0, 827, 203787, 279, 10.185805100000152
280, 2.839621714460225, 10.649305987315746, 12.85875874683658, 0.6326776, 35.0, 563, 204350, 280, 6.884066100000155
281, 4.144829581041187, 10.678674900213405, 12.967137850356739, 0.6315642999999999, 125.0, 674, 205024, 281, 8.384125999999924
282, 2.538317498727932, 10.632967867473564, 12.845551239381923, 0.6302304999999997, 155.0, 808, 205832, 282, 9.973055299999942
283, 1.5639811340803491, 10.576594680174251, 12.763048635688342, 0.6291441999999999, 30.0, 399, 206231, 283, 4.976785399999926
284, 1.5528020836582237, 10.602944723042574, 12.756173545664007, 0.6283891, 110.0, 440, 206671, 284, 5.436704899999995
285, 3.494696159535492, 10.629129675091304, 12.875208773586534, 0.6270193000000001, 230.0, 1082, 207753, 285, 13.343362599999864
286, 2.7036718170992007, 10.636518236658489, 12.856008035874993, 0.6254632, 135.0, 647, 208400, 286, 8.23452929999985
287, 1.5876261107014538, 10.600071460089826, 12.803339381308906, 0.6245505999999998, 80.0, 367, 208767, 287, 4.674274299999979
288, 1.6700926381061922, 10.612501203927316, 12.832102594251037, 0.6236001999999999, 360.0, 689, 209456, 288, 8.645476599999938
289, 1.5353807574764757, 10.610286709661588, 12.827343754178855, 0.6224050000000002, 100.0, 639, 210095, 289, 8.060681800000111
290, 3.002960544186386, 10.860256319064256, 13.11723037522792, 0.6213592000000002, 110.0, 523, 210618, 290, 6.548075899999958
291, 4.006722542057613, 10.84323720113484, 13.215932634776223, 0.6204376, 105.0, 501, 211119, 291, 6.304060600000184
292, 2.541938554778446, 10.844734627614457, 13.081371323328987, 0.6192873999999999, 180.0, 777, 211896, 292, 9.814789000000019
293, 2.473200139281989, 10.844066980390838, 13.09288776065364, 0.6174000999999993, 685.0, 1320, 213216, 293, 16.836999900000137
294, 1.5764162535338024, 10.811168690731652, 13.019791577274638, 0.6156136000000001, 125.0, 665, 213881, 294, 9.56706139999983
295, 2.7688713438928128, 10.841059614562989, 13.107327510070801, 0.6144525999999998, 80.0, 625, 214506, 295, 8.916660999999976
296, 1.861730884693131, 10.835404009058855, 13.075885284350115, 0.6131449, 260.0, 828, 215334, 296, 10.644215400000121
297, 2.2055949743587693, 10.860642507318287, 13.197686636164688, 0.6115662999999997, 125.0, 926, 216260, 297, 12.156465000000026
298, 2.8539675979046915, 10.855413240618946, 13.073927154641668, 0.6103917999999999, 55.0, 379, 216639, 298, 4.865235400000074
299, 2.9594060385769065, 10.843008150894676, 13.160635761096717, 0.6096744999999999, 50.0, 418, 217057, 299, 5.409408400000075
300, 2.316125987568703, 10.83845845277978, 13.085870423897234, 0.6084478, 445.0, 945, 218002, 300, 12.062243900000112
301, 1.5585021609390644, 10.820795546240985, 13.060814041504885, 0.6072607, 45.0, 374, 218376, 301, 4.783387400000038
302, 5.100446269410301, 10.890294971514722, 13.252219112551941, 0.6062184999999998, 230.0, 784, 219160, 302, 10.410948400000052
303, 1.5663357284757193, 10.819377719686273, 13.027910854039567, 0.6048720999999999, 135.0, 712, 219872, 303, 9.23887549999995
304, 1.7912510618724735, 10.805917807808022, 13.018368942441915, 0.6038902000000002, 55.0, 379, 220251, 304, 4.974569199999905
305, 2.3968514890923185, 10.811335084876236, 13.035176701448401, 0.6026671000000002, 75.0, 980, 221231, 305, 12.612205999999787
306, 1.8850420407506416, 10.82829862711381, 13.074136729517388, 0.6012118, 90.0, 637, 221868, 306, 8.163188900000023
307, 4.383062272113652, 10.866144616322295, 13.198895078309825, 0.5998078000000003, 230.0, 923, 222791, 307, 11.93749559999992
308, 3.2029998979453618, 10.81784095896615, 13.081574853261312, 0.5983291000000002, 165.0, 720, 223511, 308, 9.200506300000143
309, 6.419606128272437, 10.886863956014619, 13.190575794773247, 0.5970916000000002, 100.0, 655, 224166, 309, 8.593303200000037
310, 3.0366919107224843, 10.850875010555738, 13.161220934619642, 0.5958451000000002, 140.0, 730, 224896, 310, 9.496589699999959
311, 2.789526169018906, 10.845838620833826, 13.113883731170624, 0.5942728000000002, 225.0, 1017, 225913, 311, 13.147841900000003
312, 5.319571353337513, 10.860727312014653, 13.119035504414486, 0.5928894999999998, 135.0, 520, 226433, 312, 6.8085757000001195
313, 1.7109890202628382, 10.816862824622621, 13.027708125283532, 0.5917870000000001, 200.0, 705, 227138, 313, 9.095312199999853
314, 2.754868257001746, 10.844068471653255, 13.09745557139239, 0.5905809999999997, 185.0, 635, 227773, 314, 8.316621299999952
315, 3.422660440612923, 10.875542145270806, 13.130816914199235, 0.5893164999999997, 135.0, 770, 228543, 315, 10.100875899999892
316, 6.483561796143309, 10.873826251139167, 13.229730916205254, 0.5880339999999998, 160.0, 655, 229198, 316, 8.590346700000055
317, 5.2556489767841725, 10.870331344330053, 13.163686748202757, 0.586819, 80.0, 695, 229893, 317, 9.136605200000076
318, 2.97751155585022, 11.04984577420577, 13.331058414334757, 0.5857246000000002, 135.0, 521, 230414, 318, 6.895921499999986
319, 1.7255678586661816, 11.082835335231705, 13.337987202760518, 0.5849380000000001, 80.0, 353, 230767, 319, 4.632708500000035
320, 2.5465068411098155, 11.087950329140668, 13.373652260850518, 0.5835807999999997, 305.0, 1155, 231922, 320, 15.145772800000032
321, 2.9810973422844773, 11.113254316104864, 13.43794218057431, 0.5819617000000001, 85.0, 644, 232566, 321, 8.472734100000025
322, 3.684827222958754, 11.103090652632057, 13.419043794684454, 0.5805972999999999, 135.0, 872, 233438, 322, 11.56589329999997
323, 6.094209666281938, 11.155103639221192, 13.510043829345703, 0.57925, 120.0, 625, 234063, 323, 8.289825600000086
324, 3.0776271423699697, 11.092311015642021, 13.409835680547463, 0.5777838999999996, 265.0, 1004, 235067, 324, 13.306186499999967
325, 1.8106907313068707, 11.124340957723637, 13.382947111642489, 0.5764618, 75.0, 465, 235532, 325, 6.250046800000064
326, 3.0423416811816706, 11.112711510115755, 13.399972377708572, 0.5752917999999997, 340.0, 835, 236367, 326, 11.079303299999992
327, 3.3095499522940073, 11.084499432274022, 13.429277335647988, 0.5739300999999998, 90.0, 678, 237045, 327, 9.082403399999976
328, 4.237606548489286, 11.127625493921785, 13.460930263894236, 0.5724774999999998, 345.0, 936, 237981, 328, 12.471469500000012
329, 1.7218536161041509, 11.11348809076078, 13.367771968697056, 0.5711598999999998, 80.0, 528, 238509, 329, 7.0813863999999285
330, 4.2170591966284094, 11.143682502001356, 13.488784586171134, 0.5695605999999995, 450.0, 1249, 239758, 330, 16.74213500000019
331, 3.880560428068653, 11.241460879894461, 13.573839177092543, 0.5678659000000003, 190.0, 634, 240392, 331, 8.598383099999864
332, 4.885301061465198, 11.276317945585845, 13.634700755888794, 0.5662702, 510.0, 1139, 241531, 332, 15.332594900000004
333, 3.122527225750293, 11.307586457636868, 13.611562585750278, 0.5647114000000001, 100.0, 593, 242124, 333, 7.951959199999919
334, 3.593596299990966, 11.261043340694613, 13.643649832504552, 0.5635873, 185.0, 656, 242780, 334, 8.993147700000009
335, 2.5610598119683274, 11.268700537242117, 13.57911129802799, 0.561952, 600.0, 1161, 243941, 335, 15.67057839999984
336, 3.4547914288130808, 11.256225401625626, 13.583622889148717, 0.5602924, 170.0, 683, 244624, 336, 9.336625799999865
337, 3.126495831219169, 11.237019116679827, 13.57829019924005, 0.5589865, 150.0, 768, 245392, 337, 10.491719000000103
338, 4.069819309260516, 11.308126720689959, 13.712221805126436, 0.5578489000000001, 95.0, 496, 245888, 338, 6.82775730000003
339, 3.6237767254253703, 11.247463836367167, 13.624546759469169, 0.5568354999999998, 290.0, 630, 246518, 339, 8.747995599999967
340, 2.5378062462552347, 11.257305068912103, 13.600064992184365, 0.5556726999999999, 100.0, 662, 247180, 340, 9.09808320000002
341, 2.6342264439876155, 11.277002602447698, 13.591161276087348, 0.5544937000000001, 155.0, 648, 247828, 341, 8.892078800000036
342, 1.7005201938683083, 11.301286384778441, 13.602245016760696, 0.5533146999999999, 90.0, 662, 248490, 342, 9.020079200000055
343, 1.6211740201295808, 11.281053787054018, 13.630074459452961, 0.5524093, 25.0, 344, 248834, 343, 4.780334699999912
344, 4.226692874905725, 11.274829285857457, 13.623853334012074, 0.5511934000000002, 370.0, 1007, 249841, 344, 13.8761535000001
345, 6.4307752284914885, 11.359370421493669, 13.799353844489008, 0.5496948999999999, 95.0, 658, 250499, 345, 9.074508999999807
346, 4.258509749423008, 11.361417122217484, 13.74525106452072, 0.5478552999999998, 300.0, 1386, 251885, 346, 19.313524800000096
347, 4.176661461061699, 11.37238677536569, 13.864411538209373, 0.5461651, 75.0, 492, 252377, 347, 6.778602000000092
348, 2.99925180500276, 11.361118494746197, 13.688221797406912, 0.5448259000000001, 200.0, 996, 253373, 348, 13.862014199999976
349, 2.1384513334530943, 11.326880095529804, 13.655475412332413, 0.5428908999999998, 315.0, 1154, 254527, 349, 15.947940200000176
350, 7.868991540587696, 11.387000835155282, 13.884936081478967, 0.5415003999999999, 30.0, 391, 254918, 350, 5.4700652999999875
351, 4.897570149058184, 11.35869899931408, 13.763704399835495, 0.5404869999999998, 160.0, 735, 255653, 351, 10.287109899999905
352, 2.9622529820817243, 11.318724883686412, 13.69170926577085, 0.5391324999999999, 115.0, 770, 256423, 352, 10.881159300000036
353, 1.524417023750564, 11.315033126868363, 13.636572425114787, 0.5380714, 75.0, 409, 256832, 353, 5.735394699999915
354, 4.4927924714034555, 11.348832677517619, 13.729027284043175, 0.5373000999999997, 40.0, 448, 257280, 354, 6.28288079999993
355, 2.8905266859476755, 11.347656338179677, 13.718048158688608, 0.5357385999999994, 220.0, 1287, 258567, 355, 18.12349610000001
356, 1.6345513449063314, 11.328629577783841, 13.638312458006803, 0.5342536, 75.0, 363, 258930, 356, 5.1044378999999935
357, 1.5815199663556074, 11.360379972337167, 13.674624158159087, 0.5335713999999999, 30.0, 395, 259325, 357, 5.618103799999972
358, 3.8324250826930126, 11.430703777884773, 13.83548053936399, 0.5324410000000002, 375.0, 861, 260186, 358, 12.279754099999991
359, 5.480647568320555, 11.735342624465526, 14.217298498224679, 0.5309407000000002, 75.0, 806, 260992, 359, 11.373282499999732
360, 2.058370163621889, 11.628982251340693, 13.99974379854754, 0.5293441000000001, 260.0, 968, 261960, 360, 13.720018500000151
361, 3.0314050558058017, 11.689859146485354, 14.141486387201809, 0.5276313999999998, 85.0, 935, 262895, 361, 13.25017059999982
362, 4.915485159069059, 11.72656695133584, 14.245392563205067, 0.5261211999999998, 260.0, 743, 263638, 362, 10.621348900000157
363, 4.688319620005425, 11.696532479999135, 14.13417707554345, 0.5245254999999999, 350.0, 1030, 264668, 363, 14.687206199999764
364, 4.586371556208356, 11.669865361074121, 14.125037213651146, 0.5230081, 70.0, 656, 265324, 364, 9.432836299999963
365, 3.2851690211039233, 11.706701428011844, 14.116097583268818, 0.5217336999999996, 305.0, 760, 266084, 365, 10.838936799999829
366, 6.309832164718176, 11.747177871347171, 14.240797805507281, 0.5204340999999997, 120.0, 684, 266768, 366, 9.855534899999839
367, 3.244804361800207, 11.716308499703878, 14.141435545444876, 0.5187141999999997, 435.0, 1227, 267995, 367, 17.551728199999616
368, 2.761697344151333, 11.678349810810362, 14.09161109289541, 0.5170420000000001, 125.0, 631, 268626, 368, 9.686796800000138
369, 8.618978989820075, 11.76227338431662, 14.320204794674176, 0.5160726999999998, 55.0, 446, 269072, 369, 6.951867599999787
370, 6.040685175769031, 11.743247907161713, 14.238500955104827, 0.5153113000000001, 55.0, 400, 269472, 370, 5.857267099999717
371, 3.210179126289274, 11.756233903574826, 14.219684746465072, 0.5142205000000002, 180.0, 812, 270284, 371, 11.719102900000053
372, 6.244924805467204, 11.8008202959429, 14.263861823948117, 0.5130190000000001, 105.0, 523, 270807, 372, 7.9725329999996575
373, 4.568496525381939, 11.818710392034507, 14.340749238110796, 0.5119794999999998, 185.0, 632, 271439, 373, 9.438092099999722
374, 2.1228844567313434, 11.767237967167175, 14.179414465324731, 0.5104701999999998, 215.0, 1045, 272484, 374, 14.968192499999986
375, 3.2733447952268953, 11.794205483817557, 14.26609689822085, 0.5088403000000002, 185.0, 766, 273250, 375, 10.951132099999995
376, 3.04151487399206, 11.775219810343234, 14.274336005297034, 0.5075730999999999, 110.0, 642, 273892, 376, 9.33871790000012
377, 3.601129269098035, 11.728022343582577, 14.198077526357439, 0.5064768999999999, 55.0, 576, 274468, 377, 8.310324300000048
378, 4.419919195736563, 11.781020797315493, 14.343670757796414, 0.505378, 135.0, 645, 275113, 378, 9.356614100000115
379, 4.736213834435285, 11.768963850417487, 14.258789792925226, 0.5040478, 145.0, 833, 275946, 379, 12.11721979999993
380, 5.315261454007455, 11.814171685718355, 14.329991745721726, 0.5028256, 70.0, 525, 276471, 380, 7.584323200000199
381, 4.910067657062971, 11.799349610767667, 14.25795643544071, 0.5016727000000001, 245.0, 756, 277227, 381, 12.709162799999831
382, 2.2076735764193587, 11.758005219001275, 14.181955397799934, 0.4999528000000001, 720.0, 1155, 278382, 382, 18.812114199999996
383, 5.202712448089675, 11.831737698661565, 14.356460007008987, 0.4982850999999999, 160.0, 698, 279080, 383, 10.285050400000273
384, 2.97409516454274, 11.786103326867517, 14.233659894626033, 0.49682349999999986, 445.0, 926, 280006, 384, 13.654073200000312
385, 5.816939448672864, 12.053048133850098, 14.559161737230088, 0.49558510000000006, 95.0, 450, 280456, 385, 6.396433299999899
386, 2.5434832194180466, 11.978843687528586, 14.443336274250445, 0.4945825000000002, 55.0, 664, 281120, 386, 9.577187000000322
387, 4.742372575260344, 12.034628609965619, 14.546252653413548, 0.4932667000000001, 320.0, 798, 281918, 387, 11.450050500000089
388, 4.7120481214029875, 12.038667540035338, 14.537067093946192, 0.4919734000000003, 165.0, 639, 282557, 388, 9.104249499999696
389, 2.4959677874958364, 11.991508627004745, 14.510002673926227, 0.49075659999999977, 140.0, 713, 283270, 389, 10.27949129999979
390, 3.6047314192792346, 12.043105548866137, 14.54229704476527, 0.48919870000000004, 205.0, 1018, 284288, 390, 14.618134800000007
391, 2.6146278951630966, 12.047100506829533, 14.561343388640823, 0.48771640000000016, 130.0, 629, 284917, 391, 9.16366569999991
392, 3.053640236180527, 11.936414901456684, 14.428252578399341, 0.4868028999999998, 85.0, 386, 285303, 392, 5.651690700000017
393, 1.5344896951480207, 12.002475163178147, 14.457562365610487, 0.48574539999999994, 170.0, 789, 286092, 393, 11.377707799999826
394, 2.18862821457492, 12.00857158479442, 14.488465971206889, 0.4842405999999998, 205.0, 883, 286975, 394, 12.849507399999766
395, 3.896640546777616, 12.010301785122964, 14.550008251782387, 0.4825530999999998, 465.0, 992, 287967, 395, 14.366514900000311
396, 3.7589035554508854, 12.038095674282166, 14.540272863124445, 0.48110679999999967, 65.0, 615, 288582, 396, 8.995516099999804
397, 4.5096901730622285, 12.054752168737256, 14.638927759530718, 0.4797144999999999, 210.0, 932, 289514, 397, 13.612230199999885
398, 3.647945409199057, 12.048086779777993, 14.543369467829315, 0.4781088999999998, 165.0, 852, 290366, 398, 12.336664800000108
399, 4.374009035191548, 12.184286008925127, 14.790422783800835, 0.4767336999999997, 200.0, 676, 291042, 399, 9.932107200000246
400, 3.580455230916152, 12.17642857651446, 14.703307780397012, 0.4752486999999999, 230.0, 974, 292016, 400, 14.348317500000121
401, 1.826405825604197, 12.18076141389123, 14.64521254330791, 0.47404719999999984, 75.0, 361, 292377, 401, 5.693231499999911
402, 1.6069483272231264, 12.121129008214213, 14.625822500361158, 0.4733200000000001, 90.0, 447, 292824, 402, 7.0286535000000185
403, 3.8178119853552395, 12.15943324760462, 14.720585892587025, 0.47209060000000014, 220.0, 919, 293743, 403, 14.447848400000112
404, 4.071148699266719, 12.20563515368756, 14.781898783398914, 0.4703626, 135.0, 1001, 294744, 404, 15.617367800000011
405, 4.2979405840739, 12.183866210848267, 14.76585725036978, 0.4688461, 185.0, 684, 295428, 405, 10.762756000000081
406, 3.1146284133301454, 12.205403131029383, 14.744057759582272, 0.4677858999999999, 80.0, 494, 295922, 406, 7.886048800000026
407, 2.771476708264567, 12.167584802222065, 14.701125077375277, 0.4668840999999999, 125.0, 508, 296430, 407, 8.1671809999998
408, 2.475590003819405, 12.133414489810477, 14.662676263962114, 0.4657869999999999, 155.0, 711, 297141, 408, 11.235962900000231
409, 3.1270578273047462, 12.161358514574967, 14.676459580382081, 0.46447119999999986, 115.0, 751, 297892, 409, 11.94734550000021
410, 3.4745571977705105, 12.164412646458066, 14.761822788194678, 0.46348209999999984, 45.0, 348, 298240, 410, 5.5432872000001225
411, 1.4701405489226667, 12.112040006435983, 14.572020445412736, 0.4626153999999999, 110.0, 615, 298855, 411, 9.67546829999992
412, 2.6954962462186813, 12.163359662859301, 14.728319049447578, 0.46111420000000003, 210.0, 1053, 299908, 412, 16.640088500000275
413, 5.230869230539418, 12.95207449904827, 15.625273443566352, 0.4595383000000002, 140.0, 698, 300606, 413, 11.165650399999777
414, 2.9914346428618237, 13.064321013785698, 15.759267963718724, 0.45807760000000014, 415.0, 925, 301531, 414, 14.897444899999755
415, 3.394342178764311, 13.04975463334635, 15.756503744805528, 0.4566520000000001, 130.0, 659, 302190, 415, 10.535794200000055
416, 3.307556538813554, 13.073733072267943, 15.801229294475416, 0.4553956000000002, 145.0, 737, 302927, 416, 11.959515600000032
417, 2.9724234669812284, 13.063234606431893, 15.764607792407011, 0.45341020000000043, 525.0, 1469, 304396, 417, 23.422841000000062
418, 2.5739140880785967, 13.06261871771866, 15.733768807368332, 0.4514472999999997, 135.0, 712, 305108, 418, 11.613070700000208
419, 4.900801193573948, 13.109893471771379, 16.03664394141329, 0.4502133999999997, 135.0, 659, 305767, 419, 10.629917300000216
420, 4.7102069235797295, 13.075678532950123, 15.822618815120082, 0.4489011999999998, 180.0, 799, 306566, 420, 12.87973729999976
421, 4.544330982124324, 13.121822727427762, 15.863384329571444, 0.44757009999999997, 120.0, 680, 307246, 421, 11.120721300000241
422, 3.448497951150398, 13.046082993459436, 15.745707457292013, 0.4463137, 105.0, 716, 307962, 422, 11.66571870000007
423, 3.5302037327483142, 13.078549652984462, 15.839560513643875, 0.44532009999999983, 110.0, 388, 308350, 423, 6.352937399999973
424, 2.75009580477724, 13.088689737230817, 15.811091414121824, 0.4440079000000001, 360.0, 1070, 309420, 424, 17.466470299999855
425, 6.78816503287277, 13.234619569426965, 16.033255245527414, 0.4423123, 195.0, 814, 310234, 425, 13.359293400000297
426, 1.493994808501232, 13.407445597401127, 16.143934327425843, 0.4410594999999999, 135.0, 578, 310812, 426, 9.506372400000146
427, 6.7362933879178195, 13.475443781004666, 16.272266872542687, 0.4399867, 80.0, 614, 311426, 427, 10.074953700000151
428, 3.7553120000929265, 13.4671240094209, 16.238773479188893, 0.438616, 410.0, 909, 312335, 428, 14.950216400000045
429, 3.8344978378112833, 13.48337320507954, 16.297191130286233, 0.4372929999999999, 115.0, 561, 312896, 429, 9.167930200000228
430, 4.247329012885346, 13.493695186263203, 16.33485556335889, 0.43616349999999976, 170.0, 694, 313590, 430, 11.460907099999986
431, 3.873142999331773, 13.457447487072352, 16.218075666984504, 0.43504570000000004, 80.0, 548, 314138, 431, 9.140139399999953
432, 3.58539725547639, 13.44356983101628, 16.224470148452966, 0.43368579999999995, 270.0, 963, 315101, 432, 15.7700605
433, 3.1041973135437404, 13.482074791850568, 16.308556891336135, 0.4315545999999999, 170.0, 1405, 316506, 433, 22.905349399999977
434, 4.517055354290038, 13.464075115380185, 16.309011892643426, 0.4294917999999999, 460.0, 887, 317393, 434, 14.617417999999816
435, 5.862110513181259, 13.483363723754882, 16.332170669033996, 0.428167, 105.0, 585, 317978, 435, 9.749443700000029
436, 5.029847321871628, 13.455238411503453, 16.260294619426933, 0.4273057, 60.0, 372, 318350, 436, 6.245367600000009
437, 4.246163880346077, 13.467649304136938, 16.286219441160863, 0.4265299000000001, 70.0, 490, 318840, 437, 8.186255099999926
438, 2.775319770564008, 13.468530926755838, 16.209008310902835, 0.42550479999999996, 155.0, 649, 319489, 438, 10.80116500000031
439, 2.30036821611673, 13.537589089699761, 16.338198308305984, 0.42414130000000017, 265.0, 866, 320355, 439, 14.434819099999913
440, 1.8388309811188537, 13.758325341907023, 16.593277771255266, 0.42293799999999987, 115.0, 471, 320826, 440, 7.881069199999729
441, 4.923675069719508, 13.804892494704054, 16.790275988498472, 0.4219263999999998, 140.0, 653, 321479, 441, 10.876093299999866
442, 3.366619629610943, 13.763848565499995, 16.623142054111142, 0.4209832, 110.0, 395, 321874, 442, 6.585541100000228
443, 2.124524557062903, 13.686539810799264, 16.508448654381006, 0.4197951999999999, 245.0, 925, 322799, 443, 15.437947200000053
444, 6.88934447572038, 13.785712878768509, 16.675752067565917, 0.41862969999999994, 50.0, 370, 323169, 444, 6.196081399999912
445, 3.288713982123461, 13.754401294358699, 16.609518851575306, 0.417619, 310.0, 753, 323922, 445, 12.500145099999827
446, 2.6579555421953196, 13.696195920308432, 16.50839218895556, 0.4163553999999998, 205.0, 651, 324573, 446, 10.883704800000032
447, 4.335830691381026, 13.73615185082969, 16.667147535388754, 0.41491989999999984, 285.0, 944, 325517, 447, 15.769758100000217
448, 6.06421421065224, 13.69961722258007, 16.611631299958336, 0.41334490000000007, 340.0, 806, 326323, 448, 13.326781399999618
449, 3.962958164630929, 13.73301344894501, 16.67793578124908, 0.41202189999999994, 100.0, 664, 326987, 449, 11.12343009999995
450, 3.250854886136949, 13.744232186564693, 16.638525076013394, 0.4107438999999999, 100.0, 756, 327743, 450, 12.7200684000004
451, 5.286125716675807, 13.738374724005261, 16.631940971151757, 0.4094469999999998, 210.0, 685, 328428, 451, 11.447632400000202
452, 3.5598732617086806, 13.765672741453931, 16.626604431606285, 0.40796829999999995, 250.0, 958, 329386, 452, 16.008323999999902
453, 4.621748533819305, 13.867022666602928, 16.727699606186118, 0.40616470000000005, 280.0, 1046, 330432, 453, 17.484746200000245
454, 2.853471349007538, 13.956142905973039, 16.833801993783915, 0.40426929999999994, 505.0, 1060, 331492, 454, 17.723187799999778
455, 7.135377152619013, 14.022593649181388, 17.00331207986414, 0.4027069, 110.0, 676, 332168, 455, 11.379201400000056
456, 2.454065710463258, 13.887592456426965, 16.741761479033045, 0.4015009, 75.0, 664, 332832, 456, 11.064957699999923
457, 7.409216694733751, 13.98633263746613, 17.006897653364753, 0.4004001999999999, 25.0, 559, 333391, 457, 9.367284500000096
458, 3.709669027630597, 13.961399974888318, 16.846601386592813, 0.3993715, 125.0, 584, 333975, 458, 9.81410519999963
459, 5.726794043999075, 13.973249857684216, 16.892041871346624, 0.39765069999999997, 635.0, 1328, 335303, 459, 22.29148010000017
460, 2.5822396017395066, 13.940328649161518, 16.823642291193423, 0.3958344999999999, 190.0, 690, 335993, 460, 11.617976799999724
461, 2.7996607657843904, 13.994511318795475, 16.882830789059767, 0.3946303, 185.0, 648, 336641, 461, 10.896741200000179
462, 2.6705949023456834, 13.960572175863312, 16.795750673224287, 0.3934567, 175.0, 656, 337297, 462, 11.002783999999792
463, 3.622055014125376, 13.97655531921862, 16.869593159803348, 0.3922885, 80.0, 642, 337939, 463, 10.795886299999893
464, 3.612263073851018, 13.934796043233009, 16.805359968455132, 0.39082600000000023, 250.0, 983, 338922, 464, 16.538646599999993
465, 5.100047198211432, 14.002085925041513, 16.925407557898247, 0.3894607000000001, 65.0, 534, 339456, 465, 9.015427499999987
466, 1.5949963537831808, 13.962822166902699, 16.799008505517413, 0.3882483999999997, 170.0, 813, 340269, 466, 13.651025699999991
467, 3.135207270028183, 14.002480593834134, 16.891929533731872, 0.3858877000000002, 945.0, 1810, 342079, 467, 30.37041450000015
468, 3.5846625117570396, 13.981366839371328, 16.86125463951291, 0.3836872, 90.0, 635, 342714, 468, 10.70873180000035
469, 1.8352886193117577, 14.018106680742022, 16.875414157900934, 0.3823984000000001, 285.0, 797, 343511, 469, 13.436192200000278
470, 3.916601251411651, 14.039810327851043, 16.972352560685607, 0.3809755000000002, 240.0, 784, 344295, 470, 13.267597799999749
471, 6.276326576634818, 14.063313264661485, 17.00333171753249, 0.37966779999999994, 145.0, 669, 344964, 471, 11.263466100000187
472, 5.017445438278791, 14.017000225262764, 16.966022926721816, 0.37871469999999985, 80.0, 390, 345354, 472, 6.58867999999984
473, 3.7835863594796932, 14.009564032332664, 16.901759617592703, 0.3778029999999999, 150.0, 623, 345977, 473, 10.525952899999993
474, 4.489190588997149, 14.003364396247783, 16.961868286132812, 0.3763981, 65.0, 938, 346915, 474, 15.942831399999704
475, 2.8484494817382267, 13.990287030300248, 16.85831405603997, 0.37507239999999986, 95.0, 535, 347450, 475, 9.093144200000097
476, 4.811488677476923, 14.010050030175096, 16.939627379835965, 0.3736927000000001, 255.0, 998, 348448, 476, 16.820114500000273
477, 5.867274436934126, 14.060117853760088, 17.013891497617045, 0.37194399999999994, 245.0, 945, 349393, 477, 15.921493299999838
478, 2.6956199285824125, 13.959367691598288, 16.830247390560988, 0.37054000000000004, 65.0, 615, 350008, 478, 10.531273300000066
479, 2.675231889430778, 14.223233804933377, 17.135925911568307, 0.3693537999999999, 195.0, 703, 350711, 479, 11.932194499999696
480, 2.924314505545579, 14.260996610406046, 17.21728048000438, 0.36821800000000005, 185.0, 559, 351270, 480, 9.48445079999965
481, 4.0368608787587235, 14.25877928666285, 17.23147775363652, 0.3664441, 335.0, 1412, 352682, 481, 23.92659840000033
482, 5.801658219385912, 14.299785043849027, 17.321282329661322, 0.3643317999999998, 230.0, 935, 353617, 482, 15.98399930000005
483, 6.407477411993065, 14.314710644842352, 17.441118726452576, 0.36311949999999993, 50.0, 412, 354029, 483, 7.028048599999693
484, 4.9978317859137915, 14.28465298575324, 17.28304151414751, 0.36174969999999973, 550.0, 1110, 355139, 484, 18.87459220000028
485, 2.723111159615396, 14.241729373599384, 17.174685990564797, 0.3601827999999999, 95.0, 631, 355770, 485, 10.794436700000006
486, 5.505676939936549, 14.284937928179076, 17.31758384967932, 0.3591586, 145.0, 507, 356277, 486, 8.733202500000061
487, 2.1910487671565977, 14.26472053802024, 17.206951402696745, 0.3577005999999998, 265.0, 1113, 357390, 487, 19.7456416
488, 2.9800873895582645, 14.306223584147332, 17.254652299232852, 0.3562353999999999, 55.0, 515, 357905, 488, 10.297575300000062
489, 3.0474843513942504, 14.24517190327016, 17.268047456963117, 0.35519139999999993, 160.0, 645, 358550, 489, 12.518247900000006
490, 4.467203934490681, 14.274003391164952, 17.27667366613156, 0.3537604, 275.0, 945, 359495, 490, 18.79057469999998
491, 3.532932781037052, 14.306100783989443, 17.248154396202132, 0.3522943, 125.0, 684, 360179, 491, 14.568882700000358
492, 2.631784421804104, 14.284672461057964, 17.213107200598937, 0.35109729999999995, 70.0, 646, 360825, 492, 11.853327199999967
493, 4.121408824064539, 14.368750560238789, 17.352233695265937, 0.34979860000000007, 155.0, 797, 361622, 493, 16.349324100000103
494, 4.561728203539238, 14.319416243636596, 17.31858012578548, 0.34826859999999993, 195.0, 903, 362525, 494, 18.79162260000021
495, 5.027198794379739, 14.340903354375854, 17.31619009212165, 0.3464217999999998, 520.0, 1149, 363674, 495, 23.253166899999997
496, 4.044299424854107, 14.296278277635574, 17.268573924303055, 0.3446676999999998, 185.0, 800, 364474, 496, 17.505616100000225
497, 5.622379285555023, 14.338670586546263, 17.328091093649466, 0.3432564999999999, 155.0, 768, 365242, 497, 16.155091199999788
498, 5.359239821996921, 14.324818033871688, 17.329687960504547, 0.3416509000000001, 545.0, 1016, 366258, 498, 18.721720500000174
499, 6.669640605078654, 14.341723464325094, 17.36123857898623, 0.3401578, 105.0, 643, 366901, 499, 12.229892599999857
500, 3.582281156101401, 14.316631679428356, 17.26860535477793, 0.33861250000000004, 245.0, 1074, 367975, 500, 20.86085439999988
501, 2.880278115731336, 14.27974484560518, 17.176176540465224, 0.33719049999999995, 125.0, 506, 368481, 501, 9.642409000000043
502, 4.694699420896757, 14.328634074868264, 17.333563504325856, 0.3360519999999999, 110.0, 759, 369240, 502, 15.243993800000226
503, 3.6539621663072346, 14.36204082531701, 17.33301915957508, 0.33448420000000006, 365.0, 983, 370223, 503, 20.394948600000134
504, 3.4820084628416437, 14.479190314241428, 17.487153493038363, 0.3326157999999999, 320.0, 1093, 371316, 504, 23.75061800000003
505, 2.677900384425178, 14.421592210033747, 17.361230919304795, 0.3304891, 270.0, 1270, 372586, 505, 28.286578400000053
506, 4.548259345710779, 14.515734693605442, 17.52674052742879, 0.32849019999999995, 315.0, 951, 373537, 506, 21.086344899999858
507, 3.440738133674643, 14.434264307436736, 17.45183563344487, 0.32686839999999995, 450.0, 851, 374388, 507, 18.72790789999999
508, 3.8693627030316597, 14.449405574639373, 17.479240338670987, 0.3250242999999999, 395.0, 1198, 375586, 508, 25.55515060000016
509, 7.694324463630349, 14.510715822868159, 17.623109011031527, 0.3233979999999999, 150.0, 609, 376195, 509, 12.769195400000172
510, 2.0724634628763403, 14.478182263426728, 17.42744144764575, 0.32252230000000004, 65.0, 364, 376559, 510, 7.4501986000000215
511, 5.200916121600482, 14.505917990649188, 17.48609766127571, 0.3218545, 60.0, 378, 376937, 511, 7.884222900000168
512, 5.230841577695661, 14.499487640140774, 17.546121781800455, 0.32074210000000003, 335.0, 858, 377795, 512, 17.95319019999988
513, 2.4311936659410756, 14.41589378888379, 17.417058001161326, 0.3192075999999999, 235.0, 847, 378642, 513, 17.438663500000075
514, 3.8684688832808214, 14.515525822607886, 17.5298004576702, 0.31790169999999995, 125.0, 604, 379246, 514, 12.93305810000038
515, 4.325558011195476, 14.758472913842237, 17.91585113713468, 0.3165183999999999, 230.0, 933, 380179, 515, 19.688599699999486
516, 5.3762335578191065, 16.064533362217485, 19.442130711330705, 0.31475080000000005, 220.0, 1031, 381210, 516, 21.69848229999934
517, 3.5429723246794924, 16.05573549341623, 19.319690881828517, 0.3130975, 190.0, 806, 382016, 517, 17.30427950000012
518, 3.6204977136082643, 16.081912397820467, 19.3889615914803, 0.31133619999999984, 720.0, 1151, 383167, 518, 26.393901999999798
519, 5.952280054034063, 16.108612436552164, 19.510758773366558, 0.30964059999999993, 230.0, 733, 383900, 519, 17.212022599999727
520, 4.386875820563529, 16.048230419401737, 19.414905070584094, 0.3083445999999999, 135.0, 707, 384607, 520, 16.41640179999922
521, 4.486797257196047, 16.082218987927465, 19.45057600558161, 0.3069568, 235.0, 835, 385442, 521, 18.992183600000317
522, 3.424909294363278, 16.056193958111663, 19.364061664941893, 0.3053008, 430.0, 1005, 386447, 522, 22.88462139999956
523, 1.9644779560618515, 16.035458393829476, 19.294772979714622, 0.30376359999999997, 135.0, 703, 387150, 523, 16.019606400000157
524, 3.0479760853140943, 16.025940032920452, 19.337077786224057, 0.30277449999999995, 80.0, 396, 387546, 524, 9.547774200000276
525, 2.0097295620269846, 16.052596803144976, 19.357985416759146, 0.3016756, 190.0, 825, 388371, 525, 19.11940130000039
526, 6.073298243957537, 16.11891548368666, 19.49859539597123, 0.2997180999999999, 430.0, 1350, 389721, 526, 31.664834500000325
527, 4.218575662084832, 16.254890547038507, 19.633375488812504, 0.29803779999999996, 105.0, 517, 390238, 527, 11.72662229999969
528, 3.2957065139918265, 16.472915047580756, 19.84520744685859, 0.2967382, 400.0, 927, 391165, 528, 21.484663000000182
529, 3.677223473476081, 16.505847951430308, 19.925879065598114, 0.2951928999999999, 235.0, 790, 391955, 529, 19.895156999999926
530, 4.506536043188714, 16.51096243044225, 19.946781002935218, 0.29319039999999985, 350.0, 1435, 393390, 530, 33.46061980000013
531, 3.3843600320395515, 16.46698095988642, 19.864367624294538, 0.29116539999999996, 210.0, 815, 394205, 531, 19.236440100000436
532, 2.4228614605201617, 16.44737119462755, 19.82582830980089, 0.28941940000000005, 290.0, 1125, 395330, 532, 26.82400080000025
533, 5.587413357619488, 16.568625997009892, 20.06884958278725, 0.28795959999999987, 40.0, 497, 395827, 533, 11.535696400000234
534, 1.9972495623303586, 16.46131151588402, 19.820204784621055, 0.28678869999999995, 365.0, 804, 396631, 534, 19.119676999999683
535, 3.290030742508638, 16.476318096254147, 19.8898217175698, 0.285292, 190.0, 859, 397490, 535, 20.16231990000051
536, 2.863708447357492, 16.451541388980925, 19.85432941800072, 0.2839519, 140.0, 630, 398120, 536, 14.684605999999803
537, 4.52360929746094, 16.50359644161616, 19.967055831724863, 0.2823418, 350.0, 1159, 399279, 537, 27.425858399999925
538, 2.523135765946402, 16.589332957202302, 19.988710828416576, 0.28044639999999993, 460.0, 947, 400226, 538, 23.01843689999987
539, 3.274686890737255, 16.742880052203525, 20.190269715715164, 0.27877599999999997, 290.0, 909, 401135, 539, 21.233908599999268
540, 3.8417935133460306, 16.76896664609685, 20.229296402354187, 0.2764629999999999, 730.0, 1661, 402796, 540, 38.652672999999595
541, 4.008130349634165, 16.806765342080915, 20.289977547284717, 0.27443529999999977, 110.0, 592, 403388, 541, 13.76308760000029
542, 5.888185172694291, 16.844228655167964, 20.387778473190924, 0.27272080000000015, 350.0, 1313, 404701, 542, 30.3919949000001
543, 3.1951381280049076, 16.730311634094736, 20.169447522822434, 0.2710963, 140.0, 492, 405193, 543, 11.572030799999993
544, 4.802090640806476, 16.777069591414108, 20.246733326467908, 0.26954199999999995, 420.0, 1235, 406428, 544, 28.714604699999654
545, 5.579689992667869, 16.90398581606166, 20.458610331979695, 0.2681001999999999, 70.0, 367, 406795, 545, 8.656025299999783
546, 1.7565559907024408, 16.679889363226167, 20.079230180943632, 0.26737299999999997, 110.0, 441, 407236, 546, 10.834383200000048
547, 3.494581652769944, 16.77630242546331, 20.220871222819394, 0.26593029999999995, 160.0, 1162, 408398, 547, 27.116373400000157
548, 4.470160273018988, 16.818720883749002, 20.32384433554965, 0.2638080999999999, 445.0, 1196, 409594, 548, 28.010900799999945
549, 5.269248015921475, 16.95445396041228, 20.415355203930375, 0.26166250000000013, 340.0, 1188, 410782, 549, 27.799482800000078
550, 1.8452613651965346, 16.913994658333916, 20.346106452941896, 0.26027829999999996, 15.0, 350, 411132, 550, 8.217244400000709
551, 1.842699701680637, 16.927101488964098, 20.382043134065487, 0.25938819999999996, 95.0, 639, 411771, 551, 14.950315600000067
552, 4.008733287486692, 16.939301043550614, 20.451195262223813, 0.2580013, 320.0, 902, 412673, 552, 21.15041089999977
553, 2.013188268806885, 16.894536709898457, 20.33239820218199, 0.2566198, 150.0, 633, 413306, 553, 15.955721000000267
554, 2.0629986839551004, 16.957898701043952, 20.458783346907538, 0.2555712999999999, 90.0, 532, 413838, 554, 12.519478799999888
555, 1.716713693829622, 16.923354630801768, 20.37901595314556, 0.2547558999999999, 105.0, 374, 414212, 555, 8.803003400000307
556, 2.0625844827180755, 16.93036029370911, 20.387189706879347, 0.25401789999999996, 110.0, 446, 414658, 556, 10.46065709999948
557, 5.4980330804697335, 16.97395147721077, 20.51643624561955, 0.25292979999999987, 215.0, 763, 415421, 557, 16.294091499999922
558, 5.360869434804505, 16.989687336584367, 20.522612398888867, 0.25141869999999994, 330.0, 916, 416337, 558, 17.045778800000335
559, 3.8523037073268016, 16.980876903802578, 20.472883976681132, 0.2502747999999999, 75.0, 355, 416692, 559, 6.478050499999881
560, 4.1167220664654485, 16.929249628784337, 20.402667110053052, 0.2489167, 355.0, 1154, 417846, 560, 21.453659300000254
561, 3.3676028911942155, 16.97560763704604, 20.439783907167, 0.2471328999999999, 145.0, 828, 418674, 561, 15.212474799999654
562, 6.617489765033656, 17.019239362634952, 20.538342892128053, 0.24514839999999988, 380.0, 1377, 420051, 562, 26.089165200000025
563, 6.228110339929971, 17.102182948192738, 20.706354333463246, 0.24298930000000002, 410.0, 1022, 421073, 563, 19.133278900000732
564, 5.993708283612703, 17.066718495145757, 20.588083640565262, 0.24122349999999995, 305.0, 940, 422013, 564, 17.403368899999805
565, 4.721579854353331, 17.124202986061572, 20.612549343705176, 0.2398015, 200.0, 640, 422653, 565, 11.90025500000047
566, 5.039798996134384, 17.11824313454006, 20.64954027922257, 0.23845960000000005, 180.0, 851, 423504, 566, 15.803344499999184
567, 5.250795306796406, 17.081073895921097, 20.638705872474834, 0.23684769999999994, 260.0, 940, 424444, 567, 17.535979500000394
568, 4.11020236161229, 17.101272274655063, 20.649256546805407, 0.2345319999999999, 755.0, 1633, 426077, 568, 32.08281950000037
569, 4.3298832167592955, 17.13139331235561, 20.659814507483233, 0.2323485999999999, 95.0, 793, 426870, 569, 16.051866800000425
570, 4.309291140551712, 17.12173682400991, 20.65646888835836, 0.23110119999999987, 65.0, 593, 427463, 570, 11.997984100000394
571, 2.8577766951305774, 17.103872275848577, 20.655580165774325, 0.22983219999999993, 290.0, 817, 428280, 571, 16.507276100000126
572, 4.063662663809095, 17.121246821809525, 20.671916026880247, 0.22800610000000002, 275.0, 1212, 429492, 572, 24.556465099999514
573, 3.3851822824562756, 16.95147525928819, 20.46254704858336, 0.22550769999999992, 510.0, 1564, 431056, 573, 31.715847000000394
574, 4.107259915191555, 16.96452140968118, 20.512605878330717, 0.22356369999999995, 120.0, 596, 431652, 574, 12.232213199999933
575, 4.944073656855045, 16.84445064172805, 20.436787266401375, 0.22245490000000004, 140.0, 636, 432288, 575, 13.228436800000054
576, 3.659106165505946, 16.880618394504893, 20.36648785677823, 0.2208924999999999, 410.0, 1100, 433388, 576, 22.558029599999827
577, 3.2863074275953448, 16.909071810477602, 20.369268457446477, 0.2190889, 230.0, 904, 434292, 577, 18.573918999999478
578, 3.987992476014178, 16.930720300965287, 20.415050185128543, 0.2171538999999999, 295.0, 1246, 435538, 578, 25.39554500000031
579, 4.6883114653739675, 16.973811675827818, 20.510760831642912, 0.2151288999999999, 245.0, 1004, 436542, 579, 20.687111899999763
580, 3.305355823643866, 16.92472352327839, 20.37863072656816, 0.21333249999999995, 400.0, 992, 437534, 580, 20.32953290000023
581, 5.196166487975881, 16.981029794133942, 20.506037358579963, 0.2113956999999999, 245.0, 1160, 438694, 581, 24.007246500000292
582, 5.82499170058497, 16.963076697241874, 20.587051445438014, 0.2099052999999999, 105.0, 496, 439190, 582, 10.332092199999352
583, 5.641920267100754, 16.93815758810089, 20.46849895778455, 0.2087064999999999, 165.0, 836, 440026, 583, 17.358486600000106
584, 7.763451724399066, 16.9427250124884, 20.53472778194058, 0.20757339999999988, 80.0, 423, 440449, 584, 8.881323900000098
585, 5.723550676670276, 16.96552252449138, 20.513507905253523, 0.20672379999999993, 120.0, 521, 440970, 585, 10.88938909999979
586, 6.213305929906778, 17.025586488551664, 20.60259188386731, 0.20529729999999996, 300.0, 1064, 442034, 586, 22.12527290000071
587, 3.3000344672268134, 16.980885473265094, 20.447356678798688, 0.2034657999999999, 570.0, 971, 443005, 587, 20.340530200000103
588, 5.947042517280977, 16.998917092183593, 20.56404266235935, 0.20202669999999995, 130.0, 628, 443633, 588, 13.049358400000528
589, 4.064423045408706, 16.981120935243396, 20.462317277873986, 0.2009115999999999, 135.0, 611, 444244, 589, 12.872603699999672
590, 1.942973565842424, 16.85601074868219, 20.271342417498623, 0.19990180000000002, 55.0, 511, 444755, 590, 10.736175000000003
591, 5.5088364023970415, 16.975870984221157, 20.508082711206722, 0.1991133999999999, 40.0, 365, 445120, 591, 7.739284000000225
592, 5.375515173561567, 16.901624867811094, 20.443982298572536, 0.1976814999999999, 250.0, 1226, 446346, 592, 25.759798900000533
593, 5.123416458978228, 16.987817875318047, 20.52648464859226, 0.19588239999999987, 45.0, 773, 447119, 593, 16.37380630000007
594, 4.6529709035060876, 16.919968777665044, 20.444372465773224, 0.19458009999999992, 115.0, 674, 447793, 594, 14.493703899999673
595, 3.3752761894820456, 16.929395000695273, 20.39580937958733, 0.19326519999999994, 170.0, 787, 448580, 595, 16.6585556
596, 2.889878560209507, 16.99403681273569, 20.475216443064934, 0.1920043, 105.0, 614, 449194, 596, 13.136873800000103
597, 5.0103570295483335, 17.008324516836062, 20.54958553646886, 0.1905228999999999, 300.0, 1032, 450226, 597, 22.098165100000188
598, 6.574551092678827, 17.132662319343147, 20.712061553201153, 0.1887561999999999, 360.0, 931, 451157, 598, 19.98081280000042
599, 3.466453447241734, 17.074698688914474, 20.560877455091013, 0.18717669999999995, 190.0, 824, 451981, 599, 17.564856200000577
600, 4.8508681755707554, 17.134580116663408, 20.701769220295237, 0.18547029999999998, 400.0, 1072, 453053, 600, 22.85943099999986
601, 4.941111539590461, 17.18499221920411, 20.788569042508374, 0.18392679999999995, 105.0, 643, 453696, 601, 13.74904770000012
602, 2.5748298783179524, 17.078374673596205, 20.547561555120886, 0.18241749999999998, 565.0, 1034, 454730, 602, 22.028473600000325
603, 8.196273504554878, 17.194561857926217, 20.78862132245337, 0.18102519999999991, 60.0, 513, 455243, 603, 11.09350380000069
604, 10.166672367689984, 17.153933873274458, 20.759383917554032, 0.1799497, 175.0, 682, 455925, 604, 14.728876399999535
605, 6.651336619040124, 17.101669241136477, 20.706755860324535, 0.17871399999999996, 140.0, 691, 456616, 605, 14.821268200000304
606, 2.8957217560262882, 17.092151430908395, 20.548686045352543, 0.17751429999999996, 115.0, 642, 457258, 606, 13.971062900000106
607, 6.948429175211861, 17.160320652936903, 20.793550200703315, 0.17576109999999998, 605.0, 1306, 458564, 607, 28.315354500000467
608, 6.206759624346238, 17.17988224944683, 20.788914004560272, 0.17351649999999993, 420.0, 1188, 459752, 608, 25.81848280000031
609, 5.527587948385689, 17.26949206323528, 20.837954826312455, 0.17163999999999996, 300.0, 897, 460649, 609, 19.395311900000706
610, 3.9003188891453995, 17.176255597906597, 20.705732862828143, 0.17024859999999992, 110.0, 649, 461298, 610, 14.123199199999362
611, 4.429691557458469, 17.27005461556571, 20.84213510785784, 0.1691919999999999, 115.0, 525, 461823, 611, 11.508720799999537
612, 4.928851882445651, 17.248548581690375, 20.817835762475326, 0.16779159999999993, 145.0, 1031, 462854, 612, 22.552174800000103
613, 4.914294977914797, 17.28543726748346, 20.940277157671737, 0.16627239999999996, 135.0, 657, 463511, 613, 14.449137200000223
614, 4.439944721259705, 17.286594818896194, 20.847209605645006, 0.1647667, 310.0, 1016, 464527, 614, 22.248402799999894
615, 5.661937957153204, 17.299005559538628, 20.859297496801496, 0.1632645999999999, 140.0, 653, 465180, 615, 14.395039800000632
616, 7.242681260636219, 17.25620850916509, 20.838026350861664, 0.16203339999999997, 135.0, 715, 465895, 616, 15.63931919999959
617, 4.66253958840003, 17.327873348957382, 20.934043293110808, 0.1609282, 75.0, 513, 466408, 617, 11.344448300000295
618, 1.9407691287076596, 17.280469516569354, 20.777829612415143, 0.1599462999999999, 130.0, 578, 466986, 618, 12.799968100000115
619, 5.725629039932272, 17.284900473552334, 20.884870447834437, 0.15839199999999992, 425.0, 1149, 468135, 619, 25.361677699999746
620, 5.099392049122997, 17.285765749996763, 20.887583108057353, 0.1564921, 280.0, 962, 469097, 620, 21.281094699999812
621, 5.762768821675836, 17.294281026195865, 20.895521397274887, 0.15482439999999992, 270.0, 891, 469988, 621, 19.87255809999988
622, 7.652584264291826, 17.360562546612464, 20.967562901297192, 0.15356259999999997, 125.0, 511, 470499, 622, 11.402265300000181
623, 5.1126641192359665, 17.322553740475243, 20.879860188301066, 0.1523808999999999, 165.0, 802, 471301, 623, 17.86242450000009
624, 5.100045819253492, 17.3226397825977, 20.93679752124576, 0.15074469999999998, 450.0, 1016, 472317, 624, 22.58699930000057
625, 4.357631835737991, 17.271634060231168, 20.836121358891287, 0.14896449999999992, 365.0, 962, 473279, 625, 21.285051399999247
626, 5.505517295343762, 17.360620300820532, 20.924767539856283, 0.14776029999999996, 80.0, 376, 473655, 626, 8.341228999999657
627, 3.804899337400164, 17.31995650850011, 20.874766109407112, 0.14643999999999996, 205.0, 1091, 474746, 627, 24.313448900000367
628, 5.7535981008862995, 17.34770522941719, 20.93345794525299, 0.14455719999999997, 240.0, 1001, 475747, 628, 22.39913290000004
629, 7.6902882397641354, 17.39473007704452, 21.022339555659567, 0.14267889999999991, 315.0, 1086, 476833, 629, 24.403150099999948
630, 2.4531902782161907, 17.31961360689565, 20.8311739669987, 0.14082129999999993, 275.0, 978, 477811, 630, 22.186778299999787
631, 5.993197855277345, 17.39518898630497, 21.010349987163806, 0.13909419999999995, 190.0, 941, 478752, 631, 21.04098300000078
632, 4.219195375974114, 17.307707404621695, 20.854890741352953, 0.13751469999999993, 270.0, 814, 479566, 632, 18.4706213999998
633, 1.8185383323935946, 17.287351397192403, 20.784711433823702, 0.13621689999999995, 220.0, 628, 480194, 633, 14.270000800000162
634, 4.892801269722456, 17.367399725853918, 20.950186898754772, 0.1348659999999999, 275.0, 873, 481067, 634, 19.663933099999667
635, 6.4157755560904315, 17.34486345602916, 20.95304826131234, 0.13333149999999996, 255.0, 832, 481899, 635, 19.15306860000055
636, 5.153544041692152, 17.44146937767261, 21.12615989549511, 0.13187349999999992, 165.0, 788, 482687, 636, 17.898978900000657
637, 5.3658156030963395, 17.390689764820827, 21.035748441196436, 0.13050819999999988, 115.0, 729, 483416, 637, 16.61416030000055
638, 4.809617556477548, 17.372835243908522, 20.96697364892557, 0.1288071999999999, 330.0, 1161, 484577, 638, 26.370714699999553
639, 5.316333607317292, 17.345514746273267, 20.96363944123348, 0.12725739999999996, 220.0, 561, 485138, 639, 12.867122499999823
640, 4.480414592382776, 17.296866352940018, 20.9716005573025, 0.1263366999999999, 75.0, 462, 485600, 640, 10.643115500000022
641, 4.57795023421855, 17.324761098152713, 20.881606878418673, 0.12482649999999991, 450.0, 1216, 486816, 641, 27.60969870000008
642, 3.571121576400396, 17.34686059872088, 20.906956489371723, 0.1230858999999999, 160.0, 718, 487534, 642, 16.53739089999999
643, 4.351921313029864, 17.350300812689923, 20.898063163406434, 0.12175479999999995, 205.0, 761, 488295, 643, 17.563759500000742
644, 8.052481688783828, 17.41545137813267, 21.13294421537005, 0.12005559999999994, 215.0, 1127, 489422, 644, 25.94529590000002
645, 4.798576788491754, 17.377620229735765, 20.975574093717274, 0.11845719999999994, 110.0, 649, 490071, 645, 15.080459800000426
646, 3.105555675274522, 17.302919560754802, 20.82054419416777, 0.11685069999999993, 345.0, 1136, 491207, 646, 26.247843600000124
647, 3.246375377441191, 17.47383701088082, 21.084356462853588, 0.11540709999999993, 110.0, 468, 491675, 647, 10.856582699999308
648, 4.957523030612739, 17.39020413447687, 21.048203629987608, 0.11440719999999992, 95.0, 643, 492318, 648, 14.92988079999941
649, 10.901139570915767, 17.426429511463574, 21.059968436505162, 0.1135098999999999, 85.0, 354, 492672, 649, 8.303836999999476
650, 5.825808492538176, 17.444263357865182, 21.079403830650158, 0.11271249999999994, 105.0, 532, 493204, 650, 12.32792530000006
651, 4.3361304874572335, 17.372942496260286, 20.9513467486523, 0.1113417999999999, 255.0, 991, 494195, 651, 23.25255019999986
652, 7.362698742561042, 17.43468960672617, 21.116431647539137, 0.10987389999999994, 85.0, 640, 494835, 652, 15.12861630000043
653, 4.687169241228251, 17.47759848833084, 21.053516484075978, 0.1079586999999999, 175.0, 1488, 496323, 653, 34.939121800000066
654, 6.443226128782545, 17.355943066188267, 20.97889427839007, 0.10583199999999991, 215.0, 875, 497198, 654, 20.54223180000008
655, 5.04422437770628, 17.382084995019632, 20.99144088049404, 0.10416609999999993, 365.0, 976, 498174, 655, 22.997322500000337
656, 2.862303430899414, 17.30327639792793, 20.835999223374827, 0.10276389999999991, 50.0, 582, 498756, 656, 13.986804699999993
657, 8.534168400126509, 17.467974822719892, 21.125510025024415, 0.10137609999999991, 130.0, 960, 499716, 657, 22.84480960000019
658, 4.020115992603197, 17.535281211206918, 21.146082143495917, 0.10008450812064874, 235.0, 862, 500578, 658, 20.569247200000063
659, 3.634690570214761, 17.72104539974751, 21.312785874517463, 0.09999999999999948, 165.0, 829, 501407, 659, 20.783403800000087
660, 3.2693677553097613, 17.703282763695842, 21.342480520677817, 0.0999999999999988, 160.0, 955, 502362, 660, 22.985558400000627
661, 4.385238756970926, 17.718757662339645, 21.39010178305886, 0.10000000000000094, 155.0, 550, 502912, 661, 13.1000382000002
662, 6.022559970104533, 17.717643083447086, 21.385307681945864, 0.09999999999999877, 140.0, 959, 503871, 662, 22.8847367999997
663, 4.451727836190359, 17.685192113808494, 21.35322556476819, 0.1000000000000009, 75.0, 506, 504377, 663, 12.687235399999736
664, 7.968697910003895, 17.858585509722445, 21.622784236636324, 0.10000000000000094, 185.0, 646, 505023, 664, 15.467807700000776
665, 3.280721953963029, 17.757989192516245, 21.397195491384952, 0.09999999999999887, 285.0, 940, 505963, 665, 21.285343300000022
666, 6.133702120978812, 17.720962858981775, 21.391859260934297, 0.10000000000000098, 110.0, 610, 506573, 666, 14.073311099999955
667, 4.972017529744021, 17.715830657309862, 21.385463981361656, 0.0999999999999993, 235.0, 858, 507431, 667, 19.588570099999743
668, 3.6863162131216876, 17.74244707008733, 21.28938226385431, 0.10000000000000099, 135.0, 637, 508068, 668, 14.553245099999913
669, 7.734756087643639, 17.774746736408446, 21.49732479132736, 0.09999999999999896, 140.0, 921, 508989, 669, 21.592496899999787
670, 3.72674891453145, 17.78615745861459, 21.4359487174967, 0.09999999999999724, 440.0, 1468, 510457, 670, 36.40513750000082
671, 5.610758849949791, 18.029366583090564, 21.758605315135075, 0.10000000000000091, 75.0, 520, 510977, 671, 12.55232049999995
672, 4.7606714967881665, 18.14708031984893, 21.888926687565718, 0.1000000000000004, 110.0, 704, 511681, 672, 17.109375400000317
673, 2.4823682369042435, 18.02830004253036, 21.707219816380448, 0.09999999999999774, 365.0, 1249, 512930, 673, 29.868921500000397
674, 5.989497914240329, 18.055230557079046, 21.807306767026628, 0.09999999999999895, 275.0, 923, 513853, 674, 22.167963099999724
675, 4.78675005121856, 18.135211739664186, 21.901118291975397, 0.09999999999999751, 355.0, 1345, 515198, 675, 32.566955499999494
676, 4.330834610920518, 18.125335002003787, 21.822993381099188, 0.09999999999999955, 115.0, 818, 516016, 676, 19.857409299999745
677, 5.9968639113151045, 18.160284371699316, 21.918778775102002, 0.09999999999999885, 165.0, 944, 516960, 677, 22.950948900000185
678, 3.2690562316815934, 18.12321593726456, 21.856723645448184, 0.0999999999999988, 180.0, 954, 517914, 678, 23.232571599999574
679, 5.737678335349766, 18.112218229968693, 21.910693860350285, 0.09999999999999712, 655.0, 1529, 519443, 679, 37.219064900000376
680, 2.916028065018464, 18.145440297886946, 21.840311089114866, 0.10000000000000052, 180.0, 690, 520133, 680, 16.89919650000047
681, 5.640290097036039, 18.20528900274173, 22.01455007204617, 0.10000000000000028, 105.0, 717, 520850, 681, 17.37460319999991
682, 2.8993828270068898, 18.138525405020083, 21.861563421645254, 0.10000000000000099, 110.0, 636, 521486, 682, 15.80079730000034
683, 3.3641063087077923, 18.18518878358582, 21.901588812106993, 0.10000000000000095, 80.0, 574, 522060, 683, 14.244884700000512
684, 3.1771973806716516, 18.049823750045515, 21.751911112272946, 0.10000000000000091, 100.0, 523, 522583, 684, 12.969367499999862
685, 2.080948646222999, 18.116128971226406, 21.78473169468402, 0.10000000000000099, 165.0, 633, 523216, 685, 15.64700510000057
686, 5.062926090719915, 18.161335079593204, 21.95184501853935, 0.09999999999999876, 210.0, 963, 524179, 686, 23.70904100000007
687, 3.988297686918781, 18.148601088571617, 21.880184367320396, 0.10000000000000044, 315.0, 699, 524878, 687, 17.27030620000005
688, 3.888990219062557, 18.193729368896, 21.944206576339795, 0.10000000000000099, 80.0, 631, 525509, 688, 15.712011199999324
689, 3.4162731287018606, 18.1273108722645, 21.8422354487746, 0.09999999999999766, 255.0, 1278, 526787, 689, 34.57949720000033
690, 8.826245544005337, 18.24830648368429, 22.123844780518343, 0.100000000000001, 105.0, 638, 527425, 690, 17.581720299999688
691, 2.974764655542946, 18.151976172516985, 21.871598441426347, 0.10000000000000084, 85.0, 656, 528081, 691, 18.713823999999477
692, 4.61734657321407, 18.166843744887025, 21.88727793974035, 0.10000000000000085, 75.0, 476, 528557, 692, 11.469384600000012
693, 6.930961160415068, 18.15598779147372, 21.937205069914206, 0.10000000000000096, 155.0, 643, 529200, 693, 16.162825700000212
694, 3.881467162514452, 18.161421097702718, 21.974748002823873, 0.10000000000000074, 80.0, 398, 529598, 694, 9.914021800000228
695, 8.74708461547748, 18.44079889802851, 22.326619225689488, 0.09999999999999888, 325.0, 936, 530534, 695, 23.3284550999997
696, 4.090011373372474, 18.50767279717616, 22.317980694546595, 0.100000000000001, 125.0, 638, 531172, 696, 18.78723319999972
697, 5.074159435949814, 18.55396272788518, 22.348454917829063, 0.09999999999999748, 210.0, 1358, 532530, 697, 39.389606300000196
698, 4.477834717994577, 18.560272058712982, 22.39172453551584, 0.09999999999999765, 350.0, 1291, 533821, 698, 32.271199400000114
699, 4.023709465415193, 18.545107717688136, 22.377158153371443, 0.09999999999999866, 325.0, 986, 534807, 699, 26.497471900000164
700, 6.784898948522738, 18.444523396269645, 22.271848807063126, 0.10000000000000073, 105.0, 386, 535193, 700, 11.134401000000253
701, 7.091637847817126, 18.59980684382315, 22.545467410682114, 0.10000000000000073, 35.0, 393, 535586, 701, 9.299589500000366
702, 4.9871056845190855, 18.57104670457927, 22.445235600225107, 0.10000000000000081, 155.0, 658, 536244, 702, 15.498337800000627
703, 5.176501863965332, 18.360064867771033, 22.19117383282594, 0.10000000000000074, 160.0, 396, 536640, 703, 9.311529800000244
704, 8.424115782635345, 18.642086139270567, 22.504339981543175, 0.09999999999999952, 200.0, 822, 537462, 704, 19.422034899999744
705, 4.676130676388393, 18.494830931207087, 22.287865575649395, 0.1000000000000009, 110.0, 514, 537976, 705, 12.739542600000277
706, 5.908196151662956, 18.5737294773367, 22.422257654934644, 0.0999999999999989, 510.0, 935, 538911, 706, 22.284096399999726
707, 6.289940958830514, 18.588667938869584, 22.4545371289367, 0.09999999999999895, 225.0, 922, 539833, 707, 21.762877300000582
708, 5.8628567365110795, 18.568464582062518, 22.415600764481837, 0.09999999999999852, 405.0, 1017, 540850, 708, 24.263490999999703
709, 5.117417246576426, 18.52939682354892, 22.326008323335298, 0.09999999999999745, 440.0, 1370, 542220, 709, 32.34917800000039
710, 5.543800776334608, 18.664148561913393, 22.495578326027967, 0.09999999999999892, 180.0, 928, 543148, 710, 22.637825999999222
711, 4.195831493272917, 18.55428453819039, 22.37757631020038, 0.10000000000000096, 140.0, 582, 543730, 711, 15.00379729999986
712, 3.2466064317062804, 18.49415333776105, 22.309392081849396, 0.09999999999999919, 165.0, 878, 544608, 712, 22.41962340000009
713, 3.67602756021502, 18.564165448600594, 22.324887384067882, 0.1000000000000004, 155.0, 704, 545312, 713, 18.176958800000648
714, 2.006041376059988, 18.52255289895194, 22.334859804148824, 0.09999999999999949, 210.0, 826, 546138, 714, 21.217864299999746
715, 3.9832220491649664, 18.60045194777472, 22.41785651663339, 0.09999999999999772, 660.0, 1258, 547396, 715, 32.24030259999927
716, 4.578984643086651, 18.627159110940692, 22.471678783951422, 0.0999999999999972, 890.0, 1484, 548880, 716, 38.32242199999928
717, 4.381732806406206, 18.63043270248057, 22.448269748174095, 0.09999999999999816, 530.0, 1114, 549994, 717, 28.796359400000256
718, 5.448477565152859, 18.720072892839397, 22.584383308060524, 0.09999999999999888, 280.0, 937, 550931, 718, 24.092575299999226
719, 4.140634794872912, 18.679675438824823, 22.572966115614946, 0.1000000000000006, 200.0, 680, 551611, 719, 20.929919000000154
720, 6.1764202229531, 18.751449144028296, 22.644115697439943, 0.09999999999999996, 140.0, 757, 552368, 720, 19.31122630000027
721, 2.873777354123334, 18.633577451457377, 22.416998657833567, 0.10000000000000019, 210.0, 729, 553097, 721, 18.718938699999853
722, 5.539165743537957, 18.64988302616846, 22.51383388231671, 0.10000000000000088, 80.0, 504, 553601, 722, 12.760421199999655
723, 3.3749472832856684, 18.650379534776224, 22.422794179261725, 0.10000000000000092, 120.0, 539, 554140, 723, 13.593623099999604
724, 6.00933867381846, 18.713492709905545, 22.602146352859254, 0.09999999999999717, 595.0, 1504, 555644, 724, 36.97119170000042
725, 2.1764250411132795, 18.70754611766444, 22.51981210624222, 0.10000000000000095, 60.0, 565, 556209, 725, 14.404228200000034
726, 4.5840782711359145, 18.66894195498717, 22.525248308243825, 0.09999999999999895, 360.0, 922, 557131, 726, 23.693975299999693
727, 3.9416520120283156, 18.594297945874292, 22.41568203392269, 0.10000000000000099, 185.0, 636, 557767, 727, 16.328468600000633
728, 5.504037671785886, 18.746503320650678, 22.618595263349995, 0.10000000000000003, 200.0, 749, 558516, 728, 21.25268479999977
729, 1.954366007293249, 18.720844678965744, 22.4848711338449, 0.10000000000000081, 185.0, 658, 559174, 729, 19.185206000000107
730, 8.10691809491946, 18.784137834416757, 22.72980186254671, 0.10000000000000075, 95.0, 404, 559578, 730, 11.858210099999269
731, 4.170662920370146, 18.937014852531654, 22.819748450699166, 0.09999999999999871, 415.0, 972, 560550, 731, 28.17237109999951
732, 7.782477227846208, 19.195820375623107, 23.26258753408736, 0.09999999999999926, 305.0, 866, 561416, 732, 25.394337100000484
733, 2.2215796237647094, 19.205894381392238, 23.05271611961664, 0.10000000000000075, 125.0, 408, 561824, 733, 11.958182999998826
734, 3.9695519043866576, 19.144372769482647, 23.11620458169472, 0.09999999999999705, 500.0, 1571, 563395, 734, 43.56059920000007
735, 4.0105339403599904, 19.242590143536273, 23.20081628284265, 0.09999999999999817, 475.0, 1107, 564502, 735, 31.35908279999967
736, 1.9031042546233996, 19.10543925712688, 23.002135121924244, 0.09999999999999953, 205.0, 819, 565321, 736, 25.109572199999093
737, 3.8921337383492616, 19.08920064344888, 23.006909123606192, 0.10000000000000087, 90.0, 653, 565974, 737, 18.381283699998676
738, 7.023243221320436, 19.234830223553555, 23.286519642689782, 0.10000000000000099, 145.0, 633, 566607, 738, 18.826738099998693
739, 5.739288006442148, 19.145426153075448, 23.1237398736201, 0.10000000000000066, 105.0, 674, 567281, 739, 18.686130399999456
740, 5.592443482939437, 19.285547591092293, 23.331031715660764, 0.10000000000000063, 55.0, 342, 567623, 740, 10.12360550000085
741, 4.297334733469191, 19.148450140457427, 23.08540646576967, 0.09999999999999815, 380.0, 1116, 568739, 741, 33.19996739999988
742, 4.081111383261317, 19.19285108073283, 23.135558677931964, 0.09999999999999885, 300.0, 944, 569683, 742, 29.50540590000128
743, 7.62319358156518, 19.567714465773793, 23.624223097740636, 0.10000000000000063, 160.0, 677, 570360, 743, 20.553884999999354
744, 4.9344049012592555, 19.66661196338887, 23.69567534388328, 0.09999999999999869, 290.0, 980, 571340, 744, 29.893150300000343
745, 6.333543821408505, 19.63518394550807, 23.694074637453323, 0.10000000000000095, 115.0, 568, 571908, 745, 17.99058960000002
746, 2.9284091653442674, 19.59238320795436, 23.5800517756196, 0.10000000000000087, 50.0, 491, 572399, 746, 14.662016899999799
747, 5.3394750406855485, 19.60558074911946, 23.6431187087895, 0.10000000000000073, 65.0, 389, 572788, 747, 10.253924999999072
748, 7.024143209912101, 19.729108027083843, 23.85257810829386, 0.09999999999999863, 235.0, 991, 573779, 748, 26.858869100000447
749, 5.537252791258002, 19.66155364919034, 23.73318473229884, 0.0999999999999974, 590.0, 1393, 575172, 749, 38.90518669999983
750, 7.00327695658008, 19.694140457116756, 23.766487516153354, 0.09999999999999773, 285.0, 1252, 576424, 750, 34.05212329999995
751, 5.965475123550159, 19.603213999761827, 23.569325476217173, 0.10000000000000087, 115.0, 491, 576915, 751, 13.266821799999889
752, 4.776609401234559, 19.63912641797747, 23.619725082942416, 0.10000000000000042, 235.0, 700, 577615, 752, 18.737473400000454
753, 3.5240607631405316, 19.58353979467908, 23.622592356388836, 0.09999999999999955, 335.0, 817, 578432, 753, 23.345007500000065
754, 3.2536559575888364, 19.554546077325224, 23.540036131249167, 0.09999999999999888, 175.0, 937, 579369, 754, 26.14967930000057
755, 5.264542883661405, 19.540334292586834, 23.562410207391807, 0.09999999999999798, 370.0, 1166, 580535, 755, 32.631242100000236
756, 2.863792755149796, 19.45611065036648, 23.442210527566765, 0.10000000000000019, 260.0, 728, 581263, 756, 20.230800100000124
757, 4.70956461623368, 19.497484898080632, 23.52624931140822, 0.09999999999999705, 715.0, 1568, 582831, 757, 44.943173300000126
758, 2.9937439329500886, 19.503724660192216, 23.49238799867176, 0.10000000000000069, 185.0, 672, 583503, 758, 16.721381600000313
759, 5.044003152303619, 19.523802293633548, 23.513756867693854, 0.0999999999999984, 315.0, 1047, 584550, 759, 26.09286819999943
760, 4.512048081000672, 19.487088629910346, 23.46378805864277, 0.0999999999999999, 115.0, 767, 585317, 760, 20.480218099999547
761, 2.9431307583799717, 19.44192374076728, 23.379236106065825, 0.10000000000000078, 90.0, 662, 585979, 761, 17.809761900000012
762, 2.9073642395280457, 19.48207727178827, 23.428986334633993, 0.1000000000000003, 220.0, 715, 586694, 762, 21.382075299999997
763, 5.849509240444942, 19.509998799353532, 23.54540335665044, 0.09999999999999873, 220.0, 970, 587664, 763, 28.82849080000051
764, 4.315301897620486, 19.56976103381576, 23.536604077348084, 0.10000000000000092, 90.0, 535, 588199, 764, 13.987333099999887
765, 5.71224511326773, 19.525176244922207, 23.530402531582297, 0.09999999999999845, 545.0, 1033, 589232, 765, 27.241451300000335
766, 4.7932336617857, 19.431840982137775, 23.442964020687725, 0.10000000000000071, 170.0, 669, 589901, 766, 18.586865900000703
767, 7.352346385902969, 19.605726486438, 23.65108561231052, 0.09999999999999896, 185.0, 921, 590822, 767, 24.87116220000098
768, 4.922898992090611, 19.61416510657386, 23.639860487318373, 0.0999999999999986, 350.0, 999, 591821, 768, 27.127446800001053
769, 3.1059365824379106, 19.557749180744093, 23.52554959927996, 0.0999999999999971, 550.0, 1536, 593357, 769, 42.08570310000141
770, 5.159486979979348, 19.650084184604896, 23.694297295678442, 0.09999999999999856, 345.0, 1006, 594363, 770, 28.35815360000015
771, 5.677717273955326, 19.607479121409305, 23.644441156044415, 0.09999999999999848, 265.0, 1029, 595392, 771, 27.65551780000169
772, 6.794642013167641, 19.61274288399741, 23.706629703015288, 0.0999999999999984, 135.0, 1047, 596439, 772, 27.871212599999126
773, 3.1850690373672106, 19.551242620815255, 23.52609066846894, 0.10000000000000091, 115.0, 533, 596972, 773, 14.739651300000332
774, 4.536973336927569, 19.598389266800357, 23.614455241020945, 0.100000000000001, 120.0, 638, 597610, 774, 18.278536699999677
775, 3.6581848156361922, 19.584152425553057, 23.561205170783182, 0.0999999999999994, 215.0, 842, 598452, 775, 23.54659299999912
776, 6.039883135591575, 19.653113213813267, 23.679621619204436, 0.09999999999999906, 130.0, 901, 599353, 776, 25.341003499999715
777, 4.686692521329279, 19.583999885276512, 23.63333300837764, 0.10000000000000066, 105.0, 675, 600028, 777, 18.7961080999994
778, 3.3767993213750604, 19.91633664833388, 23.967203246563322, 0.0999999999999989, 275.0, 933, 600961, 778, 25.887731000000713
779, 3.2940925391797062, 20.004596021838655, 24.056674387221946, 0.10000000000000091, 40.0, 532, 601493, 779, 15.700931699999273
780, 2.6797673465250043, 19.934780609260486, 24.024453783498227, 0.0999999999999995, 165.0, 824, 602317, 780, 24.97041469999931
781, 5.705857234011436, 19.999578599272102, 24.16113425671369, 0.10000000000000046, 160.0, 696, 603013, 781, 20.12812330000088
782, 5.930762766071952, 19.96155991518408, 24.11032425729852, 0.10000000000000074, 130.0, 665, 603678, 782, 19.816517500001282
783, 7.584827190499549, 20.088816013019045, 24.26217874948316, 0.0999999999999994, 230.0, 842, 604520, 783, 24.76804590000029
784, 4.117690142783625, 19.96478809323804, 24.053488349914552, 0.09999999999999801, 390.0, 1160, 605680, 784, 46.14638039999954
785, 4.016932001609224, 20.04155715965822, 24.10469744868359, 0.10000000000000088, 185.0, 651, 606331, 785, 27.407374000000345
786, 2.1497112380359136, 19.98389007549475, 24.03351823410185, 0.10000000000000075, 120.0, 404, 606735, 786, 16.288626999999906
787, 4.535921481048903, 19.963379656209387, 24.105788726662418, 0.10000000000000091, 65.0, 529, 607264, 787, 19.712317299999995
788, 3.911192209175543, 20.0110815600345, 24.149805435381438, 0.09999999999999995, 405.0, 760, 608024, 788, 30.326918299999306
789, 3.162000813583533, 19.897445087604694, 23.99953852816745, 0.10000000000000094, 115.0, 555, 608579, 789, 25.18700329999956
790, 3.621082364548867, 19.93969545744927, 24.07477130221052, 0.09999999999999949, 190.0, 827, 609406, 790, 30.488707300000897
791, 3.7624178860880684, 19.967705180136004, 24.01736077726557, 0.10000000000000081, 25.0, 445, 609851, 791, 18.349227200000314
792, 2.900453787223033, 20.094991310606613, 24.16828722581796, 0.10000000000000038, 165.0, 705, 610556, 792, 29.836218200000076
793, 3.977848940842918, 20.168153277805875, 24.284428539276124, 0.10000000000000042, 100.0, 700, 611256, 793, 29.15157459999864
794, 2.2478639948942245, 20.142998494139505, 24.225636305502796, 0.10000000000000092, 130.0, 545, 611801, 794, 21.84387869999955
795, 5.019646699965131, 20.230498102673312, 24.43256594423662, 0.099999999999999, 225.0, 912, 612713, 795, 31.463876899999377
796, 5.828809767707402, 20.206611040884336, 24.34489539654043, 0.09999999999999952, 190.0, 821, 613534, 796, 34.54548470000009
797, 5.044319326539043, 20.204085624261655, 24.34848224374401, 0.09999999999999823, 310.0, 1092, 614626, 797, 39.40046950000033
798, 2.971852860927582, 20.17505264892578, 24.26568271484375, 0.10000000000000099, 55.0, 625, 615251, 798, 20.5565502999998
799, 5.433364629190224, 20.156727808923904, 24.30761347359758, 0.10000000000000012, 90.0, 738, 615989, 799, 26.245216100000107
800, 6.8137119376051, 20.176941578204815, 24.33364618741549, 0.10000000000000064, 125.0, 676, 616665, 800, 25.335606300001018
801, 4.828228579984068, 20.158528849628297, 24.32598859874533, 0.09999999999999755, 300.0, 1329, 617994, 801, 42.83054960000118
802, 5.224981459695544, 20.27671861802876, 24.457718839923157, 0.10000000000000099, 85.0, 618, 618612, 802, 19.07050049999998
803, 3.880458347674892, 20.1767111235184, 24.27922495199741, 0.09999999999999779, 385.0, 1231, 619843, 803, 37.734572400000616
804, 3.7598236671993477, 20.18070697260427, 24.316946796445183, 0.09999999999999823, 225.0, 1092, 620935, 804, 33.88928510000005
805, 4.126363387140799, 20.110053808382244, 24.247746272449053, 0.10000000000000098, 85.0, 606, 621541, 805, 22.441041599999153
806, 3.2656064806923046, 20.14137536020421, 24.27805839011918, 0.10000000000000092, 90.0, 536, 622077, 806, 16.85864650000076
807, 5.879385347167651, 20.117946437048534, 24.27546570490277, 0.10000000000000099, 155.0, 630, 622707, 807, 20.229889599999296
808, 4.814542841911316, 20.166516709834973, 24.30116021176602, 0.10000000000000085, 65.0, 470, 623177, 808, 16.54750729999978
809, 4.97049253059156, 20.17137648264567, 24.3221198313164, 0.1000000000000008, 155.0, 660, 623837, 809, 23.29799720000119
810, 4.6192639673003155, 20.138198271226347, 24.300268253583585, 0.10000000000000032, 170.0, 712, 624549, 810, 25.504848800001128
811, 5.353840173645453, 20.251150249363064, 24.393549243648806, 0.09999999999999859, 235.0, 1001, 625550, 811, 35.22074380000049
812, 6.954595567944718, 20.184837421852517, 24.34266357387601, 0.09999999999999816, 200.0, 1113, 626663, 812, 39.892430399999284
813, 3.737861583625081, 20.067637491127062, 24.158645859874955, 0.09999999999999876, 170.0, 962, 627625, 813, 34.144147499999235
814, 5.240841740467831, 20.155818301752994, 24.33137169888145, 0.10000000000000071, 45.0, 380, 628005, 814, 13.503573099998903
815, 4.434613752417923, 20.133803521079578, 24.26356910106323, 0.09999999999999841, 290.0, 1044, 629049, 815, 37.47215379999943
816, 2.751136451224228, 20.194115430658513, 24.275132944676784, 0.09999999999999987, 185.0, 770, 629819, 816, 27.244865999999092
817, 5.000772289263713, 20.010439524896963, 24.118562376607876, 0.09999999999999758, 580.0, 1316, 631135, 817, 47.529620799999975
818, 1.8957770102829845, 19.915705419469763, 23.972080197746372, 0.10000000000000075, 40.0, 405, 631540, 818, 14.506928299999345
819, 3.979407473576364, 19.915484127697646, 24.04597183891961, 0.10000000000000074, 140.0, 666, 632206, 819, 23.920869100000345
820, 4.921950161445292, 19.955644568372488, 24.07352919375162, 0.10000000000000099, 175.0, 633, 632839, 820, 22.946226100000786
821, 2.561975269242793, 19.939047274820606, 23.995926918332273, 0.09999999999999809, 320.0, 1135, 633974, 821, 40.75371950000044
822, 7.852199854388947, 20.015510594025823, 24.106186530426257, 0.10000000000000085, 165.0, 655, 634629, 822, 23.436477999999624
823, 2.7731463963220895, 19.940770147889644, 23.988722885711283, 0.10000000000000034, 115.0, 711, 635340, 823, 25.59227800000008
824, 6.242407728619791, 19.942135543486405, 24.0357057727199, 0.09999999999999903, 135.0, 906, 636246, 824, 32.69669829999839
825, 6.324238956480929, 20.002561119492274, 24.112655920063077, 0.10000000000000024, 105.0, 721, 636967, 825, 25.883901900000637
826, 6.80745697834275, 20.01609787562165, 24.167769065750708, 0.09999999999999781, 455.0, 1221, 638188, 826, 42.86951190000036
827, 4.8378499045668395, 19.96845772061531, 24.056767583983035, 0.09999999999999823, 200.0, 1094, 639282, 827, 38.61164599999938
828, 5.5945169932192895, 20.008241887750298, 24.10626968433117, 0.09999999999999892, 275.0, 928, 640210, 828, 32.97632679999879
829, 2.93875162877451, 19.99828933174088, 24.05642510589058, 0.09999999999999938, 275.0, 845, 641055, 829, 30.254372800000056
830, 5.9577605104008144, 20.027349763758043, 24.124999183205997, 0.09999999999999935, 230.0, 850, 641905, 830, 29.99810499999876
831, 7.7817880295761634, 20.017028227193546, 24.17872468049567, 0.10000000000000096, 80.0, 643, 642548, 831, 22.84120840000105
832, 5.75632820482124, 19.956900108794464, 24.0712343412244, 0.10000000000000088, 165.0, 651, 643199, 832, 23.295938899998873
833, 5.428447887144161, 20.00708000206966, 24.130880527332298, 0.09999999999999766, 385.0, 1279, 644478, 833, 45.240664100001595
834, 6.053054773946475, 20.016229356600157, 24.163233229585018, 0.10000000000000099, 135.0, 622, 645100, 834, 22.240173799998956
835, 4.293353154531149, 19.978576100429642, 24.025794227100977, 0.09999999999999831, 235.0, 1070, 646170, 835, 38.212324699999954
836, 3.7639199433304222, 20.011313532838727, 24.104752590160558, 0.0999999999999996, 245.0, 808, 646978, 836, 29.313017199998285
837, 2.0122397640596366, 19.972697762401506, 24.014798039797796, 0.10000000000000084, 50.0, 467, 647445, 837, 16.809761000000435
838, 4.135577851479354, 20.01980146730421, 24.127911178621716, 0.09999999999999892, 265.0, 929, 648374, 838, 33.11072130000139
839, 4.929814765396982, 20.011036339478615, 24.117619190460598, 0.09999999999999774, 275.0, 1248, 649622, 839, 50.510855399999855
840, 3.24308001078166, 20.462991246243114, 24.59038741932702, 0.09999999999999708, 510.0, 1552, 651174, 840, 62.85843059999934
841, 6.021657241767568, 20.69363932933622, 24.985124174445193, 0.10000000000000099, 110.0, 618, 651792, 841, 23.403962799999135
842, 9.40125235876993, 20.743604387310768, 25.029823064804077, 0.09999999999999816, 290.0, 1112, 652904, 842, 42.41933210000025
843, 4.006976808424252, 20.70605688967539, 24.92307882880563, 0.10000000000000099, 45.0, 634, 653538, 843, 25.067906800000856
844, 2.1049996251002154, 20.65752374879045, 24.815570262114402, 0.09999999999999952, 200.0, 821, 654359, 844, 33.69650019999972
845, 3.34523763511814, 20.684635783768417, 24.876870300810214, 0.10000000000000091, 55.0, 531, 654890, 845, 23.506320600001345
846, 4.431800277404446, 20.62772021408222, 24.857735127926755, 0.09999999999999827, 285.0, 1082, 655972, 846, 41.58803590000025
847, 2.124893079764313, 20.598924631189416, 24.76109028286404, 0.10000000000000066, 180.0, 675, 656647, 847, 26.060903899999175
848, 3.9333276914085373, 20.58126377170369, 24.788054566464183, 0.10000000000000096, 70.0, 590, 657237, 848, 19.006425699999454
849, 6.937300900727897, 20.660673916804328, 24.9486299985415, 0.09999999999999987, 220.0, 770, 658007, 849, 24.506191799999215
850, 4.726903791153508, 20.66855052856975, 24.824113969947668, 0.10000000000000084, 105.0, 461, 658468, 850, 15.128394499999558
851, 3.6529399319374956, 20.64976118607394, 24.87310320423222, 0.09999999999999777, 245.0, 1237, 659705, 851, 45.458930700000565
852, 2.9544234930241475, 20.775877719942486, 24.980863198466686, 0.09999999999999978, 400.0, 783, 660488, 852, 27.630627800001093
853, 5.537713779802138, 20.826703066310724, 25.11764520291146, 0.10000000000000024, 75.0, 722, 661210, 853, 27.338101900000765
854, 3.9112438687572637, 20.838705847280114, 25.103255215988575, 0.09999999999999766, 145.0, 1279, 662489, 854, 53.73160370000005
855, 4.8194835478851115, 20.84778959665156, 25.155255157484124, 0.09999999999999808, 280.0, 1137, 663626, 855, 41.07055059999948
856, 3.4127569778922218, 20.82377516623399, 25.068907462272392, 0.09999999999999899, 260.0, 914, 664540, 856, 35.162389000000985
857, 3.8847294376224437, 20.8934058607714, 25.154421541149247, 0.09999999999999712, 615.0, 1532, 666072, 857, 55.32091020000007
858, 4.1916624506983355, 20.866806534541865, 25.15421017818381, 0.09999999999999955, 380.0, 817, 666889, 858, 29.862198899998475
859, 3.628453230339874, 20.80270901254803, 25.02907993931614, 0.0999999999999997, 275.0, 794, 667683, 859, 30.231236100000388
860, 7.519587060276174, 20.950241289347627, 25.284272462608172, 0.10000000000000056, 210.0, 685, 668368, 860, 25.095009500000742
861, 4.013882170186856, 20.785491604860734, 24.986429557030057, 0.09999999999999887, 300.0, 941, 669309, 861, 33.48363280000012
862, 4.188272444674602, 20.865974456071854, 25.12445362485372, 0.09999999999999945, 290.0, 832, 670141, 862, 28.035711499998797
863, 2.5316766160618327, 21.174036574763292, 25.402934394069224, 0.10000000000000067, 50.0, 358, 670499, 863, 12.142740799999956
864, 6.0470962061823945, 21.170600104893555, 25.55280340100764, 0.0999999999999989, 215.0, 934, 671433, 864, 33.774962100000266
865, 5.0771935404519795, 21.131823054066412, 25.44336215360665, 0.10000000000000092, 110.0, 648, 672081, 865, 23.026658299999326
866, 5.9259453509377185, 21.147047355333473, 25.54021385758885, 0.10000000000000092, 125.0, 647, 672728, 866, 25.890380999999252
867, 2.6679102013320493, 21.096618133821465, 25.386226473078292, 0.09999999999999888, 435.0, 938, 673666, 867, 33.78670969999985
868, 2.9808956559689097, 21.137512251851454, 25.4115854342986, 0.0999999999999999, 110.0, 766, 674432, 868, 27.182289099999252
869, 4.5232325120179215, 21.086844718417936, 25.413031941748127, 0.09999999999999708, 680.0, 1555, 675987, 869, 57.538851799999975
870, 4.406329423395728, 21.07829761687474, 25.37694209665915, 0.09999999999999841, 150.0, 1046, 677033, 870, 40.99990649999927
871, 2.095314633397555, 21.01512374119325, 25.25423289970918, 0.10000000000000066, 20.0, 352, 677385, 871, 12.736744399999225
872, 5.555503162599745, 21.188649313790457, 25.521022019777618, 0.09999999999999865, 270.0, 987, 678372, 872, 38.46052339999915
873, 3.60383811638761, 21.157672617615773, 25.457294255745513, 0.09999999999999791, 420.0, 1190, 679562, 873, 44.718207600000824
874, 3.1680842561574725, 21.02332400587558, 25.327767376259807, 0.10000000000000049, 125.0, 693, 680255, 874, 25.971889000000374
875, 3.1031507943417425, 20.883611789596415, 25.120029107209678, 0.10000000000000092, 85.0, 535, 680790, 875, 19.34207150000111
876, 3.754095135490649, 20.860650182369366, 25.15798359300623, 0.10000000000000074, 45.0, 398, 681188, 876, 14.405700599998454
877, 3.000406462455084, 20.80058385280663, 25.000478783189415, 0.10000000000000099, 160.0, 641, 681829, 877, 23.664541799998915
878, 4.801015015700902, 20.863705922534344, 25.1493131171546, 0.09999999999999791, 345.0, 1191, 683020, 878, 42.522758900000554
879, 5.438741089914132, 20.880987694234022, 25.120256423950195, 0.10000000000000092, 90.0, 648, 683668, 879, 23.637369399999443
880, 5.6645897369132125, 20.967713479463217, 25.237610587008714, 0.09999999999999974, 115.0, 788, 684456, 880, 28.594454600000972
881, 7.478119378827534, 20.94729478524694, 25.259068055586383, 0.09999999999999849, 395.0, 1023, 685479, 881, 36.136610100000325
882, 3.7033058562032553, 20.909337338889042, 25.17933106483401, 0.09999999999999978, 195.0, 782, 686261, 882, 27.830910599999697
883, 9.864781221426384, 20.946043081158635, 25.37247298516908, 0.10000000000000055, 110.0, 687, 686948, 883, 24.932792999999947
884, 2.7793855100251093, 20.835413935630186, 25.098152514381294, 0.10000000000000066, 85.0, 674, 687622, 884, 29.057893299999705
885, 3.803997010225872, 20.816031696674266, 25.03923441291534, 0.09999999999999837, 365.0, 1054, 688676, 885, 47.22017119999873
886, 5.520217895783367, 20.90632395791804, 25.173327561293014, 0.1000000000000004, 95.0, 703, 689379, 886, 38.049197399999684
887, 4.002413856217093, 20.91745236582423, 25.231772599921715, 0.10000000000000067, 100.0, 673, 690052, 887, 47.00064350000139
888, 6.612915081940942, 20.995436803168275, 25.29675808183919, 0.10000000000000007, 230.0, 743, 690795, 888, 36.57469730000048
889, 2.766991008031362, 20.943717824465875, 25.18415624109645, 0.09999999999999867, 210.0, 982, 691777, 889, 47.013159500000256
890, 7.17381708865436, 20.97496801461929, 25.260575361740894, 0.10000000000000099, 140.0, 624, 692401, 890, 30.04385589999947
891, 7.64361814030372, 21.001293006829457, 25.31623099335527, 0.0999999999999981, 245.0, 1130, 693531, 891, 54.88363109999955
892, 4.485374732908428, 20.937308932545097, 25.207542066629223, 0.09999999999999844, 380.0, 1038, 694569, 892, 52.32741829999941
893, 1.9216804262021836, 20.88839509856203, 25.051694818445153, 0.10000000000000075, 75.0, 407, 694976, 893, 21.012342900001386
894, 3.1595039063330854, 20.985021963986483, 25.205300984238132, 0.1000000000000008, 145.0, 660, 695636, 894, 34.01819329999853
895, 5.367936471709364, 21.107577356798895, 25.502750128586666, 0.1000000000000007, 45.0, 377, 696013, 895, 18.553930100000798
896, 3.8642743195284797, 20.961209505254573, 25.23583630070542, 0.09999999999999863, 190.0, 990, 697003, 896, 50.02369270000054
897, 3.5218047793326592, 20.99242446797104, 25.202959835300955, 0.10000000000000091, 85.0, 522, 697525, 897, 27.025618300000133
898, 3.079141521860049, 20.973125604261835, 25.250704259757537, 0.10000000000000075, 105.0, 664, 698189, 898, 34.15113209999981
899, 2.1635136875586634, 20.79704053721197, 24.967484851848027, 0.10000000000000066, 75.0, 351, 698540, 899, 18.8865009000001
900, 3.9619086639874657, 20.92356747277775, 25.198159885702665, 0.09999999999999765, 325.0, 1288, 699828, 900, 65.60769529999925
901, 5.425597573795258, 21.03445343850752, 25.332036923845752, 0.09999999999999817, 370.0, 1108, 700936, 901, 55.41650689999915
902, 5.531796854337168, 21.018537971917098, 25.278715773025702, 0.09999999999999913, 215.0, 889, 701825, 902, 46.201916699999856
903, 6.449461711391026, 21.061658231351657, 25.376557857208674, 0.10000000000000021, 80.0, 726, 702551, 903, 37.341071799999554
904, 4.767410530645024, 21.079044014830284, 25.34910694913419, 0.09999999999999896, 235.0, 921, 703472, 904, 45.58193759999995
905, 3.4496007185131465, 21.01074972578546, 25.264750416281316, 0.09999999999999876, 220.0, 963, 704435, 905, 47.480361099998845
906, 3.5293312136466817, 20.998963788291004, 25.291990248956413, 0.1000000000000008, 110.0, 428, 704863, 906, 22.31835880000108
907, 4.542546764689441, 21.026983098216657, 25.331271020989668, 0.09999999999999856, 395.0, 1007, 705870, 907, 52.64390100000128
908, 9.256586360873172, 21.090222746521967, 25.530983459759724, 0.1000000000000005, 180.0, 691, 706561, 908, 34.807936100000006
909, 4.442347691184775, 21.01383802082464, 25.285833543522067, 0.09999999999999838, 295.0, 1053, 707614, 909, 56.48019039999963
910, 4.573664175068877, 20.965106621517496, 25.185051304519558, 0.09999999999999977, 215.0, 785, 708399, 910, 42.50314050000088
911, 3.9211208562799325, 21.003975142831877, 25.28273448793907, 0.10000000000000099, 210.0, 635, 709034, 911, 33.17699720000019
912, 2.8954806476285206, 20.96320793286097, 25.24312273847742, 0.10000000000000059, 195.0, 682, 709716, 912, 35.386872900000526
913, 6.14010689934979, 21.348624539999438, 25.779635090852906, 0.0999999999999988, 320.0, 955, 710671, 913, 50.047624000000724
914, 4.841758206526039, 21.409258370162817, 25.770707103241836, 0.09999999999999883, 210.0, 947, 711618, 914, 46.25239820000024
915, 5.7105889642094025, 21.426542652263795, 25.852461586101356, 0.1000000000000007, 90.0, 371, 711989, 915, 17.4358658000001
916, 3.0242057215023253, 21.39505190849304, 25.719957447052003, 0.10000000000000094, 50.0, 560, 712549, 916, 26.57844380000097
917, 3.902992340146437, 21.471840105113195, 25.870249006169786, 0.10000000000000064, 160.0, 676, 713225, 917, 35.7617580999995
918, 4.8897120504157385, 21.36295086937229, 25.758102998942356, 0.10000000000000056, 135.0, 685, 713910, 918, 36.03750519999994
919, 6.730258254206363, 21.375097329379948, 25.712549624552253, 0.10000000000000091, 50.0, 524, 714434, 919, 29.869943100000455
920, 4.861425689967541, 21.404078611012164, 25.80312622210075, 0.09999999999999892, 355.0, 928, 715362, 920, 43.00563720000173
921, 6.002997382700912, 21.44556605271467, 25.855265880194235, 0.09999999999999769, 315.0, 1270, 716632, 921, 56.05925559999923
922, 4.18306675459714, 21.434903967977178, 25.81652926132311, 0.09999999999999869, 260.0, 979, 717611, 922, 44.33907200000067
923, 4.346089767336072, 21.362332256335133, 25.711486139387453, 0.09999999999999935, 330.0, 848, 718459, 923, 41.17409840000073
924, 3.715705666738825, 21.41341570829734, 25.766318242977828, 0.0999999999999998, 105.0, 780, 719239, 924, 39.447514800000135
925, 4.026718476658962, 21.364846826772222, 25.72949752182257, 0.10000000000000053, 25.0, 305, 719544, 925, 15.464176499999667
926, 5.5381134335290305, 21.457772162827577, 25.86420193043622, 0.10000000000000066, 75.0, 352, 719896, 926, 18.308385800000906
927, 5.163293340783742, 21.43920209047929, 25.803548135847414, 0.09999999999999935, 240.0, 848, 720744, 927, 46.16624860000047
928, 5.623286089289092, 21.448378927989673, 25.820331946752404, 0.09999999999999891, 225.0, 930, 721674, 928, 49.6348952999997
929, 3.4346982697227806, 21.3385671332331, 25.71141431827356, 0.09999999999999855, 345.0, 1010, 722684, 929, 56.58989660000043
930, 3.765764233938678, 21.364790134742613, 25.709656510196748, 0.0999999999999987, 425.0, 976, 723660, 930, 53.233531399999265
931, 4.710231970538612, 21.40819389599712, 25.81272854845063, 0.09999999999999791, 450.0, 1190, 724850, 931, 65.68935989999954
932, 6.800190799533943, 21.414495194623917, 25.851587329419132, 0.09999999999999974, 180.0, 788, 725638, 932, 40.735099999999875
933, 6.898725975536357, 21.48519665058948, 25.98827673486397, 0.10000000000000091, 95.0, 531, 726169, 933, 27.794594799999686
934, 4.205045339760613, 21.378938330649074, 25.74010079023238, 0.09999999999999715, 290.0, 1518, 727687, 934, 80.23032030000104
935, 3.3445961679739082, 21.4092713869535, 25.773717865934962, 0.10000000000000091, 110.0, 533, 728220, 935, 28.78739029999997
936, 3.4703139509237664, 21.400165531110297, 25.71767955073802, 0.09999999999999733, 300.0, 1426, 729646, 936, 75.00189510000018
937, 4.463002716184004, 21.385759502876805, 25.771650973167127, 0.10000000000000091, 40.0, 524, 730170, 937, 28.54700100000082
938, 3.494109289487824, 21.519611617693535, 25.892845733807636, 0.09999999999999945, 200.0, 832, 731002, 938, 45.19587969999884
939, 2.6783502432793562, 21.498382930941123, 25.834981230272856, 0.0999999999999981, 305.0, 1131, 732133, 939, 60.36619249999967
940, 5.120795058504839, 21.581639670874775, 26.021245579159665, 0.09999999999999769, 415.0, 1269, 733402, 940, 63.66364500000054
941, 4.470296830003991, 21.560112469867594, 25.98560049742171, 0.09999999999999847, 270.0, 1030, 734432, 941, 56.626718400000755
942, 4.420711048035579, 21.489519875430496, 25.904401749078573, 0.1000000000000009, 100.0, 507, 734939, 942, 26.989884200000233
943, 3.3628963629586552, 21.545488698711953, 25.93267540951653, 0.09999999999999878, 135.0, 956, 735895, 943, 53.18540849999954
944, 2.890317270539517, 21.527685458080356, 25.88221252104086, 0.09999999999999988, 260.0, 769, 736664, 944, 41.33686800000032
945, 8.339341528864875, 21.525214432978977, 25.935194927713145, 0.10000000000000052, 120.0, 690, 737354, 945, 35.76629730000059
946, 4.680968863213328, 21.550698563804545, 25.927686606243157, 0.09999999999999885, 440.0, 942, 738296, 946, 50.736393499999394
947, 6.958320759916048, 21.558902453659172, 25.962020035076858, 0.09999999999999834, 275.0, 1064, 739360, 947, 56.62757280000005
948, 4.874713669109237, 21.763950590239155, 26.25518378584196, 0.09999999999999752, 370.0, 1338, 740698, 948, 69.84194320000097
949, 2.1482636243869098, 21.79682546273256, 26.158504740397134, 0.10000000000000073, 75.0, 390, 741088, 949, 20.879638200000045
950, 5.360533630774712, 21.81353198452933, 26.254458408431702, 0.09999999999999999, 280.0, 753, 741841, 950, 40.08951440000055
951, 3.7230244794695437, 21.805809827394125, 26.240675486794, 0.09999999999999973, 205.0, 790, 742631, 951, 42.36545780000051
952, 3.94351771774551, 22.105795676322312, 26.59685030427582, 0.10000000000000082, 55.0, 451, 743082, 952, 24.2360007999996
953, 5.172026114485429, 21.909920490878612, 26.40697869141395, 0.10000000000000099, 50.0, 634, 743716, 953, 34.00707610000063
954, 5.324737217825586, 21.9339809738557, 26.425980865504183, 0.09999999999999791, 270.0, 1189, 744905, 954, 62.8332203000009
955, 3.4262282421116437, 21.871423020991084, 26.290304097449546, 0.09999999999999894, 265.0, 926, 745831, 955, 49.82937250000032
956, 4.115224792328257, 21.93480520760453, 26.400604356855354, 0.09999999999999791, 365.0, 1192, 747023, 956, 62.52813529999912
957, 3.316825950103257, 21.89685701788604, 26.32020445644135, 0.09999999999999801, 395.0, 1158, 748181, 957, 49.84951550000005
958, 4.624796503250024, 21.934638596506392, 26.41700613578209, 0.09999999999999692, 455.0, 1649, 749830, 958, 73.2582652000001
959, 7.975556327539949, 22.154992684305714, 26.83501911696109, 0.10000000000000028, 80.0, 716, 750546, 959, 40.98112089999995
960, 3.3009909780363165, 22.200813242691098, 26.658347775274358, 0.10000000000000091, 105.0, 526, 751072, 960, 28.83211239999946
961, 3.9977663890986714, 22.22959281980377, 26.787196842665526, 0.10000000000000073, 105.0, 388, 751460, 961, 16.020754099999976
962, 2.885950255914525, 22.113664463162422, 26.57245952103819, 0.09999999999999909, 315.0, 896, 752356, 962, 35.900117899998804
963, 3.2918281726523837, 22.2228329871959, 26.729153255172825, 0.10000000000000087, 105.0, 487, 752843, 963, 20.011897600001248
964, 3.714609026027149, 22.23269883932682, 26.770094764303174, 0.1000000000000009, 40.0, 507, 753350, 964, 21.10836940000081
965, 4.324481039750349, 22.150157137855963, 26.703603125195016, 0.09999999999999801, 385.0, 1158, 754508, 965, 45.23919539999952
966, 4.600177735108808, 22.11323897677114, 26.63501750900451, 0.09999999999999858, 210.0, 1004, 755512, 966, 40.24906859999828
967, 5.676896496379113, 22.26995999821813, 26.891944647708655, 0.10000000000000092, 140.0, 546, 756058, 967, 21.940336099998603
968, 4.890994144746226, 22.1389071980098, 26.712045439434714, 0.09999999999999928, 285.0, 862, 756920, 968, 34.600981199999296
969, 6.099105503644001, 22.20577728364953, 26.786751287089373, 0.10000000000000087, 175.0, 653, 757573, 969, 26.178750999999465
970, 2.2509970371695145, 22.081253273358485, 26.52908439161372, 0.10000000000000023, 215.0, 723, 758296, 970, 29.13689979999981
971, 2.99538149109879, 22.195632218654136, 26.72265440341178, 0.10000000000000024, 140.0, 722, 759018, 971, 30.873275699999795
972, 6.524977615970172, 22.256975451229952, 26.846621954493585, 0.1000000000000006, 150.0, 681, 759699, 972, 28.78012250000029
973, 3.4375524402826896, 22.033248754648064, 26.47616025321504, 0.09999999999999888, 200.0, 936, 760635, 973, 37.74619580000035
974, 6.886783379228842, 22.026730960065667, 26.542131066322327, 0.09999999999999702, 545.0, 1584, 762219, 974, 69.1168732999995
975, 3.1389938277578833, 22.02394931676511, 26.530655656672344, 0.09999999999999841, 265.0, 1046, 763265, 975, 45.93927729999996
976, 3.3715651619851212, 21.990657643552915, 26.428679893278836, 0.0999999999999982, 390.0, 1101, 764366, 976, 46.27914299999975
977, 6.705549897500789, 22.024496525332104, 26.614109157222988, 0.09999999999999895, 245.0, 922, 765288, 977, 39.05050549999942
978, 2.9587721020489846, 22.0455807099599, 26.524041116406494, 0.10000000000000038, 325.0, 706, 765994, 978, 29.16141389999757
979, 2.6487138434321364, 22.048999505101282, 26.497062874506074, 0.09999999999999805, 590.0, 1146, 767140, 979, 45.925363900001685
980, 5.252036594521999, 22.042233215332033, 26.56717474975586, 0.10000000000000099, 160.0, 625, 767765, 980, 25.249918500001513
981, 4.549969721013756, 22.026762737786918, 26.5187541990762, 0.0999999999999984, 285.0, 1049, 768814, 981, 44.41447909999988
982, 4.279925674954387, 22.017272873701554, 26.483792356775897, 0.09999999999999916, 225.0, 884, 769698, 982, 37.83267909999995
983, 4.241159011317151, 22.212410582328328, 26.72013619675928, 0.09999999999999869, 340.0, 980, 770678, 983, 43.455566100001306
984, 7.3905768447338716, 22.237917165886866, 26.90641018070587, 0.10000000000000069, 50.0, 365, 771043, 984, 14.647786800000176
985, 5.547130541495196, 22.196914567473186, 26.712922206899737, 0.10000000000000067, 55.0, 362, 771405, 985, 14.391556400001718
986, 8.415571283728262, 22.296134591404396, 26.878160005883327, 0.09999999999999973, 110.0, 790, 772195, 986, 31.321004299999913
987, 5.090223271160179, 22.259487454289047, 26.76362793132288, 0.0999999999999983, 280.0, 1073, 773268, 987, 44.23560230000294
988, 5.109802188798421, 22.282171750340922, 26.885125311124966, 0.10000000000000098, 135.0, 613, 773881, 988, 29.41720559999885
989, 2.7301104774956415, 22.224571738518453, 26.703248788849354, 0.09999999999999824, 265.0, 1091, 774972, 989, 43.71966070000053
990, 4.0502280326636875, 22.20224617840199, 26.705020277687673, 0.09999999999999833, 280.0, 1068, 776040, 990, 41.91508109999995
991, 4.959167597137166, 22.28646533315601, 26.877775292201743, 0.09999999999999812, 495.0, 1126, 777166, 991, 44.56058810000104
992, 2.258414578498804, 22.16777692203633, 26.660133122003568, 0.10000000000000063, 30.0, 342, 777508, 992, 13.388747599998169
993, 3.7828400858761966, 22.252133769883635, 26.788494638755616, 0.09999999999999826, 255.0, 1086, 778594, 993, 43.92334099999789
994, 5.0751609745993385, 22.343893257175097, 26.92693122511186, 0.0999999999999967, 380.0, 1796, 780390, 994, 74.89837350000016
995, 2.8175796562680073, 22.31565783213984, 26.811900479369367, 0.09999999999999956, 330.0, 815, 781205, 995, 33.03856739999901
996, 3.035702498666885, 22.32093677432856, 26.857649678641934, 0.10000000000000088, 175.0, 651, 781856, 996, 26.556914699998742
997, 3.466438064979779, 22.36379722846571, 26.925172136735547, 0.09999999999999847, 585.0, 1032, 782888, 997, 44.41277480000281
998, 6.024538194401222, 22.420727074494835, 27.077859608053465, 0.10000000000000057, 110.0, 684, 783572, 998, 28.858711900000344
999, 4.4662198998485385, 22.363679152597843, 26.970884159062457, 0.09999999999999752, 535.0, 1337, 784909, 999, 61.66138879999926
1000, 5.230351773477944, 22.29748267466479, 26.820282364835833, 0.0999999999999996, 165.0, 808, 785717, 1000, 40.55173869999999
1001, 5.6017956257613415, 22.42743945871254, 26.934154943176114, 0.09999999999999795, 340.0, 1177, 786894, 1001, 52.5746418000017
1002, 2.964435837598606, 22.36518490146152, 26.909519981511597, 0.09999999999999981, 245.0, 779, 787673, 1002, 32.108497799999896
1003, 2.1750197388355246, 22.393580979405186, 26.882777077058403, 0.10000000000000067, 75.0, 362, 788035, 1003, 14.971410599999217
1004, 3.1639480268457003, 22.33292033774721, 26.87157075683032, 0.10000000000000088, 95.0, 652, 788687, 1004, 26.799623599999904
1005, 5.593224469400679, 22.40749076905289, 27.009469014196213, 0.10000000000000069, 65.0, 369, 789056, 1005, 18.40046760000041
1006, 3.9493886571075465, 22.299298448820373, 26.871627799884692, 0.1000000000000001, 160.0, 740, 789796, 1006, 33.89839539999957
1007, 4.044476803072421, 22.543994680678832, 27.158926505214055, 0.09999999999999874, 255.0, 967, 790763, 1007, 48.08090699999957
1008, 6.80506780123774, 22.65357771528528, 27.35631837641939, 0.09999999999999887, 140.0, 940, 791703, 1008, 44.2593375999968
1009, 4.4243409483524205, 22.55163870941509, 27.11618620699102, 0.09999999999999917, 320.0, 880, 792583, 1009, 35.92052160000094
1010, 3.7345610185082987, 22.551092559561077, 27.112921155246863, 0.10000000000000092, 125.0, 542, 793125, 1010, 22.39886320000005
1011, 7.048924641189527, 22.689258337020874, 27.311373720363694, 0.10000000000000073, 75.0, 392, 793517, 1011, 16.190687700000126
1012, 6.257035368337799, 22.717527079194298, 27.361288388172287, 0.09999999999999967, 100.0, 799, 794316, 1012, 32.6891738000013
1013, 3.10528085387649, 22.54733157304167, 27.0757380058429, 0.10000000000000088, 170.0, 652, 794968, 1013, 35.13665769999716
1014, 4.148385188515527, 22.639944914430856, 27.302377681000927, 0.09999999999999773, 445.0, 1252, 796220, 1014, 54.18108790000042
1015, 3.6486208301613132, 22.586593812115716, 27.150232184086747, 0.09999999999999891, 225.0, 932, 797152, 1015, 39.21121990000029
1016, 4.65301242031157, 22.62368839263916, 27.220918891906738, 0.10000000000000088, 55.0, 500, 797652, 1016, 20.266135399997438
1017, 4.785336287124046, 22.64257066130178, 27.21821573618296, 0.1000000000000009, 25.0, 518, 798170, 1017, 21.086240499997075
1018, 3.30035646832575, 22.623813434372977, 27.20003667915947, 0.10000000000000091, 90.0, 519, 798689, 1018, 21.772655799999484
1019, 5.076767682201332, 22.550713143940843, 27.160302255667894, 0.09999999999999991, 220.0, 765, 799454, 1019, 31.39892549999786
1020, 7.166264149979382, 22.584587950906354, 27.27541027811473, 0.10000000000000071, 210.0, 668, 800122, 1020, 35.17675010000312
1021, 3.4301084646703717, 22.52152763499577, 27.022640175674063, 0.10000000000000052, 330.0, 689, 800811, 1021, 35.52618009999787
1022, 3.9121776645134343, 22.412959477862515, 26.96122003510297, 0.0999999999999982, 350.0, 1102, 801913, 1022, 52.62031180000122
1023, 6.017890073925026, 22.347181089534317, 26.901965633658477, 0.10000000000000095, 180.0, 645, 802558, 1023, 29.393893299999036
1024, 4.15859306961298, 22.48719967594853, 27.06926636589898, 0.10000000000000066, 55.0, 675, 803233, 1024, 28.368988600002922
1025, 3.896481882700755, 22.327958699315786, 26.861439181491733, 0.09999999999999849, 340.0, 1024, 804257, 1025, 42.725392600001214
1026, 5.06935273360014, 22.535409338378905, 27.141891116333007, 0.10000000000000099, 210.0, 625, 804882, 1026, 25.650171500001306
1027, 3.4739544508965268, 22.411927210411175, 26.93720103638829, 0.09999999999999873, 255.0, 969, 805851, 1027, 39.8181422000016
1028, 3.864418353651998, 22.457123323789514, 26.987273538919318, 0.10000000000000074, 105.0, 399, 806250, 1028, 16.834456900000077
1029, 5.349680713167156, 22.59591554277756, 27.220515345632098, 0.09999999999999877, 175.0, 959, 807209, 1029, 39.79867279999962
1030, 5.121378500853162, 22.532788467991406, 27.13530698487076, 0.10000000000000087, 125.0, 653, 807862, 1030, 26.983892899999773
1031, 4.838718528927941, 22.396481714750593, 26.96110975165116, 0.09999999999999881, 175.0, 950, 808812, 1031, 39.36698940000133
1032, 4.835507359207116, 22.390119287781033, 26.989418339694094, 0.10000000000000063, 150.0, 677, 809489, 1032, 28.349268800000573
1033, 3.3721876035209832, 22.614587628022406, 27.238956608663077, 0.09999999999999759, 495.0, 1310, 810799, 1033, 54.832037899999705
1034, 3.0982429209035756, 22.864184066949303, 27.495925726480042, 0.09999999999999785, 455.0, 1208, 812007, 1034, 49.98924679999982
1035, 4.7711323100891585, 22.878115668165204, 27.51749688247713, 0.10000000000000085, 115.0, 471, 812478, 1035, 19.750834099999338
1036, 2.9046676429862877, 22.86383407553848, 27.485651551460734, 0.09999999999999869, 520.0, 980, 813458, 1036, 40.7600182999995
1037, 8.381051784765457, 22.96991355863438, 27.716346393438695, 0.1000000000000004, 135.0, 703, 814161, 1037, 29.524080800001684
1038, 5.0352491232894225, 22.894093528941827, 27.601780118765653, 0.09999999999999927, 320.0, 864, 815025, 1038, 35.92608420000033
1039, 7.518014809103816, 22.915409240105962, 27.681280301294482, 0.09999999999999926, 275.0, 866, 815891, 1039, 36.455450699999346
1040, 6.0446160582049435, 22.832120901346208, 27.458182833592097, 0.09999999999999877, 210.0, 960, 816851, 1040, 40.32817100000102
1041, 7.18233755617565, 22.897842563519166, 27.592683725545186, 0.10000000000000081, 120.0, 659, 817510, 1041, 27.594326399997954
1042, 6.210277998850284, 22.897409929903013, 27.614828526002963, 0.10000000000000098, 205.0, 614, 818124, 1042, 25.613498800001253
1043, 4.100174566632052, 22.900277407558118, 27.542289664562652, 0.09999999999999852, 270.0, 1018, 819142, 1043, 42.55080839999937
1044, 4.781467809458084, 22.817076884359352, 27.464617642489348, 0.10000000000000091, 125.0, 649, 819791, 1044, 27.772486599998956
1045, 6.981779321799498, 23.174697583288793, 28.006864518460716, 0.10000000000000073, 35.0, 391, 820182, 1045, 16.844101599999703
1046, 4.322991490151686, 23.100235365951345, 27.80477821976456, 0.09999999999999919, 155.0, 877, 821059, 1046, 37.030233400000725
1047, 3.173977685069737, 23.01085933945653, 27.65236752960024, 0.10000000000000066, 200.0, 674, 821733, 1047, 28.405580499998905
1048, 7.1112637260127585, 23.211755724095585, 27.99702113810194, 0.10000000000000012, 120.0, 737, 822470, 1048, 30.879048999999213
1049, 7.586773710623137, 23.09139397861939, 27.831509008691487, 0.09999999999999903, 440.0, 907, 823377, 1049, 38.517155900000944
1050, 3.261193753215445, 23.094103099919167, 27.783501892730968, 0.10000000000000096, 65.0, 595, 823972, 1050, 25.137862799998402
1051, 6.065279063356548, 23.11853391685705, 27.88132818402915, 0.0999999999999974, 465.0, 1392, 825364, 1051, 63.8434797000009
1052, 4.751342602201145, 23.07948700586955, 27.77008591637467, 0.10000000000000091, 70.0, 528, 825892, 1052, 28.428680900000472
1053, 5.300247736608449, 23.116112599357628, 27.89138870726759, 0.10000000000000099, 85.0, 626, 826518, 1053, 30.146148199997697
1054, 5.992295274624204, 23.1334220149662, 27.919132887393555, 0.09999999999999941, 260.0, 839, 827357, 1054, 37.992128500001854
1055, 4.282230120449295, 23.12337184363398, 27.791052234583887, 0.09999999999999892, 310.0, 928, 828285, 1055, 41.76758889999837
1056, 4.896786795208311, 23.051608268074368, 27.751941299438478, 0.09999999999999896, 170.0, 920, 829205, 1056, 42.54125899999781
1057, 5.5942726575139545, 23.129160182159797, 27.94085088857254, 0.09999999999999834, 225.0, 1063, 830268, 1057, 45.98904680000123
1058, 4.25391238157271, 22.889589305693747, 27.55948693430732, 0.09999999999999731, 545.0, 1431, 831699, 1058, 61.909794899998815
1059, 5.525843971166538, 22.893092951654914, 27.572394102693707, 0.09999999999999715, 505.0, 1514, 833213, 1059, 65.72934309999982
1060, 2.3644526225889657, 22.969938963522644, 27.606821712477384, 0.09999999999999895, 210.0, 924, 834137, 1060, 46.545647999999346
1061, 5.706207817356864, 22.955452260645952, 27.67433223670179, 0.1000000000000004, 140.0, 704, 834841, 1061, 36.04466450000109
1062, 5.302350485891993, 22.917697767001478, 27.68604404677206, 0.1000000000000007, 65.0, 670, 835511, 1062, 29.96403480000299
1063, 2.3672032251067106, 22.935589694976805, 27.593207200368244, 0.10000000000000078, 25.0, 420, 835931, 1063, 22.672092200002226
1064, 4.984128402951447, 22.88339763248668, 27.52528829574585, 0.1000000000000006, 110.0, 680, 836611, 1064, 33.60621059999903
1065, 2.247232752489744, 22.89554901601879, 27.466335109088213, 0.10000000000000085, 40.0, 478, 837089, 1065, 26.657305199998518
1066, 11.43570373742714, 22.970595531776304, 27.85738954387727, 0.10000000000000069, 75.0, 366, 837455, 1066, 18.603310300000885
1067, 8.858706767319319, 23.006870516732377, 27.859851774105355, 0.10000000000000067, 75.0, 363, 837818, 1067, 17.502051499999652
1068, 4.759533323995793, 22.94558466697226, 27.650305427362788, 0.09999999999999891, 200.0, 931, 838749, 1068, 40.49013969999942
1069, 3.05219589111805, 22.919724365234377, 27.536733483886717, 0.10000000000000099, 155.0, 625, 839374, 1069, 27.252644000000146
1070, 4.065636818572816, 23.087381352214624, 27.811787737703256, 0.10000000000000031, 110.0, 713, 840087, 1070, 33.14425400000255
1071, 5.671551421676449, 23.74136554886934, 28.589948807255368, 0.09999999999999826, 615.0, 1084, 841171, 1071, 48.64420219999738
1072, 4.4557504948957005, 23.76650222479964, 28.63118310640644, 0.09999999999999909, 225.0, 895, 842066, 1072, 40.09436210000058
1073, 4.437003250583461, 23.730181589475105, 28.517014360903108, 0.10000000000000098, 140.0, 602, 842668, 1073, 26.532742499999586
1074, 3.711643143246571, 23.75342131442711, 28.584490687469316, 0.09999999999999822, 140.0, 1098, 843766, 1074, 49.42280530000062
1075, 7.836588222727728, 23.781547259699348, 28.696379369021926, 0.10000000000000088, 135.0, 652, 844418, 1075, 33.20546169999943
1076, 5.464416590391671, 23.742130629003864, 28.57723683527071, 0.10000000000000096, 200.0, 584, 845002, 1076, 26.523412999998982
1077, 6.4679579450600775, 23.833282322428673, 28.74082548795235, 0.10000000000000095, 130.0, 566, 845568, 1077, 25.348556100001588
1078, 4.736204313509578, 23.780164337473206, 28.65825071578967, 0.09999999999999785, 410.0, 1211, 846779, 1078, 57.1774519999999
1079, 6.561839242936296, 23.87440597391426, 28.713097788439967, 0.10000000000000087, 60.0, 481, 847260, 1079, 21.398350199997367
1080, 3.8477714626001798, 23.762480529699513, 28.572124499043536, 0.09999999999999831, 195.0, 1069, 848329, 1080, 47.72144540000227
1081, 3.018750798366769, 23.727661022965197, 28.561225819213227, 0.0999999999999988, 315.0, 955, 849284, 1081, 42.19822789999671
1082, 4.286547979864857, 23.829529960374327, 28.701719968983134, 0.10000000000000099, 150.0, 621, 849905, 1082, 27.605243499998323
1083, 6.060721772435244, 24.95330570232613, 30.084289437040276, 0.10000000000000085, 120.0, 654, 850559, 1083, 30.065331900001183
1084, 3.403356353005637, 25.038889289524246, 30.095715730086617, 0.10000000000000095, 110.0, 575, 851134, 1084, 25.816491500001575
1085, 3.8072806662314584, 25.092668060652553, 30.21149157436654, 0.09999999999999898, 235.0, 916, 852050, 1085, 40.986076299999695
1086, 5.296901725095421, 25.10552255742432, 30.254033079904573, 0.09999999999999679, 610.0, 1738, 853788, 1086, 77.75499599999966
1087, 3.388234065508193, 25.11281056748223, 30.195354531896307, 0.10000000000000062, 170.0, 679, 854467, 1087, 30.14171510000233
1088, 3.2966544764309096, 25.173430448789208, 30.284215257459298, 0.100000000000001, 110.0, 638, 855105, 1088, 30.049087899998995
1089, 5.753741685642639, 25.028555113128398, 30.163919208384517, 0.10000000000000045, 95.0, 698, 855803, 1089, 35.06380050000007
1090, 8.57508912247194, 25.083361974982328, 30.095938557802246, 0.10000000000000053, 180.0, 688, 856491, 1090, 30.587732299998606
1091, 4.298291953171898, 25.2113171736562, 30.1706316253912, 0.09999999999999869, 175.0, 977, 857468, 1091, 48.16325890000007
1092, 4.592957097207934, 25.104230594918, 30.20465222593585, 0.10000000000000066, 135.0, 674, 858142, 1092, 35.52083979999952
1093, 4.142248838035197, 25.193700530611235, 30.197048151082004, 0.10000000000000095, 110.0, 580, 858722, 1093, 30.455251999999746
1094, 7.617884446493528, 25.154331279347943, 30.416755841006797, 0.10000000000000009, 205.0, 741, 859463, 1094, 60.522360599999956
1095, 6.046478615141069, 25.12329216222339, 30.22735018572814, 0.10000000000000045, 100.0, 697, 860160, 1095, 51.39694479999889
1096, 5.667165516292751, 25.107741087631204, 30.291453795510293, 0.10000000000000062, 215.0, 679, 860839, 1096, 47.26953399999911
1097, 3.6153976633442175, 25.093753342544165, 30.212838347159575, 0.1000000000000009, 125.0, 509, 861348, 1097, 32.23899700000038
1098, 5.379684285398962, 25.120569270892734, 30.282758789340946, 0.09999999999999952, 155.0, 822, 862170, 1098, 51.26184439999997
1099, 6.424339784010039, 25.237486500817248, 30.36851172251244, 0.09999999999999964, 60.0, 803, 862973, 1099, 53.59388849999959
1100, 4.159781138428581, 25.13288238003488, 30.23778655655635, 0.09999999999999816, 255.0, 1111, 864084, 1100, 72.05429020000156
1101, 4.097074657347864, 25.072056166769574, 30.183936067019385, 0.0999999999999969, 725.0, 1667, 865751, 1101, 104.36222320000161
1102, 3.994118898865749, 25.09990836292588, 30.158466552607337, 0.09999999999999827, 390.0, 1081, 866832, 1102, 69.68432349999784
1103, 7.000489280875726, 25.025954681945496, 30.170096215184213, 0.09999999999999962, 140.0, 806, 867638, 1103, 51.18321020000076
1104, 6.496218323982421, 25.200179298113323, 30.354528078386664, 0.09999999999999774, 330.0, 1247, 868885, 1104, 78.5576097000012
1105, 3.079297484524336, 25.059994672529026, 30.140678361938612, 0.09999999999999899, 150.0, 914, 869799, 1105, 57.78706979999697
1106, 3.822017304906814, 25.141081192703677, 30.227063259532706, 0.10000000000000091, 80.0, 533, 870332, 1106, 32.4602718999995
1107, 4.463760286645493, 25.147511729967412, 30.276144600886035, 0.10000000000000096, 40.0, 589, 870921, 1107, 38.63066819999949
1108, 3.8084061312022977, 25.177945403301994, 30.318183277219276, 0.09999999999999958, 125.0, 813, 871734, 1108, 52.20574250000209
1109, 4.360995471921512, 25.206244269082713, 30.310381135275197, 0.10000000000000053, 225.0, 688, 872422, 1109, 44.39069319999908
1110, 3.9636352010410585, 25.106891494548297, 30.242499049293475, 0.09999999999999837, 245.0, 1054, 873476, 1110, 68.83527599999798
1111, 5.294503786584787, 25.19870793952516, 30.39844699719686, 0.10000000000000099, 100.0, 627, 874103, 1111, 44.411327699999674
1112, 4.465203482888166, 25.182678185976467, 30.302548124638687, 0.0999999999999979, 205.0, 1196, 875299, 1112, 75.70221719999972
1113, 4.928175317034553, 25.22377859103452, 30.35304261468778, 0.09999999999999772, 320.0, 1256, 876555, 1113, 75.22009999999864
1114, 5.558939563050503, 25.209588280654536, 30.339903032256334, 0.09999999999999849, 470.0, 1025, 877580, 1114, 64.56808529999762
1115, 2.9575386329201065, 25.150099654124507, 30.238029657879572, 0.09999999999999937, 250.0, 847, 878427, 1115, 54.81810770000084
1116, 5.283057501305815, 25.25654766916746, 30.41653626746977, 0.09999999999999865, 155.0, 988, 879415, 1116, 65.31598529999974
1117, 5.492985614506822, 25.33206161197863, 30.490692817955686, 0.09999999999999806, 130.0, 1140, 880555, 1117, 74.0563183000013
1118, 4.090437246798913, 25.3655204378053, 30.528826354206473, 0.09999999999999874, 300.0, 966, 881521, 1118, 60.18227549999938
1119, 5.010211223140474, 25.27304119009876, 30.440531124840195, 0.10000000000000092, 95.0, 647, 882168, 1119, 40.178147500002524
1120, 5.354726755700264, 25.368145965286907, 30.55854721882897, 0.10000000000000078, 35.0, 422, 882590, 1120, 26.118417300000146
1121, 3.7500185738232545, 25.353176162141196, 30.477703685928375, 0.09999999999999722, 525.0, 1477, 884067, 1121, 92.3504408000008
1122, 4.119693877082459, 25.293974012181547, 30.40025678452854, 0.10000000000000078, 210.0, 661, 884728, 1122, 41.62303370000154
1123, 8.981096572157487, 25.51079792939415, 30.80160396487214, 0.10000000000000095, 140.0, 645, 885373, 1123, 39.74465439999767
1124, 7.687485319762668, 25.367132464541665, 30.584235210660136, 0.09999999999999973, 255.0, 790, 886163, 1124, 49.64441409999927
1125, 6.303991678315796, 25.41016850229037, 30.590173215822006, 0.10000000000000091, 100.0, 649, 886812, 1125, 41.35457799999858
1126, 2.3285174786753973, 25.309516306375063, 30.437399165544004, 0.10000000000000067, 65.0, 359, 887171, 1126, 22.9216731000015
1127, 4.577226909510429, 25.405790893776903, 30.594853104896917, 0.10000000000000099, 140.0, 618, 887789, 1127, 40.051660700002685
1128, 7.1757000400833295, 25.42119267733862, 30.61978784600521, 0.10000000000000091, 60.0, 533, 888322, 1128, 32.3659047000001
1129, 6.790835682957014, 25.42823847697747, 30.68483671182951, 0.10000000000000038, 110.0, 706, 889028, 1129, 44.09248680000019
1130, 3.6259476637665164, 25.324953259410947, 30.486996180450863, 0.09999999999999924, 150.0, 868, 889896, 1130, 54.75512009999875
1131, 4.220496987190563, 25.25107050836086, 30.377815634012222, 0.100000000000001, 200.0, 640, 890536, 1131, 40.39457119999861
1132, 5.787032093433401, 25.178781117551992, 30.22417569831433, 0.09999999999999833, 220.0, 1066, 891602, 1132, 67.48122330000115
1133, 5.735812451722605, 25.388884615198112, 30.479592845435793, 0.09999999999999801, 290.0, 1158, 892760, 1133, 73.06496350000089
1134, 4.785322742637046, 25.21979484634247, 30.354153486544977, 0.10000000000000088, 100.0, 501, 893261, 1134, 32.7133759999997
1135, 4.4069129649667715, 25.284001869673464, 30.452894789061396, 0.10000000000000077, 55.0, 663, 893924, 1135, 43.08385520000229
1136, 4.178202815324211, 25.239715157041125, 30.33531135510487, 0.09999999999999772, 400.0, 1256, 895180, 1136, 79.28679660000125
1137, 4.385339410221281, 25.202062794218598, 30.318859597758703, 0.09999999999999824, 205.0, 1089, 896269, 1137, 68.88663540000198
1138, 4.684907983787157, 25.265109385553682, 30.42801959391601, 0.09999999999999958, 255.0, 814, 897083, 1138, 52.59982800000216
1139, 2.294737856587375, 25.136487780920394, 30.24078025956252, 0.09999999999999949, 175.0, 827, 897910, 1139, 52.982823800000915
1140, 4.302370189746332, 25.264101284176277, 30.404777159237995, 0.10000000000000028, 115.0, 716, 898626, 1140, 46.741649399999005
1141, 3.482410316807356, 25.185633848209193, 30.30573331247462, 0.09999999999999855, 245.0, 1010, 899636, 1141, 63.59260050000012
1142, 6.110509542849319, 25.229414293564947, 30.427795392921173, 0.10000000000000075, 75.0, 664, 900300, 1142, 40.67751219999991
1143, 4.427503454601153, 25.31174713330391, 30.45467857752091, 0.0999999999999987, 230.0, 975, 901275, 1143, 61.16490829999748
1144, 3.567428915215519, 25.349214126124526, 30.48797956359335, 0.09999999999999802, 600.0, 1155, 902430, 1144, 75.23530199999732
1145, 2.327596938760499, 25.20624728458537, 30.288958456237985, 0.10000000000000099, 30.0, 634, 903064, 1145, 39.39600299999802
1146, 5.3129619344538686, 25.36063693213637, 30.5834282349496, 0.09999999999999822, 215.0, 1096, 904160, 1146, 71.10173940000095
1147, 5.077024761210202, 25.233769854626278, 30.343634686093058, 0.10000000000000024, 145.0, 721, 904881, 1147, 45.84106570000222
1148, 2.300251316256866, 25.187855455927743, 30.261307832485663, 0.10000000000000088, 110.0, 501, 905382, 1148, 31.64853900000162
1149, 3.1468944295503647, 25.28956612316262, 30.40674454022914, 0.09999999999999935, 270.0, 849, 906231, 1149, 54.14061969999966
1150, 5.18667844863141, 25.280169436153418, 30.426579701109887, 0.0999999999999971, 515.0, 1538, 907769, 1150, 98.72681720000037
1151, 2.8934945886568078, 25.284980254103303, 30.4117552819242, 0.0999999999999988, 185.0, 954, 908723, 1151, 60.39971460000015
1152, 2.383335721442539, 25.31839469738221, 30.403982646813553, 0.10000000000000081, 25.0, 445, 909168, 1152, 28.219017000003078
1153, 3.9888983083770455, 25.372358096128256, 30.550628981838337, 0.10000000000000064, 80.0, 346, 909514, 1153, 22.422964900000807
1154, 4.882749338138928, 25.28480491993275, 30.40534700484986, 0.1, 230.0, 752, 910266, 1154, 48.6260231999986
1155, 3.4059794451903413, 25.246254613664416, 30.376492867646395, 0.10000000000000092, 60.0, 540, 910806, 1155, 34.98860960000093
1156, 4.134931432486359, 25.16700390025751, 30.277961311055652, 0.09999999999999831, 165.0, 1072, 911878, 1156, 71.0729657999982
1157, 6.347016886193469, 25.43485972608639, 30.528146438934236, 0.10000000000000059, 170.0, 682, 912560, 1157, 45.07212319999962
1158, 4.763391324804136, 25.19917855880467, 30.30623414643102, 0.0999999999999983, 325.0, 1073, 913633, 1158, 71.02983019999738
1159, 4.525299688113443, 25.299510937382056, 30.40732057280504, 0.09999999999999727, 370.0, 1449, 915082, 1159, 94.96325129999968
1160, 6.231025329111396, 25.389464404131914, 30.579423437605392, 0.10000000000000074, 130.0, 666, 915748, 1160, 44.03178350000235
1161, 5.343286156211749, 25.317732737324025, 30.49380061461194, 0.09999999999999855, 225.0, 1010, 916758, 1161, 76.44714520000343
1162, 6.95882662691463, 25.346912352084313, 30.476670928137185, 0.10000000000000096, 110.0, 597, 917355, 1162, 43.536466499997914
1163, 6.094008442294796, 25.304332781459074, 30.450095650083593, 0.09999999999999742, 440.0, 1382, 918737, 1163, 91.96770760000072
1164, 4.472163657181793, 25.25459336704678, 30.384738821453517, 0.10000000000000067, 75.0, 360, 919097, 1164, 24.082080700001825
1165, 4.518427050777433, 25.307015611788454, 30.45107866741037, 0.10000000000000094, 110.0, 559, 919656, 1165, 36.7913965000007
1166, 5.1707736947401255, 25.6179752835521, 30.842479747754556, 0.09999999999999927, 220.0, 864, 920520, 1166, 56.80244490000041
1167, 5.989491107744756, 25.936599837908954, 31.249966750354886, 0.09999999999999767, 385.0, 1272, 921792, 1167, 83.27244490000157
1168, 5.176882123829053, 25.904920544191743, 31.152034660076822, 0.09999999999999877, 150.0, 959, 922751, 1168, 62.90262830000211
1169, 2.043717653506039, 25.88823597207254, 31.09747164288937, 0.10000000000000067, 10.0, 362, 923113, 1169, 23.822663200000534
1170, 4.389942943079056, 25.915566518342942, 31.205283746635505, 0.09999999999999773, 320.0, 1251, 924364, 1170, 82.33357610000166
1171, 5.051460049589831, 25.904011505423462, 31.138793312380667, 0.10000000000000071, 120.0, 669, 925033, 1171, 44.14928280000095
1172, 4.733521927759967, 25.867421841754595, 31.163558834225107, 0.09999999999999909, 235.0, 895, 925928, 1172, 58.799969300001976
1173, 6.449434212272769, 25.962097390539714, 31.2374822822244, 0.10000000000000063, 165.0, 677, 926605, 1173, 45.48004700000092
1174, 3.7871848104627635, 25.931452309213032, 31.137920255583477, 0.10000000000000087, 95.0, 492, 927097, 1174, 32.928429399999004
1175, 4.5855266042526255, 25.940552969563587, 31.220108770164828, 0.09999999999999884, 160.0, 946, 928043, 1175, 62.025633299999754
1176, 5.2811529996746165, 25.888383899723088, 31.14972768388353, 0.09999999999999913, 375.0, 888, 928931, 1176, 59.110565800001496
1177, 3.8863657086636554, 25.91907547610289, 31.161478566227476, 0.09999999999999878, 355.0, 958, 929889, 1177, 62.64439119999952
1178, 4.122852320364125, 25.988659194336492, 31.25907238086281, 0.0999999999999982, 300.0, 1101, 930990, 1178, 73.11016569999992
1179, 4.943488606309891, 26.15895080871582, 31.31275701599121, 0.10000000000000099, 105.0, 625, 931615, 1179, 42.00104729999657
1180, 4.352452012666565, 26.067966072137605, 31.343413852182106, 0.09999999999999817, 460.0, 1108, 932723, 1180, 74.0450454999991
1181, 6.767962827223592, 26.03728254706459, 31.17827399009097, 0.10000000000000082, 30.0, 452, 933175, 1181, 29.857166900001175
1182, 5.1794557783893325, 26.21076289358813, 31.458483294388216, 0.09999999999999845, 395.0, 1033, 934208, 1182, 69.2154675999991
1183, 5.1446246251324625, 26.003103192562413, 31.295210401588513, 0.10000000000000003, 160.0, 749, 934957, 1183, 50.931528099998104
1184, 3.5297673533374643, 25.93816052928958, 31.18652686016205, 0.10000000000000055, 80.0, 686, 935643, 1184, 47.99904550000065
1185, 3.7029913965219294, 26.030902606656092, 31.263770779911777, 0.09999999999999963, 155.0, 805, 936448, 1185, 53.52882370000225
1186, 6.515389722846119, 26.046004326997604, 31.389367901118455, 0.09999999999999905, 245.0, 904, 937352, 1186, 60.87786469999992
1187, 3.3265415529410043, 25.880311687787373, 31.089305887035295, 0.09999999999999956, 120.0, 816, 938168, 1187, 53.776844100000744
1188, 4.680278062344517, 25.959837821086598, 31.22183966741688, 0.09999999999999902, 170.0, 908, 939076, 1188, 63.121398999999656
1189, 5.014393981589163, 25.96920582029777, 31.298951862491315, 0.0999999999999988, 185.0, 953, 940029, 1189, 63.64137050000136
1190, 4.150988876944249, 25.947781367816003, 31.188700564288737, 0.09999999999999828, 500.0, 1076, 941105, 1190, 71.78841330000068
1191, 2.65478070049852, 25.956482572344107, 31.173821837648905, 0.09999999999999931, 210.0, 857, 941962, 1191, 56.42763709999781
1192, 5.195115284643229, 25.913582193090562, 31.221380301884242, 0.09999999999999758, 590.0, 1316, 943278, 1192, 89.0112289000026
1193, 2.484390229788556, 25.959820833863485, 31.18811225429844, 0.09999999999999949, 325.0, 827, 944105, 1193, 56.40234269999928
1194, 5.614314989185333, 26.036470611572266, 31.31759788208008, 0.10000000000000099, 115.0, 625, 944730, 1194, 42.157319100002496
1195, 4.8009648704696035, 25.959569113049096, 31.281342202532507, 0.10000000000000088, 25.0, 499, 945229, 1195, 34.81343689999994
1196, 4.374998363798478, 25.9547153196306, 31.18198220751437, 0.10000000000000078, 180.0, 662, 945891, 1196, 44.29393579999669
1197, 3.667471075779098, 26.004813940628715, 31.275585625257293, 0.09999999999999835, 450.0, 1058, 946949, 1197, 71.68515340000158
1198, 3.79884645030646, 25.96346166666778, 31.220545289619118, 0.09999999999999724, 605.0, 1463, 948412, 1198, 99.21487759999945
1199, 3.830950726933684, 26.037538294851952, 31.31150584464593, 0.09999999999999844, 260.0, 1037, 949449, 1199, 72.30351390000214
1200, 3.829869098698198, 25.860742339498422, 31.1031830284506, 0.09999999999999903, 150.0, 906, 950355, 1200, 61.63048720000006
1201, 2.604867633906709, 25.99431351643459, 31.236583071909134, 0.10000000000000099, 145.0, 628, 950983, 1201, 44.067479000001185
1202, 4.161178809188724, 25.900694945334145, 31.176151869971562, 0.0999999999999999, 190.0, 767, 951750, 1202, 53.808009700002
1203, 7.4312820773156245, 25.97325649513865, 31.32364784702236, 0.10000000000000091, 60.0, 529, 952279, 1203, 37.6533574999994
1204, 5.720789106200473, 25.947838829998584, 31.266400308010223, 0.0999999999999976, 305.0, 1306, 953585, 1204, 89.50173749999885
1205, 4.29691096542276, 25.84607729359975, 31.148337709443858, 0.10000000000000066, 150.0, 674, 954259, 1205, 47.80727809999735
1206, 8.733000695615647, 25.948953663010194, 31.321690953878992, 0.10000000000000088, 105.0, 498, 954757, 1206, 34.49949299999935
1207, 4.507279342692245, 25.993985367234583, 31.228426839264348, 0.09999999999999895, 185.0, 923, 955680, 1207, 64.234825800002
1208, 4.975854557628433, 25.948785450266694, 31.267433443288695, 0.10000000000000046, 110.0, 696, 956376, 1208, 48.0697719000018
1209, 6.695205565115815, 25.962854881963786, 31.26687522940852, 0.09999999999999853, 170.0, 1014, 957390, 1209, 70.68997690000106
1210, 3.651682627470649, 25.867484469389797, 31.056082124566313, 0.09999999999999862, 140.0, 995, 958385, 1210, 70.45171159999882
1211, 3.471858445862726, 25.918999792739783, 31.159101192075187, 0.09999999999999769, 300.0, 1271, 959656, 1211, 87.95284989999709
1212, 6.201635041147027, 26.178056631727195, 31.55660170183584, 0.09999999999999962, 70.0, 806, 960462, 1212, 56.709152899999026
1213, 6.412681224171225, 26.324364429883627, 31.7190275293255, 0.10000000000000078, 200.0, 661, 961123, 1213, 47.45110829999976
1214, 3.8834624400678672, 26.276591894761573, 31.5172609905027, 0.10000000000000091, 110.0, 530, 961653, 1214, 35.9719408000019
1215, 5.714690314199047, 26.184649087179032, 31.52363346784543, 0.0999999999999981, 485.0, 1131, 962784, 1215, 70.31300589999955
1216, 5.821566621246546, 26.280177684696127, 31.708311768748874, 0.10000000000000073, 70.0, 391, 963175, 1216, 23.682551999998395
1217, 4.351657525823993, 26.296684895893645, 31.638613950907793, 0.09999999999999995, 165.0, 759, 963934, 1217, 46.32699700000012
1218, 9.027375929326478, 26.307554307167134, 31.70920290741571, 0.0999999999999993, 285.0, 859, 964793, 1218, 57.950484799999685
1219, 7.6141818448497185, 26.308201450749657, 31.714708421725053, 0.09999999999999877, 180.0, 959, 965752, 1219, 66.27370000000155
1220, 4.049847655204976, 26.279473729338626, 31.581686498718685, 0.10000000000000024, 170.0, 721, 966473, 1220, 50.969560999998066
1221, 5.3677746856463004, 26.243082370914397, 31.564936053557474, 0.0999999999999987, 160.0, 976, 967449, 1221, 68.69684099999722
1222, 4.1860277310664795, 26.201590393584908, 31.540086648070698, 0.09999999999999847, 310.0, 1030, 968479, 1222, 71.90832890000092
1223, 5.875541305945565, 26.313681218359207, 31.715283097161187, 0.10000000000000026, 195.0, 720, 969199, 1223, 47.46244519999891
1224, 5.903934046789946, 26.276041790862287, 31.705867843825327, 0.09999999999999985, 80.0, 773, 969972, 1224, 51.13365949999934
1225, 5.67621791263214, 27.409652475026554, 32.942980485569706, 0.10000000000000085, 85.0, 479, 970451, 1225, 30.994544199998927
1226, 5.481210096610603, 27.493237075398643, 33.09540094535027, 0.09999999999999686, 515.0, 1687, 972138, 1226, 110.56379770000058
1227, 2.710350499976249, 27.552919387817383, 33.074725756569514, 0.10000000000000071, 105.0, 378, 972516, 1227, 24.7263114999987
1228, 4.766491247111179, 27.556233665790963, 33.16152546659429, 0.09999999999999887, 180.0, 940, 973456, 1228, 62.0258748999986
1229, 7.105615574532404, 27.740175954468917, 33.409923658153936, 0.10000000000000005, 135.0, 747, 974203, 1229, 49.599137499997596
1230, 3.321040357434662, 27.459873247597873, 32.991405192233785, 0.09999999999999881, 355.0, 951, 975154, 1230, 63.223942100001295
1231, 7.716318766202065, 27.57911724942796, 33.12287636411951, 0.09999999999999887, 160.0, 940, 976094, 1231, 63.95936650000294
1232, 4.145568974602506, 27.429549643730084, 32.98624206156612, 0.09999999999999694, 605.0, 1639, 977733, 1232, 87.967184000001
1233, 4.882316419779288, 27.539818910570933, 33.175006325472886, 0.10000000000000098, 125.0, 617, 978350, 1233, 32.40477159999864
1234, 2.4719605171447143, 27.371528821022626, 32.8931046189933, 0.0999999999999983, 670.0, 1073, 979423, 1234, 52.78685089999999
1235, 3.81370634391256, 27.820947582194396, 33.49174447230896, 0.09999999999999835, 395.0, 1058, 980481, 1235, 53.15307559999928
1236, 5.220148476560035, 28.079234441121418, 33.765857892589594, 0.1000000000000006, 130.0, 681, 981162, 1236, 34.23538479999843
1237, 8.416046137398089, 28.221524520453414, 33.95869527293931, 0.10000000000000087, 160.0, 653, 981815, 1237, 32.75233180000214
1238, 5.450369211740272, 28.198642856686615, 33.90683867521064, 0.0999999999999983, 265.0, 1075, 982890, 1238, 52.96492930000022
1239, 5.611886592606557, 28.391970214506664, 34.23162102172582, 0.10000000000000062, 160.0, 679, 983569, 1239, 34.155333800001245
1240, 3.1853720217943193, 28.14880338238843, 33.8109872564415, 0.09999999999999926, 390.0, 865, 984434, 1240, 46.40269050000279
1241, 3.5547198839429286, 28.28993777103395, 34.042661897714126, 0.10000000000000078, 135.0, 661, 985095, 1241, 35.213971799999854
1242, 3.7239144184526234, 28.089765991863263, 33.79679036760862, 0.10000000000000092, 130.0, 538, 985633, 1242, 28.739402100000007
1243, 6.50808103031618, 28.231440997219984, 34.06648810426448, 0.10000000000000007, 345.0, 743, 986376, 1243, 40.014552199998434
1244, 3.5393147080698433, 28.240651143875915, 33.94651906630572, 0.10000000000000095, 80.0, 578, 986954, 1244, 30.842662300001393
1245, 5.624070193682664, 28.1362128399534, 33.897503376753306, 0.100000000000001, 135.0, 639, 987593, 1245, 34.20681540000078
1246, 5.8382939700956955, 28.213211023896708, 34.008714901836136, 0.09999999999999964, 365.0, 802, 988395, 1246, 42.87919300000067
1247, 6.242754023078148, 28.19276069918231, 33.98286053054584, 0.09999999999999917, 270.0, 881, 989276, 1247, 47.487458499999775
1248, 7.408740134637054, 28.31109261808561, 34.10790034973296, 0.10000000000000075, 20.0, 403, 989679, 1248, 21.40481450000152
1249, 2.699094299510689, 28.350547301267575, 34.04230057595966, 0.0999999999999986, 240.0, 998, 990677, 1249, 53.68616789999942
1250, 3.4106668126956916, 28.66086837584185, 34.427454067181934, 0.09999999999999924, 225.0, 869, 991546, 1250, 46.5808627999977
1251, 4.725234248906891, 28.606635479568745, 34.39615027844791, 0.09999999999999844, 310.0, 1038, 992584, 1251, 55.43716180000047
1252, 5.629896967132161, 28.650429581854294, 34.51081589575633, 0.09999999999999722, 315.0, 1479, 994063, 1252, 79.01366209999833
1253, 5.233491056108307, 28.606013578302043, 34.42026866235609, 0.0999999999999986, 215.0, 997, 995060, 1253, 53.677147700000205
1254, 4.524010113951847, 28.574303225509944, 34.356887711509486, 0.09999999999999797, 220.0, 1171, 996231, 1254, 63.185758200001146
1255, 6.578745909788131, 28.659199319094373, 34.442703833946815, 0.10000000000000077, 175.0, 663, 996894, 1255, 35.948823200000334
1256, 4.999004105516658, 28.519421250801386, 34.30841167705265, 0.1000000000000009, 75.0, 508, 997402, 1256, 27.21836020000046
1257, 4.12225922996678, 28.533166292237073, 34.32285879104118, 0.10000000000000087, 135.0, 492, 997894, 1257, 26.544724600000336
1258, 5.632245764356891, 28.46076768009286, 34.24538026044243, 0.10000000000000098, 145.0, 608, 998502, 1258, 33.1375177000009
1259, 6.7578850102245696, 28.5727421329348, 34.35940852710946, 0.09999999999999833, 245.0, 1066, 999568, 1259, 57.665826199998264
