,loss,mae,mean_q,mean_eps,episode_reward,nb_episode_steps,nb_steps,episode,duration
0,0,0,0,0,55.0,399,399,0,0.9887306999999996
1, 0, 0, 0, 0, 155.0, 502, 901, 1, 1.1467516999999994
2, 0, 0, 0, 0, 135.0, 674, 1575, 2, 1.548380700000001
3, 0, 0, 0, 0, 50.0, 539, 2114, 3, 1.2886521999999996
4, 0, 0, 0, 0, 105.0, 748, 2862, 4, 1.7002695999999986
5, 0, 0, 0, 0, 55.0, 408, 3270, 5, 0.8670290999999999
6, 0, 0, 0, 0, 65.0, 375, 3645, 6, 0.8139362000000006
7, 0, 0, 0, 0, 45.0, 383, 4028, 7, 0.8328075999999989
8, 0, 0, 0, 0, 110.0, 616, 4644, 8, 1.2855033999999996
9, 0, 0, 0, 0, 460.0, 968, 5612, 9, 1.985022100000002
10, 0, 0, 0, 0, 155.0, 1100, 6712, 10, 2.256483499999998
11, 0, 0, 0, 0, 70.0, 477, 7189, 11, 1.004555100000001
12, 0, 0, 0, 0, 105.0, 606, 7795, 12, 1.2498955999999986
13, 0, 0, 0, 0, 180.0, 955, 8750, 13, 1.9755604999999967
14, 0, 0, 0, 0, 450.0, 1382, 10132, 14, 2.7834380000000003
15, 0, 0, 0, 0, 160.0, 631, 10763, 15, 1.3209434999999985
16, 0, 0, 0, 0, 215.0, 900, 11663, 16, 1.8453812999999997
17, 0, 0, 0, 0, 125.0, 815, 12478, 17, 1.6891145000000023
18, 0, 0, 0, 0, 215.0, 1419, 13897, 18, 3.0350613000000024
19, 0, 0, 0, 0, 80.0, 373, 14270, 19, 0.8128255999999965
20, 0, 0, 0, 0, 80.0, 592, 14862, 20, 1.2599514999999997
21, 0, 0, 0, 0, 480.0, 953, 15815, 21, 1.9618072999999967
22, 0, 0, 0, 0, 125.0, 753, 16568, 22, 1.5766583000000054
23, 0, 0, 0, 0, 180.0, 612, 17180, 23, 1.2953114000000028
24, 0, 0, 0, 0, 80.0, 515, 17695, 24, 1.0877504999999985
25, 0, 0, 0, 0, 230.0, 723, 18418, 25, 1.5412107000000006
26, 0, 0, 0, 0, 50.0, 391, 18809, 26, 0.8465010999999976
27, 0, 0, 0, 0, 245.0, 1224, 20033, 27, 2.514489300000001
28, 0, 0, 0, 0, 80.0, 385, 20418, 28, 0.8269979999999961
29, 0, 0, 0, 0, 155.0, 623, 21041, 29, 1.3252809000000028
30, 0, 0, 0, 0, 55.0, 516, 21557, 30, 1.1032313000000045
31, 0, 0, 0, 0, 285.0, 1030, 22587, 31, 2.2106828000000007
32, 0, 0, 0, 0, 60.0, 500, 23087, 32, 1.0641018999999972
33, 0, 0, 0, 0, 115.0, 608, 23695, 33, 1.293271599999997
34, 0, 0, 0, 0, 50.0, 607, 24302, 34, 1.2806150999999986
35, 0, 0, 0, 0, 180.0, 730, 25032, 35, 1.5321440999999965
36, 0, 0, 0, 0, 210.0, 794, 25826, 36, 1.6528455999999991
37, 0, 0, 0, 0, 145.0, 781, 26607, 37, 1.6248337000000106
38, 0, 0, 0, 0, 65.0, 577, 27184, 38, 1.2069451999999927
39, 0, 0, 0, 0, 110.0, 611, 27795, 39, 1.2981550000000084
40, 0, 0, 0, 0, 80.0, 650, 28445, 40, 1.3585653999999892
41, 0, 0, 0, 0, 120.0, 497, 28942, 41, 1.0723732999999953
42, 0, 0, 0, 0, 210.0, 1232, 30174, 42, 2.5386924999999962
43, 0, 0, 0, 0, 75.0, 655, 30829, 43, 1.3835949999999997
44, 0, 0, 0, 0, 170.0, 532, 31361, 44, 1.13951449999999
45, 0, 0, 0, 0, 215.0, 979, 32340, 45, 2.058995699999997
46, 0, 0, 0, 0, 65.0, 593, 32933, 46, 1.254646799999989
47, 0, 0, 0, 0, 120.0, 667, 33600, 47, 1.3968353000000064
48, 0, 0, 0, 0, 45.0, 562, 34162, 48, 1.1966223000000014
49, 0, 0, 0, 0, 165.0, 978, 35140, 49, 2.128471399999995
50, 0, 0, 0, 0, 10.0, 444, 35584, 50, 0.9399753999999945
51, 0, 0, 0, 0, 355.0, 940, 36524, 51, 1.9361951000000062
52, 0, 0, 0, 0, 80.0, 718, 37242, 52, 1.5092738999999966
53, 0, 0, 0, 0, 65.0, 613, 37855, 53, 1.291858099999999
54, 0, 0, 0, 0, 275.0, 1024, 38879, 54, 2.1000508999999994
55, 0, 0, 0, 0, 285.0, 884, 39763, 55, 1.8280603000000042
56, 0, 0, 0, 0, 105.0, 546, 40309, 56, 1.148042899999993
57, 0, 0, 0, 0, 460.0, 1450, 41759, 57, 2.9147846999999985
58, 0, 0, 0, 0, 30.0, 396, 42155, 58, 0.8416033999999968
59, 0, 0, 0, 0, 515.0, 1074, 43229, 59, 2.2074850000000055
60, 0, 0, 0, 0, 210.0, 821, 44050, 60, 1.7212176999999969
61, 0, 0, 0, 0, 105.0, 523, 44573, 61, 1.1218839000000003
62, 0, 0, 0, 0, 120.0, 691, 45264, 62, 1.4799165999999957
63, 0, 0, 0, 0, 180.0, 909, 46173, 63, 1.9081249000000042
64, 0, 0, 0, 0, 240.0, 821, 46994, 64, 1.729916000000003
65, 0, 0, 0, 0, 110.0, 708, 47702, 65, 1.488222499999992
66, 0, 0, 0, 0, 100.0, 578, 48280, 66, 1.306122099999996
67, 0, 0, 0, 0, 5.0, 577, 48857, 67, 1.2852062000000046
68, 0, 0, 0, 0, 100.0, 715, 49572, 68, 1.497767500000009
69, 0, 0, 0, 0, 145.0, 499, 50071, 69, 1.0609786999999926
70, 0, 0, 0, 0, 55.0, 518, 50589, 70, 1.1096976999999981
71, 0, 0, 0, 0, 120.0, 638, 51227, 71, 1.3680183999999969
72, 0, 0, 0, 0, 155.0, 641, 51868, 72, 1.3900328999999942
73, 0, 0, 0, 0, 185.0, 735, 52603, 73, 1.6066442000000052
74, 0, 0, 0, 0, 185.0, 941, 53544, 74, 1.943256599999998
75, 0, 0, 0, 0, 45.0, 421, 53965, 75, 0.8827107000000041
76, 0, 0, 0, 0, 45.0, 529, 54494, 76, 1.1247716999999966
77, 0, 0, 0, 0, 50.0, 396, 54890, 77, 0.8438591000000031
78, 0, 0, 0, 0, 365.0, 1164, 56054, 78, 2.3765566000000007
79, 0, 0, 0, 0, 110.0, 696, 56750, 79, 1.4463077000000055
80, 0, 0, 0, 0, 215.0, 819, 57569, 80, 1.6791867000000025
81, 0, 0, 0, 0, 50.0, 536, 58105, 81, 1.1508220999999992
82, 0, 0, 0, 0, 135.0, 690, 58795, 82, 1.4540307000000041
83, 0, 0, 0, 0, 210.0, 645, 59440, 83, 1.3647738999999888
84, 0, 0, 0, 0, 180.0, 643, 60083, 84, 1.3613961000000074
85, 0, 0, 0, 0, 30.0, 478, 60561, 85, 1.0378275999999858
86, 0, 0, 0, 0, 55.0, 534, 61095, 86, 1.1287221999999986
87, 0, 0, 0, 0, 75.0, 679, 61774, 87, 1.397367700000018
88, 0, 0, 0, 0, 455.0, 1211, 62985, 88, 2.4530809999999974
89, 0, 0, 0, 0, 65.0, 402, 63387, 89, 0.8508221000000162
90, 0, 0, 0, 0, 80.0, 538, 63925, 90, 1.1163158999999894
91, 0, 0, 0, 0, 605.0, 1360, 65285, 91, 2.8542171999999937
92, 0, 0, 0, 0, 160.0, 730, 66015, 92, 1.5241126999999892
93, 0, 0, 0, 0, 75.0, 493, 66508, 93, 1.0615118000000052
94, 0, 0, 0, 0, 420.0, 947, 67455, 94, 1.9518185000000017
95, 0, 0, 0, 0, 335.0, 1077, 68532, 95, 2.255240200000003
96, 0, 0, 0, 0, 240.0, 1015, 69547, 96, 2.054984100000013
97, 0, 0, 0, 0, 275.0, 836, 70383, 97, 1.7161759999999902
98, 0, 0, 0, 0, 50.0, 343, 70726, 98, 0.7365788999999836
99, 0, 0, 0, 0, 60.0, 382, 71108, 99, 0.817377300000004
100, 0, 0, 0, 0, 295.0, 948, 72056, 100, 1.9242253999999832
101, 0, 0, 0, 0, 340.0, 1165, 73221, 101, 2.368199599999997
102, 0, 0, 0, 0, 115.0, 612, 73833, 102, 1.3101061999999786
103, 0, 0, 0, 0, 15.0, 499, 74332, 103, 1.0435420000000022
104, 0, 0, 0, 0, 135.0, 493, 74825, 104, 1.0475348000000224
105, 0, 0, 0, 0, 210.0, 651, 75476, 105, 1.3536608
106, 0, 0, 0, 0, 155.0, 638, 76114, 106, 1.3532510000000002
107, 0, 0, 0, 0, 120.0, 512, 76626, 107, 1.0876288999999986
108, 0, 0, 0, 0, 215.0, 881, 77507, 108, 1.8487004999999783
109, 0, 0, 0, 0, 155.0, 671, 78178, 109, 1.4230796999999882
110, 0, 0, 0, 0, 95.0, 498, 78676, 110, 1.0511595000000113
111, 0, 0, 0, 0, 160.0, 856, 79532, 111, 1.7847140000000081
112, 0, 0, 0, 0, 55.0, 483, 80015, 112, 1.0400444999999934
113, 0, 0, 0, 0, 275.0, 897, 80912, 113, 1.8633092000000033
114, 0, 0, 0, 0, 40.0, 504, 81416, 114, 1.1456316000000015
115, 0, 0, 0, 0, 160.0, 775, 82191, 115, 1.6031475000000057
116, 0, 0, 0, 0, 140.0, 677, 82868, 116, 1.4223263000000088
117, 0, 0, 0, 0, 110.0, 670, 83538, 117, 1.4311154999999758
118, 0, 0, 0, 0, 110.0, 438, 83976, 118, 0.9215186999999787
119, 0, 0, 0, 0, 225.0, 929, 84905, 119, 1.892317399999996
120, 0, 0, 0, 0, 85.0, 641, 85546, 120, 1.3470891999999992
121, 0, 0, 0, 0, 205.0, 984, 86530, 121, 2.053656100000012
122, 0, 0, 0, 0, 225.0, 1228, 87758, 122, 2.5571305999999936
123, 0, 0, 0, 0, 385.0, 860, 88618, 123, 1.8070602999999892
124, 0, 0, 0, 0, 125.0, 561, 89179, 124, 1.1864987000000156
125, 0, 0, 0, 0, 155.0, 714, 89893, 125, 1.5105424000000198
126, 0, 0, 0, 0, 155.0, 565, 90458, 126, 1.2072886000000267
127, 0, 0, 0, 0, 35.0, 393, 90851, 127, 0.8424716000000103
128, 0, 0, 0, 0, 105.0, 570, 91421, 128, 1.2104917999999998
129, 0, 0, 0, 0, 40.0, 543, 91964, 129, 1.1681288999999992
130, 0, 0, 0, 0, 435.0, 1262, 93226, 130, 2.5893236
131, 0, 0, 0, 0, 115.0, 564, 93790, 131, 1.180223600000005
132, 0, 0, 0, 0, 170.0, 814, 94604, 132, 1.692699900000008
133, 0, 0, 0, 0, 175.0, 1005, 95609, 133, 2.0792894999999874
134, 0, 0, 0, 0, 155.0, 569, 96178, 134, 1.1888165999999956
135, 0, 0, 0, 0, 30.0, 442, 96620, 135, 0.9372663000000045
136, 0, 0, 0, 0, 160.0, 992, 97612, 136, 2.0787663000000123
137, 0, 0, 0, 0, 475.0, 919, 98531, 137, 1.948653500000006
138, 0, 0, 0, 0, 105.0, 538, 99069, 138, 1.1394202999999834
139, 0, 0, 0, 0, 30.0, 423, 99492, 139, 0.9220609999999851
140, 476.40955977006394, 58.40259049155495, 89.70376777648926, 0.9099797500000002, 120.0, 553, 100045, 140, 1.8343629999999962
141, 77.84955667173911, 58.13046084117497, 74.7747461923356, 0.9097412499999996, 30.0, 486, 100531, 141, 4.3968907
142, 43.681880867171905, 57.69613565989359, 71.7356114263782, 0.9092971000000003, 100.0, 501, 101032, 142, 4.5603366999999935
143, 42.412883212548174, 57.49684228969894, 71.06836850406559, 0.9088358500000001, 145.0, 524, 101556, 143, 5.0349121999999795
144, 37.64779176612349, 57.790029979887464, 70.99410822444122, 0.9082126000000001, 205.0, 861, 102417, 144, 7.849844399999995
145, 33.202386597056446, 57.501213079617344, 70.58244744642282, 0.9075335500000001, 305.0, 648, 103065, 145, 5.999530399999998
146, 36.735114844477906, 57.42904562852821, 70.3494220558478, 0.9070655499999998, 100.0, 392, 103457, 146, 4.081974800000012
147, 34.222388633120985, 57.34340373861854, 70.0831464177661, 0.9066402999999998, 100.0, 553, 104010, 147, 5.080932299999972
148, 32.7026959711469, 57.535534512118886, 70.31882899957145, 0.906202, 5.0, 421, 104431, 148, 3.8823442999999997
149, 29.905796832802856, 57.55835226553458, 70.22113117641872, 0.9056480500000005, 410.0, 810, 105241, 149, 7.205847399999982
150, 31.164395582521117, 57.60667855398996, 70.13705942228243, 0.9049370500000005, 135.0, 770, 106011, 150, 7.057291399999997
151, 34.51688845434854, 57.679478419104285, 70.3721419992373, 0.9043002999999997, 180.0, 645, 106656, 151, 5.958218699999975
152, 30.875411452592836, 57.55588963792947, 70.08620886186182, 0.9036689499999996, 285.0, 758, 107414, 152, 6.913975499999992
153, 28.647086806574688, 57.44130683539647, 69.85407143484522, 0.9030029500000003, 185.0, 722, 108136, 153, 6.635912700000006
154, 30.390575572361133, 57.59148582879962, 69.9831846080208, 0.9022789000000003, 330.0, 887, 109023, 154, 8.11119610000003
155, 29.027838081337716, 57.573058871641564, 69.85181989517544, 0.9015696999999999, 155.0, 689, 109712, 155, 6.34061539999999
156, 36.77580166203635, 58.821665593556, 71.46963018689837, 0.9010076499999998, 125.0, 560, 110272, 156, 5.240835899999979
157, 32.20034864106154, 59.83184481393262, 72.48816636371129, 0.90057835, 80.0, 394, 110666, 157, 3.7344540999999936
158, 30.015498304367064, 59.860468244552614, 72.5658699798584, 0.90022105, 50.0, 400, 111066, 158, 3.7279295999999817
159, 26.310883848434653, 59.67431688764583, 72.39953395923739, 0.8998056999999995, 80.0, 523, 111589, 159, 4.907933200000002
160, 20.3747585942195, 59.44032823415903, 71.98741888192984, 0.8992778500000005, 110.0, 650, 112239, 160, 6.033498500000007
161, 22.47915457102878, 59.35345894049022, 71.90090126749195, 0.8986041999999996, 210.0, 847, 113086, 161, 7.880251600000008
162, 19.190083727060063, 59.46721103919788, 71.95206573609549, 0.8978886999999998, 210.0, 743, 113829, 162, 6.967660199999955
163, 19.572655496473836, 59.47381782531738, 72.01600777215556, 0.89727625, 130.0, 618, 114447, 163, 5.768706100000031
164, 22.364165889692007, 59.5783689918758, 72.1136931989178, 0.8966404000000004, 210.0, 795, 115242, 164, 7.471467999999959
165, 23.605162169925126, 59.628717094762216, 72.10650882524314, 0.8960207500000003, 155.0, 582, 115824, 165, 5.397594999999967
166, 21.658649364659485, 59.49988728375502, 71.87987928793464, 0.8954393499999994, 175.0, 710, 116534, 166, 6.655122600000027
167, 19.03947466018831, 59.42529043419566, 71.68162404747073, 0.894853, 55.0, 593, 117127, 167, 5.577337199999988
168, 18.659944450533068, 59.51342032406781, 71.84085983843417, 0.8943197499999997, 15.0, 592, 117719, 168, 5.580233099999987
169, 17.643845155634033, 59.51024693214089, 71.88654676098034, 0.8936866000000004, 180.0, 815, 118534, 169, 7.47774830000003
170, 18.857105073589963, 59.31033683428304, 71.53418190467175, 0.8931425499999999, 20.0, 394, 118928, 170, 3.885809600000016
171, 19.60508255627629, 59.61580378776093, 71.97498941271087, 0.8926799499999994, 75.0, 634, 119562, 171, 5.571574499999997
172, 19.0548124787102, 59.567460680110926, 71.75914526294683, 0.8921863000000001, 80.0, 463, 120025, 172, 4.1416878
173, 30.870060968548525, 60.41136680052946, 72.94147050791773, 0.8916908500000003, 120.0, 638, 120663, 173, 5.362389499999949
174, 23.907548517794222, 60.53940720991655, 73.09653829063771, 0.8912206, 45.0, 407, 121070, 174, 3.840449299999989
175, 21.7646395923188, 60.21920359356803, 72.81173781282413, 0.8907476500000002, 40.0, 644, 121714, 175, 5.448225100000002
176, 27.1325050536324, 60.35828533172607, 72.99602275175207, 0.8903048499999999, 50.0, 340, 122054, 176, 3.0813679999999977
177, 18.771265216307206, 60.058753764990605, 72.52967670325077, 0.8898548499999995, 125.0, 660, 122714, 177, 5.608710299999984
178, 21.630407182260413, 60.15324930384539, 72.67643330523357, 0.8890921000000003, 285.0, 1035, 123749, 178, 9.223332200000016
179, 17.670920420228764, 60.11878543429904, 72.44918854197908, 0.8882659000000002, 180.0, 801, 124550, 179, 6.919880500000033
180, 20.19732583074405, 60.065370335122296, 72.4828824413066, 0.8876188, 120.0, 637, 125187, 180, 5.795482800000002
181, 19.54734257572804, 60.17915812022354, 72.84901094374638, 0.8869860999999993, 190.0, 769, 125956, 181, 6.8706052
182, 20.260080952740644, 60.02362687960434, 72.50879278874879, 0.8860384000000006, 390.0, 1337, 127293, 182, 11.864557199999979
183, 20.45812629866721, 60.21028613075992, 72.72554913148058, 0.8850821500000001, 180.0, 788, 128081, 183, 7.070379500000001
184, 17.92646683488688, 60.16866928731008, 72.5917660904574, 0.8841938499999995, 185.0, 1186, 129267, 184, 11.745271099999968
185, 17.883741669229583, 60.36280594740692, 72.60770765880028, 0.883423, 50.0, 527, 129794, 185, 4.805557399999998
186, 24.190875371026426, 61.537256400061224, 74.15753427924655, 0.8829216999999995, 80.0, 587, 130381, 186, 5.440884400000016
187, 23.847074674317618, 62.299052998090794, 74.97060082863933, 0.8822948500000002, 170.0, 806, 131187, 187, 7.493727699999965
188, 27.405534409148036, 62.451027247189735, 75.3041053512148, 0.8816414499999997, 210.0, 646, 131833, 188, 6.0460919999999305
189, 23.720000632569928, 62.3337979041024, 75.00352982841672, 0.8811406000000004, 80.0, 467, 132300, 189, 4.396222399999942
190, 24.09655002800815, 62.29627276041422, 75.00335999760762, 0.8807063500000001, 75.0, 498, 132798, 190, 4.7449444000000085
191, 26.01845780952827, 62.11577271148042, 74.78482744977191, 0.8801604999999999, 215.0, 715, 133513, 191, 6.651682100000016
192, 23.859892355299543, 62.1633425635853, 74.61620038679277, 0.8795255500000002, 210.0, 696, 134209, 192, 6.305721400000039
193, 26.262426224721743, 62.20767280473138, 74.89383044733613, 0.8789193999999997, 125.0, 651, 134860, 193, 5.890806699999985
194, 26.418213816425745, 62.31527901890382, 74.90250160201357, 0.8781953499999996, 460.0, 958, 135818, 194, 8.760285799999906
195, 24.17941751266061, 62.29728779590635, 74.9029101707097, 0.8775837999999999, 30.0, 401, 136219, 195, 3.6900890000000572
196, 25.63204046033604, 62.33119439768698, 75.01714288242772, 0.8770573000000003, 185.0, 769, 136988, 196, 7.016790900000046
197, 28.79631982284807, 62.45437136167809, 75.22262106195602, 0.8764745500000002, 85.0, 526, 137514, 197, 4.6110007000000905
198, 24.870134537147752, 62.187480134675, 74.69795079086767, 0.8759408499999994, 120.0, 660, 138174, 198, 6.077966100000026
199, 24.666715042407695, 62.29897909311148, 74.871447460468, 0.8753513500000003, 110.0, 650, 138824, 199, 5.937770399999977
200, 23.157977773529193, 62.23999446210986, 74.7503501201727, 0.8744770000000004, 215.0, 1293, 140117, 200, 11.78899869999998
201, 16.318239465385975, 62.83493696270567, 75.57187074603456, 0.8736724000000001, 90.0, 495, 140612, 201, 4.570967400000086
202, 14.298093575738662, 62.85326745656616, 75.60459906295691, 0.8730468999999993, 210.0, 895, 141507, 202, 8.22546120000004
203, 12.87776307437731, 62.675381100696065, 75.35685858519182, 0.8723957500000001, 85.0, 552, 142059, 203, 5.0643162000000075
204, 13.92574078613042, 62.63004134174839, 75.32881924831909, 0.8717599000000003, 410.0, 861, 142920, 204, 7.86013109999999
205, 13.270567488670348, 62.56782188415527, 75.31243796454535, 0.8711699500000003, 45.0, 450, 143370, 205, 4.192330599999991
206, 14.381792877491634, 62.68497226707023, 75.46462052972322, 0.8707546, 120.0, 473, 143843, 206, 4.402734600000031
207, 13.410183450506954, 62.73787030475896, 75.50514102098418, 0.8701727499999993, 185.0, 820, 144663, 207, 7.736321299999986
208, 15.66505763561103, 62.46515304419645, 75.25444707445278, 0.8695211500000002, 110.0, 628, 145291, 208, 5.89240749999999
209, 12.80659055944734, 62.65271282102087, 75.4172440026194, 0.8687818000000003, 195.0, 1015, 146306, 209, 9.562868999999978
210, 15.868788923950381, 62.76168363807845, 75.67899227838447, 0.8681401000000002, 105.0, 411, 146717, 210, 3.845269700000017
211, 13.831766662191837, 62.56330306682181, 75.21719214256774, 0.8677436499999999, 45.0, 470, 147187, 211, 4.428449799999953
212, 12.74020605134964, 62.288297134399414, 74.9152092590332, 0.8673071499999996, 75.0, 500, 147687, 212, 4.699869699999908
213, 13.747149780767936, 62.444849989149304, 75.17097245958117, 0.8667783999999998, 180.0, 675, 148362, 213, 6.3403580000000375
214, 14.238386619182034, 62.513064107822096, 75.22758421279092, 0.8662388499999997, 120.0, 524, 148886, 214, 4.993943400000035
215, 11.993289607273173, 62.491744752271735, 75.10666247704302, 0.8658334000000002, 35.0, 377, 149263, 215, 3.58461920000002
216, 12.915627633061325, 62.55394046850372, 75.223094190631, 0.8654072500000001, 80.0, 570, 149833, 216, 5.388793700000065
217, 10.883059963995581, 61.779599950238925, 74.3180624187322, 0.8649063999999999, 180.0, 543, 150376, 217, 5.162230099999988
218, 11.018141141650172, 61.802014845056135, 74.36093189963421, 0.8643276999999996, 110.0, 743, 151119, 218, 7.026687400000014
219, 8.73256200570969, 61.76374027835336, 74.27692602242634, 0.8637107500000002, 165.0, 628, 151747, 219, 5.9748945999999705
220, 10.080702617560348, 61.589743511550815, 74.12756795939167, 0.8629682500000001, 290.0, 1022, 152769, 220, 9.862321100000031
221, 10.318743051075545, 61.66368010786713, 74.29345608799835, 0.8621789499999999, 160.0, 732, 153501, 221, 7.2712271999999984
222, 9.946958597171752, 61.62607996221532, 74.22656341797527, 0.8615129499999996, 120.0, 748, 154249, 222, 7.503547300000037
223, 9.028409019039898, 61.77297726142697, 74.35087806887744, 0.8606228500000009, 240.0, 1230, 155479, 223, 12.504489600000056
224, 13.026046956618002, 61.75945840670368, 74.43097022449564, 0.8597264500000001, 145.0, 762, 156241, 224, 7.701836800000024
225, 12.953276490904594, 61.738455621271186, 74.37342395330822, 0.8591364999999995, 120.0, 549, 156790, 225, 5.511509499999988
226, 10.035509303251072, 61.747711629842655, 74.30896394495554, 0.8585447499999999, 135.0, 766, 157556, 226, 7.754084799999987
227, 12.882898260199505, 61.83073367954041, 74.48598083116994, 0.8578378000000003, 210.0, 805, 158361, 227, 8.171825600000034
228, 9.38421858655082, 61.710532150268556, 74.37196755303277, 0.8572730500000004, 60.0, 450, 158811, 228, 4.608284600000047
229, 10.348531697768914, 61.76312562540958, 74.30681040914435, 0.8567285500000003, 335.0, 760, 159571, 229, 7.661710999999968
230, 10.624001559271688, 62.03362979676201, 74.73990256724305, 0.8561444499999996, 80.0, 538, 160109, 230, 5.4915981999999985
231, 11.611758366765299, 63.00054309317659, 75.89807327479532, 0.8555409999999999, 210.0, 803, 160912, 231, 8.199727100000018
232, 9.197447277174343, 63.28002636525705, 76.10132563964515, 0.8548452999999999, 160.0, 743, 161655, 232, 7.605539000000022
233, 9.416651185630828, 63.01595971750658, 75.87661998955778, 0.8542787500000002, 155.0, 516, 162171, 233, 5.369025100000044
234, 11.460267818605844, 63.14864078205302, 76.02907535886985, 0.8536559499999998, 260.0, 868, 163039, 234, 8.941772799999967
235, 14.356705427855896, 63.20548939327542, 76.17547845634626, 0.8529526000000002, 105.0, 695, 163734, 235, 7.219171699999947
236, 9.492018073041226, 62.942400984515814, 75.78617907780036, 0.8523028000000005, 160.0, 749, 164483, 236, 7.730658500000004
237, 11.436710036868805, 63.14964725417672, 76.08605615312482, 0.8517196000000004, 135.0, 547, 165030, 237, 5.777984499999889
238, 10.583851028102004, 62.953555416830866, 75.72564645748812, 0.8511935500000001, 80.0, 622, 165652, 238, 6.5097279999999955
239, 12.611658663411665, 62.98527859994189, 75.890864370815, 0.8506152999999994, 120.0, 663, 166315, 239, 6.924012199999993
240, 13.358867222371728, 62.958404872393366, 75.9675482239386, 0.8500942000000002, 55.0, 495, 166810, 240, 5.143355100000008
241, 11.066210819296932, 63.017217361074536, 75.8261689502497, 0.8494876000000005, 255.0, 853, 167663, 241, 8.905624999999986
242, 8.500841705684875, 62.91192073219292, 75.64909136477596, 0.8486623000000005, 225.0, 981, 168644, 242, 10.209809999999948
243, 10.37960717623884, 63.27336457859386, 76.09498157501221, 0.8480228499999998, 120.0, 440, 169084, 243, 4.632431999999994
244, 11.201151468272748, 63.04958034777589, 75.93411285332724, 0.8476218999999998, 45.0, 451, 169535, 244, 4.762080399999945
245, 9.03051403207273, 63.116880024543555, 75.89146541778051, 0.8470710999999996, 135.0, 773, 170308, 245, 8.080016399999977
246, 11.777343647806054, 63.09180580856454, 76.00554965418628, 0.8461967500000003, 300.0, 1170, 171478, 246, 12.380781200000001
247, 12.980666805451838, 63.14086126202914, 76.16822755516473, 0.84549115, 125.0, 398, 171876, 247, 4.193094499999916
248, 10.054706198628208, 63.08693045608136, 75.88844571153656, 0.8450442999999996, 80.0, 595, 172471, 248, 6.301856799999996
249, 12.298174071963665, 63.12727046610283, 76.03905292415402, 0.8443814499999996, 155.0, 878, 173349, 249, 9.201170400000024
250, 9.54053530622931, 63.1450369867378, 75.95137458541446, 0.8436956499999998, 95.0, 646, 173995, 250, 6.841872299999977
251, 11.092451179194413, 63.172397910158146, 76.20329672663615, 0.8431156000000003, 80.0, 643, 174638, 251, 6.780108799999994
252, 8.914158674679241, 63.04675324595704, 75.8550268679249, 0.8424734499999998, 210.0, 784, 175422, 252, 8.350440400000025
253, 10.240136826663509, 62.84315472787371, 75.72849018448731, 0.8418718000000001, 70.0, 553, 175975, 253, 5.904853099999968
254, 10.316785206244543, 62.862096346341644, 75.65953322190505, 0.8414474500000002, 35.0, 390, 176365, 254, 4.182360199999948
255, 14.189601897905066, 62.76820383221812, 75.7125660574566, 0.8408998000000003, 410.0, 827, 177192, 255, 8.96413080000002
256, 11.929880487992897, 62.95922009485849, 75.84232664878324, 0.8401654000000004, 160.0, 805, 177997, 256, 8.610484400000018
257, 10.035945101448124, 63.1593936429647, 75.99405576926868, 0.8393796999999995, 440.0, 941, 178938, 257, 10.044429199999968
258, 10.160539344308486, 62.801124675853835, 75.56786159642739, 0.8386732000000001, 80.0, 629, 179567, 258, 6.822401300000024
259, 8.971237203613493, 62.065359396288045, 74.7256241993998, 0.8380018000000001, 125.0, 863, 180430, 259, 9.252268099999924
260, 7.515450978171232, 61.11476162871624, 73.5305971516743, 0.8373151000000002, 150.0, 663, 181093, 260, 7.13676369999996
261, 6.8411007113983295, 61.05541058990853, 73.41106878175326, 0.83672335, 90.0, 652, 181745, 261, 7.154354000000012
262, 10.073394311515267, 61.06578783541181, 73.53432728549008, 0.8361568000000004, 65.0, 607, 182352, 262, 6.603582099999926
263, 8.35314023547781, 60.990031765901016, 73.46306791220645, 0.8355803500000004, 110.0, 674, 183026, 263, 7.44017620000011
264, 9.165850834103741, 61.05950117621496, 73.52732872254217, 0.8348986000000002, 210.0, 841, 183867, 264, 9.098015399999895
265, 13.656198769654983, 61.18346888224284, 73.84141520964793, 0.8343446500000002, 65.0, 390, 184257, 265, 4.296718999999939
266, 9.021627295250987, 61.033484432744046, 73.38863727345186, 0.8339396499999999, 80.0, 510, 184767, 266, 5.478265699999838
267, 6.033744106562401, 61.03581631030399, 73.40800201494467, 0.8335351, 80.0, 389, 185156, 267, 4.2708374999999705
268, 8.28474145960443, 61.00261519879711, 73.44760098749278, 0.83265445, 215.0, 1568, 186724, 268, 17.04792590000011
269, 11.288779032313991, 61.11614869448369, 73.62240356338287, 0.83149975, 225.0, 998, 187722, 269, 11.005452999999989
270, 8.867227874238507, 61.22940895728816, 73.74015835032743, 0.8307063999999994, 140.0, 765, 188487, 270, 8.477624299999889
271, 8.987820886268517, 61.2043194350801, 73.68126494649778, 0.8301884500000003, 80.0, 386, 188873, 271, 4.43053000000009
272, 9.804031827835122, 61.08130748825844, 73.60038038696905, 0.8298365499999999, 105.0, 396, 189269, 272, 4.4052469999999175
273, 7.232790928649305, 61.09235643966818, 73.52256297766228, 0.8293712499999998, 80.0, 638, 189907, 273, 7.095948600000156
274, 8.01625353033362, 61.098371987738766, 73.59016086564597, 0.82883485, 20.0, 554, 190461, 274, 6.12719519999996
275, 7.199318487818043, 61.058044036229454, 73.51681359608968, 0.8283695499999999, 75.0, 480, 190941, 275, 5.334124400000064
276, 9.074802157606882, 61.230346890481826, 73.86129166438192, 0.8279010999999997, 100.0, 561, 191502, 276, 6.307378700000072
277, 7.980491469363253, 61.01905360574018, 73.47854449791822, 0.8274232000000001, 30.0, 501, 192003, 277, 5.621624699999984
278, 5.251013056166082, 61.01386284271733, 73.41253553900727, 0.8269470999999997, 105.0, 557, 192560, 278, 6.143665499999997
279, 7.588364680639402, 61.04815771147961, 73.53108924204909, 0.8264107000000003, 160.0, 635, 193195, 279, 7.093780899999956
280, 9.018583836882494, 61.10518442291409, 73.65636859464011, 0.8254818999999999, 290.0, 1429, 194624, 280, 15.990620699999909
281, 8.457986797770314, 61.23680107350881, 73.70608446555684, 0.8245603000000001, 55.0, 619, 195243, 281, 6.955567500000143
282, 9.532232347092638, 61.20020638000377, 73.85760452019449, 0.8240355999999995, 80.0, 547, 195790, 282, 6.1342844999999215
283, 8.646068375607332, 61.27793087641398, 73.78601426442464, 0.8235194500000005, 105.0, 600, 196390, 283, 6.75730180000005
284, 8.562324151856664, 61.220191425747345, 73.72159132545377, 0.8226662499999998, 315.0, 1296, 197686, 284, 14.567549299999882
285, 6.937272720832329, 61.14715835769455, 73.62658358487217, 0.82173655, 155.0, 770, 198456, 285, 8.67787159999989
286, 7.813383895295615, 61.09609653998395, 73.62351519720895, 0.8210372499999999, 180.0, 784, 199240, 286, 8.91394860000014
287, 9.490626955615635, 61.18566219084853, 73.79171777427743, 0.8203901500000002, 105.0, 654, 199894, 287, 7.424740999999813
288, 7.074731814021341, 61.72569234584405, 74.27864862457524, 0.8199297999999998, 55.0, 369, 200263, 288, 4.169036199999937
289, 8.591693299793706, 61.71376458394159, 74.38592499801793, 0.81958915, 20.0, 388, 200651, 289, 4.448450699999967
290, 7.482047190268834, 61.59940511530096, 74.15521542437665, 0.8192066500000001, 45.0, 462, 201113, 290, 5.253217199999881
291, 8.293243365077412, 61.93172659780465, 74.57647374471028, 0.8187692500000001, 30.0, 510, 201623, 291, 5.794613799999979
292, 6.952029303937662, 61.680014225694, 74.24461551103435, 0.8182652499999994, 110.0, 610, 202233, 292, 7.000807699999996
293, 8.550921721960462, 61.80798270588829, 74.4506915978023, 0.8176883500000003, 105.0, 672, 202905, 293, 7.665432100000089
294, 8.882584164844701, 61.76624907355123, 74.44382191289422, 0.8171658999999999, 45.0, 489, 203394, 294, 5.6261571
295, 7.925126348387811, 61.87499539775233, 74.50825920104981, 0.8166668499999998, 65.0, 620, 204014, 295, 7.104526999999962
296, 5.495160123235301, 61.613082113536265, 74.12929672364764, 0.81616555, 90.0, 494, 204508, 296, 5.6620333999999275
297, 6.321118737378203, 61.49635355920777, 73.97782201299924, 0.8156583999999999, 95.0, 633, 205141, 297, 7.285826999999927
298, 5.657711903538023, 61.5366853130107, 74.08202379187759, 0.8151530500000003, 55.0, 490, 205631, 298, 5.645524299999806
299, 7.752786122442846, 61.80871717712289, 74.5511144854725, 0.8146909000000003, 105.0, 537, 206168, 299, 6.155904700000065
300, 6.507597527570194, 61.75633507859183, 74.33812398195883, 0.8141009499999995, 210.0, 774, 206942, 300, 9.057540400000107
301, 7.187732455622443, 61.75960392791358, 74.3367362116549, 0.8133651999999999, 215.0, 861, 207803, 301, 10.18646119999994
302, 6.8164239208544455, 61.71098117930915, 74.34212313416184, 0.8126429499999998, 225.0, 744, 208547, 302, 8.781482800000049
303, 7.3377526495315575, 61.73959005361777, 74.30960375349099, 0.8120192500000002, 85.0, 642, 209189, 303, 7.593812500000013
304, 5.475082119759689, 61.615515940729985, 74.1062959854599, 0.8114544999999997, 135.0, 613, 209802, 304, 7.243456599999945
305, 8.388681151385846, 61.95319347000968, 74.67552234116785, 0.8107727499999996, 175.0, 902, 210704, 305, 10.740908799999943
306, 8.997415046813854, 62.09715859461931, 74.85034809476035, 0.8099182000000004, 315.0, 997, 211701, 306, 11.743406699999923
307, 8.674393601234883, 61.9254086607246, 74.68244886911043, 0.8091347500000002, 160.0, 744, 212445, 307, 8.854731000000129
308, 6.404805035600959, 62.01641296750356, 74.61659417646287, 0.8083089999999993, 360.0, 1091, 213536, 308, 12.732646899999963
309, 7.713167636676136, 62.06203435054864, 74.84012600652069, 0.8075971000000003, 75.0, 491, 214027, 309, 5.814244500000086
310, 6.129646671056016, 62.039113089594615, 74.70664786122327, 0.8069360500000001, 215.0, 978, 215005, 310, 11.475012300000117
311, 4.826905826832672, 62.16900017147972, 74.77969167934734, 0.8062408000000001, 125.0, 567, 215572, 311, 6.754891900000075
312, 8.492845849039849, 62.063699072219904, 74.82411888208281, 0.8057453499999996, 80.0, 534, 216106, 312, 6.346654499999886
313, 7.5155370337768685, 62.031870584119545, 74.8102091078424, 0.8051905000000003, 110.0, 699, 216805, 313, 8.316223199999968
314, 6.705665023664226, 61.875568798210615, 74.51304751756953, 0.8045690500000001, 180.0, 682, 217487, 314, 8.056228099999998
315, 4.85914770886302, 62.00905728340149, 74.5792149793018, 0.8039453500000003, 210.0, 704, 218191, 315, 8.440833499999826
316, 6.3334709599883565, 61.85946558181699, 74.4529736536103, 0.8033049999999999, 155.0, 719, 218910, 316, 8.543444399999998
317, 4.722807022695956, 61.82510507998259, 74.36988410617994, 0.8027226999999996, 90.0, 575, 219485, 317, 6.878366899999946
318, 4.576711175922586, 62.01716440024496, 74.61472329532398, 0.8021962000000001, 110.0, 595, 220080, 318, 7.112328999999818
319, 9.266168040249187, 62.370060856634446, 75.2095250668733, 0.80170075, 30.0, 506, 220586, 319, 5.985476300000073
320, 5.597690979450828, 62.344855894758375, 75.02419762556997, 0.8011180000000002, 215.0, 789, 221375, 320, 9.432196900000008
321, 9.225427202252021, 62.431275350501735, 75.26059563188667, 0.80046415, 110.0, 664, 222039, 321, 7.9889822000000095
322, 6.473722419132887, 62.34863582774751, 75.05453279702971, 0.7998926499999995, 110.0, 606, 222645, 322, 7.31326480000007
323, 5.194987504792636, 62.307043371256995, 74.954884193917, 0.7992396999999999, 385.0, 845, 223490, 323, 10.19727439999997
324, 5.869879649235652, 62.390079534970795, 75.15240818720598, 0.7984850499999999, 410.0, 832, 224322, 324, 10.0645856000001
325, 6.396017713199523, 62.2125006345945, 74.90833770894558, 0.7978217500000002, 180.0, 642, 224964, 325, 7.733910899999955
326, 6.836870231907883, 62.33855916117574, 75.14506998865596, 0.7972871499999996, 50.0, 546, 225510, 326, 6.736075000000028
327, 6.408675838018132, 62.40168490068192, 75.0751131241938, 0.7967525500000004, 155.0, 642, 226152, 327, 7.795555700000023
328, 6.9504999019079285, 62.36267825627731, 75.09610623505156, 0.7959326500000007, 285.0, 1180, 227332, 328, 14.274552800000038
329, 6.626005752010175, 62.27255404659877, 75.06863541307258, 0.7949737, 135.0, 951, 228283, 329, 11.705345999999963
330, 4.9573578253770485, 62.522303713285005, 75.21316626133063, 0.7943702499999997, 155.0, 390, 228673, 330, 4.78523610000002
331, 4.007615416459495, 62.33583839299642, 74.98195120646604, 0.7939891000000002, 65.0, 457, 229130, 331, 5.601727899999787
332, 6.6233017486679255, 62.38054238669408, 75.19771209762142, 0.7934806000000002, 155.0, 673, 229803, 332, 8.260919999999942
333, 8.748928335945754, 62.85905455411011, 75.77946463112308, 0.7928744499999996, 135.0, 674, 230477, 333, 8.360376999999971
334, 6.811296240510846, 62.79927421768359, 75.64330557406022, 0.7922080000000001, 155.0, 807, 231284, 334, 9.87897010000006
335, 8.278333742442982, 62.72599243637203, 75.5667784816535, 0.7915545999999994, 180.0, 645, 231929, 335, 7.9339840000000095
336, 6.006568240827059, 62.82749217565319, 75.59438956903598, 0.7907230000000003, 410.0, 1203, 233132, 336, 14.735059899999897
337, 5.310828280050072, 62.95548151387305, 75.81183754733061, 0.7898185000000003, 240.0, 807, 233939, 337, 9.940678200000093
338, 4.498051900377564, 62.875929006740485, 75.65907729446764, 0.7890260499999998, 155.0, 954, 234893, 338, 11.903634499999953
339, 6.241612735289064, 62.80331423065879, 75.61776731230997, 0.7881215499999995, 320.0, 1056, 235949, 339, 13.280917300000056
340, 6.658335503446239, 62.893977626088706, 75.75263459906814, 0.7873641999999996, 90.0, 627, 236576, 340, 7.970779800000173
341, 6.18086602800117, 62.95171435705885, 75.78477418398809, 0.7868575000000002, 30.0, 499, 237075, 341, 6.148539999999912
342, 6.321811262393991, 62.913239081700645, 75.79562568664551, 0.7864169500000001, 120.0, 480, 237555, 342, 6.017721699999811
343, 4.188698346970173, 62.86347652582022, 75.6167313355666, 0.7859669499999995, 60.0, 520, 238075, 343, 6.639060400000062
344, 6.0458083206195194, 62.797160056437676, 75.62887357366525, 0.7854769000000004, 110.0, 569, 238644, 344, 7.135625699999991
345, 5.367083731009133, 62.83391876795783, 75.61797057683744, 0.7848626500000003, 180.0, 796, 239440, 345, 9.998805000000175
346, 4.4309669788008845, 62.76512435282357, 75.52601344558886, 0.7842214000000004, 160.0, 629, 240069, 346, 7.923456600000009
347, 5.785191634378611, 63.013001084840795, 75.88198392805103, 0.7836247000000001, 125.0, 697, 240766, 347, 8.812616300000172
348, 9.743911716264563, 62.96406371376731, 75.98350698297673, 0.7829645499999993, 110.0, 770, 241536, 348, 9.701447899999948
349, 6.551581511914264, 62.70703134685755, 75.50974300503731, 0.7823876500000002, 65.0, 512, 242048, 349, 6.502331299999923
350, 5.758287487912838, 62.72914792308279, 75.55279750487666, 0.7817999500000001, 355.0, 794, 242842, 350, 10.139512100000047
351, 5.652054128226112, 62.9775557125316, 75.7902884090648, 0.7811749000000001, 80.0, 595, 243437, 351, 7.599045700000033
352, 5.557351360490331, 62.777872461850954, 75.58241430593996, 0.7803779499999995, 390.0, 1176, 244613, 352, 14.814163000000008
353, 11.1406800829251, 62.74591007306882, 75.70469891143681, 0.7796174499999999, 45.0, 514, 245127, 353, 6.598567000000003
354, 10.338430659418487, 63.030111268509266, 76.05327476932361, 0.7791152499999998, 65.0, 602, 245729, 354, 7.912736700000096
355, 5.868441918357726, 62.80525639687815, 75.57590514152281, 0.7784956000000004, 135.0, 775, 246504, 355, 9.91633869999987
356, 4.0109144564942865, 62.91725192295591, 75.69097402550851, 0.7778709999999999, 210.0, 613, 247117, 356, 7.906124699999964
357, 4.748755688920165, 62.88749810048213, 75.67201366405916, 0.7771347999999993, 235.0, 1023, 248140, 357, 13.25982810000005
358, 6.959030871128612, 62.95263862609863, 75.87741659563991, 0.7762190500000004, 455.0, 1012, 249152, 358, 12.869366600000149
359, 5.869451444638871, 62.991873730188125, 75.79469961407541, 0.7754504500000001, 130.0, 696, 249848, 359, 8.968781799999988
360, 4.799784578706907, 62.733540223323615, 75.50579870365779, 0.7748163999999996, 260.0, 713, 250561, 360, 9.129028999999946
361, 6.433690444890248, 63.06257463019827, 75.96623852978583, 0.7741643500000003, 110.0, 736, 251297, 361, 9.51857270000005
362, 8.353547048374239, 63.00675508934797, 76.0407011065053, 0.7735987, 110.0, 521, 251818, 362, 6.805536399999937
363, 5.814338494589173, 62.9455436179097, 75.77992682378039, 0.7729021000000003, 280.0, 1027, 252845, 363, 13.318531399999983
364, 5.3076343075355465, 62.87167038900327, 75.67660920456429, 0.77219065, 155.0, 554, 253399, 364, 7.272747700000082
365, 7.315446781473241, 63.00732131939422, 75.9686943546718, 0.7715718999999995, 125.0, 821, 254220, 365, 10.71746989999997
366, 5.035320853348821, 62.92623898055818, 75.71625400914087, 0.7709432500000001, 230.0, 576, 254796, 366, 7.566245300000219
367, 5.671375058346157, 62.83009503038624, 75.62259336061115, 0.7703285499999999, 110.0, 790, 255586, 367, 10.363360899999861
368, 4.436083088491274, 62.78337489141934, 75.56062996905783, 0.7696625500000001, 170.0, 690, 256276, 368, 9.075067199999921
369, 4.775957984800794, 62.98676813903608, 75.76559656544735, 0.7690784499999995, 55.0, 608, 256884, 369, 8.031553499999973
370, 6.977280618230502, 62.8269330291748, 75.63840571085612, 0.76846735, 135.0, 750, 257634, 370, 10.008310599999959
371, 4.78096752214324, 63.078854336796034, 75.88356024960437, 0.7678310499999997, 100.0, 664, 258298, 371, 8.779992899999797
372, 5.674727987062944, 62.94014669976325, 75.77298960616777, 0.7671277000000005, 365.0, 899, 259197, 372, 11.89370319999989
373, 7.9560770537097785, 62.992754226507145, 75.8984938665878, 0.7664135499999998, 120.0, 688, 259885, 373, 9.229333100000076
374, 4.205778378524021, 63.207816155833264, 76.04355154552313, 0.7659289000000002, 80.0, 389, 260274, 374, 5.51917020000019
375, 8.198001825347651, 63.774269692064586, 76.86683370299258, 0.765196300000001, 260.0, 1239, 261513, 375, 16.8215995999999
376, 9.126451912129573, 63.74832997285118, 76.78843487880026, 0.7643485000000004, 120.0, 645, 262158, 376, 8.901719800000137
377, 6.177507467038558, 63.781501268405044, 76.7769026124212, 0.7636338999999998, 170.0, 943, 263101, 377, 12.798014100000046
378, 5.256927763778507, 63.871679830737655, 76.8218997323684, 0.7628644000000001, 180.0, 767, 263868, 378, 10.949416600000177
379, 5.165527130231407, 63.78295786605984, 76.77101749084672, 0.7622429499999999, 30.0, 614, 264482, 379, 8.363451799999893
380, 5.320268681263312, 63.76660937121791, 76.73476219503289, 0.7614401500000004, 635.0, 1170, 265652, 380, 15.994989599999826
381, 4.981250267366276, 63.959196644670826, 76.95286048861111, 0.7604240499999991, 215.0, 1088, 266740, 381, 14.749527500000113
382, 7.146371466607435, 63.71883737310344, 76.7734807674482, 0.7596334, 120.0, 669, 267409, 382, 9.175827000000254
383, 5.259898512210896, 63.87005271008734, 76.86746416712654, 0.7590281499999999, 140.0, 676, 268085, 383, 9.20089390000021
384, 4.292889885701987, 63.85233122813129, 76.81803001170596, 0.7585178499999999, 55.0, 458, 268543, 384, 6.387976600000002
385, 9.217434989106387, 63.875579671453416, 77.06755071654355, 0.7579526499999998, 210.0, 798, 269341, 385, 11.071758000000045
386, 5.14151179488535, 63.83388379806989, 76.82123876003092, 0.7572871000000002, 120.0, 681, 270022, 386, 9.301817500000197
387, 4.193088437405013, 64.42694667331001, 77.45547342657152, 0.7568002000000001, 50.0, 401, 270423, 387, 4.928086400000211
388, 6.180614268057274, 64.3762681533351, 77.52515141342626, 0.7562484999999999, 125.0, 825, 271248, 388, 10.019359200000054
389, 6.81243746318383, 64.28252681685083, 77.46504996146685, 0.7552940499999998, 595.0, 1296, 272544, 389, 15.975808200000301
390, 4.069303829790143, 64.3765724872856, 77.42614688009883, 0.7544921500000003, 80.0, 486, 273030, 390, 6.09091430000035
391, 7.48940515379015, 64.37933370494996, 77.5950835591929, 0.7539939999999999, 110.0, 621, 273651, 391, 7.773981599999843
392, 5.968059210860658, 64.3678739695322, 77.44395991734096, 0.75341215, 120.0, 672, 274323, 392, 8.430462799999987
393, 4.822716513325135, 64.47750520444657, 77.6279517109259, 0.7528636000000001, 90.0, 547, 274870, 393, 6.913846499999636
394, 6.229056265301655, 64.28998743067133, 77.39558175437809, 0.7519226499999994, 500.0, 1544, 276414, 394, 19.27203419999978
395, 4.141234786650818, 64.38151708338549, 77.44547765194571, 0.7509258999999997, 180.0, 671, 277085, 395, 8.470753800000239
396, 6.881660769075419, 64.475171423943, 77.58212731510488, 0.7503188500000003, 125.0, 678, 277763, 396, 8.540698899999825
397, 4.460199846625328, 64.53027360026041, 77.63015717569986, 0.7496762499999999, 105.0, 750, 278513, 397, 9.529269799999838
398, 5.074915900658185, 64.38430827773799, 77.49014358807688, 0.7489801, 410.0, 797, 279310, 398, 10.06411270000035
399, 6.199650202136841, 64.29468051325665, 77.37665408614778, 0.7483131999999999, 120.0, 685, 279995, 399, 8.695503200000076
400, 6.234707063420656, 64.92861200900788, 78.08506553731065, 0.74783575, 80.0, 376, 280371, 400, 4.81289229999993
401, 6.279043886791239, 64.94292770148559, 78.12035905511885, 0.7474928500000001, 45.0, 386, 280757, 401, 4.8744581000000835
402, 6.8422422251057196, 64.97635570257117, 78.25348976413983, 0.7467894999999998, 515.0, 1177, 281934, 402, 14.921791199999916
403, 5.596044023039276, 64.96794811946408, 78.21857615667558, 0.7460285500000001, 65.0, 514, 282448, 403, 6.540122000000338
404, 8.347875298464551, 64.9084337275079, 78.26991289828686, 0.7455857499999999, 85.0, 470, 282918, 404, 6.0422223999999005
405, 4.422593061571823, 65.00894898803011, 78.10632913563948, 0.7451388999999997, 120.0, 523, 283441, 405, 6.749277700000221
406, 5.872213289552222, 65.05764711772603, 78.29470386226907, 0.7446259000000002, 135.0, 617, 284058, 406, 7.809252600000036
407, 4.3338606540956315, 64.91418691476186, 78.11310544468108, 0.7440458499999999, 135.0, 672, 284730, 407, 9.580728000000363
408, 8.63181018227568, 64.92239571840335, 78.25394069231473, 0.74346265, 155.0, 624, 285354, 408, 8.710145199999715
409, 8.07171561990636, 64.91571682403004, 78.23064458270701, 0.7429123000000001, 135.0, 599, 285953, 409, 8.395786999999928
410, 6.119845097825788, 64.6809007294324, 77.83908047083358, 0.7424001999999996, 35.0, 539, 286492, 410, 7.577824599999985
411, 8.27050006911039, 64.89502038236223, 78.20715241409228, 0.7418773000000004, 85.0, 623, 287115, 411, 8.840905900000052
412, 7.865110295798939, 64.83977508544922, 78.04740289077458, 0.7413692500000001, 80.0, 506, 287621, 412, 7.210415699999885
413, 5.983946943015571, 64.84653912687368, 78.0198228148558, 0.7408206999999994, 110.0, 713, 288334, 413, 10.051927100000285
414, 7.829998883165863, 64.88690559437732, 78.21020349919401, 0.74022805, 75.0, 604, 288938, 414, 8.632063900000048
415, 5.8885055029586, 65.02297324071358, 78.29565402524021, 0.7396655499999997, 100.0, 646, 289584, 415, 9.163158199999998
416, 6.083357402671002, 65.00150547919773, 78.23772535553171, 0.7390189000000003, 180.0, 791, 290375, 416, 11.180945000000065
417, 6.4449534286942445, 64.96463666540204, 78.16700857335871, 0.7381877499999996, 300.0, 1056, 291431, 417, 14.849058700000114
418, 5.513621109453115, 64.86649678704919, 78.04692136414796, 0.7374205000000001, 155.0, 649, 292080, 418, 9.29349639999964
419, 8.018649271529192, 65.07661790301086, 78.35588733405824, 0.7368458499999997, 110.0, 628, 292708, 419, 9.043361699999878
420, 6.1926276816622075, 65.18650402045398, 78.42544342420116, 0.7362734500000003, 120.0, 644, 293352, 420, 9.406708900000012
421, 6.443910804863383, 64.99432286518376, 78.26852074599847, 0.7356146499999999, 210.0, 820, 294172, 421, 11.890092999999979
422, 6.867968558629542, 65.09477919085896, 78.36364092834376, 0.7349608000000003, 80.0, 633, 294805, 422, 9.121378499999992
423, 5.196436764897482, 64.97930997056844, 78.18216073325135, 0.7344190000000002, 75.0, 571, 295376, 423, 8.269256400000359
424, 6.190371970123748, 64.99871070890535, 78.23483988571645, 0.7338033999999997, 135.0, 797, 296173, 424, 11.46358199999986
425, 5.398722835373335, 65.0754388626258, 78.31001357090327, 0.7329709, 320.0, 1053, 297226, 425, 15.536496799999895
426, 7.924337333272756, 65.0671858858284, 78.36919298936068, 0.7323454, 45.0, 337, 297563, 426, 5.058049700000083
427, 7.226294299545274, 65.14730392260985, 78.45818234573711, 0.7315601500000006, 660.0, 1408, 298971, 427, 20.287273500000083
428, 7.704536413076382, 65.25929552910205, 78.61581435879016, 0.7306057000000005, 85.0, 713, 299684, 428, 10.371764399999847
429, 5.616695182660857, 64.75942963952417, 77.94236254763675, 0.7299851499999999, 210.0, 666, 300350, 429, 9.710140500000307
430, 7.41234770923203, 64.27753835303761, 77.41532436858085, 0.7293965500000001, 110.0, 642, 300992, 430, 9.39737150000019
431, 6.705983521830337, 64.49753289027917, 77.65912518408116, 0.7286009500000008, 240.0, 1126, 302118, 431, 16.403758800000105
432, 6.461602053067214, 64.66999236630721, 77.8797234414329, 0.7278386500000004, 105.0, 568, 302686, 432, 8.337064199999986
433, 7.05329809967481, 64.47442658652722, 77.61481173340704, 0.72726355, 185.0, 710, 303396, 433, 10.287368499999957
434, 6.560476358356088, 64.67410518335954, 77.89192867735356, 0.7267559499999998, 90.0, 418, 303814, 434, 6.262516100000084
435, 5.98645097042491, 64.43502455181098, 77.54382603264258, 0.726355, 105.0, 473, 304287, 435, 6.954977299999882
436, 5.238882910776402, 64.33995824722346, 77.38989226844478, 0.72589825, 50.0, 542, 304829, 436, 7.985329499999807
437, 5.744063658541755, 64.55685236807645, 77.684529774497, 0.72527815, 180.0, 836, 305665, 437, 12.294581300000118
438, 6.683485813691784, 64.42012292846998, 77.64732846890044, 0.7247296000000002, 110.0, 383, 306048, 438, 5.6699877000000924
439, 5.500819057503269, 64.57739744107586, 77.71216331040564, 0.72433945, 60.0, 484, 306532, 439, 7.156988400000046
440, 6.133923466623128, 64.51876866429073, 77.70349610598763, 0.7237625499999997, 345.0, 798, 307330, 440, 11.909492899999805
441, 3.782833330435921, 64.31752866479194, 77.30723124295245, 0.7231096000000001, 155.0, 653, 307983, 441, 9.763207599999987
442, 3.9362363027955833, 64.39525404700352, 77.45817261245777, 0.7225430499999996, 85.0, 606, 308589, 442, 9.123069499999929
443, 5.434056152176887, 64.44803732412832, 77.55687226433102, 0.7219180000000002, 155.0, 783, 309372, 443, 11.581247900000108
444, 4.371086114744761, 64.40566964728065, 77.50526037176284, 0.7213505499999997, 160.0, 478, 309850, 444, 7.0482812000000195
445, 5.838655043135185, 64.13451600782942, 77.14370227096104, 0.72095365, 35.0, 404, 310254, 445, 6.080143700000008
446, 6.964502266254918, 64.14918983576398, 77.26999966851596, 0.7205369500000001, 80.0, 522, 310776, 446, 7.821656399999938
447, 5.1278743880771405, 63.99965796319608, 76.98188951759856, 0.71990425, 415.0, 884, 311660, 447, 13.175994700000047
448, 5.328683230622712, 64.09417529252504, 77.12495487687661, 0.7192279000000003, 105.0, 619, 312279, 448, 9.348299900000256
449, 7.333682594785976, 64.11043283912574, 77.20396867673496, 0.7184687499999995, 210.0, 1068, 313347, 449, 16.125362799999948
450, 5.340845130084536, 64.19046548072328, 77.24940204845817, 0.7176074500000003, 155.0, 846, 314193, 450, 12.994725000000017
451, 4.917330358474654, 64.03321865264405, 76.95344369969469, 0.7168883499999998, 110.0, 752, 314945, 451, 11.387589599999956
452, 4.614280473397058, 63.898564652835624, 76.87344728357651, 0.71639695, 20.0, 340, 315285, 452, 5.223484500000268
453, 5.713315084882376, 64.15052182240623, 77.18049459809644, 0.715915, 105.0, 731, 316016, 453, 11.09137200000032
454, 7.752135697591818, 64.0904264678225, 77.20735700506913, 0.7152098499999999, 210.0, 836, 316852, 454, 12.62192240000013
455, 6.758589099988713, 64.1129069727423, 77.10221940095204, 0.7145271999999998, 120.0, 681, 317533, 455, 10.535414800000126
456, 7.931955458426018, 64.10964049280217, 77.19939008504592, 0.7139156500000005, 180.0, 678, 318211, 456, 10.697502900000018
457, 4.691400911813843, 64.10358142153267, 77.10384575953402, 0.71324245, 235.0, 818, 319029, 457, 13.307914200000141
458, 4.209842805674452, 63.93945737370474, 76.85618802982414, 0.7126488999999998, 70.0, 501, 319530, 458, 8.20151420000002
459, 5.7223260304120585, 63.98515246984527, 76.95794173113005, 0.7121948500000002, 35.0, 508, 320038, 459, 7.602452599999651
460, 7.305872089659365, 64.32564506163963, 77.48984468900241, 0.7113110500000005, 345.0, 1456, 321494, 460, 21.280490799999825
461, 8.222887840995686, 64.29269184139993, 77.35792280238309, 0.7103431, 135.0, 695, 322189, 461, 10.124697600000218
462, 5.100710632330567, 64.36093987425323, 77.41253508565569, 0.7094556999999992, 210.0, 1277, 323466, 462, 20.458284100000128
463, 5.856371998038567, 64.33901962888822, 77.4413406225568, 0.70827175, 540.0, 1354, 324820, 463, 21.14612390000002
464, 5.5032677501060885, 64.43958152402145, 77.51524795648706, 0.7074855999999998, 10.0, 393, 325213, 464, 5.971101099999942
465, 6.640889636120041, 64.34303552685803, 77.478240275201, 0.7068371499999994, 200.0, 1048, 326261, 465, 17.732448400000067
466, 6.527744574985941, 64.46389502962968, 77.54397072529073, 0.7059331000000003, 245.0, 961, 327222, 466, 17.174631099999715
467, 7.017627572157869, 64.5568340619405, 77.76524272671452, 0.7051118500000002, 235.0, 864, 328086, 467, 14.832663400000001
468, 4.97741856966256, 64.30773691656465, 77.3221523411466, 0.7043432499999994, 420.0, 844, 328930, 468, 13.524065199999768
469, 7.559992381762632, 64.43700448981612, 77.6236959515196, 0.7035476500000002, 150.0, 924, 329854, 469, 14.709993100000247
470, 8.512019779419635, 63.92687758976733, 76.98938637096796, 0.7029694, 105.0, 361, 330215, 470, 5.90362660000028
471, 3.545276759143822, 63.64655000461127, 76.49594443403409, 0.7025824000000003, 75.0, 499, 330714, 471, 8.537553200000275
472, 5.464835089803254, 63.70065256863705, 76.66890177910932, 0.7021481500000003, 20.0, 466, 331180, 472, 7.813179299999774
473, 6.770940160524518, 63.79865020526136, 76.83845450392569, 0.7012998999999991, 600.0, 1419, 332599, 473, 22.012276400000246
474, 6.957732006143301, 63.738195933806594, 76.66940399952423, 0.7002226000000001, 235.0, 975, 333574, 474, 14.820040200000221
475, 4.106943870364111, 63.640285811846766, 76.51138011111489, 0.69949945, 110.0, 632, 334206, 475, 9.769935599999826
476, 5.648994345862495, 63.70739239891254, 76.63070256968747, 0.6989081499999996, 105.0, 682, 334888, 476, 10.558682399999725
477, 9.00848292530948, 63.54680040956453, 76.47971415337716, 0.6983654500000003, 95.0, 524, 335412, 477, 9.142594100000224
478, 7.147317581516315, 63.561365216168916, 76.5959769251294, 0.6979456000000002, 75.0, 409, 335821, 478, 6.996709600000031
479, 6.655120146928956, 63.67345210484096, 76.64178063125206, 0.6974213499999997, 125.0, 756, 336577, 479, 12.637004900000193
480, 4.731634186402009, 63.57669185484895, 76.44382768518784, 0.6967904500000002, 185.0, 646, 337223, 480, 10.489356300000054
481, 6.3257294736748975, 63.702629619936864, 76.6239172297416, 0.6961244499999998, 225.0, 834, 338057, 481, 12.558318399999735
482, 6.270599913122744, 63.66433543564951, 76.64600289156692, 0.6954890500000003, 110.0, 578, 338635, 482, 9.814671200000248
483, 6.6655939289316235, 63.73718468871811, 76.7102247799621, 0.6948055000000004, 150.0, 941, 339576, 483, 17.32628160000013
484, 4.887905333093975, 63.48335650347281, 76.3442688319994, 0.6940715500000003, 90.0, 690, 340266, 484, 13.738611099999616
485, 7.267340855441824, 63.55916876688491, 76.53039823657404, 0.69351445, 110.0, 548, 340814, 485, 9.67469630000005
486, 5.097047174874077, 63.603113347833805, 76.51647572865608, 0.6929658999999996, 100.0, 671, 341485, 486, 12.260431900000185
487, 5.285175305837161, 63.52693358252059, 76.40024136629971, 0.6921442000000007, 275.0, 1155, 342640, 487, 20.436598400000094
488, 7.606059207942317, 63.63495082889967, 76.65295586646798, 0.6913774000000005, 15.0, 549, 343189, 488, 9.473209200000383
489, 4.995069385577414, 63.618080471633775, 76.50275131832204, 0.69083605, 180.0, 654, 343843, 489, 10.41250140000011
490, 10.260653145003076, 63.723039101581186, 76.88462617445965, 0.6903653499999997, 60.0, 392, 344235, 490, 6.0261473999999
491, 4.890000200873829, 63.46990599162838, 76.25018658415641, 0.69001525, 55.0, 386, 344621, 491, 6.200719300000401
492, 6.52325411177263, 63.58339282223018, 76.48787392362624, 0.6894541000000004, 410.0, 861, 345482, 492, 14.785933199999818
493, 4.949107628429856, 63.61402772693439, 76.52959591089393, 0.6886702000000001, 190.0, 881, 346363, 493, 14.159183000000212
494, 7.743717404627582, 63.68287145800707, 76.72452782421577, 0.6879785500000002, 130.0, 656, 347019, 494, 10.894489499999963
495, 6.815143041597265, 63.31504921118418, 76.15960097312927, 0.6874241499999996, 95.0, 576, 347595, 495, 9.531881899999917
496, 6.088698128388785, 63.60295642650891, 76.48008418813721, 0.6868418500000002, 110.0, 718, 348313, 496, 10.869839899999988
497, 7.272207924340883, 63.66941473494361, 76.64972928970579, 0.6862068999999996, 135.0, 693, 349006, 497, 10.681496800000332
498, 7.184257506138247, 63.54251565308871, 76.43882970846663, 0.6855445000000002, 125.0, 779, 349785, 498, 11.986804099999972
499, 4.906448885241979, 63.477676444363624, 76.27102116628306, 0.6848685999999998, 135.0, 723, 350508, 499, 11.172826299999997
500, 6.8083754966839205, 63.655485125894685, 76.58305379949465, 0.6841031499999999, 225.0, 978, 351486, 500, 15.872028300000238
501, 5.6434934204751315, 63.63511538662753, 76.55468854799375, 0.6832535499999999, 125.0, 910, 352396, 501, 15.223887899999681
502, 6.300609911659764, 63.40726232900634, 76.27980396193387, 0.6825555999999999, 120.0, 641, 353037, 502, 9.985029099999792
503, 6.582566556885819, 63.5213127432326, 76.46804194678619, 0.6819192999999995, 145.0, 773, 353810, 503, 12.446252300000197
504, 5.161447910806997, 63.57013087078808, 76.4781677990425, 0.6812947000000001, 80.0, 615, 354425, 504, 9.608202299999903
505, 6.076151764879352, 63.605476135532605, 76.49022801717122, 0.6806237500000001, 235.0, 876, 355301, 505, 14.03038719999995
506, 5.144863295148934, 63.52991853765376, 76.3744567774366, 0.6799456000000001, 95.0, 631, 355932, 506, 9.812677599999915
507, 4.174981918917188, 63.66318356309092, 76.5876598682433, 0.6793705, 105.0, 647, 356579, 507, 10.210346200000004
508, 5.128401554497589, 63.47472335237906, 76.32530413015905, 0.67885345, 45.0, 502, 357081, 508, 8.08190229999991
509, 7.031664626032878, 63.38728539230477, 76.26155262482472, 0.6783643000000001, 110.0, 585, 357666, 509, 9.25138990000005
510, 5.0091691036625665, 63.565819043452194, 76.46737921686456, 0.6778737999999997, 105.0, 505, 358171, 510, 8.198658700000124
511, 7.038022731267028, 63.4222751981649, 76.35952220130805, 0.6772883500000006, 210.0, 796, 358967, 511, 12.863194499999736
512, 6.000699234560873, 63.36427579326859, 76.25421033960673, 0.6766678, 45.0, 583, 359550, 512, 9.463526099999854
513, 4.921767240595854, 63.4574481436105, 76.32651650293803, 0.6761160999999997, 105.0, 643, 360193, 513, 10.318637299999864
514, 7.369990231177328, 63.457068075290195, 76.35240065647199, 0.6753358000000006, 560.0, 1091, 361284, 514, 17.808192999999847
515, 6.589978901150915, 63.37988863286284, 76.31869500936921, 0.67467025, 75.0, 388, 361672, 515, 6.28636779999988
516, 7.024598326072493, 63.36174602846129, 76.24743944353762, 0.6742922499999999, 150.0, 452, 362124, 516, 7.4415123000003405
517, 4.707998132369996, 63.356620257206245, 76.16692157459997, 0.6735654999999997, 395.0, 1163, 363287, 517, 19.03081740000016
518, 7.301727160529827, 63.3555224140798, 76.2480306069682, 0.6727564, 75.0, 635, 363922, 518, 10.053386000000046
519, 6.182786876622515, 63.625659897010244, 76.57452370339979, 0.6721695999999997, 210.0, 669, 364591, 519, 10.985874500000136
520, 5.442985130064299, 63.479483047888074, 76.39105478549632, 0.6715616500000003, 410.0, 682, 365273, 520, 10.719919299999674
521, 4.617429258567946, 63.581803591926594, 76.41128566808868, 0.6710752, 105.0, 399, 365672, 521, 6.487661600000138
522, 7.813451896837303, 63.44818134812137, 76.35819961049509, 0.6706062999999995, 135.0, 643, 366315, 522, 10.522643400000106
523, 7.116927212886228, 63.365560740308304, 76.25224016883598, 0.6701400999999998, 35.0, 393, 366708, 523, 6.579067699999996
524, 6.527072721146965, 63.246328164865304, 76.07754800699136, 0.6696635499999999, 155.0, 666, 367374, 524, 10.943569500000194
525, 5.698274082249883, 63.375314903634, 76.19429695114405, 0.6691347999999997, 80.0, 509, 367883, 525, 8.21436360000007
526, 6.199130808676409, 63.285934834828495, 76.15417839766614, 0.6686038000000001, 105.0, 671, 368554, 526, 11.03077570000005
527, 7.02643589867623, 63.43137182247867, 76.38011635944342, 0.6680192499999998, 105.0, 628, 369182, 527, 10.36179519999996
528, 9.483167055751904, 63.43229149967791, 76.3944716396102, 0.6673631500000002, 330.0, 830, 370012, 528, 13.41472479999993
529, 6.031365393217906, 63.78403761163113, 76.78252694830539, 0.6667115499999998, 155.0, 618, 370630, 529, 10.270246500000212
530, 5.417489622117353, 63.61886128267214, 76.49574135554553, 0.6661787500000002, 75.0, 566, 371196, 530, 9.482371000000057
531, 4.722763149246204, 63.57397332001554, 76.44814463965474, 0.6655059999999999, 165.0, 929, 372125, 531, 15.185059400000227
532, 6.012437247042627, 63.44256490026683, 76.29172330526076, 0.6645785499999994, 290.0, 1132, 373257, 532, 18.501286199999868
533, 4.7347679198149475, 63.364719811641805, 76.17229024251301, 0.6636978999999997, 210.0, 825, 374082, 533, 13.441044300000158
534, 6.228505830095156, 63.71859105107766, 76.67688722394276, 0.6631479999999997, 85.0, 397, 374479, 534, 6.599353000000065
535, 5.857385928960556, 63.541284185774785, 76.41640872143685, 0.66263095, 60.0, 752, 375231, 535, 12.692226399999981
536, 5.59709721456887, 63.489455130792436, 76.34009760316067, 0.6619019499999996, 140.0, 868, 376099, 536, 14.375013800000033
537, 7.450343256477274, 63.65710341720432, 76.67739392633308, 0.6612814, 75.0, 511, 376610, 537, 8.496016300000065
538, 6.956207618808947, 63.687530074944476, 76.63893428432287, 0.6608381499999997, 75.0, 474, 377084, 538, 7.994468700000198
539, 7.252062467174096, 63.57895662481135, 76.53370685924183, 0.6603773500000003, 65.0, 550, 377634, 539, 9.054675899999893
540, 5.031577638833504, 63.4995430116731, 76.3699460285466, 0.6595763499999997, 450.0, 1230, 378864, 540, 20.28788080000004
541, 5.417306092905625, 63.42498810207866, 76.28886783803586, 0.6585341500000005, 260.0, 1086, 379950, 541, 17.864491099999668
542, 7.303588782108116, 63.70107328106543, 76.67224344950236, 0.6577448500000002, 160.0, 668, 380618, 542, 10.960202199999912
543, 6.674816406467125, 63.48163468453683, 76.37221932297118, 0.6571621000000001, 125.0, 627, 381245, 543, 10.354283000000123
544, 7.958626299414651, 63.534472005707876, 76.49132748161044, 0.6564767499999994, 440.0, 896, 382141, 544, 14.978020099999867
545, 6.900349841166392, 63.43996343054541, 76.30810983672397, 0.6557198500000001, 140.0, 786, 382927, 545, 13.178591100000176
546, 6.497795370792689, 63.43840620485071, 76.38309424413394, 0.6550376499999997, 135.0, 730, 383657, 546, 12.280272299999979
547, 5.403752692774603, 63.47241129784068, 76.30342104966473, 0.6543559, 215.0, 785, 384442, 547, 13.217208200000186
548, 6.85916054544689, 63.43551048992349, 76.27503013336401, 0.6536898999999994, 120.0, 695, 385137, 548, 11.674547200000234
549, 12.320409700956963, 63.59397733120518, 76.66980711376394, 0.6531413500000001, 100.0, 524, 385661, 549, 8.861802699999771
550, 5.507942886046045, 63.256810013329954, 76.028783970717, 0.6527314000000001, 55.0, 387, 386048, 550, 6.54199619999963
551, 6.551249959032264, 63.35876789985345, 76.23187902796339, 0.6522494499999996, 120.0, 684, 386732, 551, 11.495766500000173
552, 7.384273512220475, 63.45236246267647, 76.37414035760227, 0.65147635, 340.0, 1034, 387766, 552, 17.5059368000002
553, 7.0191205192531925, 63.36807857081294, 76.19349778816104, 0.6505502499999997, 440.0, 1024, 388790, 553, 17.24097470000015
554, 6.220214309878865, 63.42294039921454, 76.28625896520782, 0.6497816499999999, 120.0, 684, 389474, 554, 11.673165799999879
555, 6.06070017746268, 63.79991197238003, 76.73863012176609, 0.6490423000000004, 240.0, 959, 390433, 555, 16.1704265999997
556, 5.030108555285859, 64.04354978768006, 76.97437402554546, 0.6483240999999998, 180.0, 637, 391070, 556, 11.892590199999631
557, 6.596012771386524, 64.10544183336455, 77.1270468372038, 0.6477242500000004, 350.0, 696, 391766, 557, 13.499998400000095
558, 8.208703267511236, 64.2368587614998, 77.36287229023283, 0.64724095, 50.0, 378, 392144, 558, 6.644106799999918
559, 4.718824200317293, 64.03104137184616, 76.96620609184463, 0.6468453999999997, 45.0, 501, 392645, 559, 8.591755099999773
560, 5.068740771567754, 64.10828371640653, 77.05938512726692, 0.6463013500000004, 150.0, 708, 393353, 560, 12.239516500000263
561, 7.027939575650001, 64.18512589084646, 77.23755105440733, 0.6455709999999997, 180.0, 915, 394268, 561, 15.874399899999844
562, 6.918598743719194, 64.21456379676933, 77.2419540011899, 0.6448276000000004, 180.0, 737, 395005, 562, 13.282407499999863
563, 6.613131005844108, 64.09643250717947, 77.08798060360634, 0.6439267000000002, 365.0, 1265, 396270, 563, 21.77401480000026
564, 10.185939638470026, 64.24972968381994, 77.43487172968247, 0.6430514500000001, 120.0, 680, 396950, 564, 11.91102490000003
565, 6.395590041049927, 64.19982601673257, 77.27697467091194, 0.6424443999999996, 180.0, 669, 397619, 565, 12.427986500000316
566, 7.91258184949557, 64.08842710494996, 77.11998593648275, 0.64187335, 65.0, 600, 398219, 566, 10.825195200000053
567, 7.583438415499712, 64.16883623363167, 77.15713081612492, 0.6413315499999999, 105.0, 604, 398823, 567, 12.081766100000095
568, 8.049517671230737, 63.97185108289806, 77.00028220360433, 0.6408145000000004, 75.0, 545, 399368, 568, 10.057749100000365
569, 5.199147150379534, 63.83738664663602, 76.75771799968939, 0.6400287999999998, 370.0, 1201, 400569, 569, 21.415165000000343
570, 4.597028695967193, 63.55081465926065, 76.36167109920288, 0.6392224000000002, 180.0, 591, 401160, 570, 10.934589700000288
571, 5.418119707896808, 63.5186251057623, 76.4292176252264, 0.6387274, 65.0, 509, 401669, 571, 9.364183400000002
572, 7.017494118747317, 63.697215453777176, 76.6842077696606, 0.6379480000000002, 240.0, 1223, 402892, 572, 21.875008299999536
573, 4.480528437292722, 63.66337729753003, 76.49508499305846, 0.6368837499999994, 335.0, 1142, 404034, 573, 19.887184300000627
574, 7.724507146036342, 63.72480190524603, 76.7454892363779, 0.6359329000000005, 465.0, 971, 405005, 574, 17.004353500000434
575, 7.613575725489367, 63.72998376005872, 76.66025062098038, 0.6353254000000002, 30.0, 379, 405384, 575, 6.609010099999978
576, 5.961502301113222, 63.62994652606071, 76.52408384189779, 0.63485875, 105.0, 658, 406042, 576, 11.898576200000207
577, 7.261320303231025, 63.78510769667234, 76.66412164519986, 0.6342665499999999, 125.0, 658, 406700, 577, 12.807002900000043
578, 9.825959131745405, 63.839298928430836, 76.93730264116627, 0.6336802000000004, 155.0, 645, 407345, 578, 11.435680999999931
579, 7.17003389781919, 63.60956401910739, 76.57997759314313, 0.6330898, 180.0, 667, 408012, 579, 11.608830099999977
580, 5.459460705087791, 63.65439336884149, 76.48052188867484, 0.6324940000000002, 210.0, 657, 408669, 580, 11.637064000000464
581, 5.988468277681751, 63.48955720906687, 76.35896172380578, 0.6320331999999999, 35.0, 367, 409036, 581, 6.394352799999979
582, 5.136537747398902, 63.63499313104348, 76.47579179164892, 0.6315111999999998, 210.0, 793, 409829, 582, 14.349804200000108
583, 6.843761081915849, 62.67144977768571, 75.4284521054216, 0.6307489000000002, 230.0, 901, 410730, 583, 17.075828800000636
584, 8.016306848806442, 62.46989042006411, 75.13547128773017, 0.6300383499999996, 115.0, 678, 411408, 584, 12.411658699999862
585, 4.787960792607717, 62.43540064764938, 75.06669546749546, 0.6293111500000005, 275.0, 938, 412346, 585, 17.15476910000052
586, 6.219954423060019, 62.38332795461019, 75.03645281473796, 0.6284840499999995, 165.0, 900, 413246, 586, 16.36716290000004
587, 6.701558000562734, 62.45181791877501, 75.14798102262245, 0.6277294, 160.0, 777, 414023, 587, 13.837819999999738
588, 6.216338619483369, 62.411315607343404, 75.05814298357282, 0.6270647499999996, 195.0, 700, 414723, 588, 12.59210769999936
589, 7.197507618337731, 62.23230024688579, 74.8416803940739, 0.6264586000000001, 110.0, 647, 415370, 589, 11.605370899999798
590, 5.387214841194956, 62.27412707492175, 74.89487038570572, 0.6257156499999996, 220.0, 1004, 416374, 590, 18.26908319999984
591, 6.249698382545085, 62.46341165815081, 75.09210064600384, 0.6249803500000001, 135.0, 630, 417004, 591, 11.705462799999623
592, 5.857981714037116, 62.52079732980905, 75.21239871118682, 0.6243575499999997, 290.0, 754, 417758, 592, 13.610533500000201
593, 4.409461406362315, 62.35180626269834, 74.91668045705318, 0.62372755, 100.0, 646, 418404, 593, 11.451435400000264
594, 6.270665293297316, 62.44953291383508, 75.19126388530802, 0.6230754999999999, 210.0, 803, 419207, 594, 14.479079199999433
595, 5.9405763827757365, 62.35660000408397, 75.01484789567836, 0.6224693500000003, 30.0, 544, 419751, 595, 10.077192600000672
596, 5.896134445620076, 62.23830950896219, 74.82542101651585, 0.6219631000000002, 105.0, 581, 420332, 596, 11.038333800000146
597, 4.127218967922648, 61.78842211271587, 74.24441111858626, 0.6214023999999995, 170.0, 665, 420997, 597, 12.322965399999703
598, 5.543363240659846, 62.05324389061801, 74.60613927860689, 0.6208830999999999, 110.0, 489, 421486, 598, 9.29034799999954
599, 5.418584912684229, 62.025709025065105, 74.51688001844619, 0.62046055, 120.0, 450, 421936, 599, 8.29090400000041
600, 5.091358116380871, 61.93969341754914, 74.50695404052735, 0.6198980499999994, 275.0, 800, 422736, 600, 14.517798400000174
601, 4.1716880186265985, 61.838186774142955, 74.30203907988792, 0.61922845, 95.0, 688, 423424, 601, 12.966805099999874
602, 8.432149799558179, 61.88035510219423, 74.4660005012699, 0.6186798999999997, 130.0, 531, 423955, 602, 9.893559400000413
603, 7.984552450761584, 61.92298016482837, 74.50053591561282, 0.6181453000000002, 120.0, 657, 424612, 603, 12.752580800000032
604, 5.9763830332528975, 61.934524431451855, 74.48321185600767, 0.6172920999999995, 270.0, 1239, 425851, 604, 22.887546300000395
605, 5.6429076005095755, 61.76736070559575, 74.26446613898644, 0.61636015, 435.0, 832, 426683, 605, 16.020909599999868
606, 6.802981508444555, 62.029486158619754, 74.56592718562725, 0.6156959499999995, 155.0, 644, 427327, 606, 12.309878000000026
607, 9.068531961963854, 61.9098111533822, 74.55132841285243, 0.6151168, 155.0, 643, 427970, 607, 12.072783499999787
608, 9.763121710453607, 62.113605463052096, 74.84771441809738, 0.6145430499999998, 65.0, 632, 428602, 608, 11.903479800000241
609, 6.832283638925715, 61.89198092258338, 74.4056126132156, 0.6140210500000002, 45.0, 528, 429130, 609, 9.842339599999832
610, 10.334194440104895, 62.05210552215576, 74.74383257759942, 0.61345945, 210.0, 720, 429850, 610, 14.274582400000327
611, 6.34483235353907, 61.44608113360361, 73.86659729938403, 0.6126431500000002, 355.0, 1094, 430944, 611, 21.10058200000003
612, 6.863954848463812, 61.49215962396377, 73.94131270057072, 0.6117089499999997, 200.0, 982, 431926, 612, 18.44427739999992
613, 7.100795968675613, 61.39377222900391, 73.81226943969726, 0.6107045500000006, 410.0, 1250, 433176, 613, 23.477438599999914
614, 6.829309321649191, 61.314511071181876, 73.75559601202244, 0.6097730500000005, 155.0, 820, 433996, 614, 15.474951300000612
615, 5.033957002374033, 61.20255023136473, 73.59862002155236, 0.6089936499999998, 210.0, 912, 434908, 615, 16.950448300000062
616, 6.559556317123378, 61.38400425558305, 73.86128929113652, 0.6083033500000001, 65.0, 622, 435530, 616, 12.104881100000057
617, 8.425475184838902, 61.554359607548676, 74.18686990663987, 0.6077331999999999, 120.0, 645, 436175, 617, 12.144706699999915
618, 4.399917485128984, 61.242137767213045, 73.60477449281296, 0.6071522500000001, 110.0, 646, 436821, 618, 12.909878099999332
619, 5.859467704690272, 61.600968643367466, 74.04970537672294, 0.6065546500000001, 125.0, 682, 437503, 619, 12.875723499999367
620, 4.684938381186553, 61.437338703700476, 73.8079335130964, 0.6059327499999995, 135.0, 700, 438203, 620, 13.383158800000274
621, 5.3208766522192725, 61.52757295048607, 73.97689509790098, 0.60524065, 210.0, 838, 439041, 621, 15.71711730000061
622, 4.750358684710702, 61.35588929117942, 73.76042395221944, 0.6046871499999997, 50.0, 392, 439433, 622, 7.236393000000135
623, 5.099446302028502, 61.0006453091981, 73.34174744268083, 0.6041539000000005, 135.0, 793, 440226, 623, 15.55302650000067
624, 6.5881062760323035, 60.62951802486131, 72.9392381459725, 0.6032615499999996, 360.0, 1190, 441416, 624, 22.899372500000027
625, 7.177999716826756, 60.58471861986409, 72.8797134267731, 0.6023089, 180.0, 927, 442343, 625, 17.491352400000324
626, 7.114103991734354, 60.6389292592426, 72.94217672961497, 0.6016608999999998, 75.0, 513, 442856, 626, 9.825032800000372
627, 6.501069778024374, 60.44911475911591, 72.68340158617846, 0.60115375, 85.0, 614, 443470, 627, 12.055183999999826
628, 13.48343496535385, 60.60200164405887, 73.0713165110299, 0.6007186, 25.0, 353, 443823, 628, 7.152086300000519
629, 8.284935801170334, 60.34655367757571, 72.63069482414188, 0.6003810999999997, 35.0, 397, 444220, 629, 7.592152799999894
630, 5.102244480988445, 60.44650226169162, 72.66191869542219, 0.5999230000000003, 110.0, 621, 444841, 630, 11.944488499999352
631, 6.067919883418369, 60.626648080957544, 72.85884346260323, 0.5993438500000001, 155.0, 666, 445507, 631, 12.998292399999627
632, 9.564109572563222, 60.56205477437015, 72.98919865441701, 0.5986189000000003, 245.0, 945, 446452, 632, 18.722566199999164
633, 4.639907081439657, 60.36544110937026, 72.52736034208131, 0.5980082499999999, 150.0, 412, 446864, 633, 8.597220200000265
634, 6.909092216807253, 60.59192907295975, 72.94340887630688, 0.5975933499999998, 85.0, 510, 447374, 634, 9.894258100000116
635, 6.837632960560969, 60.46229157744155, 72.73285867938887, 0.5970452500000003, 140.0, 708, 448082, 635, 14.289766099999724
636, 7.249944137992003, 60.59677232106527, 72.91399675515981, 0.5963756499999999, 90.0, 780, 448862, 636, 15.225047599999925
637, 5.337317262212315, 60.53819116294294, 72.77816749885339, 0.5957281000000004, 145.0, 659, 449521, 637, 12.891169300000001
638, 4.011851081717338, 60.62405269501975, 72.80304147539096, 0.5952326500000001, 35.0, 442, 449963, 638, 9.248718100000588
639, 5.3394951304218035, 60.9527627817557, 73.23686008156709, 0.5945418999999994, 415.0, 1093, 451056, 639, 22.71820209999987
640, 7.661422652775342, 61.117684969209456, 73.56126882140539, 0.5936194000000001, 515.0, 957, 452013, 640, 19.74510830000054
641, 5.487008320874181, 60.9671033320908, 73.26155024561389, 0.5928364000000004, 210.0, 783, 452796, 641, 16.0382668000002
642, 5.67692211853979, 60.74754638343494, 73.0049970509161, 0.5921703999999999, 185.0, 697, 453493, 642, 14.378194500000063
643, 8.140936030699656, 61.015486919696514, 73.41211225069486, 0.5915642500000002, 105.0, 650, 454143, 643, 12.650116300000263
644, 6.475201604404757, 60.95541307510868, 73.34281238186745, 0.590923, 150.0, 775, 454918, 644, 15.517750800000613
645, 9.47749750339933, 61.03527700814523, 73.45897437595318, 0.5902642000000002, 130.0, 689, 455607, 645, 14.062383200000113
646, 10.527908186000936, 60.89729868784672, 73.35936433167016, 0.5896864000000002, 30.0, 595, 456202, 646, 13.708800000000338
647, 7.642885501694492, 60.78206298107237, 73.12489213718204, 0.5892471999999997, 50.0, 381, 456583, 647, 8.882737500000076
648, 7.816692829858429, 60.82095829387535, 73.15262324841723, 0.5887711000000001, 110.0, 677, 457260, 648, 16.22115919999942
649, 8.239860025469545, 61.00986219875475, 73.39907079966281, 0.5880367000000002, 195.0, 955, 458215, 649, 23.27533250000033
650, 8.437665252989223, 60.998058820481546, 73.378856126532, 0.5872748500000003, 170.0, 738, 458953, 650, 17.980189599999903
651, 7.391117807867638, 61.03304575798784, 73.44567396253011, 0.5866633, 105.0, 621, 459574, 651, 13.25570770000013
652, 7.147640175405723, 60.76869709527315, 73.11809153200976, 0.5860823499999999, 20.0, 670, 460244, 652, 14.368193799999972
653, 5.676863518158029, 60.24673316488904, 72.41210457271397, 0.5854645000000002, 120.0, 703, 460947, 653, 14.52211669999997
654, 5.682483257315422, 60.28555952492407, 72.4344477895963, 0.5847233499999999, 395.0, 944, 461891, 654, 18.551147800000763
655, 6.50699487078916, 60.42184716432833, 72.63829765707104, 0.5841212500000001, 45.0, 394, 462285, 655, 7.777871299999788
656, 4.766380791843403, 60.20231871306896, 72.35554300993681, 0.5837135499999998, 50.0, 512, 462797, 656, 10.034152500000346
657, 5.78330773635594, 60.208066830328704, 72.44035693173353, 0.58321, 70.0, 607, 463404, 657, 12.11997539999993
658, 10.627894419516233, 60.254788047032996, 72.53065406853426, 0.5826830500000002, 15.0, 564, 463968, 658, 12.110779799999364
659, 5.708458221611682, 60.334680675120836, 72.5203801487269, 0.5822690499999998, 90.0, 356, 464324, 659, 7.5421965000005
660, 6.013128830472164, 60.389897999010586, 72.60606071962948, 0.581878, 140.0, 513, 464837, 660, 11.257513800000197
661, 5.075271545153744, 60.277262735121454, 72.43510243332406, 0.5811224500000001, 415.0, 1166, 466003, 661, 24.548172700000578
662, 6.1633291193383615, 60.30796300332377, 72.472108572755, 0.5801977000000003, 210.0, 889, 466892, 662, 19.116866800000025
663, 5.562058794960495, 60.194153033116066, 72.34406896191975, 0.5795074, 45.0, 645, 467537, 663, 13.942022899999756
664, 4.5601392071559355, 60.294648271221156, 72.50650495868689, 0.5789062000000003, 115.0, 691, 468228, 664, 14.92285340000035
665, 6.467148150732208, 60.2717421258797, 72.51513957695975, 0.5782901500000001, 170.0, 678, 468906, 665, 13.558368299999529
666, 7.7931535653863335, 60.190851527049126, 72.42744741702737, 0.5776259499999997, 210.0, 798, 469704, 666, 16.51888190000045
667, 7.486285830358807, 61.52621238694774, 74.00166419598696, 0.5767664500000003, 230.0, 1112, 470816, 667, 23.751008100000035
668, 6.110383424790282, 62.05514396868254, 74.59550335532741, 0.5760950499999999, 30.0, 380, 471196, 668, 8.392809500000112
669, 5.459774386595216, 62.07683627647266, 74.49286977868331, 0.5757188500000002, 45.0, 456, 471652, 669, 9.7010250000003
670, 7.226667899644137, 62.175761362008416, 74.75947213942005, 0.5752206999999997, 60.0, 651, 472303, 670, 13.866716600000473
671, 6.241681680224041, 61.97697300466931, 74.49071492389469, 0.5745943000000003, 125.0, 741, 473044, 671, 15.232365599999866
672, 4.96660714811749, 61.8791978718322, 74.41308102077907, 0.5740786000000001, 95.0, 405, 473449, 672, 8.22754630000054
673, 9.021133956337428, 61.9277849715689, 74.52822768169901, 0.5735651499999994, 105.0, 736, 474185, 673, 16.636035999999876
674, 8.107221225464754, 61.90712494448007, 74.40371047577668, 0.5727483999999999, 750.0, 1079, 475264, 674, 23.500921500000004
675, 7.29051409046214, 62.181985002608116, 74.8001085974562, 0.5718641500000001, 240.0, 886, 476150, 675, 19.38305760000003
676, 8.701327944181385, 62.22230763381786, 74.92364793413141, 0.57122515, 90.0, 534, 476684, 676, 12.884915099999489
677, 6.903613303685538, 62.105032009134085, 74.66413869134955, 0.5706167500000001, 155.0, 818, 477502, 677, 18.7964707000001
678, 6.0753706972594514, 61.89816178408536, 74.38747759154349, 0.5696546499999998, 330.0, 1320, 478822, 678, 31.21018550000008
679, 6.933940018512107, 62.413549464457745, 75.02197498630834, 0.5688941499999998, 45.0, 370, 479192, 679, 8.348939900000005
680, 5.841028769754869, 62.26944925196876, 74.80217837748555, 0.5684887, 105.0, 531, 479723, 680, 12.511316400000396
681, 5.987331848237767, 62.005689925721235, 74.5223819199887, 0.5678469999999999, 215.0, 895, 480618, 681, 20.686355599999843
682, 6.090082412362099, 62.246799116134646, 74.8758850479126, 0.5672642500000001, 105.0, 400, 481018, 682, 8.952017200000228
683, 6.390167454288793, 62.2009137645704, 74.77112633924325, 0.5667885999999999, 140.0, 657, 481675, 683, 15.188933899999938
684, 7.012932076532044, 62.007025164975005, 74.50788848844796, 0.5660659000000002, 210.0, 949, 482624, 684, 20.54583079999975
685, 5.002365211445477, 61.99808551419166, 74.47836394771453, 0.5653598499999998, 210.0, 620, 483244, 685, 12.543408600000475
686, 8.211224655279024, 62.00637459341935, 74.61754638191283, 0.5647951000000002, 165.0, 635, 483879, 686, 13.0309670000006
687, 5.04130835886991, 61.83589587912436, 74.32019994994062, 0.5643532000000001, 50.0, 347, 484226, 687, 8.333810999999514
688, 8.391042796613105, 61.88806369823723, 74.52661044131347, 0.5639531499999998, 40.0, 542, 484768, 688, 12.26938539999992
689, 6.905794166783297, 61.87547344008303, 74.3641717511844, 0.5634338500000002, 110.0, 612, 485380, 689, 14.089147400000002
690, 6.360629003396077, 61.925248939379124, 74.4587267985386, 0.5629550500000001, 135.0, 452, 485832, 690, 9.991195000000516
691, 5.225984647600224, 61.75149681198765, 74.18891536781726, 0.5625279999999998, 75.0, 497, 486329, 691, 10.882044199999655
692, 7.657245484230329, 61.8642815953536, 74.45447857534285, 0.5619916000000004, 125.0, 695, 487024, 692, 16.184761499999695
693, 5.020983691001263, 61.85704958526069, 74.29662304661989, 0.5612482, 265.0, 957, 487981, 693, 21.968908200000442
694, 7.093498709803097, 62.10312753821509, 74.73267534788967, 0.5605615000000002, 40.0, 569, 488550, 694, 12.602598800000123
695, 5.3869238946162445, 61.88960225672661, 74.38882343678534, 0.5600210500000001, 125.0, 632, 489182, 695, 12.883451599999717
696, 6.857836306095123, 61.831567044325276, 74.38376653429488, 0.5594171499999998, 100.0, 710, 489892, 696, 14.482038500000272
697, 8.884307092020636, 62.767193519603325, 75.49596778218205, 0.5584757499999998, 240.0, 1382, 491274, 697, 31.094947599999614
698, 7.923680775568626, 62.759490382728394, 75.48799028655178, 0.5575717000000001, 165.0, 627, 491901, 698, 13.109006199999385
699, 8.66999136683658, 62.74955751496473, 75.471628107712, 0.5568570999999997, 175.0, 961, 492862, 699, 20.48420249999981
700, 5.647438979457697, 62.66916079743538, 75.27284364057947, 0.5559904, 395.0, 965, 493827, 700, 20.659399699999994
701, 7.535370587824341, 62.64069325897615, 75.30906532616649, 0.5551074999999998, 575.0, 997, 494824, 701, 21.258944500000325
702, 5.477098170783699, 62.83419681707194, 75.49527706383424, 0.5543114499999999, 180.0, 772, 495596, 702, 16.315334500000063
703, 7.098994732994429, 62.75639171868983, 75.4523613728268, 0.5536445500000003, 150.0, 710, 496306, 703, 15.007098499999302
704, 7.253391816866141, 62.75813737556116, 75.44771711308367, 0.5530537, 70.0, 603, 496909, 704, 13.343612599999688
705, 5.778381014924783, 62.68486999511719, 75.3198789860652, 0.5524898499999996, 40.0, 650, 497559, 705, 13.794887099999869
706, 6.3273578096116445, 62.82009997182488, 75.51134649360347, 0.5516533000000003, 440.0, 1209, 498768, 706, 26.22024060000058
707, 6.101946762018653, 62.61414697179833, 75.23744820590957, 0.55088515, 45.0, 498, 499266, 707, 10.828052500000013
708, 7.588719026013191, 62.71105261382109, 75.42007961865538, 0.5502988, 210.0, 805, 500071, 708, 18.211242099999254
709, 6.910326262574587, 61.79265761019579, 74.27481769447895, 0.5496953499999997, 60.0, 536, 500607, 709, 11.52620399999978
710, 9.854238452275485, 62.10210341678635, 74.78201755560112, 0.5491243000000002, 215.0, 733, 501340, 710, 17.411185699999805
711, 9.569557967282362, 61.93164223071086, 74.55668701825046, 0.5484159999999997, 245.0, 841, 502181, 711, 18.028628400000343
712, 8.182735282656914, 61.74666717382779, 74.1951881586606, 0.5477095000000001, 140.0, 729, 502910, 712, 16.44487520000075
713, 7.8530559542155505, 61.947087799676574, 74.47752696122274, 0.5471541999999999, 75.0, 505, 503415, 713, 10.893526400000155
714, 6.406805317713012, 61.945124923235014, 74.46414428296994, 0.5464458999999999, 365.0, 1069, 504484, 714, 23.343329000000267
715, 8.44425424409339, 61.987951093921005, 74.60222679172294, 0.5456628999999997, 120.0, 671, 505155, 715, 14.643818999999894
716, 4.667428235362347, 61.7949815334234, 74.18233197434505, 0.5451814000000001, 55.0, 399, 505554, 716, 9.301265799999783
717, 5.006119771263538, 61.94057794050737, 74.38802741790985, 0.5446157500000001, 160.0, 858, 506412, 717, 18.926656399999956
718, 9.472423184231223, 61.92443029294611, 74.46278498677603, 0.5439384999999998, 160.0, 647, 507059, 718, 14.012883999999758
719, 9.469048948365986, 61.79694396647507, 74.35784529478401, 0.5433516999999999, 110.0, 657, 507716, 719, 14.337968900000305
720, 7.919551984068994, 61.8555979823628, 74.38867457391292, 0.5427621999999996, 230.0, 653, 508369, 720, 13.746623999999429
721, 8.36205661157788, 61.78725689820242, 74.30574871803519, 0.5420440000000002, 475.0, 943, 509312, 721, 20.38967380000031
722, 5.9858146214988865, 61.93663293542996, 74.38272038849307, 0.5413001499999996, 105.0, 710, 510022, 722, 15.000639400000182
723, 9.50714832412209, 61.877572957859485, 74.48913976203563, 0.54067105, 125.0, 688, 510710, 723, 14.616084799999953
724, 8.162846718703648, 61.90939955608941, 74.41709404628999, 0.5401729, 80.0, 419, 511129, 724, 8.929785399999673
725, 7.093224229315917, 61.65934523264567, 74.05198964436849, 0.5397143499999999, 90.0, 600, 511729, 725, 13.021809400000166
726, 7.644509065103173, 61.65376054001491, 74.12870085643623, 0.5386347999999996, 455.0, 1799, 513528, 726, 38.237362900000335
727, 7.0043450827847735, 61.80353811399533, 74.2902694556231, 0.53749585, 130.0, 732, 514260, 727, 15.600820600000588
728, 11.492157387860278, 61.993222995514564, 74.68132144035177, 0.5369549500000002, 10.0, 470, 514730, 728, 10.218643999999586
729, 7.412136763022752, 61.79985850530219, 74.27200416737733, 0.53622685, 235.0, 1148, 515878, 729, 24.30772160000015
730, 10.977388570602027, 61.84119099222553, 74.38084651287937, 0.5353664500000002, 255.0, 764, 516642, 730, 16.359513100000186
731, 7.65600469248726, 61.93884726991045, 74.53188333714262, 0.5348111500000001, 70.0, 470, 517112, 731, 10.084706799999367
732, 8.975115066348549, 61.743980481880556, 74.25382844694369, 0.5340672999999999, 165.0, 1183, 518295, 732, 25.444414000000506
733, 7.806425604257691, 61.70653692524085, 74.24659982959876, 0.53337475, 105.0, 356, 518651, 733, 7.707144800000606
734, 7.371050031664436, 61.89180087892554, 74.34897153110113, 0.5329296999999997, 75.0, 633, 519284, 734, 13.813772299999982
735, 6.759684088938641, 61.59131213494067, 73.99196464250673, 0.5324063500000001, 125.0, 530, 519814, 735, 11.40092470000036
736, 7.552553254383706, 61.414680679334296, 73.8511230358179, 0.5316400000000001, 160.0, 1173, 520987, 736, 25.174849899999572
737, 6.969655915388405, 61.54204690214205, 73.97446341762155, 0.5309127999999999, 95.0, 443, 521430, 737, 9.570608600000014
738, 7.022591003446223, 61.36264611052451, 73.7665454595289, 0.5303754999999999, 180.0, 751, 522181, 738, 16.36988409999958
739, 6.3302461027278545, 61.489148180276125, 73.91166258655349, 0.5295799000000001, 275.0, 1017, 523198, 739, 22.135980899999595
740, 8.210348181640823, 61.32420113860165, 73.74505033971474, 0.5284495, 530.0, 1495, 524693, 740, 32.38851049999994
741, 10.094216339255702, 61.33406860986366, 73.96823233558878, 0.5274846999999999, 45.0, 649, 525342, 741, 14.01103140000032
742, 7.093107915031696, 61.51697026898047, 73.96381689973934, 0.5268920500000002, 125.0, 668, 526010, 742, 14.515322900000683
743, 6.409807856486746, 61.422787220520384, 73.8049301282894, 0.5262872500000001, 50.0, 676, 526686, 743, 14.661403899999641
744, 6.598654075659585, 61.63093810266613, 74.06383275835611, 0.5255542000000002, 185.0, 953, 527639, 744, 20.76958519999971
745, 6.8071506305953635, 61.47657073385388, 73.87456739504391, 0.5247874, 120.0, 751, 528390, 745, 16.61642859999938
746, 7.456855285695081, 61.538651308750666, 73.93937855053426, 0.5241798999999999, 65.0, 599, 528989, 746, 13.236077499999737
747, 6.189260648681393, 61.233395406130164, 73.55712405605826, 0.5232704500000005, 310.0, 1422, 530411, 747, 31.410674200000358
748, 6.8435227704708534, 60.96098780153815, 73.29223144589545, 0.5221594, 215.0, 1047, 531458, 748, 23.006357799999932
749, 7.752007775230257, 60.88886536098324, 73.23893880666853, 0.52120405, 295.0, 1076, 532534, 749, 23.7427830000006
750, 6.384535440333085, 60.99846495014347, 73.39721485686628, 0.5204570499999999, 35.0, 584, 533118, 750, 13.197463100000277
751, 7.226619709551461, 60.90927045628176, 73.17919032048371, 0.5197694500000003, 240.0, 944, 534062, 751, 20.78746990000036
752, 7.259021754671887, 61.144329390874724, 73.47281728139738, 0.5190494499999999, 80.0, 656, 534718, 752, 14.493324299999585
753, 7.0958148487228945, 61.0531519990106, 73.34681364993921, 0.5183519500000003, 150.0, 894, 535612, 753, 19.943582199999582
754, 8.739419491519891, 60.97018288548947, 73.30677194248328, 0.5175909999999999, 210.0, 797, 536409, 754, 18.577803600000152
755, 7.150546459755317, 60.99107789751237, 73.28380544052511, 0.51705505, 135.0, 394, 536803, 755, 9.315399399999478
756, 9.111208359783708, 61.12313499490462, 73.5125747776131, 0.5164462, 260.0, 959, 537762, 756, 22.316131899999164
757, 6.999763274945802, 61.000246836393636, 73.29882863091822, 0.5155498000000002, 405.0, 1033, 538795, 757, 24.499914800000624
758, 7.666647218576033, 61.00952468506277, 73.32335430302032, 0.5146907499999996, 130.0, 876, 539671, 758, 20.1160488000005
759, 7.251508724975721, 61.84325147079209, 74.36701754661603, 0.51397795, 375.0, 708, 540379, 759, 16.458164900000156
760, 7.5905827892360405, 62.63808703636055, 75.28605433222073, 0.5133578499999999, 155.0, 670, 541049, 760, 15.914038699999765
761, 10.440130083411226, 62.658851659693426, 75.36677171607718, 0.5127715000000002, 90.0, 633, 541682, 761, 17.459657699999298
762, 7.4708998870224725, 62.606878019148304, 75.35492735524332, 0.5122634500000001, 120.0, 496, 542178, 762, 12.831471299999976
763, 8.090349592437372, 62.391185304079606, 74.97831585785605, 0.5116829499999995, 210.0, 794, 542972, 763, 19.13056730000062
764, 5.849984282099708, 62.5168226046825, 75.13273001092625, 0.51086845, 265.0, 1016, 543988, 764, 25.63743059999979
765, 7.149403322581313, 62.34391811493611, 74.93500944371729, 0.5100337, 180.0, 839, 544827, 765, 19.86749719999989
766, 10.609669020900933, 62.474576097268326, 75.18575811386108, 0.5092817499999999, 210.0, 832, 545659, 766, 19.829424200000176
767, 9.851989910473938, 62.5721743977354, 75.2456932977272, 0.5085487000000003, 110.0, 797, 546456, 767, 20.994668000000274
768, 7.521101272269858, 62.40876788081545, 74.9637155749581, 0.5077148499999997, 405.0, 1056, 547512, 768, 24.17653259999952
769, 6.337687247970575, 62.29657903859313, 74.89384844605352, 0.5069840499999999, 150.0, 568, 548080, 769, 12.915715299999647
770, 7.301150404641429, 62.52882134622349, 75.18028750345277, 0.5061223, 330.0, 1347, 549427, 770, 30.941396199999872
771, 8.167419404284708, 62.31491675015153, 74.98112274169922, 0.5051899000000002, 90.0, 725, 550152, 771, 18.234983199999988
772, 6.298660098522944, 62.140269964976156, 74.72775137202127, 0.5045499999999998, 115.0, 697, 550849, 772, 17.028748499999892
773, 9.76677345460637, 62.24248008693126, 74.87601214074697, 0.5037445000000002, 215.0, 1093, 551942, 773, 26.068517299999257
774, 8.851766362480404, 62.24800766528177, 74.84028251849311, 0.5027923000000003, 320.0, 1023, 552965, 774, 25.060394000000088
775, 5.1130275157571745, 62.21435595408044, 74.75206572166229, 0.5021551, 40.0, 393, 553358, 775, 9.473824699999568
776, 7.135431851302911, 62.22686885698192, 74.87212821069707, 0.50180095, 40.0, 394, 553752, 776, 11.012810599999284
777, 6.432986413221125, 62.22592214108012, 74.78672019615692, 0.501193, 280.0, 957, 554709, 777, 22.586772600000586
778, 6.655219188584408, 62.300784602635346, 74.86737878289021, 0.5004428499999996, 105.0, 710, 555419, 778, 16.555087800000365
779, 7.543395748598055, 62.175084409579426, 74.78406170724143, 0.49961215, 280.0, 1136, 556555, 779, 26.4377771999998
780, 6.099655627822265, 62.501095563937454, 75.09296808487329, 0.49882014999999996, 110.0, 624, 557179, 780, 14.670615800000633
781, 9.027079392201973, 62.331959290937945, 75.02745694247159, 0.49824235000000017, 90.0, 660, 557839, 781, 15.225798299999951
782, 6.545077580093422, 62.202769889026136, 74.72195140230907, 0.4977108999999999, 80.0, 521, 558360, 782, 13.510836300000847
783, 5.362216125764148, 62.37554658020978, 74.90178861501538, 0.4972186, 135.0, 573, 558933, 783, 14.522532699999829
784, 7.320214602498897, 62.11098196624667, 74.68316747148252, 0.49665204999999996, 225.0, 686, 559619, 784, 20.153213600000527
785, 5.665386856412788, 62.09555794304884, 74.61354650712912, 0.49612825000000005, 30.0, 478, 560097, 785, 13.179505099999915
786, 7.530868765253287, 61.455983154939645, 73.84842077541701, 0.4954217500000001, 255.0, 1092, 561189, 786, 27.227319200000238
787, 9.506292514814787, 61.774038768949964, 74.32884712824746, 0.49461850000000024, 155.0, 693, 561882, 787, 19.66629929999999
788, 8.172398526266397, 61.6422999705382, 74.172083567424, 0.4937837499999999, 385.0, 1162, 563044, 788, 30.3312734000001
789, 7.725010527997482, 61.77994711340928, 74.2789242628144, 0.49307634999999994, 50.0, 410, 563454, 789, 13.78263270000025
790, 6.152641635395232, 61.56506184169224, 73.96835671561105, 0.49241935000000003, 230.0, 1050, 564504, 790, 30.265271599999323
791, 7.799443021309241, 61.57150664560336, 74.00959985263562, 0.4915099000000002, 240.0, 971, 565475, 791, 26.857828399999562
792, 6.146652009371702, 61.50541120821291, 73.89590017645209, 0.49087314999999987, 35.0, 444, 565919, 792, 12.425682799999777
793, 6.704724711744348, 61.654622972011566, 74.09764964878559, 0.4904429500000001, 75.0, 512, 566431, 793, 14.101033599999937
794, 6.911712267233819, 61.61182172315502, 73.9763141349847, 0.4900239999999999, 105.0, 419, 566850, 794, 13.79505109999991
795, 7.553160183384257, 61.622586896864036, 74.1521204528162, 0.48962305, 75.0, 472, 567322, 795, 15.100061799999821
796, 8.63107424259331, 61.81434392522517, 74.28591321417824, 0.48904120000000006, 180.0, 821, 568143, 796, 21.122927500000515
797, 6.265193277953325, 61.54856091312, 73.8972604572773, 0.48826855, 300.0, 896, 569039, 797, 27.39329909999924
798, 7.733220908839207, 61.74403798734987, 74.20592414558708, 0.48758815, 120.0, 616, 569655, 798, 18.329718299999513
799, 8.606205725338723, 61.75837381857413, 74.29353404574924, 0.4868249500000001, 405.0, 1080, 570735, 799, 32.08998919999976
800, 5.651528832997471, 61.49050675660068, 73.8647573823665, 0.4860298, 110.0, 687, 571422, 800, 18.798963100000037
801, 7.7033167600442045, 61.534495539577975, 73.95609218503334, 0.4851549999999996, 380.0, 1257, 572679, 801, 31.646649199999956
802, 9.655302226371408, 61.74016738385177, 74.21448545469694, 0.4842775000000001, 205.0, 693, 573372, 802, 16.773571800000354
803, 9.398608901099582, 61.41043338883802, 73.88495855205225, 0.48372759999999976, 80.0, 529, 573901, 803, 13.067468199999894
804, 6.542582888229798, 61.57925724135086, 73.96702136918019, 0.4830341500000002, 565.0, 1012, 574913, 804, 24.704647399999885
805, 8.147202738192146, 61.61964405555379, 74.04295910953395, 0.48228084999999954, 130.0, 662, 575575, 805, 16.63007220000054
806, 7.181637947201729, 61.56362862141927, 73.94528909301758, 0.4816454500000001, 205.0, 750, 576325, 806, 18.260041000000456
807, 6.671439596372334, 61.62256998255633, 74.02512246591074, 0.48102849999999986, 75.0, 621, 576946, 807, 15.015658700000131
808, 9.643239944121083, 61.779287210857596, 74.35486078626327, 0.48027745000000027, 460.0, 1048, 577994, 808, 26.356688800000484
809, 8.472528027728618, 61.642618562438834, 74.11207549257875, 0.47938914999999954, 235.0, 926, 578920, 809, 23.025488500000392
810, 6.083740911865041, 61.62048235853352, 74.02712289910568, 0.47863900000000004, 310.0, 741, 579661, 810, 17.964042300000074
811, 10.015089474935289, 61.041132017300164, 73.3388746129496, 0.47793519999999967, 215.0, 823, 580484, 811, 20.662476999999853
812, 5.661967753488505, 60.569945293924086, 72.70155065516327, 0.47718190000000005, 210.0, 851, 581335, 812, 22.05175919999965
813, 6.719459783217412, 60.57085978390351, 72.77961422577305, 0.47662749999999987, 70.0, 381, 581716, 813, 9.706752200000665
814, 6.909483357225232, 60.69591986845957, 72.97697596676903, 0.47610100000000016, 130.0, 789, 582505, 814, 19.818238799999563
815, 8.891322052230114, 60.771260063837836, 73.03263844038703, 0.47540079999999996, 110.0, 767, 583272, 815, 20.322743400000036
816, 5.883918952363962, 60.520656629857726, 72.68089133233651, 0.47474470000000013, 135.0, 691, 583963, 816, 17.571725999999217
817, 8.42902682759545, 60.50756765192205, 72.70527403397993, 0.47418625, 70.0, 550, 584513, 817, 14.189706000000115
818, 7.51338955470971, 60.57228103588368, 72.80082140708792, 0.47352115000000006, 285.0, 928, 585441, 818, 24.247395999999753
819, 6.675775799929397, 60.54967614263296, 72.77527148276567, 0.47264274999999983, 285.0, 1024, 586465, 819, 28.30348520000007
820, 7.697159099217432, 60.640770628910516, 72.85201627647031, 0.47174410000000017, 425.0, 973, 587438, 820, 25.62983449999956
821, 8.454640288429912, 60.75238621074111, 73.09638612486265, 0.4708391499999997, 290.0, 1038, 588476, 821, 27.94618140000057
822, 8.770455017261197, 60.6619615519357, 72.95009975598795, 0.47000889999999995, 170.0, 807, 589283, 822, 23.186876499999926
823, 7.4177759169130635, 60.51947537035045, 72.72033450154974, 0.46928215000000034, 230.0, 808, 590091, 823, 23.54426760000024
824, 8.61490254216599, 60.407823016808464, 72.60959541272817, 0.4686323500000001, 105.0, 636, 590727, 824, 18.237681900000098
825, 8.058700570048709, 60.25930542454575, 72.36476647116922, 0.4679749, 200.0, 825, 591552, 825, 23.321179899998242
826, 7.633821533957204, 60.084075927734375, 72.1983586088451, 0.46736875000000017, 80.0, 522, 592074, 826, 14.410962800000561
827, 10.778861140584091, 60.344526895350064, 72.6040707125776, 0.46673199999999954, 335.0, 893, 592967, 827, 24.27439240000058
828, 6.7251392181014875, 60.364399565747505, 72.4983660568147, 0.4660259500000001, 150.0, 676, 593643, 828, 18.084191300000384
829, 7.550554451743399, 60.27908945083618, 72.41621515524649, 0.46522854999999963, 315.0, 1096, 594739, 829, 29.17587090000052
830, 8.12231811990744, 60.36467574453596, 72.55532790924691, 0.46438075000000006, 210.0, 788, 595527, 830, 20.716356600001745
831, 7.387613685039374, 60.37044232881986, 72.55736850445088, 0.46373365000000016, 165.0, 650, 596177, 831, 20.94662480000079
832, 6.594129662609325, 60.20838957462671, 72.27244743311181, 0.46305955000000015, 155.0, 848, 597025, 832, 24.29770009999993
833, 10.311863566680652, 60.20641634716251, 72.36595158460663, 0.4622351500000002, 165.0, 984, 598009, 833, 27.116780199999994
834, 6.633714768398418, 60.27011793710468, 72.44244932920002, 0.4614318999999999, 245.0, 801, 598810, 834, 23.745374000000083
835, 9.359534120907533, 60.39907493930896, 72.65734393896146, 0.4606165000000002, 300.0, 1011, 599821, 835, 28.589092500000334
836, 9.38574881702222, 59.64826466833244, 71.74011815051414, 0.45985644999999975, 135.0, 678, 600499, 836, 22.793564599998717
837, 6.8985292546307955, 59.45400432821955, 71.3971841617349, 0.4591063000000001, 595.0, 989, 601488, 837, 29.65205530000094
838, 6.148806134993966, 59.504310515120224, 71.44146974924449, 0.45849474999999984, 75.0, 370, 601858, 838, 10.31790699999874
839, 7.072207355049735, 59.755971819772846, 71.75231109207125, 0.4578449500000004, 340.0, 1074, 602932, 839, 29.27083280000079
840, 8.220141664895838, 59.5597831400925, 71.52542407472747, 0.4570659999999998, 165.0, 657, 603589, 840, 17.517218500001036
841, 8.233942419695804, 59.657343218017324, 71.69063447609108, 0.45634015000000017, 250.0, 956, 604545, 841, 24.94763039999998
842, 7.403281632580875, 59.46060489136496, 71.4152664196344, 0.4556183499999996, 210.0, 648, 605193, 842, 18.918572399999903
843, 8.013862525137549, 59.25087362500038, 71.20254687462031, 0.4550374, 95.0, 643, 605836, 843, 16.647483400000056
844, 6.200089175455837, 59.437022410001425, 71.34268383113343, 0.45437409999999984, 125.0, 831, 606667, 844, 22.768198600000687
845, 5.71675815848248, 59.51412420747368, 71.46759857373674, 0.4537198, 120.0, 623, 607290, 845, 17.358044900000095
846, 7.5634680315362, 59.29041590816096, 71.1893531460511, 0.45316585, 100.0, 608, 607898, 846, 18.01794500000142
847, 11.201919081635133, 59.54804938308482, 71.58702271172801, 0.45251020000000003, 135.0, 849, 608747, 847, 25.258018299999094
848, 7.752813407790072, 59.586684912329844, 71.59483172050447, 0.45189145000000014, 60.0, 526, 609273, 848, 16.77149350000036
849, 6.6810198841303805, 59.504895537439054, 71.47554325187294, 0.45134649999999965, 110.0, 685, 609958, 849, 19.8678775999997
850, 9.019541782274878, 59.18571198827739, 71.1629636397907, 0.45066835, 195.0, 822, 610780, 850, 21.723219299999982
851, 8.595900595563227, 59.1897409425993, 71.17069287594724, 0.4499051499999996, 260.0, 874, 611654, 851, 26.25149820000115
852, 8.17131577300878, 59.23376759642611, 71.13359764370335, 0.44922070000000003, 135.0, 647, 612301, 852, 19.13262709999981
853, 8.416079319207785, 58.95091211907217, 70.82497392763919, 0.4485924999999997, 125.0, 749, 613050, 853, 22.105941300000268
854, 5.409517146387503, 59.14382343387129, 70.99938496072494, 0.44807454999999996, 75.0, 402, 613452, 854, 11.51731800000016
855, 6.985396032667521, 59.1092937411684, 70.99833201206091, 0.4475966500000001, 90.0, 660, 614112, 855, 19.701650100001643
856, 5.820956443077169, 58.94174950846126, 70.72740327642205, 0.44705934999999997, 135.0, 534, 614646, 856, 15.473767299999963
857, 8.351928550967932, 58.99825243299054, 70.90284918144884, 0.44649595, 120.0, 718, 615364, 857, 21.181621199999427
858, 6.7613471557774885, 59.01371789166308, 70.87214413740503, 0.4458871, 115.0, 635, 615999, 858, 17.36001059999944
859, 7.822149177922228, 59.021516988700334, 70.90931609479811, 0.4449011500000005, 340.0, 1556, 617555, 859, 44.234270599999945
860, 7.955683326498248, 59.02670563382022, 70.91837468582673, 0.4437919000000002, 215.0, 909, 618464, 860, 26.648279699998966
861, 7.517246955796913, 59.13332168243743, 71.01770050551865, 0.44297334999999965, 180.0, 910, 619374, 861, 27.71789499999977
862, 7.5162903002781025, 58.88321429533117, 70.75258452471564, 0.44218135000000003, 320.0, 850, 620224, 862, 26.726608799999667
863, 7.406879844831991, 58.09989984615429, 69.8361815117501, 0.44139924999999963, 155.0, 888, 621112, 863, 24.923921699999482
864, 7.743318617392441, 58.19623872589211, 69.90828314666251, 0.44072335, 160.0, 614, 621726, 864, 17.638949199999843
865, 6.651880759459275, 58.31047278374702, 70.04146669294451, 0.4399965999999995, 120.0, 1001, 622727, 865, 28.64869650000037
866, 7.8307325791408955, 58.17288371608017, 69.94826353475189, 0.4391128000000001, 260.0, 963, 623690, 866, 26.800613800000065
867, 11.450452392313359, 58.38818642135579, 70.20684865864139, 0.43851249999999997, 50.0, 371, 624061, 867, 11.372996899999634
868, 8.130199761096808, 58.192339058453, 69.9362307788784, 0.43805439999999984, 115.0, 647, 624708, 868, 17.942124799999874
869, 6.615930717979228, 58.26778561069119, 69.98852041459853, 0.4375400499999999, 75.0, 496, 625204, 869, 12.90532709999934
870, 7.426164570545179, 58.15540322006019, 69.86106774860917, 0.43681960000000025, 465.0, 1105, 626309, 870, 28.732638000001316
871, 6.067815342309883, 58.044369240980025, 69.72660290339681, 0.43601499999999976, 180.0, 683, 626992, 871, 17.44672680000076
872, 8.493244523814669, 58.03119565463634, 69.78281641168843, 0.4353112000000001, 115.0, 881, 627873, 872, 22.764461599999777
873, 9.397086080549093, 58.15196279704277, 69.91109109042313, 0.4345493499999997, 165.0, 812, 628685, 873, 22.469430099999954
874, 5.7730959551899055, 57.98328115229021, 69.58679015176338, 0.4339274499999998, 105.0, 570, 629255, 874, 15.191566299999977
875, 6.467687335284108, 58.23659642537435, 69.95574488038541, 0.4332105999999997, 430.0, 1023, 630278, 875, 27.54215330000079
876, 7.337223397970483, 58.315656444522375, 70.04579445755114, 0.43237135, 215.0, 842, 631120, 876, 22.805727099999785
877, 9.108451556785942, 58.318678824188154, 70.10300367994381, 0.4316405499999996, 130.0, 782, 631902, 877, 20.334882799999832
878, 6.784004526466307, 58.491826300084945, 70.18620769794171, 0.43113654999999995, 30.0, 338, 632240, 878, 9.877161099999284
879, 6.874165431788948, 58.184246518026015, 69.9332409508327, 0.4307995, 50.0, 411, 632651, 879, 11.379142499999944
880, 7.983413090055639, 58.14457599061908, 69.89743395256274, 0.43024329999999966, 155.0, 825, 633476, 880, 22.7988093999993
881, 9.634853589138011, 58.292157568798714, 70.0815896190726, 0.42929064999999994, 500.0, 1292, 634768, 881, 36.27528660000098
882, 7.699661555092135, 58.453393553545375, 70.23241454826858, 0.4284086500000001, 135.0, 668, 635436, 882, 18.65039919999981
883, 8.537154609448201, 58.31807369885144, 70.13055095500775, 0.42785829999999997, 105.0, 555, 635991, 883, 16.39947299999949
884, 6.271244698482401, 58.04827545166015, 69.62574270809398, 0.4274172999999997, 50.0, 425, 636416, 884, 11.897520799999256
885, 8.992864635603205, 58.485642097712, 70.29414709804247, 0.42698169999999996, 80.0, 543, 636959, 885, 16.295430600001055
886, 9.117952330204714, 58.43474449192446, 70.25632593157802, 0.4264408, 120.0, 659, 637618, 886, 18.123093500000323
887, 7.942464551300987, 58.28643945390667, 70.02076939406746, 0.4257226000000002, 235.0, 937, 638555, 887, 26.71250990000044
888, 10.371090089296708, 58.290529818307085, 70.07077322608701, 0.42500889999999997, 105.0, 649, 639204, 888, 18.159876699999586
889, 8.469703627500719, 58.471054469728934, 70.21322234811134, 0.42448510000000017, 80.0, 515, 639719, 889, 13.964756900000793
890, 10.295014189673882, 58.19177602466784, 69.98566994667053, 0.4235693499999998, 500.0, 1520, 641239, 890, 42.28573310000138
891, 8.137576703467067, 58.1025454142737, 69.81440476311577, 0.42260184999999995, 105.0, 630, 641869, 891, 17.728384899999583
892, 7.791508069003585, 58.21178959756002, 69.92261437604027, 0.42207174999999997, 100.0, 548, 642417, 892, 15.495645500001046
893, 8.95483771471337, 58.179180494665054, 69.91907870724629, 0.42146650000000024, 185.0, 797, 643214, 893, 23.07642450000094
894, 6.008914855102224, 58.1260932037041, 69.79258596096972, 0.4207122999999998, 195.0, 879, 644093, 894, 25.171683999999004
895, 9.452467974117052, 58.1058255808887, 69.88273859429292, 0.41999905, 195.0, 706, 644799, 895, 20.726264599999922
896, 6.905869412648169, 58.032063618881445, 69.68665036025206, 0.4192065999999999, 300.0, 1055, 645854, 896, 30.471585100000084
897, 8.04711168926013, 57.93168645451313, 69.66444511531677, 0.41844114999999993, 105.0, 646, 646500, 897, 18.302628499999628
898, 9.137467797557775, 58.04615605587991, 69.74122968677916, 0.4177427499999998, 205.0, 906, 647406, 898, 26.066806099999667
899, 9.180041621031958, 58.09989402820538, 69.87077633333412, 0.41691925, 185.0, 924, 648330, 899, 26.4168333000016
900, 10.584082640894694, 58.34207418815574, 70.11914120008, 0.4163243499999998, 30.0, 398, 648728, 900, 11.564989700000297
901, 6.8810738022914775, 58.09928045476192, 69.7433579099165, 0.41574430000000023, 120.0, 891, 649619, 901, 26.052380499999344
902, 7.686181589961052, 58.13947166884241, 69.86355143145096, 0.41512555000000007, 95.0, 484, 650103, 902, 14.241148999999496
903, 8.666006598291517, 58.940503716331634, 70.78989569748504, 0.4145167000000001, 270.0, 869, 650972, 903, 25.237436399998842
904, 10.053363169417894, 59.09142628521987, 71.03244296405876, 0.41367835, 145.0, 994, 651966, 904, 29.292419400000654
905, 8.350551763098853, 59.03143519796833, 70.88043361011381, 0.412939, 105.0, 649, 652615, 905, 18.119527700000617
906, 7.086656029330041, 59.00195623018027, 70.85202531376343, 0.41223564999999984, 145.0, 914, 653529, 906, 25.7484041000007
907, 9.062299441465965, 58.98012070289025, 70.86779478219839, 0.4115318499999999, 135.0, 650, 654179, 907, 19.23050619999958
908, 7.257524283762349, 59.059844337433226, 70.93036475200427, 0.41089779999999987, 125.0, 759, 654938, 908, 21.858260700000756
909, 5.894676921439013, 59.108394910385236, 71.02780110767306, 0.41035330000000003, 105.0, 451, 655389, 909, 12.845991700000013
910, 9.452280307655734, 59.18195328845328, 71.15605845023235, 0.40985964999999996, 180.0, 646, 656035, 910, 19.449361599999975
911, 9.829488847851753, 58.994391927719114, 70.90772232055664, 0.40938895, 65.0, 400, 656435, 911, 11.825067300000228
912, 9.565327386269395, 58.90251652982222, 70.81657032192689, 0.40903705, 35.0, 382, 656817, 912, 11.204707299999427
913, 8.8750048914597, 59.12537982303512, 71.01252665902425, 0.40845024999999996, 310.0, 922, 657739, 913, 26.816057
914, 14.835051719506582, 59.0442636311849, 70.99898973592123, 0.40786659999999986, 45.0, 375, 658114, 914, 11.044707000000926
915, 7.47269714333117, 59.06977313041687, 70.97114494800567, 0.4073378500000001, 190.0, 800, 658914, 915, 23.348339500000293
916, 9.968892906766488, 59.09085291980272, 70.9977907887493, 0.40675195, 45.0, 502, 659416, 916, 14.600293400000737
917, 8.331400545317717, 59.07138182514846, 70.96078433412494, 0.4063033, 20.0, 495, 659911, 917, 14.636099499999546
918, 7.44010914646105, 58.41472524061386, 70.21151469460429, 0.40565845, 125.0, 938, 660849, 918, 27.430781600000046
919, 8.19935011094291, 58.38767232110025, 70.16899875266711, 0.4048371999999997, 285.0, 887, 661736, 919, 25.58190790000117
920, 6.791337507583533, 58.44279938230089, 70.18354373616017, 0.4040848000000001, 120.0, 785, 662521, 920, 22.83758250000028
921, 10.77264915022815, 58.478358199543756, 70.30294383035975, 0.4033035999999999, 475.0, 951, 663472, 921, 27.974504600000728
922, 6.942702454498071, 58.4187109027794, 70.1467883115757, 0.4025750500000001, 140.0, 668, 664140, 922, 19.407008500000302
923, 7.356563699464448, 58.35931041827217, 70.17158433347464, 0.4019927500000001, 105.0, 626, 664766, 923, 18.27242870000009
924, 8.479710974667258, 58.415272689560084, 70.15827075717519, 0.40134025, 100.0, 824, 665590, 924, 22.946685200000502
925, 9.605062791729361, 58.443466416911654, 70.22772153440114, 0.4005819999999996, 210.0, 861, 666451, 925, 23.968442200000936
926, 8.673697680661594, 58.327210237276184, 70.10877571442053, 0.3997859500000001, 215.0, 908, 667359, 926, 25.80844259999867
927, 8.570527280953382, 58.473065735961725, 70.30695278543821, 0.39908980000000005, 80.0, 639, 667998, 927, 18.29573750000054
928, 5.808632348547404, 58.41321245985476, 70.09041864456064, 0.39861910000000006, 80.0, 407, 668405, 928, 11.625678100001096
929, 6.589039525270153, 58.35420494523733, 70.10472259422787, 0.3980880999999999, 155.0, 773, 669178, 929, 21.58749699999862
930, 10.315395287186478, 58.28388250606418, 70.0503495207726, 0.39729340000000013, 395.0, 993, 670171, 930, 29.211740500000815
931, 6.5734735547110095, 57.52904519369436, 69.12646859191184, 0.39661434999999984, 65.0, 516, 670687, 931, 15.196258799998759
932, 9.842494955012215, 57.53539873508112, 69.14863252422697, 0.3960855999999999, 110.0, 659, 671346, 932, 18.550706800000626
933, 8.307930381970593, 57.42922017733593, 69.02215809584422, 0.39536469999999985, 155.0, 943, 672289, 933, 27.266480899999806
934, 9.857714115825159, 57.692166385624034, 69.41049677956553, 0.3946177, 145.0, 717, 673006, 934, 20.608065299998998
935, 10.804613666890733, 57.60370550120449, 69.2717338458785, 0.3939291999999999, 80.0, 813, 673819, 935, 22.964198299998316
936, 5.668358599700669, 57.465662951802095, 69.04295460309169, 0.3932730999999999, 120.0, 645, 674464, 936, 19.101330299999972
937, 8.677477330568216, 57.54238777809202, 69.18227102878105, 0.3926917, 105.0, 647, 675111, 937, 18.336327799999708
938, 8.90666996394022, 57.326760166771614, 68.94852210241731, 0.3922327, 50.0, 373, 675484, 938, 10.56650339999942
939, 7.47033651910714, 57.34156843446386, 68.91664922542381, 0.3916603000000001, 165.0, 899, 676383, 939, 25.820188399999097
940, 10.85939155737007, 57.526605750896316, 69.14115111739547, 0.3907697499999998, 445.0, 1080, 677463, 940, 30.650899199999913
941, 6.8696176145797985, 57.657324471070105, 69.22260143913819, 0.3899966500000001, 105.0, 638, 678101, 941, 18.083508300000176
942, 5.906925129661438, 57.381133931423584, 68.89774768711281, 0.3892878999999999, 220.0, 937, 679038, 942, 27.05667689999973
943, 7.091438806457199, 57.55774082211282, 69.12027259296079, 0.38849095000000006, 180.0, 834, 679872, 943, 23.47919439999896
944, 6.625884301908052, 58.343690866441584, 70.09994681276868, 0.3876679000000003, 205.0, 995, 680867, 944, 28.991633499999807
945, 10.590576998032086, 58.47880988221501, 70.37338446025137, 0.38694249999999997, 120.0, 617, 681484, 945, 17.655550800000128
946, 9.124853993012646, 58.494689455457554, 70.29520269867722, 0.38638225, 60.0, 628, 682112, 946, 18.180075500000385
947, 6.04886127716409, 58.18723797009495, 69.89051773226595, 0.38592279999999995, 50.0, 393, 682505, 947, 11.262598200000866
948, 8.515074713696263, 58.377647947246636, 70.1584811132291, 0.3853350999999997, 190.0, 913, 683418, 948, 28.85268840000026
949, 8.327651190592023, 58.42878537712939, 70.23179416894227, 0.3844549, 255.0, 1043, 684461, 949, 29.86911599999985
950, 6.605340238672037, 58.50017745384803, 70.25866588299091, 0.3836930500000001, 110.0, 650, 685111, 950, 18.89061220000076
951, 7.610118480820309, 58.3938536881487, 70.15109460472604, 0.3831656499999999, 100.0, 522, 685633, 951, 15.421925799999372
952, 7.112525495026223, 58.37001962783835, 70.16742092040322, 0.3826143999999998, 155.0, 703, 686336, 952, 20.60120739999911
953, 11.937119316499757, 58.44528553923782, 70.35366132794594, 0.3819452500000001, 150.0, 784, 687120, 953, 23.914719099999274
954, 6.081605799513705, 58.50581435259651, 70.21027163337259, 0.38120994999999985, 220.0, 850, 687970, 954, 26.09876559999975
955, 6.676442616105222, 58.64307278075008, 70.43555905111356, 0.3804499, 210.0, 839, 688809, 955, 27.722567799999524
956, 6.745992832098689, 58.39593949999128, 70.17117598942347, 0.3797573499999999, 110.0, 700, 689509, 956, 23.385432900000524
957, 9.9509362068428, 58.35025572301857, 70.16600459125412, 0.37921645, 110.0, 502, 690011, 957, 15.982826999999816
958, 8.171808958260836, 59.63310040618514, 71.63940724676607, 0.3786670000000001, 210.0, 719, 690730, 958, 22.957546400000865
959, 9.238283660371652, 59.69244268610236, 71.73230043475547, 0.3779429500000002, 245.0, 890, 691620, 959, 27.705700000000434
960, 5.925647100760736, 59.54161577006333, 71.47588657786828, 0.3773066500000001, 55.0, 524, 692144, 960, 19.466903000000457
961, 9.045049972102507, 59.8046991849683, 71.8945940794404, 0.37672164999999985, 155.0, 776, 692920, 961, 23.621699700001045
962, 7.529685673508339, 59.57972574234009, 71.55150079727173, 0.3760772499999999, 110.0, 656, 693576, 962, 21.626554499998747
963, 5.716504625534011, 59.56878499805323, 71.49309135690957, 0.3754710999999998, 110.0, 691, 694267, 963, 21.928431000000273
964, 10.344183534252293, 59.59830058041741, 71.69047660827637, 0.3748541499999999, 175.0, 680, 694947, 964, 22.35876730000018
965, 11.080015275593611, 59.82598883291746, 71.93922395504494, 0.37425024999999995, 180.0, 662, 695609, 965, 21.87229269999989
966, 6.289069999312592, 59.631566768468815, 71.5784774713738, 0.3736427499999999, 105.0, 688, 696297, 966, 23.36845919999905
967, 8.711136331026163, 59.67390056114412, 71.71250137501518, 0.3729348999999999, 255.0, 885, 697182, 967, 34.379229100000885
968, 9.359533756373605, 59.792296904205934, 71.84520000577997, 0.37222255, 125.0, 698, 697880, 968, 26.77677659999972
969, 7.204541539198242, 59.792515319613265, 71.86483690815587, 0.37151785, 250.0, 868, 698748, 969, 27.962929299999814
970, 7.312380314221856, 59.86522671586124, 71.88785680878696, 0.3708964, 65.0, 513, 699261, 970, 17.19450809999944
971, 7.524197604268563, 59.83875013303808, 71.88340305738419, 0.37025110000000017, 210.0, 921, 700182, 971, 31.38411829999859
972, 9.064908196478894, 60.203673177262026, 72.3717174362508, 0.36947800000000014, 90.0, 797, 700979, 972, 26.331526899999517
973, 8.248133463465322, 60.16053233709861, 72.30546404020055, 0.36883360000000004, 105.0, 635, 701614, 973, 21.63866380000036
974, 7.538262051763013, 60.32037052512169, 72.45170100529988, 0.36837505, 50.0, 384, 701998, 974, 13.89280780000081
975, 7.849245044603833, 59.928607126619326, 72.03897912567366, 0.36802090000000004, 95.0, 403, 702401, 975, 14.393825099999958
976, 6.8793967545489245, 60.13624150360224, 72.22215091223005, 0.3676046500000001, 65.0, 522, 702923, 976, 20.96156179999889
977, 8.124660764148528, 60.29485834091105, 72.47118824433515, 0.36720145, 75.0, 374, 703297, 977, 13.171126900000672
978, 7.91139852609261, 60.13262734930199, 72.22401144188571, 0.36665965000000017, 150.0, 830, 704127, 978, 28.66388580000057
979, 9.13502397254362, 60.18872146606445, 72.36175669007382, 0.36602065, 65.0, 590, 704717, 979, 20.18033370000012
980, 8.376831588691767, 60.19889902774199, 72.29761886007992, 0.36546355, 105.0, 648, 705365, 980, 21.98522530000082
981, 10.654543830358213, 60.17425474043815, 72.3473348094571, 0.3646139499999999, 330.0, 1240, 706605, 981, 42.63542509999934
982, 9.792831189159688, 60.18480757069705, 72.34243823742044, 0.36369055000000006, 375.0, 812, 707417, 982, 27.545236900001328
983, 14.102420121098364, 60.25324518853726, 72.52343396234778, 0.3631640500000001, 55.0, 358, 707775, 983, 11.871803099998942
984, 6.167960510699146, 60.15663001738399, 72.24023623179241, 0.3628161999999999, 75.0, 415, 708190, 984, 14.02699229999962
985, 7.062192103414385, 60.11350359787812, 72.17369209323917, 0.3622298500000001, 185.0, 888, 709078, 985, 30.87296569999853
986, 8.413501743681351, 60.15279104485867, 72.29487156790823, 0.3614130999999996, 185.0, 927, 710005, 986, 32.49270449999858
987, 14.039831369191177, 58.53813204900855, 70.47775921094633, 0.3608217999999999, 80.0, 387, 710392, 987, 13.240527899999506
988, 9.990203780689459, 58.383520685393236, 70.02601010772004, 0.36049104999999987, 50.0, 348, 710740, 988, 11.99464220000118
989, 11.57055311083997, 58.23724527977432, 70.10480535201245, 0.3596751999999999, 470.0, 1465, 712205, 989, 50.74109230000067
990, 7.525739604641091, 58.18619300765221, 69.92186818749013, 0.35857044999999965, 470.0, 990, 713195, 990, 33.64791409999998
991, 10.645158428373268, 58.07391055579324, 69.78605075021392, 0.35793954999999983, 115.0, 412, 713607, 991, 15.001587900000231
992, 9.861041821060125, 58.355605223955, 70.16581746151573, 0.3575233, 65.0, 513, 714120, 992, 17.73852799999986
993, 9.702303965268523, 58.19493227750301, 69.90713928076639, 0.3570103000000001, 135.0, 627, 714747, 993, 21.835969799998566
994, 9.406333191698431, 58.49051130624642, 70.30448463626374, 0.3562493499999999, 305.0, 1064, 715811, 994, 36.51781949999895
995, 10.498349942844433, 58.44085360845738, 70.23504462236068, 0.35541640000000013, 135.0, 787, 716598, 995, 27.015804300001037
996, 9.53068990988761, 58.38305809542259, 70.201327580991, 0.3547, 210.0, 805, 717403, 996, 27.922885100000713
997, 6.8613411472704176, 58.26192111825584, 69.93569476478979, 0.35403850000000003, 155.0, 665, 718068, 997, 24.054813200000353
998, 10.668784287427702, 58.305664869192256, 70.08798093009594, 0.35323704999999994, 440.0, 1116, 719184, 998, 37.988648399999875
999, 9.819732982688155, 58.34469821672498, 70.11451371081768, 0.3523681, 165.0, 815, 719999, 999, 28.471967699999368
1000, 7.824450520159554, 57.73339063175693, 69.34283576742575, 0.3516314499999999, 185.0, 822, 720821, 1000, 29.288756199999625
1001, 7.423638325992478, 57.36885788929032, 68.87886670698603, 0.3509627499999998, 120.0, 664, 721485, 1001, 23.658927099999346
1002, 10.187391375076203, 57.58344736735026, 69.19469754900251, 0.35042769999999995, 85.0, 525, 722010, 1002, 18.096374900000228
1003, 7.965296422794155, 57.386852002525764, 68.9755525654459, 0.34999479999999994, 35.0, 437, 722447, 1003, 14.690734300000258
1004, 9.88579223721553, 57.52676400742211, 69.09885109727756, 0.34951644999999987, 340.0, 626, 723073, 1004, 22.350521500000468
1005, 9.870802056578738, 57.50799909897009, 69.1830924147132, 0.34880184999999975, 260.0, 962, 724035, 1005, 35.931074699999954
1006, 8.654757593196969, 57.51706036777361, 69.10101591948921, 0.3478613499999999, 190.0, 1128, 725163, 1006, 43.93781940000008
1007, 8.739137471245753, 57.455862952567436, 69.01989464115452, 0.34702075000000004, 140.0, 740, 725903, 1007, 24.787836100000277
1008, 8.88158787916461, 57.48773467416421, 69.08814214748413, 0.3462994, 170.0, 863, 726766, 1008, 29.254665300000852
1009, 6.995190776048068, 57.49539576000084, 69.08920616767425, 0.34573870000000007, 35.0, 383, 727149, 1009, 12.229359900000418
1010, 9.81056098109853, 57.55977474651505, 69.18008411373712, 0.34531209999999984, 30.0, 565, 727714, 1010, 19.397908400000233
1011, 11.874880893470404, 57.42293640648648, 69.0769533016981, 0.34464204999999987, 140.0, 924, 728638, 1011, 35.18809479999982
1012, 6.357099216006479, 57.27432038486794, 68.72590422693551, 0.34405660000000005, 55.0, 377, 729015, 1012, 11.967591000000539
1013, 7.791255282427737, 57.29581456745932, 68.8362791095665, 0.34366150000000006, 120.0, 501, 729516, 1013, 16.16988069999934
1014, 9.658012264346645, 57.97328979699321, 69.68041439142702, 0.3429387999999999, 165.0, 1105, 730621, 1014, 40.466693000000305
1015, 7.662998223951621, 58.29696701108947, 69.96989683895455, 0.34209324999999996, 210.0, 774, 731395, 1015, 27.83170709999831
1016, 8.124929977570726, 58.32834969192255, 70.14572841873586, 0.3415802499999999, 60.0, 366, 731761, 1016, 12.382927200000267
1017, 8.438510334189933, 58.30655270347113, 69.99209730896769, 0.3412377999999999, 25.0, 395, 732156, 1017, 14.21221019999939
1018, 6.120329303994323, 58.22300533525871, 69.89901550177372, 0.34076305, 120.0, 660, 732816, 1018, 24.817692599999646
1019, 8.140937841990414, 58.30434563753292, 70.04835924519672, 0.33996880000000024, 310.0, 1105, 733921, 1019, 39.74021309999989
1020, 8.46326052068993, 58.38166353179187, 70.11103633286582, 0.3392316999999999, 80.0, 533, 734454, 1020, 18.212053400000514
1021, 5.980631057507552, 58.43333504152806, 70.20193674212358, 0.3386962000000001, 110.0, 657, 735111, 1021, 22.514154000000417
1022, 7.410291369029155, 58.35983457750573, 70.15068734916242, 0.3379141, 345.0, 1081, 736192, 1022, 39.72410949999903
1023, 8.168301486335267, 58.462880945753774, 70.26771876455723, 0.3372710499999999, 50.0, 348, 736540, 1023, 11.906917899999826
1024, 8.805912265449427, 58.32729754930132, 70.07392207799333, 0.33671395, 255.0, 890, 737430, 1024, 31.990554699999848
1025, 12.426810084896928, 58.39696828991759, 70.2947301864624, 0.33612984999999984, 75.0, 408, 737838, 1025, 15.088173000000097
1026, 8.3254770057671, 58.26913148128625, 70.07827397548792, 0.3356492499999999, 130.0, 660, 738498, 1026, 24.003624500001024
1027, 9.848365318819909, 58.28900761988999, 70.01444317386476, 0.33511239999999987, 55.0, 533, 739031, 1027, 16.87865469999997
1028, 7.438200054591215, 58.69477648191814, 70.42327524499048, 0.3346947999999999, 50.0, 395, 739426, 1028, 13.433350799999971
1029, 9.423210536039644, 58.37443218692656, 70.17201801269285, 0.33429384999999995, 55.0, 496, 739922, 1029, 18.805663400000412
1030, 9.888967753997372, 57.003842606956574, 68.4505157088056, 0.33348744999999985, 395.0, 1296, 741218, 1030, 55.14978479999991
1031, 9.468919952637155, 56.96291728565174, 68.53529010223727, 0.3326603499999998, 110.0, 542, 741760, 1031, 19.514958300000217
1032, 5.622004270553589, 56.977521348475676, 68.37954198599961, 0.33212349999999996, 115.0, 651, 742411, 1032, 23.0628715999992
1033, 9.946693704064403, 57.03260247785966, 68.56115573841137, 0.33150294999999996, 105.0, 728, 743139, 1033, 25.62034870000025
1034, 9.817468107904308, 56.999239217728885, 68.52368932515517, 0.33067719999999984, 325.0, 1107, 744246, 1034, 40.36805010000171
1035, 7.044100151915727, 56.98019737848188, 68.40012539449403, 0.32973040000000003, 365.0, 997, 745243, 1035, 35.89872000000105
1036, 9.822670502665574, 57.01009026599688, 68.57613293524184, 0.3290976999999999, 80.0, 409, 745652, 1036, 14.93552439999985
1037, 8.150244678854099, 56.966995859753126, 68.37349881680717, 0.32859549999999993, 110.0, 707, 746359, 1037, 27.780653699999675
1038, 9.810654043272182, 57.11992302053446, 68.64945897802842, 0.32797224999999997, 110.0, 678, 747037, 1038, 26.42007829999966
1039, 8.574981195725737, 56.90926854319162, 68.31906424820153, 0.32726935, 130.0, 884, 747921, 1039, 35.29284600000028
1040, 6.0953512725200545, 57.05923053012805, 68.4988144906719, 0.3264710499999999, 265.0, 890, 748811, 1040, 34.84448020000127
1041, 9.406505850568475, 56.94422883468692, 68.40450741356885, 0.32564034999999997, 355.0, 956, 749767, 1041, 37.72986300000048
1042, 11.373624288365244, 57.387293543815616, 68.99015858173371, 0.3248501499999999, 430.0, 800, 750567, 1042, 31.95021429999906
1043, 9.561542375736936, 57.451345306040125, 69.0827137932909, 0.32406625, 220.0, 942, 751509, 1043, 37.295012399999905
1044, 7.172574137018723, 57.66499792820204, 69.24004224898033, 0.32293900000000014, 255.0, 1563, 753072, 1044, 59.80130569999892
1045, 7.26359007943918, 57.507659207266094, 69.06157799664163, 0.3218337999999999, 280.0, 893, 753965, 1045, 33.97316510000019
1046, 6.3134705004868685, 57.587053381366495, 69.13241374639817, 0.32114035000000013, 80.0, 648, 754613, 1046, 33.47169329999997
1047, 11.907575739307921, 57.66892199257548, 69.38329405673714, 0.3205584999999999, 220.0, 645, 755258, 1047, 22.41711860000032
1048, 10.803276345524631, 57.53666042890705, 69.13891731637423, 0.31999374999999985, 105.0, 610, 755868, 1048, 21.032605200000035
1049, 7.442813849449157, 57.30234880085233, 68.76998516034476, 0.3195415, 75.0, 395, 756263, 1049, 13.940345099999831
1050, 8.429546410094463, 57.56361110737807, 69.11533875616075, 0.3189223000000001, 360.0, 981, 757244, 1050, 35.47017989999949
1051, 8.16344283527918, 57.486079134013316, 69.08424977551398, 0.3181824999999999, 55.0, 663, 757907, 1051, 30.423295399999915
1052, 8.08801952302456, 57.64432228088379, 69.20870540912335, 0.31759165000000006, 155.0, 650, 758557, 1052, 26.158414699999412
1053, 7.936108022517429, 57.56239418756394, 69.11679012136052, 0.31694005000000003, 180.0, 798, 759355, 1053, 33.46184259999973
1054, 6.922100047294166, 57.63449530043864, 69.21516374756442, 0.3163923999999999, 135.0, 419, 759774, 1054, 17.7198202999989
1055, 9.32942961578138, 57.70917617639456, 69.36494953723103, 0.3155536, 705.0, 1445, 761219, 1055, 55.18679669999983
1056, 8.098758628523786, 58.093887292713354, 69.81859574674233, 0.31462029999999996, 145.0, 629, 761848, 1056, 26.564987400000973
1057, 7.936399847751865, 57.678686700969806, 69.27205423683762, 0.3140317, 130.0, 679, 762527, 1057, 29.844515999999203
1058, 9.665837881216794, 57.815812621548005, 69.4513539918186, 0.31335805000000005, 185.0, 818, 763345, 1058, 32.33465939999951
1059, 10.568518317814144, 57.76366780239081, 69.46709713845883, 0.3127037500000001, 110.0, 636, 763981, 1059, 26.891469700000016
1060, 7.3122699867050915, 57.76122586955455, 69.34029924401683, 0.3121308999999999, 155.0, 637, 764618, 1060, 25.194537800000035
1061, 7.781584041871067, 57.797302924159645, 69.45290154269125, 0.31147210000000003, 160.0, 827, 765445, 1061, 32.68632969999999
1062, 9.19219009835779, 57.86938222838037, 69.60199500896313, 0.31080834999999973, 105.0, 648, 766093, 1062, 25.983179899998504
1063, 8.828141126559492, 57.80153092836079, 69.43965964400978, 0.3100037499999999, 185.0, 1140, 767233, 1063, 45.121124400000554
1064, 8.282370668603468, 57.858767386739565, 69.45981034862903, 0.30920050000000004, 105.0, 645, 767878, 1064, 27.433954200001608
1065, 9.388418080812194, 57.75923376968227, 69.48978072753067, 0.3085174000000001, 180.0, 873, 768751, 1065, 33.67408449999857
1066, 6.926619348930564, 57.66677424297241, 69.27517310893478, 0.30775195000000005, 180.0, 828, 769579, 1066, 26.687288200000694
1067, 8.06692727614992, 57.8201908058672, 69.48617768250922, 0.30708730000000006, 105.0, 649, 770228, 1067, 20.34874679999848
1068, 9.230193431281673, 57.13155592290849, 68.73592388568147, 0.3066215499999999, 30.0, 386, 770614, 1068, 12.220071000001553
1069, 9.538098809441257, 57.45095517356293, 69.01362619262946, 0.3060095499999999, 170.0, 974, 771588, 1069, 30.948387000000366
1070, 9.569277844999148, 57.491724638218216, 69.12042554219563, 0.30513654999999973, 285.0, 966, 772554, 1070, 30.257426599999235
1071, 8.869363277811253, 57.48277547644483, 69.01128364287925, 0.3044646999999999, 65.0, 527, 773081, 1071, 16.525556500000675
1072, 8.77978144216445, 57.414067860853635, 68.98256412138575, 0.30382119999999974, 130.0, 903, 773984, 1072, 29.008203299999877
1073, 9.838306669004355, 57.34322473670863, 68.93986919258214, 0.3031304499999998, 125.0, 632, 774616, 1073, 20.58864530000028
1074, 9.155955601930618, 57.57326988567006, 69.16746783516624, 0.30235104999999973, 265.0, 1100, 775716, 1074, 40.398499200000515
1075, 7.148233250477543, 57.46658289661146, 69.03646562654679, 0.30152755000000003, 110.0, 730, 776446, 1075, 26.80979650000154
1076, 9.259841773041828, 57.40693536632789, 69.01851426389165, 0.30074815, 530.0, 1002, 777448, 1076, 36.86401090000072
1077, 8.672289118992316, 57.476980949608055, 69.05040564459723, 0.299881, 375.0, 925, 778373, 1077, 34.311288400000194
1078, 9.495455204320134, 57.46282404275765, 69.0705937665208, 0.2991654999999999, 140.0, 665, 779038, 1078, 24.524959399999716
1079, 7.900917779771564, 57.61223127218074, 69.20477564145895, 0.29845179999999993, 260.0, 921, 779959, 1079, 33.748638299999584
1080, 8.57401650319142, 56.62517999751227, 68.15850684472493, 0.29783575, 75.0, 448, 780407, 1080, 16.483785000000353
1081, 9.303316630969901, 56.45912977533603, 67.8668538583528, 0.29724175000000014, 280.0, 872, 781279, 1081, 32.044439900000725
1082, 8.286606503114852, 56.3946902997261, 67.7427062485023, 0.2966788, 10.0, 379, 781658, 1082, 13.94278200000008
1083, 11.258542964250427, 56.398205765066386, 67.81014467276364, 0.2963458, 45.0, 361, 782019, 1083, 13.17431039999974
1084, 14.069843720204805, 56.50384756980634, 67.9851123712879, 0.2958823000000001, 35.0, 669, 782688, 1084, 24.774254399999336
1085, 9.938965248643973, 56.48061078308494, 67.87026924327681, 0.29487475000000024, 685.0, 1570, 784258, 1085, 57.66129980000005
1086, 8.418647686594216, 56.59546259207319, 67.97045590304589, 0.2938779999999998, 155.0, 645, 784903, 1086, 23.941674800000328
1087, 10.481433599509305, 56.427446740789065, 67.78387889239484, 0.29313279999999997, 415.0, 1011, 785914, 1087, 37.26254229999904
1088, 8.488195210907636, 56.519784741616874, 67.87215817739165, 0.29248839999999987, 135.0, 421, 786335, 1088, 15.864208099999814
1089, 7.270221503908239, 56.57032211236491, 67.86274224616007, 0.29199249999999993, 115.0, 681, 787016, 1089, 24.916458499999862
1090, 8.008172281656908, 56.43316654373488, 67.78441739801464, 0.29129814999999987, 235.0, 862, 787878, 1090, 31.75436769999942
1091, 7.457684454933069, 56.36628339855394, 67.70668112265098, 0.2906272, 55.0, 629, 788507, 1091, 22.96458899999925
1092, 8.546455190901197, 56.51750764188567, 67.92418184479396, 0.2900638, 35.0, 623, 789130, 1092, 23.093677700000626
1093, 7.692218899141072, 56.536846390520324, 67.96230761366336, 0.28941715000000007, 120.0, 814, 789944, 1093, 30.154290100001163
1094, 8.807131500547918, 57.969552510186666, 69.66149421210761, 0.28870120000000005, 75.0, 777, 790721, 1094, 28.66665639999883
1095, 10.294594880166516, 58.039854974374066, 69.81999603470224, 0.28804060000000004, 115.0, 691, 791412, 1095, 25.613464599999133
1096, 7.6198761965662625, 57.96318241564208, 69.65193685794466, 0.2873476000000001, 210.0, 849, 792261, 1096, 31.400903200001267
1097, 6.696755877562931, 58.10389925208113, 69.73912232052068, 0.2866600000000001, 155.0, 679, 792940, 1097, 25.33191210000041
1098, 7.414925514613811, 58.160495221911376, 69.82813504916518, 0.28599265000000007, 420.0, 804, 793744, 1098, 29.99508380000043
1099, 7.411821577946345, 57.98653593063354, 69.67851870854696, 0.28546885, 5.0, 360, 794104, 1099, 13.410914800000683
1100, 8.630347130049106, 58.10033770420755, 69.82652888335, 0.28501659999999995, 130.0, 645, 794749, 1100, 24.33914889999869
1101, 9.548063296572053, 58.13233960453885, 69.83150706073653, 0.28436139999999993, 180.0, 811, 795560, 1101, 30.579485500000374
1102, 8.788350214214288, 58.08210884508237, 69.79440108996646, 0.28364814999999993, 120.0, 774, 796334, 1102, 28.995148300000437
1103, 9.489050048948403, 58.1907975933158, 69.95755936821658, 0.2829483999999999, 145.0, 781, 797115, 1103, 29.292972299999747
1104, 9.700779707511751, 58.20259610036524, 69.94870512659956, 0.28230174999999996, 110.0, 656, 797771, 1104, 24.793625500000417
1105, 7.985328245276554, 58.03166502146209, 69.72613652419662, 0.28155789999999986, 235.0, 997, 798768, 1105, 37.353966700000456
1106, 7.679402124318551, 58.09036730067936, 69.74174651498869, 0.2808234999999999, 75.0, 635, 799403, 1106, 23.856759799999054
1107, 8.640181746062767, 58.45092475637329, 70.25456038334265, 0.2801048499999999, 345.0, 962, 800365, 1107, 36.19126570000117
1108, 16.597432185399352, 58.75306210784137, 70.77813741035268, 0.27949465000000007, 80.0, 394, 800759, 1108, 14.743178400000033
1109, 7.370038185170088, 58.68064601837643, 70.48029182070778, 0.27914724999999996, 80.0, 378, 801137, 1109, 14.551652399999512
1110, 9.664412298943043, 58.912357173596824, 70.79481610099899, 0.27842949999999966, 350.0, 1217, 802354, 1110, 45.95660190000126
1111, 6.756157942351924, 58.69662826890783, 70.4719980708584, 0.27751195000000006, 150.0, 822, 803176, 1111, 31.17031019999922
1112, 7.629225025130384, 58.50489209706113, 70.31195145789916, 0.27690040000000005, 95.0, 537, 803713, 1112, 20.336861800000406
1113, 11.10525773611789, 58.833169229673025, 70.72575500557092, 0.2762596, 115.0, 887, 804600, 1113, 33.71026239999992
1114, 7.622394042544895, 58.596557757059735, 70.37583078596327, 0.27545545, 60.0, 900, 805500, 1114, 34.30624720000014
1115, 8.97838060989777, 58.64640802112229, 70.50916286687259, 0.2744775999999999, 435.0, 1273, 806773, 1115, 48.210643500000515
1116, 6.187526819856163, 58.592110556278506, 70.37410419105153, 0.2736225999999998, 115.0, 627, 807400, 1116, 24.05872880000061
1117, 9.026864654076942, 58.83694753016861, 70.65058421871385, 0.27294534999999986, 210.0, 878, 808278, 1117, 33.44096759999957
1118, 7.001186606475652, 58.57347929642497, 70.32106503253708, 0.27225729999999987, 155.0, 651, 808929, 1118, 25.05655420000039
1119, 8.052508127612946, 58.79201858471601, 70.66016791417049, 0.27168355000000005, 95.0, 624, 809553, 1119, 23.895240699999704
1120, 7.423847877137039, 59.143512692658796, 71.04724786177925, 0.2707817500000001, 290.0, 1380, 810933, 1120, 53.22567199999867
1121, 7.815562145292582, 59.34794150332669, 71.31560139415527, 0.2700090999999999, 15.0, 337, 811270, 1121, 13.16389530000015
1122, 6.960601685199982, 59.32449447240585, 71.20756150074494, 0.2694186999999999, 155.0, 975, 812245, 1122, 37.512150599999586
1123, 9.441580661632784, 59.42751763591836, 71.42312348660387, 0.26861139999999983, 55.0, 819, 813064, 1123, 31.384123300000283
1124, 10.594428868296037, 59.357389632072156, 71.32335248248268, 0.26777125, 325.0, 1048, 814112, 1124, 40.92128059999959
1125, 6.6486066863856506, 59.307424133982735, 71.18763111050569, 0.2668969, 215.0, 895, 815007, 1125, 34.66044179999881
1126, 8.991100238037538, 59.37812510516865, 71.37804500274908, 0.2659424499999998, 590.0, 1226, 816233, 1126, 47.10831709999911
1127, 9.429081090723846, 59.47866508443519, 71.4931957939765, 0.2647953999999999, 430.0, 1323, 817556, 1127, 51.57323859999997
1128, 11.56451977766046, 59.32742534984242, 71.35170100699398, 0.26391295, 120.0, 638, 818194, 1128, 25.27318120000018
1129, 6.026920060433251, 59.387055841708815, 71.31602509723264, 0.2631654999999999, 255.0, 1023, 819217, 1129, 39.79198110000107
1130, 8.65445318167628, 59.479601502248464, 71.42262413362293, 0.2623896999999999, 125.0, 701, 819918, 1130, 25.079584799999793
1131, 8.690132798884697, 59.250546632548094, 71.20077009540302, 0.26184655, 20.0, 506, 820424, 1131, 18.02121629999965
1132, 6.4035946661038015, 59.22690033054501, 71.12962298326089, 0.2613313, 135.0, 639, 821063, 1132, 23.058809599999222
1133, 7.788389761376289, 59.180729592493336, 71.09917269566263, 0.26081154999999995, 35.0, 516, 821579, 1133, 18.69970690000082
1134, 10.956487730580879, 59.463260365771006, 71.56376638660183, 0.2603021499999999, 60.0, 616, 822195, 1134, 23.450007199999163
1135, 8.242949592412174, 59.45938414269751, 71.4653784280295, 0.2596154499999999, 130.0, 910, 823105, 1135, 32.351531300000715
1136, 8.333161156554924, 59.42888756778753, 71.35795626239242, 0.2588207499999998, 195.0, 856, 823961, 1136, 35.07867029999943
1137, 8.402687681422204, 59.4379249087063, 71.43363289871013, 0.25792659999999995, 300.0, 1131, 825092, 1137, 49.07426149999992
1138, 7.866808472640092, 59.411933803661896, 71.36801120538536, 0.25700319999999993, 205.0, 921, 826013, 1138, 40.205964900000254
1139, 9.57927212704008, 59.366901076842694, 71.35290810574128, 0.25615539999999987, 245.0, 963, 826976, 1139, 44.510817000000316
1140, 7.068348786667103, 59.44706414492076, 71.37146048509437, 0.25542729999999997, 50.0, 655, 827631, 1140, 25.874755699998786
1141, 7.9522199124896105, 59.343305826187134, 71.32615753241947, 0.2546285499999998, 260.0, 1120, 828751, 1141, 43.91493300000002
1142, 7.7603482199805, 59.42472483506843, 71.37569747753997, 0.25388334999999995, 35.0, 536, 829287, 1142, 21.27441920000092
1143, 6.315796391648719, 59.26058410037314, 71.18445105791398, 0.25329159999999984, 155.0, 779, 830066, 1143, 31.177132300001176
1144, 6.705697115047886, 58.17840913356929, 69.86104361539945, 0.25272009999999995, 45.0, 491, 830557, 1144, 19.61090940000031
1145, 6.2876243534402585, 58.26186835671973, 69.96549235366462, 0.25227054999999987, 55.0, 508, 831065, 1145, 20.043396400000347
1146, 8.403210755261135, 58.07388862261579, 69.84056504649607, 0.25151950000000006, 365.0, 1161, 832226, 1146, 46.06994580000173
1147, 7.1564190093913504, 58.05657488493454, 69.73147730796904, 0.2505033999999998, 415.0, 1097, 833323, 1147, 44.57353950000106
1148, 8.622610750918588, 58.27150748394154, 70.05804322384022, 0.24981534999999994, 80.0, 432, 833755, 1148, 17.530652800000098
1149, 10.309185074020295, 58.29080824010512, 70.01871964812818, 0.24912369999999978, 670.0, 1105, 834860, 1149, 44.866981700000906
1150, 7.982420726074814, 58.109348700903254, 69.75498380634446, 0.24830334999999984, 130.0, 718, 835578, 1150, 28.46397590000197
1151, 8.466878638575377, 58.12639260611079, 69.81782444622982, 0.24747579999999986, 170.0, 1121, 836699, 1151, 47.28489659999832
1152, 9.813157941248278, 58.48221307051809, 70.2955311487256, 0.2468089, 55.0, 361, 837060, 1152, 14.880211899999267
1153, 8.420705367640076, 58.13764451708913, 69.81825882047633, 0.24633999999999992, 150.0, 681, 837741, 1153, 28.003588100000343
1154, 9.419295616217685, 58.071749306432395, 69.80820621636654, 0.24566949999999993, 130.0, 809, 838550, 1154, 33.034117300001526
1155, 6.157911385800547, 58.211570732466136, 69.92726637570912, 0.24506965000000003, 135.0, 524, 839074, 1155, 21.327203900000313
1156, 7.417371712668768, 58.21111888101656, 69.88734243807261, 0.24437394999999998, 285.0, 1022, 840096, 1156, 41.6933117999979
1157, 8.255445996939843, 58.30400679264162, 70.05922882380744, 0.2434572999999999, 175.0, 1015, 841111, 1157, 41.84656940000059
1158, 7.714611152492002, 58.20345589011576, 69.97506390012126, 0.24271749999999986, 155.0, 629, 841740, 1158, 25.479478900000686
1159, 5.8177689316992955, 58.432857682307564, 70.16702638069789, 0.24226164999999997, 60.0, 384, 842124, 1159, 16.12248720000207
1160, 8.221009527672912, 58.266680693015076, 69.98772215231871, 0.24186069999999996, 45.0, 507, 842631, 1160, 19.87789260000136
1161, 8.49092484071108, 58.382334525517585, 70.2159216946987, 0.24117219999999998, 415.0, 1023, 843654, 1161, 37.43346730000121
1162, 7.656596179175026, 58.269587376538446, 70.01560467551737, 0.24040585, 60.0, 680, 844334, 1162, 28.929522800000996
1163, 7.605493658641353, 58.23952293992043, 69.91972784996032, 0.23981184999999985, 135.0, 640, 844974, 1163, 30.569838899999013
1164, 7.292356816720552, 58.15867697166895, 69.85890456686512, 0.2390531499999999, 155.0, 1046, 846020, 1164, 49.72504190000109
1165, 7.579989963662839, 58.21686217028224, 69.94842656072743, 0.23843214999999987, 35.0, 334, 846354, 1165, 15.279950700001791
1166, 7.8430333234097285, 58.307097590134994, 70.09171488546633, 0.23792499999999991, 180.0, 793, 847147, 1166, 36.782769099998404
1167, 9.923248753115887, 58.246242817555824, 70.00034021092212, 0.23728239999999998, 70.0, 635, 847782, 1167, 27.866152099999454
1168, 7.385155799757143, 58.33263159101936, 70.09853358785058, 0.23671404999999995, 125.0, 628, 848410, 1168, 26.869031400001404
1169, 9.644964847947664, 58.35630404430887, 70.12043060542305, 0.23605885000000007, 210.0, 828, 849238, 1169, 37.44694060000256
1170, 7.975018229379374, 58.32010823418112, 70.08744350321153, 0.23538024999999996, 320.0, 680, 849918, 1170, 29.625593200002186
1171, 6.084213336345747, 58.099728031948956, 69.79788785685135, 0.23465080000000002, 310.0, 941, 850859, 1171, 38.55270059999748
1172, 8.295794446111085, 58.231353777000706, 69.99665916396911, 0.23392854999999996, 120.0, 664, 851523, 1172, 27.1652983999993
1173, 6.908747759649504, 57.94844188351603, 69.56080067651511, 0.23340160000000001, 105.0, 507, 852030, 1173, 20.277690599999914
1174, 7.194206680237562, 58.101729031266835, 69.7744841213884, 0.23278194999999993, 230.0, 870, 852900, 1174, 36.69660570000269
1175, 7.112049282082166, 58.05601896730944, 69.71783020267866, 0.2321415999999999, 25.0, 553, 853453, 1175, 20.709240100000898
1176, 8.343707387794309, 58.05694580078125, 69.81246945395398, 0.2317118499999999, 110.0, 402, 853855, 1176, 15.96124719999716
1177, 7.559072114880148, 58.14663247894823, 69.91239012333385, 0.23101794999999997, 320.0, 1140, 854995, 1177, 44.006135300001915
1178, 7.98046861804994, 58.35074424034601, 70.11335839480715, 0.23014179999999987, 230.0, 807, 855802, 1178, 30.469048299997667
1179, 11.018347405978558, 58.16739981862727, 69.91613658193195, 0.2294964999999999, 20.0, 627, 856429, 1179, 27.2146098000012
1180, 5.490369013566273, 57.95245400283608, 69.59070723869897, 0.22898079999999996, 160.0, 519, 856948, 1180, 22.56912039999952
1181, 11.539249493700666, 58.1491240289692, 69.89516472282332, 0.22852629999999993, 65.0, 491, 857439, 1181, 22.03825660000075
1182, 9.41996547864864, 58.20797550678253, 69.91561554646006, 0.22759975000000013, 365.0, 1568, 859007, 1182, 60.36131260000184
1183, 8.660860128657331, 58.20502665251204, 69.96583628237826, 0.22666239999999993, 25.0, 515, 859522, 1183, 21.880138000000443
1184, 6.1405492678922435, 58.09832483877931, 69.75898531160466, 0.22619934999999997, 60.0, 514, 860036, 1184, 19.828703800001676
1185, 8.874090758702122, 58.255995911287975, 70.10819385712405, 0.22566925, 175.0, 664, 860700, 1185, 26.454118000001472
1186, 6.082387502020111, 58.19796540785809, 69.9356153384358, 0.22510584999999986, 160.0, 588, 861288, 1186, 23.77448849999928
1187, 6.7058960517029185, 58.22420925697315, 69.95430889159582, 0.22455459999999994, 185.0, 637, 861925, 1187, 24.570823999998538
1188, 5.954783943117849, 58.049678006709016, 69.73504120466725, 0.2237243499999998, 215.0, 1208, 863133, 1188, 50.4263770999969
1189, 6.54423576673465, 58.16140601314716, 69.86500718415672, 0.22287924999999997, 80.0, 670, 863803, 1189, 28.633294399998704
1190, 8.640232076458002, 58.14699984405, 69.88686351452844, 0.22241844999999996, 35.0, 354, 864157, 1190, 14.200933600001008
1191, 5.882223426134374, 58.08905224150895, 69.76941456682805, 0.22177989999999986, 130.0, 1065, 865222, 1191, 40.63306680000096
1192, 7.622408938472186, 58.00675735120964, 69.6775016843446, 0.22100859999999994, 150.0, 649, 865871, 1192, 27.027045000002545
1193, 8.951878244500238, 58.132182101838154, 69.92976800448515, 0.21998799999999993, 625.0, 1619, 867490, 1193, 63.6873513999999
1194, 7.559639380578694, 58.1566985904277, 69.84887308124812, 0.2188391499999999, 175.0, 934, 868424, 1194, 36.25117350000073
1195, 7.537383756389155, 58.03922849432669, 69.73373630818658, 0.2177321500000001, 450.0, 1526, 869950, 1195, 77.64717240000027
1196, 7.3293382714927935, 58.14497541105796, 69.90428789162341, 0.2166080499999999, 195.0, 972, 870922, 1196, 49.90964410000015
1197, 9.312285488575512, 58.32901417394603, 70.11838555780257, 0.21588084999999987, 90.0, 644, 871566, 1197, 34.493708900001366
1198, 5.93873643107107, 57.98643517160282, 69.64206766080456, 0.21543039999999997, 50.0, 357, 871923, 1198, 19.795475599999918
1199, 6.569792425675358, 58.058209909123484, 69.74023039015077, 0.21495699999999995, 170.0, 695, 872618, 1199, 38.507467200000974
1200, 6.707844311222784, 58.09950487975597, 69.75375151895395, 0.21435669999999996, 135.0, 639, 873257, 1200, 42.29109619999872
1201, 6.391015564796815, 58.09417593329521, 69.83346175349408, 0.21363895000000002, 370.0, 956, 874213, 1201, 52.703662100000656
1202, 6.842024808257048, 58.15115609747278, 69.93894210724423, 0.21298239999999996, 30.0, 503, 874716, 1202, 25.535911800001486
1203, 5.887426555655681, 58.086410237955356, 69.75792223206031, 0.21246039999999983, 90.0, 657, 875373, 1203, 34.099582400001964
1204, 9.127933623988996, 58.03247776996461, 69.78001102821177, 0.21174669999999993, 125.0, 929, 876302, 1204, 49.78034659999685
1205, 8.78091415396575, 58.126594558401976, 69.84695739447194, 0.21086919999999992, 260.0, 1021, 877323, 1205, 52.81723250000141
1206, 6.7380545683128314, 58.159016975773625, 69.86643769569004, 0.21010419999999994, 140.0, 679, 878002, 1206, 32.38115789999938
1207, 8.24817081445968, 58.12446814237144, 69.9085042453305, 0.20938510000000002, 170.0, 919, 878921, 1207, 44.476891800000885
1208, 6.2591378300104825, 58.054193464006694, 69.72798948742094, 0.20849904999999988, 300.0, 1050, 879971, 1208, 52.28493679999883
1209, 6.066985933278317, 57.79828066703601, 69.41277763171074, 0.20762289999999992, 145.0, 897, 880868, 1209, 43.95490449999852
1210, 8.884984672661417, 57.6570089910632, 69.31300830841064, 0.20683404999999985, 320.0, 856, 881724, 1210, 44.64793919999647
1211, 7.95699638297653, 57.629182467293425, 69.24355989615314, 0.20607669999999995, 185.0, 827, 882551, 1211, 43.00388000000021
1212, 6.4646980513467405, 57.69752788543701, 69.30075878393454, 0.20526534999999999, 255.0, 976, 883527, 1212, 47.5381916999977
1213, 7.806303965044208, 57.71623595803976, 69.32620768249035, 0.20459574999999994, 80.0, 512, 884039, 1213, 22.61937129999933
1214, 7.268837132585469, 57.680908437475004, 69.30157843493222, 0.2039697999999999, 310.0, 879, 884918, 1214, 39.55418780000036
1215, 7.167458760881138, 57.71622004480419, 69.29752789190906, 0.20312335000000004, 395.0, 1002, 885920, 1215, 45.52398610000091
1216, 8.6209837484275, 57.765971233494476, 69.4866293143322, 0.20248254999999996, 70.0, 422, 886342, 1216, 18.7207473999988
1217, 8.497370259768052, 57.71912437958243, 69.40218969614718, 0.20186289999999998, 340.0, 955, 887297, 1217, 44.013594300002296
1218, 5.948634518693525, 57.7169178045106, 69.31908185431298, 0.20105244999999997, 125.0, 846, 888143, 1218, 48.51308879999851
1219, 8.352713052912762, 57.723108126991676, 69.31950755872225, 0.2004579999999999, 45.0, 475, 888618, 1219, 26.093365700002323
1220, 5.86427899312973, 57.59192757161458, 69.14230023193359, 0.2000754999999999, 60.0, 375, 888993, 1220, 16.58557700000165
1221, 8.115057775575233, 57.68476182532545, 69.37674345614705, 0.19958679999999998, 140.0, 711, 889704, 1221, 34.22673150000264
1222, 8.151892405719149, 57.70465557995964, 69.38753463146733, 0.19880784999999998, 310.0, 1020, 890724, 1222, 49.62170960000003
1223, 8.412463410371638, 57.70315648224792, 69.3825146398757, 0.19776339999999995, 360.0, 1301, 892025, 1223, 63.95654830000058
1224, 5.549287115983867, 57.781409406232406, 69.39810060037149, 0.19667845, 305.0, 1110, 893135, 1224, 52.84145680000074
1225, 7.346442139916276, 57.66692751958753, 69.36700036150472, 0.19589589999999993, 140.0, 629, 893764, 1225, 28.646723900001234
1226, 6.950323552569224, 57.78457822931354, 69.37265039477828, 0.19538469999999994, 80.0, 507, 894271, 1226, 21.364600799999607
1227, 7.384060677828697, 57.5860596876878, 69.16993806545551, 0.19468855000000007, 325.0, 1040, 895311, 1227, 46.53591640000013
1228, 9.065475808966964, 57.58050004857856, 69.24569275252617, 0.19359325, 545.0, 1394, 896705, 1228, 61.9689572999996
1229, 6.050381857949572, 57.5983981291453, 69.14548523609454, 0.19268514999999994, 70.0, 624, 897329, 1229, 31.905955799997173
1230, 9.443127876369532, 57.57456166879078, 69.2195908722034, 0.19203039999999993, 410.0, 831, 898160, 1230, 42.415049200000794
1231, 7.8231164313642445, 57.514074577796336, 69.13332862060456, 0.19105074999999996, 525.0, 1346, 899506, 1231, 63.03268359999856
1232, 7.344556958934703, 57.37339890880502, 68.91607297344125, 0.19002924999999987, 290.0, 924, 900430, 1232, 42.210348699998576
1233, 8.297352752570868, 57.22652244567871, 68.80982566162979, 0.18923454999999992, 235.0, 842, 901272, 1233, 39.41908799999874
1234, 6.133309344137892, 57.17768237737962, 68.67867805104197, 0.18849114999999997, 155.0, 810, 902082, 1234, 38.7324105000007
1235, 7.545120232266371, 57.10361671180618, 68.67035601586521, 0.18748404999999996, 375.0, 1428, 903510, 1235, 63.87621719999879
1236, 8.678922759994085, 57.23721798515641, 68.80971823333688, 0.18630774999999997, 325.0, 1186, 904696, 1236, 52.56748239999797
1237, 7.365633222425408, 57.202487699285015, 68.7430631464178, 0.18543249999999997, 230.0, 759, 905455, 1237, 33.923018699999375
1238, 5.302308405617928, 57.221239380559105, 68.73889879770887, 0.1849284999999999, 105.0, 361, 905816, 1238, 15.159606500001246
1239, 4.968220610732901, 57.154372437359534, 68.58548381977118, 0.18453609999999998, 10.0, 511, 906327, 1239, 21.926942000001873
1240, 8.61981595752935, 57.14233744245751, 68.67075562949897, 0.1841473, 85.0, 353, 906680, 1240, 14.755636100002448
1241, 6.878752422359816, 57.07647168365801, 68.66450921201489, 0.18369099999999994, 185.0, 661, 907341, 1241, 26.85510140000042
1242, 9.994470103092455, 57.22476266035393, 68.79916034053214, 0.18303174999999988, 130.0, 804, 908145, 1242, 35.202556500000355
1243, 6.268169836708609, 57.19984662555864, 68.73494642984475, 0.18243729999999994, 85.0, 517, 908662, 1243, 21.82729069999914
1244, 6.692861991744145, 57.232590346552094, 68.80812082275772, 0.18191619999999997, 120.0, 641, 909303, 1244, 29.084356699997443
1245, 6.66598192745462, 57.16850836318627, 68.69111351717143, 0.18144729999999995, 40.0, 401, 909704, 1245, 17.023924900000566
1246, 6.625597099418296, 57.24251388480916, 68.74669621814185, 0.18086814999999984, 330.0, 886, 910590, 1246, 35.82770470000105
1247, 9.034493480035117, 57.29837116725008, 68.98394760346748, 0.18014994999999992, 145.0, 710, 911300, 1247, 29.828267799999594
1248, 6.277256009809401, 57.32560501859037, 68.89302370952214, 0.1795595499999999, 55.0, 602, 911902, 1248, 24.616887599997426
1249, 7.3053939482553405, 57.23515585602307, 68.74578645841672, 0.17912394999999992, 75.0, 366, 912268, 1249, 15.311872700000094
1250, 7.240050120281693, 57.25340193678068, 68.77866310273241, 0.1786239999999999, 130.0, 745, 913013, 1250, 30.716030200001114
1251, 7.309649255347741, 57.224823088579065, 68.72925899715486, 0.1778716, 85.0, 927, 913940, 1251, 39.908471499998996
1252, 12.251662831918653, 57.58681575418106, 69.29720287604873, 0.17708905, 165.0, 812, 914752, 1252, 39.162471599996934
1253, 6.178838227881108, 57.41790179863661, 68.9597029200571, 0.17642304999999994, 140.0, 668, 915420, 1253, 33.221703200000775
1254, 7.62254951566041, 57.26128697562051, 68.80265986169135, 0.17586504999999988, 70.0, 572, 915992, 1254, 27.649238300000434
1255, 7.753326092160875, 57.26775051871139, 68.83119326812832, 0.1752935499999999, 185.0, 698, 916690, 1255, 34.88375190000079
1256, 5.274084654732014, 57.220105434027246, 68.68575519651878, 0.17475084999999996, 115.0, 508, 917198, 1256, 24.487385399999766
1257, 7.029879247896712, 57.47938680106943, 69.03404130177064, 0.17420544999999998, 100.0, 704, 917902, 1257, 35.1984678000008
1258, 6.723696940065342, 57.289295877729145, 68.82274238430723, 0.17371224999999993, 75.0, 392, 918294, 1258, 19.096250899998267
1259, 6.113230969918811, 57.255252972893096, 68.83587138549142, 0.17337024999999992, 65.0, 368, 918662, 1259, 18.293958700000076
1260, 6.7662888883085515, 57.35796066097446, 68.92042494820548, 0.17294725, 70.0, 572, 919234, 1260, 28.485933199997817
1261, 6.915831765941074, 57.27277880637877, 68.78730338311965, 0.1724108499999999, 50.0, 620, 919854, 1261, 30.64766370000143
1262, 9.120153542576318, 56.82192072361074, 68.36295532064236, 0.1717088499999998, 200.0, 940, 920794, 1262, 46.90588179999759
1263, 6.42570453549391, 56.64904968106017, 68.07290010603647, 0.17088894999999996, 215.0, 882, 921676, 1263, 43.76638549999916
1264, 13.02792448146281, 56.71090416503108, 68.20153059990578, 0.1702166499999999, 50.0, 612, 922288, 1264, 30.598178199998074
1265, 9.094622398621029, 56.326934548997386, 67.69229558571098, 0.16976664999999994, 50.0, 388, 922676, 1265, 19.135105000001204
1266, 6.690526937022968, 56.62695810322148, 68.0093946727013, 0.16917894999999994, 205.0, 918, 923594, 1266, 46.09654650000084
1267, 5.618527972575945, 56.64105772360777, 68.01534513424605, 0.16832709999999984, 190.0, 975, 924569, 1267, 48.84202480000022
1268, 7.316533242259095, 56.70021706508509, 68.15067253406482, 0.16736229999999996, 305.0, 1169, 925738, 1268, 57.99123300000065
1269, 7.163888569210435, 56.68106414840653, 68.08714201447967, 0.16638579999999997, 290.0, 1001, 926739, 1269, 49.148414199997205
1270, 7.863623777111371, 56.726964055379234, 68.19573369852702, 0.16526034999999997, 365.0, 1500, 928239, 1270, 73.4874525999985
1271, 8.39504033519061, 56.68465805053711, 68.17236111986585, 0.1641731499999999, 280.0, 916, 929155, 1271, 45.06838639999842
1272, 7.03726553748727, 56.62282959183115, 68.0127720977739, 0.16344999999999996, 170.0, 691, 929846, 1272, 35.081407099998614
1273, 5.447923077797553, 56.474127793462024, 67.83217481097336, 0.16285284999999997, 125.0, 636, 930482, 1273, 30.970349399998668
1274, 8.414341827539298, 56.33993668841501, 67.74584265162802, 0.16204014999999988, 285.0, 1170, 931652, 1274, 57.34828159999961
1275, 9.970050383756957, 56.321761331656774, 67.7429879250948, 0.16112169999999998, 70.0, 871, 932523, 1275, 43.718962900002225
1276, 7.7748363940031275, 56.22292340463069, 67.54196678859361, 0.16042959999999992, 135.0, 667, 933190, 1276, 32.95863570000074
1277, 8.46232614801012, 56.308819282861975, 67.66195164298377, 0.159724, 245.0, 901, 934091, 1277, 45.0046594000014
1278, 8.083448838497716, 56.40483686773164, 67.8010852089801, 0.15898419999999988, 240.0, 743, 934834, 1278, 37.48653810000178
1279, 6.7366782020810305, 56.44742616733772, 67.82335208141839, 0.15819039999999998, 335.0, 1021, 935855, 1279, 50.666848000000755
1280, 6.0126297898510455, 56.263320489881146, 67.59237548755203, 0.15735429999999997, 110.0, 837, 936692, 1280, 42.19416449999699
1281, 6.933783243611916, 56.23857555473676, 67.62204359276481, 0.15667209999999993, 30.0, 679, 937371, 1281, 34.0435114000029
1282, 7.781061758268924, 56.175648110923696, 67.52550668324042, 0.15611499999999992, 105.0, 559, 937930, 1282, 28.090649600002507
1283, 7.831494492791942, 56.37598199094035, 67.7576578981928, 0.1554688, 160.0, 877, 938807, 1283, 44.92751449999923
1284, 7.393413332002317, 56.40097067041568, 67.7729814337344, 0.15449769999999993, 665.0, 1281, 940088, 1284, 64.32284080000318
1285, 6.750930801933839, 56.16139954847103, 67.49184785528583, 0.15348159999999986, 155.0, 977, 941065, 1285, 49.25740049999877
1286, 7.748622873751997, 56.15382851949952, 67.45467513972527, 0.152623, 170.0, 931, 941996, 1286, 47.72220539999762
1287, 5.525194298950109, 56.124109505162096, 67.38066835692435, 0.15190704999999996, 55.0, 660, 942656, 1287, 33.76353240000026
1288, 6.447756938028093, 56.08164591886559, 67.3998692454124, 0.15116905, 255.0, 980, 943636, 1288, 49.107562599998346
1289, 12.29964215068639, 56.25339317321777, 67.66803621971744, 0.1505714499999999, 50.0, 348, 943984, 1289, 18.24275590000252
1290, 7.0878230956925545, 56.5127389274582, 67.86104608008687, 0.15018849999999995, 25.0, 503, 944487, 1290, 25.152677800000674
1291, 5.6143469706795734, 56.23405665736045, 67.47193804973831, 0.14976684999999992, 55.0, 434, 944921, 1291, 21.854723899999954
1292, 9.570375187789173, 56.268273954038264, 67.59408529028134, 0.14915844999999997, 135.0, 918, 945839, 1292, 46.99276649999956
1293, 9.035293789530888, 56.1984341334934, 67.54398090667145, 0.14850864999999988, 185.0, 526, 946365, 1293, 27.372158499998477
1294, 7.145834834618889, 56.2515144308614, 67.61098820187267, 0.1478376999999999, 130.0, 965, 947330, 1294, 49.92642279999927
1295, 7.11674101289765, 56.33938731922342, 67.707198655107, 0.14698359999999996, 130.0, 933, 948263, 1295, 47.792371399998956
1296, 9.820830844447975, 56.18161052063084, 67.5698298659392, 0.14627709999999997, 65.0, 637, 948900, 1296, 32.78068599999824
1297, 6.576487629579639, 56.20873396609311, 67.52944519448914, 0.14570289999999989, 110.0, 639, 949539, 1297, 32.14911209999991
1298, 9.609798516891422, 55.98740759033618, 67.2926170621368, 0.14488569999999998, 280.0, 1177, 950716, 1298, 60.69162739999956
1299, 8.01949522183055, 55.74970845304708, 67.01081804449801, 0.14400639999999992, 200.0, 777, 951493, 1299, 41.18698930000028
1300, 8.619958406836867, 55.742603532530424, 67.03223317098275, 0.14334399999999992, 335.0, 695, 952188, 1300, 35.358840599998075
1301, 6.612427068432738, 55.734063025287305, 66.96158918068343, 0.14258889999999994, 245.0, 983, 953171, 1301, 50.85138200000074
1302, 8.429759962335229, 55.77911454772949, 67.04448638916016, 0.14169654999999995, 195.0, 1000, 954171, 1302, 51.31109080000169
1303, 8.271318059038911, 55.85557568215916, 67.11176055842995, 0.14072004999999993, 175.0, 1170, 955341, 1303, 60.19669900000008
1304, 6.092664003533723, 55.849060213662746, 67.01175378525484, 0.14002749999999997, 75.0, 369, 955710, 1304, 19.110355199998594
1305, 9.819666311710982, 55.75235599877262, 67.03328347713389, 0.13956534999999992, 120.0, 658, 956368, 1305, 34.17380100000082
1306, 8.497920633272726, 55.8783392829527, 67.17639900199342, 0.13884939999999993, 150.0, 933, 957301, 1306, 48.2233931999981
1307, 8.89957587602147, 55.763330443831514, 67.08732096504292, 0.13804839999999988, 145.0, 847, 958148, 1307, 44.76691910000227
1308, 8.408285094729084, 55.84406076883603, 67.08666592143052, 0.13716819999999996, 265.0, 1109, 959257, 1308, 58.522398000000976
1309, 8.769145763067412, 55.79719358874905, 67.0315976441472, 0.13643199999999994, 75.0, 527, 959784, 1309, 27.484576999999263
1310, 7.587398414272273, 55.730421946144695, 66.9720028384182, 0.13604950000000002, 25.0, 323, 960107, 1310, 17.259342900000775
1311, 8.697944196255515, 55.715401279490884, 67.01600079475244, 0.1354482999999999, 310.0, 1013, 961120, 1311, 52.40671529999963
1312, 8.71511400394335, 55.627733676019545, 66.8905423710684, 0.13476699999999997, 50.0, 501, 961621, 1312, 26.76131130000067
1313, 6.599427128019694, 55.81135410008424, 67.0582546727264, 0.13423869999999993, 100.0, 673, 962294, 1313, 34.97847179999735
1314, 7.186246384684746, 55.613860831962334, 66.81409538543976, 0.13363614999999995, 110.0, 666, 962960, 1314, 35.28699100000085
1315, 7.025914227487622, 55.792989720355024, 67.05402948568155, 0.13317265, 25.0, 364, 963324, 1315, 19.00815149999835
1316, 5.9548102186827245, 55.746168602094784, 66.97480180952815, 0.13264929999999997, 250.0, 799, 964123, 1316, 42.68190599999798
1317, 6.026028659175473, 55.56149886848594, 66.74892413062196, 0.13202829999999996, 125.0, 581, 964704, 1317, 30.694575800000166
1318, 6.726207756337121, 55.5444140163653, 66.75339758512791, 0.13130694999999992, 275.0, 1022, 965726, 1318, 53.81094110000049
1319, 6.082922827892155, 55.679767727586366, 66.88297154483922, 0.1306449999999999, 40.0, 449, 966175, 1319, 23.755536500000744
1320, 7.698114044087775, 55.805986688211306, 67.05228662985832, 0.12992274999999998, 300.0, 1156, 967331, 1320, 60.28304939999725
1321, 6.8560572635891, 55.846977465350264, 67.09203240696162, 0.12901689999999996, 245.0, 857, 968188, 1321, 44.04665319999913
1322, 9.525629037068517, 55.76630925526567, 67.04704976869175, 0.12809979999999999, 375.0, 1181, 969369, 1322, 61.61582520000229
1323, 6.543081394915006, 55.56715996178991, 66.71878595901197, 0.12714624999999996, 190.0, 938, 970307, 1323, 49.62223129999984
1324, 5.880757128384226, 54.932578356399425, 65.97789897398764, 0.12641049999999995, 105.0, 697, 971004, 1324, 36.154073900001094
1325, 6.072581342598306, 54.98805518693562, 66.03853270373767, 0.12581244999999994, 155.0, 632, 971636, 1325, 33.60004739999931
1326, 7.550179821846421, 55.04453200823962, 66.21510036084686, 0.12530889999999995, 85.0, 487, 972123, 1326, 25.482443599998078
1327, 6.782166383926775, 55.064668625476315, 66.1667631111893, 0.12463074999999992, 235.0, 1020, 973143, 1327, 53.87961539999742
1328, 6.9079680943764945, 55.07265288900025, 66.1567050885686, 0.12385089999999993, 75.0, 713, 973856, 1328, 38.34394719999909
1329, 6.048319063822887, 54.85572395561645, 65.91212266043635, 0.12302289999999995, 265.0, 1127, 974983, 1329, 59.947197500001494
1330, 7.321876164094931, 55.07856666149736, 66.19328952970959, 0.1219865499999999, 265.0, 1176, 976159, 1330, 64.25976330000049
1331, 6.201142391318272, 55.1054410028724, 66.24359899481803, 0.12121569999999994, 135.0, 537, 976696, 1331, 28.481318300000567
1332, 4.692044889082283, 55.237721799156084, 66.29717514811573, 0.12077874999999995, 55.0, 434, 977130, 1332, 23.049312200000713
1333, 6.053149995789679, 55.128599493987956, 66.13511691936402, 0.12041289999999998, 105.0, 379, 977509, 1333, 20.644786400000157
1334, 5.3214452133797785, 55.017588910933725, 66.070801462329, 0.1197181, 400.0, 1165, 978674, 1334, 62.481699500000104
1335, 7.005096522547753, 55.085806266767676, 66.23613425936625, 0.11878974999999993, 210.0, 898, 979572, 1335, 48.43180139999822
1336, 8.216185336194327, 55.19495622129265, 66.30165598711629, 0.11821419999999994, 30.0, 381, 979953, 1336, 20.58817210000052
1337, 6.775369815504436, 54.414942296754894, 65.37014079937214, 0.1179028, 35.0, 311, 980264, 1337, 16.43770500000028
1338, 8.971595208289877, 54.84269722030916, 65.93149248886876, 0.1175391999999999, 75.0, 497, 980761, 1338, 26.887969700001122
1339, 5.030376883602339, 54.67225284418784, 65.64410285003915, 0.11704329999999996, 20.0, 605, 981366, 1339, 32.351423399999476
1340, 8.945386796520681, 54.785593248224586, 65.88522587990275, 0.11644029999999997, 330.0, 735, 982101, 1340, 40.36193339999954
1341, 5.386473170613897, 54.712979059634, 65.70317527660426, 0.11595429999999993, 15.0, 345, 982446, 1341, 18.54217559999961
1342, 9.298874274566234, 54.61405803145264, 65.70761464825637, 0.11529864999999993, 285.0, 1112, 983558, 1342, 59.696300799998426
1343, 7.425400744381291, 54.72497990275214, 65.80779771961721, 0.11455209999999998, 115.0, 547, 984105, 1343, 30.423174600000493
1344, 9.270643549877295, 54.829107538275764, 65.95204157348073, 0.11410974999999993, 45.0, 436, 984541, 1344, 24.088625199998205
1345, 9.114411315773472, 54.87518463520089, 66.01459997157858, 0.11346804999999992, 195.0, 990, 985531, 1345, 53.4943174
1346, 7.320512027110116, 54.90124421776608, 65.98277357492323, 0.1123659999999999, 245.0, 1459, 986990, 1346, 79.0704788999974
1347, 7.415995349534544, 54.884682400255315, 65.95754745667239, 0.11114919999999998, 400.0, 1245, 988235, 1347, 56.386440800000855
1348, 7.966448955090573, 54.93368244642481, 66.03751587907016, 0.11004264999999988, 375.0, 1214, 989449, 1348, 52.88156539999909
1349, 5.372163239283626, 54.71202633224107, 65.66752537145636, 0.10929789999999998, 80.0, 441, 989890, 1349, 20.09571380000125
1350, 8.19776200422451, 54.38061472962356, 65.36573204768592, 0.10853829999999993, 375.0, 1247, 991137, 1350, 55.842815100000735
1351, 9.003023320101365, 54.21482310232637, 65.17619207124002, 0.1075649499999999, 120.0, 916, 992053, 1351, 40.435917300001165
1352, 4.567846257163554, 54.094319198344905, 64.95022243457836, 0.10686609999999999, 150.0, 637, 992690, 1352, 28.455413899999257
1353, 6.573208119471868, 54.12206441945043, 65.00925894550893, 0.10638369999999993, 40.0, 435, 993125, 1353, 19.159387600000628
1354, 7.119820900111391, 54.400401081586274, 65.36424192463335, 0.10571859999999993, 430.0, 1043, 994168, 1354, 46.86347229999956
1355, 6.252014634679405, 54.1775419410992, 65.07610506897494, 0.10472184999999995, 320.0, 1172, 995340, 1355, 52.2552179000013
1356, 8.6456016389387, 54.34421577740433, 65.32465801669242, 0.10359594999999995, 240.0, 1330, 996670, 1356, 57.816601299997274
1357, 9.248978023899648, 54.34454713498411, 65.31503088424174, 0.10263339999999992, 155.0, 809, 997479, 1357, 35.190216099999816
1358, 7.477047581812713, 54.52793628506811, 65.58661705170115, 0.10211229999999988, 45.0, 349, 997828, 1358, 15.265785899999173
1359, 6.619457199443661, 54.29384748022676, 65.23517141484118, 0.10129014999999993, 145.0, 1478, 999306, 1359, 64.10014909999882
