,loss,mae,mean_q,mean_eps,episode_reward,nb_episode_steps,nb_steps,episode,duration
0,0,0,0,0,90.0,587,587,0,1.2083285999999998
1, 0, 0, 0, 0, 105.0, 620, 1207, 1, 1.4507168000000004
2, 0, 0, 0, 0, 15.0, 439, 1646, 2, 1.0894983000000007
3, 0, 0, 0, 0, 105.0, 587, 2233, 3, 1.5082985999999998
4, 0, 0, 0, 0, 255.0, 915, 3148, 4, 2.3021196999999987
5, 0, 0, 0, 0, 120.0, 550, 3698, 5, 1.2947955000000029
6, 0, 0, 0, 0, 80.0, 504, 4202, 6, 1.1621840999999975
7, 0, 0, 0, 0, 210.0, 839, 5041, 7, 1.8581152000000003
8, 0, 0, 0, 0, 45.0, 459, 5500, 8, 1.0751905000000015
9, 0, 0, 0, 0, 50.0, 513, 6013, 9, 1.2243773000000004
10, 0, 0, 0, 0, 410.0, 836, 6849, 10, 2.0140188000000023
11, 0, 0, 0, 0, 110.0, 666, 7515, 11, 1.623000900000001
12, 0, 0, 0, 0, 30.0, 561, 8076, 12, 1.2598063999999987
13, 0, 0, 0, 0, 270.0, 1103, 9179, 13, 2.481312499999998
14, 0, 0, 0, 0, 155.0, 547, 9726, 14, 1.187539600000001
15, 0, 0, 0, 0, 100.0, 390, 10116, 15, 0.8444211000000053
16, 0, 0, 0, 0, 110.0, 654, 10770, 16, 1.3787947000000003
17, 0, 0, 0, 0, 105.0, 779, 11549, 17, 1.6957766999999961
18, 0, 0, 0, 0, 105.0, 567, 12116, 18, 1.2116578000000047
19, 0, 0, 0, 0, 135.0, 662, 12778, 19, 1.3555212999999995
20, 0, 0, 0, 0, 215.0, 821, 13599, 20, 1.6997015000000033
21, 0, 0, 0, 0, 260.0, 1161, 14760, 21, 2.395169899999999
22, 0, 0, 0, 0, 10.0, 433, 15193, 22, 0.907112699999999
23, 0, 0, 0, 0, 315.0, 1187, 16380, 23, 2.3723178000000047
24, 0, 0, 0, 0, 155.0, 768, 17148, 24, 1.5988297999999972
25, 0, 0, 0, 0, 240.0, 871, 18019, 25, 1.7891347999999994
26, 0, 0, 0, 0, 210.0, 765, 18784, 26, 1.6045770000000061
27, 0, 0, 0, 0, 35.0, 510, 19294, 27, 1.0522041999999985
28, 0, 0, 0, 0, 130.0, 621, 19915, 28, 1.2614967000000021
29, 0, 0, 0, 0, 120.0, 782, 20697, 29, 1.5574294999999978
30, 0, 0, 0, 0, 120.0, 743, 21440, 30, 1.612440300000003
31, 0, 0, 0, 0, 180.0, 783, 22223, 31, 1.6592410000000015
32, 0, 0, 0, 0, 145.0, 636, 22859, 32, 1.425455399999997
33, 0, 0, 0, 0, 30.0, 584, 23443, 33, 1.4676659
34, 0, 0, 0, 0, 110.0, 628, 24071, 34, 1.3420386000000022
35, 0, 0, 0, 0, 135.0, 748, 24819, 35, 1.7144269999999935
36, 0, 0, 0, 0, 90.0, 544, 25363, 36, 1.278422599999999
37, 0, 0, 0, 0, 65.0, 568, 25931, 37, 1.5954677000000004
38, 0, 0, 0, 0, 80.0, 550, 26481, 38, 1.554005200000006
39, 0, 0, 0, 0, 345.0, 948, 27429, 39, 2.2547967
40, 0, 0, 0, 0, 65.0, 404, 27833, 40, 0.9189113000000049
41, 0, 0, 0, 0, 155.0, 682, 28515, 41, 1.5352187000000015
42, 0, 0, 0, 0, 120.0, 724, 29239, 42, 1.5199116000000004
43, 0, 0, 0, 0, 155.0, 789, 30028, 43, 1.658725700000005
44, 0, 0, 0, 0, 110.0, 408, 30436, 44, 0.8475107999999949
45, 0, 0, 0, 0, 105.0, 358, 30794, 45, 0.7601736000000017
46, 0, 0, 0, 0, 180.0, 727, 31521, 46, 1.4669471999999928
47, 0, 0, 0, 0, 140.0, 648, 32169, 47, 1.3420674999999989
48, 0, 0, 0, 0, 360.0, 1138, 33307, 48, 2.3883189000000016
49, 0, 0, 0, 0, 465.0, 1555, 34862, 49, 3.2072766
50, 0, 0, 0, 0, 180.0, 770, 35632, 50, 1.8216700999999915
51, 0, 0, 0, 0, 230.0, 1051, 36683, 51, 2.347522699999999
52, 0, 0, 0, 0, 105.0, 496, 37179, 52, 1.1601347999999945
53, 0, 0, 0, 0, 120.0, 696, 37875, 53, 1.6220317999999878
54, 0, 0, 0, 0, 335.0, 812, 38687, 54, 1.7983625000000103
55, 0, 0, 0, 0, 220.0, 994, 39681, 55, 2.0026327000000066
56, 0, 0, 0, 0, 120.0, 491, 40172, 56, 1.0317638000000073
57, 0, 0, 0, 0, 55.0, 414, 40586, 57, 0.8388556000000023
58, 0, 0, 0, 0, 55.0, 413, 40999, 58, 0.8224450000000019
59, 0, 0, 0, 0, 115.0, 800, 41799, 59, 1.5455683999999934
60, 0, 0, 0, 0, 120.0, 657, 42456, 60, 1.3620571000000012
61, 0, 0, 0, 0, 105.0, 647, 43103, 61, 1.3077348999999998
62, 0, 0, 0, 0, 210.0, 741, 43844, 62, 1.4712830999999937
63, 0, 0, 0, 0, 55.0, 387, 44231, 63, 0.8149566000000021
64, 0, 0, 0, 0, 380.0, 813, 45044, 64, 1.592947499999994
65, 0, 0, 0, 0, 110.0, 443, 45487, 65, 0.9523720000000111
66, 0, 0, 0, 0, 180.0, 763, 46250, 66, 1.4983919999999955
67, 0, 0, 0, 0, 85.0, 385, 46635, 67, 0.7623851999999971
68, 0, 0, 0, 0, 350.0, 939, 47574, 68, 1.8267031999999972
69, 0, 0, 0, 0, 110.0, 642, 48216, 69, 1.2701959999999985
70, 0, 0, 0, 0, 100.0, 694, 48910, 70, 1.356080899999995
71, 0, 0, 0, 0, 140.0, 839, 49749, 71, 1.615279700000002
72, 0, 0, 0, 0, 20.0, 593, 50342, 72, 1.1721778
73, 0, 0, 0, 0, 180.0, 694, 51036, 73, 1.3662571000000128
74, 0, 0, 0, 0, 155.0, 840, 51876, 74, 1.637009500000005
75, 0, 0, 0, 0, 120.0, 757, 52633, 75, 1.4914334999999994
76, 0, 0, 0, 0, 75.0, 517, 53150, 76, 1.0326636000000065
77, 0, 0, 0, 0, 50.0, 499, 53649, 77, 0.9948812000000089
78, 0, 0, 0, 0, 55.0, 597, 54246, 78, 1.1915496000000019
79, 0, 0, 0, 0, 450.0, 1541, 55787, 79, 2.929957800000011
80, 0, 0, 0, 0, 80.0, 376, 56163, 80, 0.7923284000000024
81, 0, 0, 0, 0, 210.0, 820, 56983, 81, 1.6624306999999874
82, 0, 0, 0, 0, 210.0, 796, 57779, 82, 1.6257295000000056
83, 0, 0, 0, 0, 350.0, 797, 58576, 83, 1.5874225999999965
84, 0, 0, 0, 0, 75.0, 532, 59108, 84, 1.0547061000000042
85, 0, 0, 0, 0, 290.0, 976, 60084, 85, 1.9435847999999964
86, 0, 0, 0, 0, 50.0, 556, 60640, 86, 1.3312010000000214
87, 0, 0, 0, 0, 110.0, 726, 61366, 87, 1.625080799999978
88, 0, 0, 0, 0, 155.0, 786, 62152, 88, 1.9268881000000135
89, 0, 0, 0, 0, 155.0, 953, 63105, 89, 2.242276000000004
90, 0, 0, 0, 0, 50.0, 501, 63606, 90, 1.1153690000000154
91, 0, 0, 0, 0, 215.0, 847, 64453, 91, 1.8480567000000008
92, 0, 0, 0, 0, 140.0, 676, 65129, 92, 1.564338399999997
93, 0, 0, 0, 0, 105.0, 518, 65647, 93, 1.102461500000004
94, 0, 0, 0, 0, 80.0, 545, 66192, 94, 1.271547499999997
95, 0, 0, 0, 0, 240.0, 822, 67014, 95, 1.7629142000000115
96, 0, 0, 0, 0, 120.0, 656, 67670, 96, 1.3792715000000157
97, 0, 0, 0, 0, 155.0, 774, 68444, 97, 1.559424100000001
98, 0, 0, 0, 0, 155.0, 756, 69200, 98, 1.5721826999999848
99, 0, 0, 0, 0, 45.0, 413, 69613, 99, 0.873777600000011
100, 0, 0, 0, 0, 105.0, 551, 70164, 100, 1.1194079999999929
101, 0, 0, 0, 0, 105.0, 674, 70838, 101, 1.4442195999999967
102, 0, 0, 0, 0, 75.0, 385, 71223, 102, 0.8231199999999887
103, 0, 0, 0, 0, 105.0, 690, 71913, 103, 1.4404238000000191
104, 0, 0, 0, 0, 105.0, 812, 72725, 104, 1.9298618999999917
105, 0, 0, 0, 0, 180.0, 954, 73679, 105, 2.046619700000008
106, 0, 0, 0, 0, 135.0, 590, 74269, 106, 1.32899740000002
107, 0, 0, 0, 0, 110.0, 596, 74865, 107, 1.2632081999999798
108, 0, 0, 0, 0, 155.0, 834, 75699, 108, 1.7644769999999994
109, 0, 0, 0, 0, 215.0, 960, 76659, 109, 2.0621433000000025
110, 0, 0, 0, 0, 240.0, 877, 77536, 110, 1.9703073999999958
111, 0, 0, 0, 0, 155.0, 782, 78318, 111, 1.6230668000000037
112, 0, 0, 0, 0, 180.0, 865, 79183, 112, 1.8722166000000016
113, 0, 0, 0, 0, 120.0, 790, 79973, 113, 1.7202642999999966
114, 0, 0, 0, 0, 50.0, 506, 80479, 114, 1.1370999000000097
115, 0, 0, 0, 0, 130.0, 759, 81238, 115, 1.6520843999999784
116, 0, 0, 0, 0, 210.0, 874, 82112, 116, 1.8572986000000071
117, 0, 0, 0, 0, 315.0, 877, 82989, 117, 1.7265098999999964
118, 0, 0, 0, 0, 160.0, 841, 83830, 118, 1.8143542999999909
119, 0, 0, 0, 0, 165.0, 766, 84596, 119, 1.624857800000001
120, 0, 0, 0, 0, 350.0, 1103, 85699, 120, 2.3329126000000144
121, 0, 0, 0, 0, 120.0, 778, 86477, 121, 1.60319819999998
122, 0, 0, 0, 0, 120.0, 622, 87099, 122, 1.3350749999999891
123, 0, 0, 0, 0, 210.0, 830, 87929, 123, 1.7444320000000175
124, 0, 0, 0, 0, 130.0, 589, 88518, 124, 1.2948002999999915
125, 0, 0, 0, 0, 45.0, 561, 89079, 125, 1.2660895999999866
126, 0, 0, 0, 0, 110.0, 755, 89834, 126, 1.5310961000000134
127, 0, 0, 0, 0, 380.0, 835, 90669, 127, 1.7193253000000084
128, 0, 0, 0, 0, 225.0, 875, 91544, 128, 1.7904543999999873
129, 0, 0, 0, 0, 105.0, 754, 92298, 129, 1.5009206999999947
130, 0, 0, 0, 0, 130.0, 735, 93033, 130, 1.4786790999999937
131, 0, 0, 0, 0, 75.0, 513, 93546, 131, 1.1053556999999898
132, 0, 0, 0, 0, 110.0, 793, 94339, 132, 1.7622226000000012
133, 0, 0, 0, 0, 120.0, 627, 94966, 133, 1.3691209000000129
134, 0, 0, 0, 0, 180.0, 782, 95748, 134, 1.6478857999999832
135, 0, 0, 0, 0, 210.0, 813, 96561, 135, 1.6482935000000225
136, 0, 0, 0, 0, 155.0, 786, 97347, 136, 1.7150694999999985
137, 0, 0, 0, 0, 170.0, 1028, 98375, 137, 2.1980422999999973
138, 0, 0, 0, 0, 185.0, 916, 99291, 138, 1.8785215999999991
139, 8085.018041493941, 52.91736065611548, 68.09636538369315, 0.9099554500000001, 155.0, 808, 100099, 139, 2.66548370000001
140, 1818.4630762282989, 97.59212443283793, 136.94623247001329, 0.9095450499999993, 215.0, 814, 100913, 140, 7.504412400000007
141, 68.9404783386782, 111.20314375176487, 132.77352168990905, 0.9088052500000005, 230.0, 830, 101743, 141, 7.739991299999986
142, 56.05967300756654, 110.99440103787094, 132.86420694607406, 0.9081302499999998, 140.0, 670, 102413, 142, 5.785523299999994
143, 51.985540080437296, 110.89027420043945, 132.79638702979454, 0.9072437500000002, 295.0, 1300, 103713, 143, 10.971842900000013
144, 46.70222052885461, 110.93687680101148, 132.87116907544706, 0.9064850500000002, 60.0, 386, 104099, 144, 3.298848200000009
145, 46.57093796194816, 111.04261916997481, 133.04608071580225, 0.9059585500000006, 115.0, 784, 104883, 145, 6.507215900000006
146, 41.35281250254441, 110.97501536286104, 133.0379618240096, 0.9051571, 235.0, 997, 105880, 146, 8.228912899999955
147, 41.84061217231872, 110.89117585203518, 132.88830367749492, 0.90442675, 35.0, 626, 106506, 147, 5.091812200000049
148, 47.43851433117011, 110.80942322847149, 132.88817082647907, 0.9039011499999996, 105.0, 542, 107048, 148, 4.451144700000043
149, 47.47371180203496, 110.84645024513712, 133.0188632731535, 0.9034367500000001, 90.0, 490, 107538, 149, 4.052570299999957
150, 45.41961571555468, 110.72740605992091, 132.8967039080286, 0.9027869500000005, 265.0, 954, 108492, 150, 7.915850800000044
151, 47.03410198430347, 110.80326569915577, 132.8952763794334, 0.9020750500000001, 95.0, 628, 109120, 151, 5.496707500000014
152, 56.28418324982756, 110.60320279983453, 132.72915093034635, 0.9012771999999997, 175.0, 1145, 110265, 152, 9.916275499999983
153, 61.076916050651796, 110.46860146522522, 132.5046853604524, 0.9004307499999997, 380.0, 736, 111001, 153, 6.283233499999994
154, 50.90622842061269, 110.45894399419561, 132.5873226131405, 0.8997998499999998, 105.0, 666, 111667, 154, 6.227405499999975
155, 47.542033916840616, 110.48038517140687, 132.81697617626378, 0.8992711000000002, 75.0, 509, 112176, 155, 5.725621399999966
156, 49.40466732955561, 110.31497650890816, 132.6957143420708, 0.8985807999999997, 450.0, 1025, 113201, 156, 15.201828599999999
157, 43.608685646140785, 110.4703625126889, 132.7740169993618, 0.8977091499999996, 210.0, 912, 114113, 157, 13.773432600000035
158, 48.35877884427706, 110.31104444662729, 132.63266202608744, 0.8968667500000003, 165.0, 960, 115073, 158, 11.148287699999969
159, 47.026407244522915, 110.35756227314978, 132.75445007670027, 0.89611705, 105.0, 706, 115779, 159, 8.361035999999956
160, 48.97263219871237, 110.35259292261772, 132.69763120173224, 0.8954366499999992, 150.0, 806, 116585, 160, 8.628997999999967
161, 47.0238459462101, 110.21375709459619, 132.55950553671826, 0.8946104500000008, 335.0, 1030, 117615, 161, 9.008464599999968
162, 49.80687951546795, 110.29276319539773, 132.65721543510006, 0.8936699500000004, 365.0, 1060, 118675, 162, 9.370000000000005
163, 44.85455133768625, 110.28356685707286, 132.49574420254152, 0.8929436499999996, 75.0, 554, 119229, 163, 4.823719100000005
164, 45.06712619128357, 110.52660541203123, 132.8785416671715, 0.8923316499999997, 210.0, 806, 120035, 164, 6.985922899999991
165, 41.83072734222632, 110.61795037349295, 132.78404719547854, 0.8916566500000003, 135.0, 694, 120729, 165, 6.102851900000019
166, 35.37831268593913, 110.38638010181364, 132.48530869405778, 0.8911247500000005, 105.0, 488, 121217, 166, 4.122696399999995
167, 31.02054341488826, 110.37728700515775, 132.61520229527895, 0.890659, 80.0, 547, 121764, 167, 4.797970700000008
168, 36.032717008406905, 110.30004286510786, 132.67131379023354, 0.8902026999999998, 105.0, 467, 122231, 168, 3.9901277000000164
169, 30.38766703298883, 110.39126356137794, 132.66839978495784, 0.8895938499999994, 425.0, 886, 123117, 169, 7.853057899999953
170, 32.79546190197107, 110.32934058282389, 132.66243899985434, 0.8887244500000008, 365.0, 1046, 124163, 170, 9.230930099999966
171, 25.458606733617557, 110.59467221911909, 132.94067006480412, 0.8879864500000001, 35.0, 594, 124757, 171, 5.112510400000019
172, 27.719466019266005, 110.38136649766349, 132.63368866924097, 0.8872457499999996, 380.0, 1052, 125809, 172, 9.165679699999998
173, 31.49012915315513, 110.2439761644397, 132.56974225057533, 0.8862877000000002, 535.0, 1077, 126886, 173, 9.4494689
174, 25.312071116890493, 110.28897608359028, 132.55834570456676, 0.8855744499999999, 65.0, 508, 127394, 174, 4.44172420000001
175, 30.065576678762834, 110.3610307474931, 132.6922997633616, 0.8850002499999999, 335.0, 768, 128162, 175, 6.77630240000002
176, 30.63550677757827, 110.23021478000719, 132.60571276370345, 0.8844111999999995, 105.0, 541, 128703, 176, 4.6729482000000075
177, 26.45521017181373, 110.46055343770314, 132.84562567418692, 0.8835890499999998, 240.0, 1286, 129989, 177, 11.314352500000041
178, 36.61710506894604, 106.62995684376621, 129.41855071596723, 0.8825900500000003, 285.0, 934, 130923, 178, 8.107610899999997
179, 30.8179106477369, 106.65984759537525, 129.4076956449451, 0.8814848499999999, 440.0, 1522, 132445, 179, 13.164693799999895
180, 35.08172255301778, 106.65017505838901, 129.4834001879149, 0.8805155500000001, 105.0, 632, 133077, 180, 5.726776000000086
181, 35.21725040281212, 106.59704102526655, 129.29693450508537, 0.8799035500000002, 150.0, 728, 133805, 181, 6.580333399999972
182, 33.01217829824579, 106.43380123183073, 129.2718810340673, 0.8792298999999999, 210.0, 769, 134574, 182, 7.025018699999919
183, 27.371332448385747, 106.51469464290405, 129.25581302036574, 0.8786997999999997, 15.0, 409, 134983, 183, 3.7601178999999547
184, 30.034018408441423, 106.58998296242817, 129.18406633045572, 0.8783371000000002, 65.0, 397, 135380, 184, 3.4775346000000127
185, 29.77523937609312, 106.55342851417342, 129.30376856514576, 0.8776778500000009, 240.0, 1068, 136448, 185, 9.649327900000003
186, 32.54069972881163, 106.79640392341999, 129.58168351529824, 0.8770190500000002, 70.0, 396, 136844, 186, 3.648742200000015
187, 29.502763036934727, 106.52354287756495, 129.31195254038616, 0.8766541, 75.0, 415, 137259, 187, 3.8037209000000303
188, 33.74587514479662, 106.41465341209046, 129.2347329762589, 0.87622345, 105.0, 542, 137801, 188, 4.964375300000029
189, 33.53042059863055, 106.58610629611545, 129.21931178340205, 0.8756757999999996, 120.0, 675, 138476, 189, 6.432503099999963
190, 26.963780554383995, 106.5607149362564, 129.42426551580428, 0.8747960500000007, 720.0, 1280, 139756, 190, 12.11895179999999
191, 23.489354674689867, 106.46956080736773, 128.4941997825171, 0.8739311500000004, 110.0, 642, 140398, 191, 6.363300799999934
192, 22.94219563402634, 106.50977945878148, 127.96795848033861, 0.8732133999999997, 260.0, 953, 141351, 192, 9.1302326
193, 21.036648146548675, 106.558938771338, 128.03417264644187, 0.8724227499999996, 190.0, 804, 142155, 193, 7.831419800000049
194, 19.88646063362526, 106.54932441964054, 128.03956396848162, 0.8717212000000001, 135.0, 755, 142910, 194, 7.458089200000018
195, 20.806295148513286, 106.66669309413928, 128.20072251420967, 0.8709908500000002, 210.0, 868, 143778, 195, 8.569434000000001
196, 22.573028635691447, 106.37689850588879, 127.91357339146626, 0.8704134999999997, 65.0, 415, 144193, 196, 4.106503500000031
197, 27.334112214748977, 106.5969331616261, 128.2396782578015, 0.8700071500000001, 30.0, 488, 144681, 197, 4.925749799999949
198, 20.847673826691466, 106.69949205330008, 128.2878418130048, 0.8695747, 45.0, 473, 145154, 198, 4.702031199999965
199, 20.658938828919286, 106.54571045868157, 128.0840148097785, 0.8690715999999998, 125.0, 645, 145799, 199, 6.339683100000002
200, 18.73479732473226, 106.45681189150665, 127.94350590583034, 0.8685892000000003, 30.0, 427, 146226, 200, 4.188555899999983
201, 24.939510679042517, 106.62837801296831, 128.23972609426144, 0.8677612, 355.0, 1413, 147639, 201, 13.85203439999998
202, 18.926681961332047, 106.67773645922055, 128.2424112286484, 0.8667662499999995, 105.0, 798, 148437, 202, 8.081693299999984
203, 20.22713845085963, 106.66202583097468, 128.2425628403486, 0.8660089000000002, 135.0, 885, 149322, 203, 8.67456859999993
204, 22.113532840681216, 106.6226722068451, 128.19670984262595, 0.86530375, 135.0, 682, 150004, 204, 6.928995100000066
205, 23.969835555447, 106.44537477833885, 128.17724170003618, 0.8647952499999996, 45.0, 448, 150452, 205, 4.415786099999991
206, 17.121308794992412, 106.28923799130256, 127.8906910909626, 0.8643682000000001, 65.0, 501, 150953, 206, 5.112325499999997
207, 18.343208018904445, 106.24240578180071, 127.77326581669949, 0.8638295500000001, 105.0, 696, 151649, 207, 6.805817700000034
208, 19.805838164716665, 106.33871314279429, 127.90787430564956, 0.8631981999999999, 105.0, 707, 152356, 208, 7.083496299999979
209, 17.063095154522134, 106.1666670691767, 127.64342652464943, 0.8626924000000001, 110.0, 417, 152773, 209, 4.3251253000000816
210, 20.82811812564433, 106.32100876517917, 127.90920344530906, 0.8621217999999998, 220.0, 851, 153624, 210, 8.583730100000025
211, 24.92665329015932, 106.12892090909867, 127.58193415012943, 0.8615327500000004, 65.0, 458, 154082, 211, 4.745275500000048
212, 19.62070322712672, 106.3076472528202, 127.85624506055694, 0.8611520500000002, 45.0, 388, 154470, 212, 3.997895700000072
213, 24.579125557420713, 106.28539842936746, 127.92753238600966, 0.8606431000000001, 180.0, 743, 155213, 213, 7.6025171
214, 18.24598150966957, 106.26175664180896, 127.76085574810321, 0.8600396500000006, 125.0, 598, 155811, 214, 6.076472400000057
215, 20.65607513474152, 106.35424473855348, 127.93581915661296, 0.8595163000000001, 105.0, 565, 156376, 215, 5.807801499999982
216, 20.435229913005983, 106.41779012292382, 127.9143395524684, 0.8589852999999994, 110.0, 615, 156991, 216, 6.1416225000000395
217, 19.42761780892577, 106.2203993752738, 127.64181190562026, 0.85851595, 100.0, 428, 157419, 217, 4.46321469999998
218, 22.32398229160092, 106.16315471042286, 127.68850194324146, 0.8581649500000001, 30.0, 352, 157771, 218, 3.6828071999999565
219, 15.203151708627864, 106.37460541528118, 127.92131428153718, 0.8576798499999999, 210.0, 726, 158497, 219, 7.432741399999941
220, 19.722165984904716, 106.45642431158768, 127.91799673474269, 0.8571308500000002, 105.0, 494, 158991, 220, 5.1833398999999645
221, 19.1215372966386, 106.40813182245196, 127.95422742014465, 0.8565948999999998, 180.0, 697, 159688, 221, 7.037514699999974
222, 17.96400887478386, 106.13643239877422, 127.60007007201934, 0.8560260999999998, 55.0, 567, 160255, 222, 5.960609399999953
223, 16.538406961763915, 105.95252028079616, 127.35223859828841, 0.8554838499999999, 90.0, 638, 160893, 223, 6.786611999999991
224, 20.863056850466325, 105.89587619723456, 127.36212418847724, 0.8548713999999998, 135.0, 723, 161616, 224, 7.492473000000018
225, 19.215761113669625, 105.96535939784796, 127.46347823587159, 0.8542900000000002, 135.0, 569, 162185, 225, 5.772926299999995
226, 21.250857462084703, 105.69045160632854, 127.09677305349855, 0.8537329, 155.0, 669, 162854, 226, 6.936166299999968
227, 19.07976479589661, 105.99132840407209, 127.42055556562788, 0.8531424999999998, 110.0, 643, 163497, 227, 6.7664320999999745
228, 20.123991854122202, 105.82092306408046, 127.26130023839414, 0.8523685000000009, 460.0, 1077, 164574, 228, 11.007954799999993
229, 18.69916532922674, 105.88980046025029, 127.37069086145472, 0.8516408500000003, 60.0, 540, 165114, 229, 5.587551299999973
230, 19.00003847539425, 105.73692757924398, 127.19538140614827, 0.8511278500000002, 140.0, 600, 165714, 230, 6.333563199999958
231, 17.885875119194516, 105.86069164177637, 127.24940243850682, 0.8505963999999996, 65.0, 581, 166295, 231, 6.18364280000003
232, 18.44457715842873, 105.69179078936577, 127.1454520970583, 0.8501045500000003, 120.0, 512, 166807, 232, 5.4554368000000295
233, 18.114335225812166, 105.84971952773368, 127.35670848194275, 0.8494898500000005, 225.0, 854, 167661, 233, 9.010278299999982
234, 17.45194595803346, 105.84971964653349, 127.30696220325564, 0.8488684000000005, 20.0, 527, 168188, 234, 5.981515400000035
235, 16.667801875588637, 105.85582022164799, 127.24092123193205, 0.8480629, 210.0, 1263, 169451, 235, 13.255816500000037
236, 16.138772397550916, 105.81970106129731, 127.22052208703893, 0.8471408499999997, 255.0, 786, 170237, 236, 8.239839399999937
237, 18.2080880807682, 105.42038223015189, 126.86466774982796, 0.8464321000000001, 345.0, 789, 171026, 237, 8.400326899999982
238, 18.887213013455515, 105.33175144820918, 126.73763952098909, 0.8458574500000002, 55.0, 488, 171514, 238, 5.268562700000075
239, 16.580150385970597, 105.42621877691248, 126.77282007447965, 0.8453102499999998, 170.0, 728, 172242, 239, 7.796442400000046
240, 21.515445331086312, 105.42662449451643, 126.81863514969989, 0.8448165999999999, 65.0, 369, 172611, 240, 3.9055916000000934
241, 16.2294383279145, 105.36595714966764, 126.71029652775945, 0.8444174500000001, 110.0, 518, 173129, 241, 5.564730199999985
242, 15.336296942137709, 105.4114077018969, 126.7650976007635, 0.8439616000000001, 85.0, 495, 173624, 242, 5.354664500000013
243, 14.111688309944093, 105.40502729980284, 126.74603224017733, 0.84314575, 350.0, 1318, 174942, 243, 14.04890499999999
244, 18.002655997872353, 105.43295481235167, 126.91148674638966, 0.8422682499999996, 90.0, 632, 175574, 244, 6.521278300000063
245, 20.66216500968619, 105.33500647586182, 126.73831685163739, 0.8414645499999998, 410.0, 1154, 176728, 245, 12.253593300000034
246, 13.863958050820337, 105.39956660039459, 126.81686319373695, 0.8406018999999998, 150.0, 763, 177491, 246, 8.223851700000068
247, 17.75993991846633, 105.5722378529002, 126.99036330211011, 0.8400097000000002, 35.0, 553, 178044, 247, 6.107912499999998
248, 19.13946165627038, 105.356678258289, 126.84332468292929, 0.8394440499999996, 110.0, 704, 178748, 248, 7.726578500000073
249, 16.70232548373653, 105.44544134446969, 126.8461851486223, 0.8387217999999995, 230.0, 901, 179649, 249, 9.435727400000019
250, 17.965933459231778, 105.88607374602068, 127.3266562451246, 0.8378713000000001, 190.0, 989, 180638, 250, 10.319313800000032
251, 18.075526826601717, 106.03336446113441, 127.57215938254645, 0.8370703000000002, 125.0, 791, 181429, 251, 8.318616599999928
252, 14.340793034322159, 106.16069398900514, 127.67886777077952, 0.8363795499999992, 180.0, 744, 182173, 252, 8.177841400000034
253, 19.283285533161205, 106.21395726089644, 127.79067644106796, 0.8358382000000001, 160.0, 459, 182632, 253, 5.043677200000047
254, 12.791540535918454, 105.91036205243945, 127.27929750600255, 0.8354521, 155.0, 399, 183031, 254, 4.364233500000182
255, 15.636709508183715, 106.02903439162614, 127.48932911513688, 0.8349953499999998, 130.0, 616, 183647, 255, 6.531386199999815
256, 12.133906885419252, 106.17861769334326, 127.6619378935616, 0.83452735, 50.0, 424, 184071, 256, 4.698873099999901
257, 17.003817839328857, 106.1788839452407, 127.78490090370178, 0.8340917499999999, 120.0, 544, 184615, 257, 5.838209699999879
258, 15.942015266877238, 106.0842441201284, 127.62565693775369, 0.833121999999999, 625.0, 1611, 186226, 258, 17.3855966000001
259, 17.228421891502208, 106.20246272873679, 127.79232802306618, 0.8319142000000003, 245.0, 1073, 187299, 259, 11.825491400000146
260, 14.562859295596715, 106.05240419326728, 127.51694503910883, 0.8310519999999997, 270.0, 843, 188142, 260, 9.372569300000123
261, 14.585997393311457, 106.09644539411678, 127.57689759897632, 0.8303630500000001, 150.0, 688, 188830, 261, 7.563356300000123
262, 15.12598263321908, 106.1360379668282, 127.76458022665344, 0.8297659, 170.0, 639, 189469, 262, 6.967557299999953
263, 13.809615811697379, 105.79653919104373, 127.2946603107715, 0.8291516500000006, 140.0, 726, 190195, 263, 8.10831230000008
264, 17.050923665911853, 105.31730828199558, 126.78130188901982, 0.8284491999999999, 515.0, 835, 191030, 264, 9.398380199999792
265, 15.544296116786015, 105.23109663544093, 126.54778972321733, 0.8278983999999999, 85.0, 389, 191419, 265, 4.3563722000001235
266, 13.165682137105179, 105.19900493710816, 126.5687761084288, 0.827434, 210.0, 643, 192062, 266, 7.312677499999836
267, 11.784823618489776, 105.32357919816491, 126.72716655776941, 0.8269569999999997, 65.0, 417, 192479, 267, 4.694021799999973
268, 15.83644902885531, 105.29347269707927, 126.72421992102335, 0.8264404, 230.0, 731, 193210, 268, 8.28730570000016
269, 14.140799573863426, 105.17407481495927, 126.50183466469369, 0.8259269500000003, 65.0, 410, 193620, 269, 4.527665399999933
270, 13.877103031778148, 105.28918467056735, 126.64763567168829, 0.8253999999999996, 130.0, 761, 194381, 270, 8.624164699999938
271, 12.888999986797572, 105.15268934249877, 126.43404457092285, 0.8248775500000002, 80.0, 400, 194781, 271, 4.55312129999993
272, 13.564153527776247, 105.17719028723286, 126.55294745309013, 0.8244644500000002, 140.0, 518, 195299, 272, 5.882573699999966
273, 14.180161440234526, 105.36833374915547, 126.78583907616414, 0.8238619, 230.0, 821, 196120, 273, 9.230570799999896
274, 16.765631532203294, 105.33196020068121, 126.70650787726136, 0.8231239, 125.0, 819, 196939, 274, 9.257128899999998
275, 13.645302325729926, 105.35904881619145, 126.74537599645176, 0.8225343999999997, 15.0, 491, 197430, 275, 5.631959499999994
276, 12.598203119793128, 105.24552157901982, 126.61430266460133, 0.8219048499999998, 140.0, 908, 198338, 276, 10.41959780000002
277, 16.163749394615895, 105.41733477994526, 126.92044106229017, 0.8212752999999999, 125.0, 491, 198829, 277, 5.547670800000105
278, 12.177730765825833, 105.18297049005498, 126.4649068087683, 0.8207812000000004, 105.0, 607, 199436, 278, 6.9294700000000375
279, 15.345223122081062, 105.31389082407827, 126.75601704033863, 0.8202484000000002, 50.0, 577, 200013, 279, 6.6694744000001265
280, 15.512271686829994, 104.84890133107203, 126.23741482465695, 0.8197605999999996, 120.0, 507, 200520, 280, 5.734906500000079
281, 19.806593409643092, 104.79237370655454, 126.21407599284731, 0.8193236500000004, 80.0, 464, 200984, 281, 5.286542000000054
282, 16.297523474612202, 104.9126545393548, 126.15245732590725, 0.8189164000000002, 30.0, 441, 201425, 282, 5.092948999999862
283, 10.77962305556666, 104.72669048540988, 125.94006392444193, 0.8184956499999998, 65.0, 494, 201919, 283, 5.828947599999992
284, 16.659561894895873, 104.69168902828486, 126.02983624311898, 0.8178395500000003, 290.0, 964, 202883, 284, 11.135092299999997
285, 11.57708257650866, 104.64042202847675, 125.78470598239343, 0.817174, 20.0, 515, 203398, 285, 5.937889399999904
286, 15.622863347227769, 104.75646804532911, 126.04482320362554, 0.8166195999999996, 120.0, 717, 204115, 286, 8.327044900000146
287, 9.961597787755206, 104.77706578819497, 126.01107844380499, 0.8160652, 135.0, 515, 204630, 287, 6.087132799999836
288, 14.023377857435769, 104.7872407431631, 126.07638010590024, 0.8153807500000001, 295.0, 1006, 205636, 288, 11.621809900000017
289, 7.963190194529368, 104.77753342320129, 125.97328043439379, 0.8145982000000002, 210.0, 733, 206369, 289, 8.59033999999997
290, 14.01901754909205, 104.71233601539497, 126.0341247133831, 0.8140581999999996, 100.0, 467, 206836, 290, 5.474713000000065
291, 15.45774680337906, 104.77134338378906, 126.0658523071289, 0.8135668000000004, 115.0, 625, 207461, 291, 7.247894299999871
292, 13.49426055774211, 104.77270908082801, 126.06605288410036, 0.8130024999999999, 105.0, 629, 208090, 292, 7.413231600000017
293, 15.26831275736, 104.67901594498578, 125.9387781386282, 0.8123522500000003, 150.0, 816, 208906, 293, 9.503045099999781
294, 11.909844908668605, 104.57184891916734, 125.71096803086975, 0.81172675, 75.0, 574, 209480, 294, 6.724127300000191
295, 13.518739552483526, 104.60851561818336, 125.89326216183167, 0.8112065499999995, 60.0, 582, 210062, 295, 6.8581733000000895
296, 12.492671591853632, 103.90160205433669, 124.98971473175345, 0.8107129000000002, 90.0, 515, 210577, 296, 5.9283691000000545
297, 12.322349609160055, 104.01880371050828, 125.13708251438061, 0.8101612000000001, 95.0, 711, 211288, 297, 8.321705500000007
298, 12.80478708803914, 103.84711435198611, 124.91141036920672, 0.8095321000000003, 155.0, 687, 211975, 298, 8.05580810000015
299, 11.440643180808621, 103.95221118910686, 125.0934830364557, 0.8086968999999998, 365.0, 1169, 213144, 299, 13.64268530000004
300, 10.763708417356941, 103.92647663175751, 124.97175135637194, 0.8079971500000002, 85.0, 386, 213530, 300, 4.4783052000000225
301, 10.03979080990206, 103.89486989050008, 124.96247824219158, 0.8075543500000001, 120.0, 598, 214128, 301, 7.168711799999983
302, 11.215474648363127, 103.81783222665592, 124.95446419229313, 0.8071088499999997, 30.0, 392, 214520, 302, 4.617381499999965
303, 8.962017326174221, 104.05421866565199, 125.1480356608151, 0.8066980000000002, 120.0, 521, 215041, 303, 6.292899600000055
304, 11.928226907154093, 103.66894089548211, 124.65504640796189, 0.8061985000000003, 75.0, 589, 215630, 304, 6.748603600000024
305, 16.32895757554441, 104.04512119293213, 125.38639792617487, 0.8057570499999998, 85.0, 392, 216022, 305, 4.7287926000001335
306, 13.203792977684293, 103.92841510342973, 125.04443721672071, 0.8050613499999993, 240.0, 1154, 217176, 306, 13.812374500000033
307, 12.964643881450431, 103.82442190525089, 124.92035877927859, 0.8041815999999999, 105.0, 801, 217977, 307, 9.480334299999868
308, 13.151503285840011, 103.87342639710761, 124.98662691610559, 0.8035867, 60.0, 521, 218498, 308, 6.082983099999865
309, 15.142677766910152, 103.80627864052953, 124.99229557014046, 0.8031312999999999, 45.0, 491, 218989, 309, 5.834970299999895
310, 9.612604099628687, 103.75844232610503, 124.71978756034869, 0.8027262999999999, 55.0, 409, 219398, 310, 4.842999899999995
311, 11.851584361608213, 103.72601975661058, 124.73833876389723, 0.8022790000000003, 80.0, 585, 219983, 311, 7.115923600000087
312, 10.080195172456653, 103.96795820999753, 125.04894266326272, 0.8017335999999998, 155.0, 627, 220610, 312, 7.618256199999905
313, 13.886496731563177, 104.08468694073915, 125.28994774925334, 0.8011504000000002, 210.0, 669, 221279, 313, 8.068189399999937
314, 13.26764471943562, 104.10053032232086, 125.26659349582494, 0.8005510000000001, 135.0, 663, 221942, 314, 8.036496700000043
315, 9.476529389771109, 104.10285944866045, 125.18446143871637, 0.7998980499999992, 180.0, 788, 222730, 315, 9.597267600000123
316, 12.33341809047593, 104.09198682461566, 125.24666067201491, 0.7991587000000001, 200.0, 855, 223585, 316, 10.368085500000007
317, 10.21158818425359, 104.14155571543571, 125.2943670795691, 0.7981912, 215.0, 1295, 224880, 317, 15.733783799999856
318, 12.198506667286404, 104.12336486627248, 125.32386338415225, 0.7973906499999996, 100.0, 484, 225364, 318, 5.820981999999958
319, 8.777132226688218, 104.02242989664379, 125.0493887337474, 0.7968447999999999, 210.0, 729, 226093, 319, 8.96360709999999
320, 11.437898662340125, 104.00892796440385, 125.12361546475144, 0.7961216500000006, 175.0, 878, 226971, 320, 10.86475879999989
321, 9.244650816838993, 103.9164245254115, 124.97781479986091, 0.7954529500000003, 135.0, 608, 227579, 321, 7.502554000000146
322, 11.436873556765098, 104.04773272437978, 125.24121985266773, 0.7946960499999999, 300.0, 1074, 228653, 322, 13.245208300000058
323, 11.455378720869652, 104.09535745244041, 125.26016807556152, 0.79363855, 390.0, 1276, 229929, 323, 15.78424959999984
324, 13.1960455523725, 103.30393967172975, 124.31594987013608, 0.7926922000000003, 210.0, 827, 230756, 324, 10.23403189999999
325, 15.649689916591306, 103.4015659818072, 124.52750930308301, 0.7921045000000001, 100.0, 479, 231235, 325, 5.926551600000039
326, 12.433350300634062, 103.27730107823491, 124.21421664239352, 0.7915770999999996, 210.0, 693, 231928, 326, 8.447496499999943
327, 11.401860595542313, 103.22839871258803, 124.09030269569075, 0.7909777000000003, 110.0, 639, 232567, 327, 8.07542239999998
328, 12.7037718816177, 103.29441677769528, 124.24816078475759, 0.7904057499999998, 130.0, 632, 233199, 328, 7.965701500000023
329, 9.616602597758174, 103.39070013591221, 124.3523580233256, 0.7898189500000005, 135.0, 672, 233871, 329, 8.463928899999928
330, 6.633911263068779, 103.46112702823746, 124.35342364491898, 0.7892434000000002, 70.0, 607, 234478, 330, 7.60877349999987
331, 11.180393857822718, 103.46312532178993, 124.59066741855916, 0.7888131999999998, 45.0, 349, 234827, 331, 4.5017725000000155
332, 9.134277329420495, 103.36536981138732, 124.41448217523677, 0.7884802000000001, 125.0, 391, 235218, 332, 5.032363499999974
333, 8.081516676405979, 103.4681420431263, 124.38899976251409, 0.7878956500000001, 255.0, 908, 236126, 333, 11.493705999999975
334, 11.330801278104902, 103.48558610690111, 124.5482688316932, 0.7872705999999997, 55.0, 481, 236607, 334, 6.059778099999903
335, 10.464660512836199, 103.23706349589284, 124.17501973749098, 0.7868737, 30.0, 401, 237008, 335, 5.098209300000008
336, 13.406674162357815, 103.31858207879152, 124.34315988888777, 0.7865182000000003, 35.0, 389, 237397, 336, 4.993520600000011
337, 7.40888699371382, 103.39474650791713, 124.30307243965767, 0.7861100499999998, 80.0, 518, 237915, 337, 6.566324699999996
338, 9.668990470593869, 103.41601890691832, 124.34742875338932, 0.7855547500000001, 200.0, 716, 238631, 338, 9.026929599999903
339, 9.254215374903042, 103.45986425681193, 124.55635083307985, 0.7850404000000001, 60.0, 427, 239058, 339, 5.446359099999881
340, 7.939981331491572, 103.34519805256119, 124.34018606202216, 0.7846376499999996, 130.0, 468, 239526, 340, 5.993962599999804
341, 9.141216138642058, 103.34538837661091, 124.34188404572316, 0.7841638000000004, 140.0, 585, 240111, 341, 7.25235930000008
342, 14.572414438173707, 102.91955716269356, 123.88858185495648, 0.7836989500000001, 90.0, 448, 240559, 342, 5.717903299999989
343, 10.853063418725727, 103.15981801815835, 124.09209941466504, 0.7832511999999995, 20.0, 547, 241106, 343, 7.055936299999985
344, 10.648978546616577, 102.81883196603684, 123.66121227400643, 0.7827026500000004, 155.0, 672, 241778, 344, 8.638572999999951
345, 12.815578814402995, 103.00107279621747, 123.97279451124538, 0.7820614000000002, 180.0, 753, 242531, 345, 9.644048600000133
346, 10.132580062545882, 103.01768739852437, 123.83694633062632, 0.7813558000000003, 360.0, 815, 243346, 346, 10.379929100000027
347, 10.531075876171343, 102.84281127074054, 123.77211677337361, 0.7807483000000001, 105.0, 535, 243881, 347, 6.823580300000003
348, 10.436029216437209, 102.99718824681608, 123.90384595207927, 0.779919849999999, 425.0, 1306, 245187, 348, 16.754426600000215
349, 11.52620846257921, 102.94911901909008, 123.87147418908906, 0.7790756499999997, 120.0, 570, 245757, 349, 7.461523400000033
350, 13.255049333648277, 102.98684985821063, 123.91031606254275, 0.7784798500000004, 380.0, 754, 246511, 350, 9.752832800000078
351, 10.546405110276487, 102.89799332504637, 123.78292534568094, 0.7777643499999998, 230.0, 836, 247347, 351, 10.650326999999834
352, 10.7768075976266, 102.89821191812399, 123.83034678968616, 0.7771447000000002, 60.0, 541, 247888, 352, 7.138952499999959
353, 12.967703961047464, 102.93090361425679, 123.90562185453942, 0.7764733000000006, 275.0, 951, 248839, 353, 12.518864599999915
354, 9.519915337652966, 102.90940757361248, 123.72636159261067, 0.7757902000000002, 45.0, 567, 249406, 354, 7.3723126999998385
355, 11.970862504129936, 102.66989535181551, 123.57890649438707, 0.7752007000000004, 165.0, 743, 250149, 355, 9.769338599999855
356, 11.215651370467633, 101.98516890758604, 122.72679253825991, 0.7746377499999997, 30.0, 508, 250657, 356, 6.630149900000106
357, 10.037718581510525, 101.84362785488952, 122.48126568513759, 0.7739501499999998, 320.0, 1020, 251677, 357, 13.544753700000001
358, 11.538528534414645, 101.81940145931915, 122.48873185982227, 0.7731590499999997, 105.0, 738, 252415, 358, 9.588750699999991
359, 12.089924321060739, 101.82478952040474, 122.55100231435155, 0.7725349, 80.0, 649, 253064, 359, 8.57883629999992
360, 9.09014397554634, 101.7810946436371, 122.44130925689568, 0.7720295499999997, 15.0, 474, 253538, 360, 6.358800199999905
361, 9.928225780837238, 101.78190740346909, 122.42086991071702, 0.7715282500000002, 110.0, 640, 254178, 361, 8.487983600000007
362, 11.604595411353849, 101.8534182163185, 122.63742142794842, 0.7709518000000002, 180.0, 641, 254819, 362, 8.503934999999956
363, 11.102347693350191, 101.89252094178353, 122.60373632944444, 0.7700180500000001, 210.0, 1434, 256253, 363, 19.109101599999804
364, 8.7265041387811, 101.78747618798496, 122.40772663557611, 0.7690419999999997, 180.0, 735, 256988, 364, 9.692748000000165
365, 10.387473821332774, 101.81899454175812, 122.50868555442574, 0.7684493500000001, 130.0, 582, 257570, 365, 7.83441700000003
366, 9.369779547343828, 101.73453990050724, 122.35729346956525, 0.76798585, 60.0, 448, 258018, 366, 5.970258699999931
367, 10.67609855572703, 101.72694198034142, 122.38603226856519, 0.76761685, 35.0, 372, 258390, 367, 4.789961700000049
368, 12.375875696288265, 101.92601494136045, 122.73487655038458, 0.7672096000000003, 90.0, 533, 258923, 368, 7.218176100000164
369, 8.187337404794624, 101.74965769542854, 122.33507893508269, 0.7667236000000001, 135.0, 547, 259470, 369, 7.363254599999891
370, 10.48235140872095, 101.85839840763936, 122.58967203636692, 0.7662474999999995, 90.0, 511, 259981, 370, 6.910812299999861
371, 11.80752434388854, 102.3459605791254, 123.20206249988964, 0.7657687000000003, 70.0, 553, 260534, 371, 7.437593800000059
372, 11.301226174039595, 102.13717811837847, 122.90882891834443, 0.7652759499999999, 25.0, 542, 261076, 372, 7.4039768000000095
373, 12.412565901929291, 102.12906991015272, 122.91530213889662, 0.7647827499999996, 115.0, 554, 261630, 373, 7.578856500000029
374, 12.075753744492548, 102.1991248531196, 122.99080203689692, 0.7642976500000002, 110.0, 524, 262154, 374, 7.027502999999797
375, 10.578526613536297, 102.08183744289731, 122.82932071557781, 0.7637266, 210.0, 745, 262899, 375, 9.979538300000058
376, 7.53089818018823, 102.00563855460994, 122.64873168481648, 0.7630655500000001, 155.0, 724, 263623, 376, 9.80050899999992
377, 10.33922939960139, 102.00834290782038, 122.71909075030676, 0.7624274500000001, 170.0, 694, 264317, 377, 9.263594999999896
378, 9.262046362655571, 102.04924170809439, 122.7806677039401, 0.7618892499999997, 75.0, 502, 264819, 378, 6.835004100000106
379, 12.335619251797931, 102.30709000040329, 123.13947294787445, 0.76141, 145.0, 563, 265382, 379, 7.740864600000123
380, 12.900608926356261, 102.01131050705064, 122.72136298646318, 0.7608393999999997, 125.0, 705, 266087, 380, 9.638544099999763
381, 10.754610450896951, 102.08856956845239, 122.84747923593673, 0.7602386500000003, 155.0, 630, 266717, 381, 8.456656600000315
382, 12.544172170478337, 102.1505928418913, 122.92668701509086, 0.7595479000000004, 215.0, 905, 267622, 382, 12.431878700000198
383, 8.095572961024448, 102.1254272164842, 122.80440944656826, 0.7587928000000004, 185.0, 773, 268395, 383, 10.641281799999888
384, 9.4219137126755, 102.07266979543571, 122.7684199341342, 0.7580237499999998, 520.0, 936, 269331, 384, 12.96294080000007
385, 11.023086392834445, 102.01534392951818, 122.7538814080252, 0.7570665999999998, 240.0, 1191, 270522, 385, 16.36215089999996
386, 13.189757522845184, 102.23174022525231, 123.07321057483678, 0.7561513000000001, 210.0, 843, 271365, 386, 11.710624299999836
387, 8.73802219018524, 102.29033105167342, 123.03523600542987, 0.7554803500000001, 120.0, 648, 272013, 387, 8.941059499999938
388, 10.453233222989642, 102.2604696962255, 123.1143305851863, 0.7549605999999996, 40.0, 507, 272520, 388, 7.083021199999621
389, 11.429273926219794, 102.3893304536509, 123.23138368961423, 0.7544228500000001, 105.0, 688, 273208, 389, 9.661177599999974
390, 12.213864866857982, 102.14551582221178, 122.99288575094633, 0.7538153499999998, 145.0, 662, 273870, 390, 9.329990900000212
391, 10.49605077807583, 102.2766804026134, 123.01491909881136, 0.7532159500000004, 185.0, 670, 274540, 391, 9.363279199999852
392, 15.07713263063896, 102.36860633167794, 123.22488774245348, 0.7526377, 75.0, 615, 275155, 392, 8.614036099999794
393, 9.776369109275802, 102.14469362111025, 122.80137542259465, 0.7516818999999989, 250.0, 1509, 276664, 393, 21.152794200000244
394, 11.265923623238976, 102.43774991059423, 123.25322748308805, 0.7508237499999996, 80.0, 398, 277062, 394, 5.696142000000236
395, 10.367454803334585, 102.25176803448511, 122.96247996105942, 0.7503022000000004, 205.0, 761, 277823, 395, 10.720713700000033
396, 9.932822536223659, 102.2925682831986, 123.02167235904923, 0.7496677, 185.0, 649, 278472, 396, 9.273589899999934
397, 10.151166314154528, 102.27164925945534, 123.00861391027024, 0.7490151999999998, 165.0, 801, 279273, 397, 11.386039500000152
398, 11.529564163967827, 101.75974588965768, 122.41750774323376, 0.7480841500000007, 290.0, 1268, 280541, 398, 17.795831500000077
399, 11.58682519445043, 101.2146900133428, 121.82308856968072, 0.7470801999999999, 180.0, 963, 281504, 399, 13.363331800000196
400, 12.49847038295842, 101.12250504604606, 121.66931804095128, 0.7463565999999998, 110.0, 645, 282149, 400, 9.050486099999944
401, 9.290108038603893, 101.14234469361101, 121.6913119637893, 0.7456996000000004, 175.0, 815, 282964, 401, 11.694820600000185
402, 10.573703334735075, 101.15954472010668, 121.67057159947531, 0.7450443999999997, 155.0, 641, 283605, 402, 9.191159599999992
403, 12.496029659080984, 101.16518945338733, 121.72086850141727, 0.7444418500000002, 110.0, 698, 284303, 403, 9.961405000000013
404, 10.598070675681592, 101.26489906453908, 121.88070442971218, 0.7438874499999998, 45.0, 534, 284837, 404, 7.52984349999997
405, 8.93456275138674, 100.98577587272547, 121.46956373770026, 0.7434694, 20.0, 395, 285232, 405, 5.758614100000159
406, 12.798869428734912, 101.12423181266428, 121.70563153418425, 0.7430509, 145.0, 535, 285767, 406, 7.695075600000109
407, 10.908576001526697, 101.30392446981077, 121.88275343835413, 0.7423561000000002, 295.0, 1009, 286776, 407, 14.514269799999965
408, 11.359623851108763, 101.13357354619126, 121.66620292269144, 0.7415974000000001, 155.0, 677, 287453, 408, 9.788266800000201
409, 10.223850818498393, 101.17113233102032, 121.6622637639647, 0.7409858499999995, 135.0, 682, 288135, 409, 9.881517300000269
410, 10.579346578928732, 101.18536447270125, 121.6784414710354, 0.7403860000000002, 80.0, 651, 288786, 410, 9.2191985999998
411, 12.078469146645084, 101.3024368378835, 121.89605731431074, 0.7397227000000001, 255.0, 823, 289609, 411, 11.984598399999868
412, 12.623765186462908, 100.84704441525624, 121.40432846001919, 0.7390468000000003, 20.0, 679, 290288, 412, 10.020999500000016
413, 7.758137506331159, 100.35823479698215, 120.72785795619914, 0.7383290499999998, 445.0, 916, 291204, 413, 13.297171100000014
414, 10.069974626604976, 100.4685223752802, 120.83329537781802, 0.7376000500000004, 180.0, 704, 291908, 414, 10.363602299999911
415, 7.883799216968177, 100.26346155841354, 120.59612178364355, 0.7369893999999999, 90.0, 653, 292561, 415, 9.573686200000338
416, 13.691148467973811, 100.52509716973789, 121.02027878323615, 0.7364161000000004, 120.0, 621, 293182, 416, 9.13769339999999
417, 9.404155537932938, 100.32469470278203, 120.71262723049352, 0.7357465000000002, 210.0, 867, 294049, 417, 12.805861299999833
418, 13.280825021855362, 100.52922817142418, 121.0042216698532, 0.7351804, 30.0, 391, 294440, 418, 5.836333900000227
419, 8.432991945083456, 100.41013570163072, 120.7886302243054, 0.7346610999999998, 305.0, 763, 295203, 419, 11.289564199999859
420, 12.426814123310827, 100.3606624454647, 120.76618298617277, 0.7339712499999996, 150.0, 770, 295973, 420, 11.479264999999941
421, 9.363024484452367, 100.27730885875869, 120.57788241859573, 0.7332746500000002, 320.0, 778, 296751, 421, 11.45872829999962
422, 8.817425069713446, 100.33601051412856, 120.64899010797862, 0.7326324999999997, 120.0, 649, 297400, 422, 9.713928699999997
423, 10.465566562747316, 100.25355903687806, 120.62336857371736, 0.7319548, 215.0, 857, 298257, 423, 12.64406340000005
424, 11.350141480326652, 100.37774481201171, 120.83725769042968, 0.7313441499999999, 25.0, 500, 298757, 424, 7.540911099999903
425, 9.29117467839635, 100.18103051411241, 120.50409043850583, 0.7308338500000002, 110.0, 634, 299391, 425, 9.40937040000017
426, 9.67649967124842, 100.36383057725888, 120.7650049787497, 0.7302322000000002, 210.0, 703, 300094, 426, 10.539627900000141
427, 8.893409439763486, 100.69221822473386, 121.07139898135962, 0.7296440499999994, 195.0, 604, 300698, 427, 8.996374899999864
428, 11.63207793060826, 100.81449678552295, 121.31504120614365, 0.7291499500000002, 105.0, 494, 301192, 428, 7.510645599999862
429, 11.382356006140803, 100.73336572940944, 121.16968906092711, 0.7286063499999998, 155.0, 714, 301906, 429, 10.627140099999906
430, 10.138035489281636, 100.64991293793516, 121.11921662905468, 0.7280245000000003, 140.0, 579, 302485, 430, 8.737662699999873
431, 10.365048369097893, 100.81454874281718, 121.35586679426706, 0.7274143, 185.0, 777, 303262, 431, 11.939316099999814
432, 9.486708250496887, 100.80047220154736, 121.33057155435209, 0.7267685499999994, 155.0, 658, 303920, 432, 9.888412100000096
433, 11.719024338761079, 100.85862290920565, 121.38564492907777, 0.7262101000000001, 155.0, 583, 304503, 433, 8.854243600000245
434, 9.82673992112114, 100.85519365073716, 121.34763144742959, 0.7255819, 170.0, 813, 305316, 434, 12.296789999999874
435, 9.931942241414198, 100.76338359287807, 121.23199729313926, 0.7249892500000001, 80.0, 504, 305820, 435, 7.771856800000023
436, 8.928987472856006, 100.70629191634679, 121.07454461075685, 0.72448975, 30.0, 606, 306426, 436, 9.2969578000002
437, 8.543757647777406, 100.7704827602093, 121.25051448895381, 0.7240298499999999, 115.0, 416, 306842, 437, 6.198707699999886
438, 8.824247409339332, 100.72578064152069, 121.16323411625586, 0.7234759, 110.0, 815, 307657, 438, 12.533278299999893
439, 13.02200104178609, 100.75606343862172, 121.31981448611698, 0.7226929000000001, 365.0, 925, 308582, 439, 13.888873299999887
440, 11.481397324508894, 100.7380099446817, 121.2196193397737, 0.72173395, 520.0, 1206, 309788, 440, 18.436234599999807
441, 9.486645036073643, 99.887536311747, 120.13404817516006, 0.7207961499999999, 210.0, 878, 310666, 441, 13.359043999999813
442, 10.116914239877657, 99.50070298955926, 119.7506167763158, 0.7200846999999998, 185.0, 703, 311369, 442, 11.080762999999934
443, 9.61236104714243, 99.59478395505059, 119.76878964990601, 0.7191698500000003, 285.0, 1330, 312699, 443, 20.544682000000194
444, 11.568324254994312, 99.62751189593611, 119.8419985442326, 0.7181537499999993, 210.0, 928, 313627, 444, 14.474357800000234
445, 9.003578102048822, 99.69631816384322, 119.96605995315278, 0.71743555, 135.0, 668, 314295, 445, 10.45886530000007
446, 8.025742549299421, 99.6077769931343, 119.84683821266263, 0.7167880000000002, 375.0, 771, 315066, 446, 12.160077900000033
447, 9.927657630799139, 99.50833467379084, 119.7334142019838, 0.7161287500000002, 120.0, 694, 315760, 447, 10.746667800000068
448, 9.28377110366501, 99.67105378677596, 119.8978032781117, 0.7155752499999996, 80.0, 536, 316296, 448, 8.450525800000378
449, 8.055619106837549, 99.52987421751023, 119.72509990930557, 0.7150460500000001, 185.0, 640, 316936, 449, 9.908109500000137
450, 9.581619840025777, 99.530380512106, 119.72509612558777, 0.7143274000000002, 210.0, 957, 317893, 450, 15.085052399999768
451, 11.455314822211294, 99.56726357072054, 119.83798953192029, 0.7136722000000001, 30.0, 499, 318392, 451, 7.893886100000145
452, 8.325863710133468, 99.59081204358269, 119.75683793460621, 0.71314165, 120.0, 680, 319072, 452, 10.805408400000033
453, 7.446276551534629, 99.5879385743964, 119.76309538779785, 0.7126191999999999, 90.0, 481, 319553, 453, 7.625385899999856
454, 6.761386279765583, 99.50792651382719, 119.64564052125577, 0.7122258999999997, 110.0, 393, 319946, 454, 6.2233305999998265
455, 9.2466023029634, 99.15533240201911, 119.35591160230516, 0.711802, 60.0, 549, 320495, 455, 8.715173699999923
456, 11.764381000726688, 99.11567522374595, 119.1777941075767, 0.7111859500000001, 200.0, 820, 321315, 456, 13.100504400000318
457, 9.176500748420654, 99.02638401386709, 119.08046330131499, 0.7103723499999999, 185.0, 988, 322303, 457, 15.626539200000025
458, 11.197038972094738, 99.13585059736027, 119.27971446713921, 0.7096055500000005, 245.0, 716, 323019, 458, 11.428306399999656
459, 11.577792718718872, 99.01793697165706, 119.19575337001255, 0.7090502500000001, 120.0, 518, 323537, 459, 8.164694500000223
460, 10.56882029734552, 98.95009463050148, 118.98664536909624, 0.70842115, 275.0, 880, 324417, 460, 14.152677100000346
461, 11.053073248224395, 99.0484926506663, 119.19200831509093, 0.7078370500000003, 55.0, 418, 324835, 461, 6.597684100000151
462, 7.557322074313045, 98.87901121994545, 118.87692564748713, 0.7074140499999999, 35.0, 522, 325357, 462, 8.42770580000024
463, 9.183944939069992, 98.94152319081232, 119.01682129377929, 0.706888, 115.0, 647, 326004, 463, 10.570015599999806
464, 10.265745616571646, 99.25106094475079, 119.31576648989417, 0.7064173000000001, 30.0, 399, 326403, 464, 6.431193500000063
465, 10.969461098989633, 99.06185945404098, 119.1746110209178, 0.7059402999999996, 150.0, 661, 327064, 465, 10.731218399999761
466, 8.93707994728441, 99.0328307353275, 119.09352006151083, 0.7054511500000002, 65.0, 426, 327490, 466, 6.92860010000004
467, 12.314579270530546, 99.08442273664703, 119.25668077605764, 0.7050713500000002, 65.0, 418, 327908, 467, 6.8323270999999295
468, 8.65269282854993, 99.06302009979424, 119.20005979887094, 0.7044161499999996, 315.0, 1038, 328946, 468, 16.793276500000047
469, 5.898430924446552, 99.19165314513367, 119.27780886563387, 0.7037757999999998, 80.0, 385, 329331, 469, 6.309248900000057
470, 6.7805447765281865, 98.97843836902946, 119.0304511449383, 0.7033456, 55.0, 571, 329902, 470, 9.377133699999831
471, 9.978711771242546, 98.34517825482234, 118.26878945975122, 0.7027471000000002, 160.0, 759, 330661, 471, 12.123905899999954
472, 7.901015679227229, 98.22550745693694, 118.11989775327879, 0.7021166500000002, 125.0, 642, 331303, 472, 10.52498259999993
473, 9.658704096817774, 98.28428067294034, 118.26048813496739, 0.7015554999999996, 185.0, 605, 331908, 473, 9.793540099999973
474, 8.716426659625332, 98.07795664152006, 117.86672244019887, 0.7009948000000001, 120.0, 641, 332549, 474, 10.612774400000035
475, 10.826279000994342, 98.27085521544292, 118.25208486480155, 0.7003378, 180.0, 819, 333368, 475, 13.468148799999653
476, 9.133286783768797, 98.21305538182781, 118.20800351633609, 0.6996448000000004, 320.0, 721, 334089, 476, 11.815280799999982
477, 8.162906034278498, 98.11912983475641, 117.99374777062239, 0.6988293999999995, 515.0, 1091, 335180, 477, 17.758334099999956
478, 11.315489766175066, 98.15600021658182, 118.18577996251325, 0.6981759999999999, 60.0, 361, 335541, 478, 6.026575699999739
479, 10.422815957939289, 98.12178775964193, 118.02829237805297, 0.6974699500000006, 220.0, 1208, 336749, 479, 19.849103199999718
480, 12.54136870282811, 98.27654504156732, 118.17903838714996, 0.6967530999999999, 45.0, 385, 337134, 480, 6.351451999999881
481, 8.90721290614951, 98.27157712909097, 118.1626471771053, 0.6963597999999999, 80.0, 489, 337623, 481, 8.14991340000006
482, 7.048860516833014, 98.20729668552138, 118.07086607538552, 0.6959156499999998, 80.0, 498, 338121, 482, 8.264435199999753
483, 10.653763231238555, 98.27874882751591, 118.28370392099488, 0.6952586499999999, 190.0, 962, 339083, 483, 15.992063400000006
484, 8.207694839343937, 98.23578851054035, 118.18406248718422, 0.6944828499999995, 355.0, 762, 339845, 484, 12.546987400000035
485, 10.609378994567187, 96.78203142721821, 116.42076616963064, 0.6939113499999999, 110.0, 508, 340353, 485, 8.531819099999666
486, 11.562674381843122, 95.928772393791, 115.44130668591167, 0.6933321999999997, 195.0, 779, 341132, 486, 12.781019699999888
487, 12.19732446288997, 96.02024692493481, 115.55637929727743, 0.6928178500000001, 75.0, 364, 341496, 487, 6.093836999999894
488, 9.431564228623422, 95.86430760740323, 115.26378489875309, 0.6923003500000003, 340.0, 786, 342282, 488, 12.922625100000005
489, 13.575701801127263, 95.97749189312539, 115.54667955034235, 0.6917864499999997, 75.0, 356, 342638, 489, 5.918742600000314
490, 8.862966399246115, 96.0401045481364, 115.60171694871856, 0.6914048500000001, 80.0, 492, 343130, 490, 8.211829999999736
491, 9.09868586481586, 95.82899428893052, 115.21988565284357, 0.6908788000000001, 215.0, 677, 343807, 491, 11.31595950000019
492, 9.014740680690942, 95.93373558133148, 115.4126686828081, 0.6902645499999994, 210.0, 688, 344495, 492, 11.577647399999933
493, 6.355311182269361, 96.05747590959072, 115.53300642967224, 0.6897245499999999, 130.0, 512, 345007, 493, 8.602429200000188
494, 8.594073635501585, 95.77570028697953, 115.1189154721378, 0.6892538500000001, 80.0, 534, 345541, 494, 8.963964499999747
495, 7.395939158573746, 95.97248964309692, 115.47038274765015, 0.6888335499999999, 75.0, 400, 345941, 495, 6.57644879999998
496, 8.456893548934916, 95.9510431235384, 115.4339475324077, 0.6881792500000001, 230.0, 1054, 346995, 496, 17.70745510000006
497, 7.339315732262123, 95.97844933126575, 115.365676755103, 0.6875123499999998, 35.0, 428, 347423, 497, 7.076897599999938
498, 8.690019845093934, 95.91610371881198, 115.41525514632309, 0.6869723500000002, 180.0, 772, 348195, 498, 12.9504565000002
499, 10.99444041713831, 95.93984143552863, 115.41576590722109, 0.6862635999999999, 100.0, 803, 348998, 499, 13.433314800000062
500, 7.888554349179483, 95.91641031371222, 115.38046680556403, 0.6856430500000001, 85.0, 576, 349574, 500, 9.636896999999863
501, 11.198151679532016, 95.86461864958287, 115.34559900040388, 0.6851052999999999, 80.0, 619, 350193, 501, 10.315305300000091
502, 6.8357977692440555, 95.96521217758591, 115.40208467277321, 0.6845603499999997, 180.0, 592, 350785, 502, 9.944826000000376
503, 9.854266478733424, 95.90715060569651, 115.4433034094578, 0.6840190000000002, 125.0, 611, 351396, 503, 10.288142400000197
504, 8.199296947720153, 95.95669441899368, 115.4446419247497, 0.6833125000000001, 210.0, 959, 352355, 504, 15.999716000000262
505, 8.388522371031135, 95.91514960953896, 115.29188880408057, 0.6825123999999999, 210.0, 819, 353174, 505, 13.70377869999993
506, 10.606566708386355, 96.08836246159906, 115.5669220054658, 0.6818166999999995, 90.0, 727, 353901, 506, 12.348328199999742
507, 8.6849474187342, 95.92903341777584, 115.4211440605203, 0.68114215, 165.0, 772, 354673, 507, 12.900041299999884
508, 8.774316136461605, 95.9364158975419, 115.42786246448306, 0.6805260999999997, 45.0, 597, 355270, 508, 10.004659700000047
509, 10.261536429510713, 96.04735483292812, 115.58714926177544, 0.6798466000000003, 190.0, 913, 356183, 509, 15.310083300000315
510, 7.932656804607028, 95.96507866269066, 115.36353380475725, 0.6791994999999996, 75.0, 525, 356708, 510, 8.88749800000005
511, 9.39279757968534, 96.09723932268267, 115.60275982744015, 0.6785406999999998, 165.0, 939, 357647, 511, 15.682891099999779
512, 7.796271127236427, 95.94595430718094, 115.44216964283927, 0.6778985499999999, 55.0, 488, 358135, 512, 8.327781799999684
513, 10.835747573080413, 96.18628226463947, 115.71743568630393, 0.6774337000000001, 35.0, 545, 358680, 513, 9.168877399999928
514, 9.348988746069164, 96.02878537524346, 115.5394385886592, 0.67686625, 180.0, 716, 359396, 514, 12.051304499999787
515, 7.783695364016065, 95.2434659470222, 114.53585535258438, 0.6760881999999994, 135.0, 1013, 360409, 515, 17.07064219999984
516, 7.905789597491667, 94.14859630097024, 113.21696592421122, 0.6753754000000001, 25.0, 571, 360980, 516, 9.801803599999857
517, 8.506709325885723, 94.03951271475619, 113.12734244946186, 0.6749051499999995, 75.0, 474, 361454, 517, 7.990915800000039
518, 6.58853286225223, 94.00528199148242, 113.03624540012375, 0.6743584000000004, 135.0, 741, 362195, 518, 12.452878599999622
519, 7.7787908322246855, 94.07537306052656, 113.27787118026276, 0.6736788999999999, 285.0, 769, 362964, 519, 14.002433699999983
520, 9.849796773823961, 94.06684124335814, 113.15162352229773, 0.6730124500000003, 110.0, 712, 363676, 520, 13.115962500000023
521, 11.81355264611369, 94.26484555976336, 113.49963247609693, 0.6723050500000001, 205.0, 860, 364536, 521, 16.836264999999912
522, 9.139967655418095, 94.07539994039654, 113.16502777539164, 0.6716993500000003, 50.0, 486, 365022, 522, 9.180637500000103
523, 8.47837826878638, 94.13556304106841, 113.22053505562447, 0.6710644000000001, 245.0, 925, 365947, 523, 17.163810900000044
524, 7.402071070000267, 94.09756750574145, 113.18774918514846, 0.6702642999999999, 180.0, 853, 366800, 524, 14.769736300000204
525, 9.60314601316861, 94.05448487413479, 113.22507432115627, 0.66966535, 65.0, 478, 367278, 525, 8.182433400000264
526, 10.081708293844914, 94.09386080380143, 113.21772956848145, 0.6689282500000001, 350.0, 1160, 368438, 526, 19.506723299999976
527, 8.268598406708666, 94.1959101193911, 113.32202233896626, 0.6681290499999999, 75.0, 616, 369054, 527, 10.452043600000252
528, 8.641739741276583, 94.09462607586322, 113.17291954185472, 0.6675912999999998, 75.0, 579, 369633, 528, 9.807535599999937
529, 8.502930350304705, 93.38414215682565, 112.36992151278959, 0.6668227000000007, 505.0, 1129, 370762, 529, 19.02293490000011
530, 8.886146251719687, 92.99144203021156, 111.89624924275637, 0.6658565500000004, 570.0, 1018, 371780, 530, 17.390502600000218
531, 6.573701049090888, 93.05315265958271, 111.94070864014864, 0.6650298999999995, 175.0, 819, 372599, 531, 13.93087659999992
532, 6.956716254662792, 93.02565137755197, 111.90057794822837, 0.66442285, 45.0, 530, 373129, 532, 9.065287400000216
533, 6.536709248683772, 92.98492955652421, 111.82716572355403, 0.6638049999999999, 240.0, 843, 373972, 533, 14.384140799999841
534, 9.958495169323742, 93.08325417972941, 111.9988401573956, 0.6631111000000004, 205.0, 699, 374671, 534, 11.915638400000262
535, 10.90956504207294, 93.07455892077947, 112.14904966192731, 0.6625841499999999, 50.0, 472, 375143, 535, 8.114632899999833
536, 12.457303903805904, 93.19723646375868, 112.13374603793153, 0.6621084999999997, 135.0, 585, 375728, 536, 10.064578600000004
537, 10.517248156052803, 93.08165229066077, 112.06630058452295, 0.6615307000000001, 125.0, 699, 376427, 537, 12.019494600000144
538, 10.575474191270768, 93.10298523902892, 111.9349578499794, 0.6609281499999997, 130.0, 640, 377067, 538, 11.015012299999853
539, 7.791734109932109, 92.96410477070869, 111.80978657203384, 0.6602846500000005, 180.0, 790, 377857, 539, 13.649233999999979
540, 9.162552860750404, 93.01996980247084, 111.85645894625557, 0.65967985, 90.0, 554, 378411, 540, 9.484714599999734
541, 8.553502308078489, 93.07876500436815, 111.93139599137388, 0.6590057499999997, 315.0, 944, 379355, 541, 16.216642900000352
542, 10.16314051506472, 93.04785377477207, 111.99871729437545, 0.6581728, 460.0, 907, 380262, 542, 15.669201600000179
543, 9.37617106608755, 92.63007519897802, 111.47542957753443, 0.6574424500000002, 225.0, 716, 380978, 543, 12.43216620000021
544, 7.196673575191866, 92.51779701696574, 111.19099902579798, 0.65695735, 80.0, 362, 381340, 544, 6.3136200000003555
545, 6.352492832749869, 92.55916503505661, 111.31478250908681, 0.6564173499999992, 305.0, 838, 382178, 545, 14.40658590000021
546, 12.353049577563404, 92.53869318483893, 111.53925854702051, 0.6558832000000002, 80.0, 349, 382527, 546, 6.0572142000000895
547, 10.122471049732374, 92.63193319988339, 111.49257082571668, 0.6552415000000001, 325.0, 1077, 383604, 547, 18.71995059999972
548, 10.286792488457277, 92.54679453034507, 111.36542294378913, 0.6544715500000001, 135.0, 634, 384238, 548, 11.079299099999844
549, 7.666656938027025, 92.66104185598459, 111.39067493885885, 0.6538752999999997, 90.0, 691, 384929, 549, 12.00305950000029
550, 12.786115137180861, 92.50020398906634, 111.33508893181296, 0.6533348500000002, 70.0, 510, 385439, 550, 8.934498800000256
551, 7.066507993174381, 92.65446149065195, 111.38581097712282, 0.6526112500000004, 235.0, 1098, 386537, 551, 19.220396700000038
552, 7.907692271913213, 92.63045407116898, 111.34391316359606, 0.6518957500000001, 55.0, 492, 387029, 552, 8.660102499999994
553, 7.632124468746741, 92.61033816902986, 111.40739263192305, 0.6512454999999998, 380.0, 953, 387982, 553, 16.673191899999892
554, 9.593305264723506, 92.59202612696306, 111.43233899517985, 0.6505291000000004, 140.0, 639, 388621, 554, 11.330559200000152
555, 8.324567340752658, 92.53522757275611, 111.28770737914118, 0.6499431999999999, 35.0, 663, 389284, 555, 11.648717000000033
556, 7.830554611668303, 92.51175759055398, 111.31899845683492, 0.6492587500000001, 225.0, 858, 390142, 556, 15.20247419999987
557, 10.08751235892009, 92.22649612954136, 110.93741041614163, 0.64848205, 200.0, 868, 391010, 557, 15.437222200000178
558, 8.67070609895933, 91.97545974485335, 110.56998672792989, 0.6478682499999998, 80.0, 496, 391506, 558, 8.895913299999847
559, 15.186715448178777, 92.29878979093047, 111.29515335540356, 0.6474799, 60.0, 367, 391873, 559, 6.4600728000000345
560, 6.639274697005749, 92.175868147698, 110.87309863325478, 0.64700425, 120.0, 690, 392563, 560, 12.24798150000015
561, 11.755436720564658, 92.18605225630273, 111.01250589933589, 0.6463171000000005, 185.0, 837, 393400, 561, 15.50688029999992
562, 6.890572768008037, 92.13218606936907, 110.80710199630833, 0.6455093499999996, 460.0, 958, 394358, 562, 17.302881100000377
563, 8.6139528205333, 92.1456807454427, 110.92239979580717, 0.64487845, 35.0, 444, 394802, 563, 7.864478200000121
564, 9.185695389503396, 92.2148956612591, 110.92990190745432, 0.6442628500000003, 225.0, 924, 395726, 564, 16.350273499999275
565, 8.972474541902155, 92.15896179149678, 110.86816063174953, 0.6435698500000004, 115.0, 616, 396342, 565, 11.097073299999465
566, 7.25988862972848, 92.26336749113058, 110.91146160077444, 0.6429371500000001, 135.0, 790, 397132, 566, 14.053106899999875
567, 7.751833204750542, 92.17212872891812, 110.84465468466819, 0.6421820499999998, 245.0, 888, 398020, 567, 15.87253260000034
568, 7.492111854235331, 92.30996962483724, 110.94627620442708, 0.6416137000000001, 30.0, 375, 398395, 568, 6.7724694999997155
569, 7.3460116621334945, 92.07942838084941, 110.69347455550214, 0.6412685499999998, 30.0, 392, 398787, 569, 7.1171181999998225
570, 6.7438522467898965, 92.29464954561955, 110.99671798877502, 0.6408518500000002, 80.0, 534, 399321, 570, 9.87382929999967
571, 8.691975073165194, 92.0486183895427, 110.77352876116515, 0.6403996000000002, 5.0, 471, 399792, 571, 8.486306299999342
572, 9.638882432051384, 92.09255207368057, 110.8078812926355, 0.6399410499999999, 70.0, 548, 400340, 572, 9.958462499999769
573, 5.698677335172493, 92.20517908694309, 110.82497044374826, 0.6393916, 235.0, 673, 401013, 573, 12.226248300000407
574, 5.609824522252266, 92.0477276963454, 110.70769841120793, 0.6387962500000002, 140.0, 650, 401663, 574, 11.805035599999428
575, 8.595528636650837, 92.18711614946947, 110.94902037492035, 0.6381864999999997, 215.0, 705, 402368, 575, 12.829725999999937
576, 8.875167317857088, 92.27915925811742, 111.00198625818781, 0.6373324, 320.0, 1193, 403561, 576, 21.567366799999945
577, 13.316686701309937, 92.31387434381737, 111.11986871261323, 0.6365444500000003, 135.0, 558, 404119, 577, 10.118857100000241
578, 10.23408202418634, 92.18031570832149, 110.90915982228405, 0.6357925000000005, 275.0, 1113, 405232, 578, 19.726337800000692
579, 6.072814466752471, 92.14715774454535, 110.74204161128895, 0.6348709000000002, 170.0, 935, 406167, 579, 15.49130570000034
580, 8.640036893019806, 92.14009258373363, 110.78529220993454, 0.6340338999999994, 225.0, 925, 407092, 580, 15.267018800000187
581, 6.918633777220463, 92.07610497843, 110.6600401685233, 0.6334021, 135.0, 479, 407571, 581, 7.968314300000202
582, 7.242619095579402, 92.16147714902277, 110.80333275990944, 0.6328580499999997, 245.0, 730, 408301, 582, 11.969501600000513
583, 7.461666697133476, 92.27286035297462, 110.94378575812881, 0.6323545, 45.0, 389, 408690, 583, 6.530647100000351
584, 8.664678504826819, 92.16912580117946, 110.88505772846501, 0.6318842500000001, 240.0, 656, 409346, 584, 10.891235700000834
585, 9.40261894813997, 92.20012886059455, 110.91480261172433, 0.6313050999999996, 85.0, 631, 409977, 585, 10.583184099999926
586, 8.31265364989328, 91.42879504362742, 109.92957385381062, 0.6305891499999998, 320.0, 960, 410937, 586, 16.131399700000657
587, 9.999682012819225, 91.3842615456223, 110.01661857413964, 0.6298515999999995, 170.0, 679, 411616, 587, 11.228397199999563
588, 11.221370232310788, 91.46863864591752, 110.07006155430585, 0.6293502999999999, 15.0, 435, 412051, 588, 7.189248699999553
589, 7.659728773747646, 91.36143273696261, 109.89078173199071, 0.6288314500000001, 65.0, 718, 412769, 589, 11.88150990000031
590, 7.099860409952578, 91.34907836914063, 109.81850669735768, 0.6282338499999999, 110.0, 610, 413379, 590, 10.19848120000006
591, 6.725822191992073, 91.36800898937753, 109.92624172604856, 0.6277024000000001, 95.0, 571, 413950, 591, 9.629051299999446
592, 9.220192002142086, 91.33111011798565, 109.84579530373598, 0.6270944499999996, 215.0, 780, 414730, 592, 13.118021600000247
593, 7.695820723504823, 91.25182070830668, 109.71913626084077, 0.6264604000000001, 90.0, 629, 415359, 593, 10.54076350000014
594, 8.593257240756698, 91.3042149514145, 109.86475155279503, 0.6258150999999997, 165.0, 805, 416164, 594, 13.472413899999992
595, 7.94549206225248, 91.44375976196655, 110.00697940212864, 0.6250023999999998, 215.0, 1001, 417165, 595, 16.73066910000034
596, 9.172002571652975, 91.5493236049529, 110.14928340296592, 0.6242729499999996, 120.0, 620, 417785, 596, 10.530529599999682
597, 8.350619170953584, 91.25652454210365, 109.75910954445786, 0.6237041500000001, 210.0, 644, 418429, 597, 10.904775900000459
598, 9.671853149491312, 91.46957685284666, 110.04519895698189, 0.62316505, 110.0, 554, 418983, 598, 9.306258599999637
599, 10.88931003932587, 91.22837217287584, 109.72909897023982, 0.62259895, 55.0, 704, 419687, 599, 11.869006799999624
600, 9.600718095576557, 90.90269671393402, 109.3839793686221, 0.6219698500000002, 110.0, 694, 420381, 600, 11.816335500000605
601, 9.386737964603284, 90.2166564031942, 108.50691946673867, 0.6213177999999996, 160.0, 755, 421136, 601, 12.942619000000377
602, 6.4680930641384755, 90.21511454160522, 108.48622133942689, 0.62071345, 110.0, 588, 421724, 602, 10.071960500000387
603, 8.687509157296484, 90.16666807198759, 108.45388937330848, 0.6201279999999997, 180.0, 713, 422437, 603, 12.081871699999283
604, 10.168886946590614, 90.27637430010844, 108.57218535996164, 0.6195547000000001, 105.0, 561, 422998, 604, 9.559451099999933
605, 7.868104800178049, 90.22888113938792, 108.54004374244244, 0.6189868000000001, 105.0, 701, 423699, 605, 11.916262099999585
606, 8.817698271728533, 90.34351755482282, 108.65663695520209, 0.6184391499999999, 155.0, 516, 424215, 606, 8.846363999999994
607, 7.396229357090142, 90.16429121717275, 108.45599370723149, 0.61795675, 45.0, 556, 424771, 607, 9.587872000000061
608, 8.697492751616434, 90.3951913317426, 108.75782677765771, 0.6174720999999999, 60.0, 521, 425292, 608, 9.005458999999973
609, 8.084973435021617, 90.27075572569677, 108.60536776115558, 0.6168709000000002, 290.0, 815, 426107, 609, 14.099812999999813
610, 7.749389607931068, 90.12225106918135, 108.3166591860842, 0.6162980500000002, 40.0, 458, 426565, 610, 7.932133000000249
611, 8.138656068479918, 90.50711547046839, 108.86528412855662, 0.6158700999999998, 50.0, 493, 427058, 611, 8.51275700000042
612, 11.064905328250894, 90.28809925426137, 108.68292587742661, 0.6154255000000002, 65.0, 495, 427553, 612, 8.627327100000002
613, 8.35218940099749, 90.16894813684317, 108.43360960789217, 0.6149219500000002, 80.0, 624, 428177, 613, 10.713581999999406
614, 8.039785299667694, 90.2497932267015, 108.62450556511426, 0.6143945499999995, 30.0, 548, 428725, 614, 9.559286099999554
615, 10.091273742482548, 90.25390088943928, 108.64026108140754, 0.6138559000000002, 180.0, 649, 429374, 615, 11.163634800000182
616, 6.329365652519656, 90.20131071002248, 108.47061018427827, 0.6131853999999998, 100.0, 841, 430215, 616, 14.580017599999337
617, 7.512149471471586, 90.1037795369218, 108.3976254812101, 0.6125117500000004, 165.0, 656, 430871, 617, 11.368025900000248
618, 11.214860846347861, 90.27589914510538, 108.74978102799301, 0.6120117999999999, 55.0, 455, 431326, 618, 7.858907000000727
619, 6.942602169827222, 89.97855066301744, 108.16461464859987, 0.6114348999999996, 225.0, 827, 432153, 619, 14.37726339999972
620, 10.012781639900059, 90.23813576698304, 108.55397974967957, 0.6107027500000002, 180.0, 800, 432953, 620, 13.896468500000083
621, 10.101849338449078, 90.27577056884766, 108.57093100842134, 0.6101604999999999, 80.0, 405, 433358, 621, 7.108983699999953
622, 9.386069200943984, 90.30853983711457, 108.7174861462817, 0.6096736000000001, 135.0, 677, 434035, 622, 11.697704899999735
623, 7.317994050192137, 90.26146529817233, 108.55901811140298, 0.6090607, 160.0, 685, 434720, 623, 11.987989899999775
624, 6.569395820159452, 90.12734875874006, 108.34094511691522, 0.6081471999999997, 210.0, 1345, 436065, 624, 23.395446900000024
625, 7.480592244673634, 90.21013716735558, 108.53706257715339, 0.6070546000000001, 215.0, 1083, 437148, 625, 19.06114869999965
626, 8.965441648626612, 90.13875781165228, 108.44652337876578, 0.60634045, 30.0, 504, 437652, 626, 8.933471299999837
627, 11.09486389366745, 90.17256718881629, 108.57791469706191, 0.6057630999999997, 180.0, 779, 438431, 627, 13.659825499999897
628, 8.864638715725963, 90.15471509976149, 108.49416356570954, 0.6051511, 135.0, 581, 439012, 628, 10.314199400000689
629, 7.9161411777896395, 89.95704312728623, 108.2349858558784, 0.6043586499999999, 260.0, 1180, 440192, 629, 20.767242000000806
630, 8.746051069268738, 89.05860585834256, 107.10339864095052, 0.6035563, 165.0, 603, 440795, 630, 10.763665899999978
631, 8.314062508561745, 88.99058831971267, 107.04787392451846, 0.60307615, 45.0, 464, 441259, 631, 8.202094500000385
632, 7.41046183900605, 88.95019752970671, 106.98179752473797, 0.6023687500000002, 315.0, 1108, 442367, 632, 19.697751400000016
633, 6.0050374137964555, 89.00601371904699, 107.02710701779621, 0.60157495, 95.0, 656, 443023, 633, 11.720743899999434
634, 10.454262673307996, 88.99223224394912, 107.10874713232758, 0.6010835499999999, 90.0, 436, 443459, 634, 7.809730199999649
635, 7.712160213756682, 88.86078707803816, 106.85575110160265, 0.6006191499999999, 45.0, 596, 444055, 635, 10.561565699999846
636, 7.695287729601252, 88.87734409926308, 106.91276179558788, 0.6001110999999999, 30.0, 533, 444588, 636, 9.51588189999984
637, 9.845559951494153, 89.01792189173092, 107.13617088236086, 0.5995774, 155.0, 653, 445241, 637, 11.621319900000344
638, 9.268472836774164, 89.04002692010508, 107.15309184618329, 0.5989860999999996, 105.0, 661, 445902, 638, 11.765134499999476
639, 7.388485895200345, 88.93930720683164, 106.9592356411916, 0.5981162500000001, 215.0, 1272, 447174, 639, 22.52911909999966
640, 7.3367711484087685, 88.91887474280561, 106.95499951136594, 0.5971546000000002, 240.0, 865, 448039, 640, 15.447676699999647
641, 8.392058434441186, 89.06431388518587, 107.11756689754533, 0.5965102, 135.0, 567, 448606, 641, 10.245653300000413
642, 5.93719442707662, 88.88267336714382, 106.87288335489389, 0.5959733499999997, 80.0, 626, 449232, 642, 11.390003800000159
643, 9.003583748595545, 88.75424214873689, 106.81290717234283, 0.5952402999999999, 125.0, 1003, 450235, 643, 18.19200170000022
644, 8.51058178662282, 88.10376519742219, 105.99006449657938, 0.59454055, 105.0, 552, 450787, 644, 9.97802369999954
645, 9.29228963107882, 88.21420163806208, 106.1214941551243, 0.59389435, 260.0, 884, 451671, 645, 15.99570230000063
646, 8.912422654925445, 88.1274658748894, 106.02762764079382, 0.5931945999999997, 125.0, 671, 452342, 646, 12.150396
647, 5.318527892573711, 87.99245043413354, 105.7554745572058, 0.59259835, 145.0, 654, 452996, 647, 11.786070699999982
648, 10.187982248643843, 87.99637892307379, 105.91467044292352, 0.5920232499999997, 105.0, 624, 453620, 648, 11.226633799999945
649, 9.264333348082092, 88.06434780762142, 105.97772908334716, 0.5914828000000001, 35.0, 577, 454197, 649, 10.496081600000252
650, 8.01477252447467, 87.98937997118387, 105.78219710537826, 0.59099005, 85.0, 518, 454715, 650, 9.431073300000207
651, 8.282347700605959, 87.98941771368972, 105.80072146485755, 0.5905179999999998, 75.0, 531, 455246, 651, 9.655383899999833
652, 8.914050314472705, 88.06529969989128, 105.94065889599361, 0.58965895, 475.0, 1378, 456624, 652, 25.0092396
653, 7.360505459772661, 88.06479235143469, 105.86390914404953, 0.5887036000000002, 110.0, 745, 457369, 653, 13.696666300000288
654, 5.517154044129465, 88.04149729983467, 105.84059670174013, 0.5879287, 285.0, 977, 458346, 654, 17.743144699999903
655, 7.0376453276579, 87.94803623470118, 105.75991229934385, 0.5871529000000002, 280.0, 747, 459093, 655, 13.659613899999385
656, 8.341085712428873, 87.87589153303976, 105.67992106157608, 0.5865746500000001, 120.0, 538, 459631, 656, 9.857174200000372
657, 8.955151562456185, 87.59167092035074, 105.36474155944452, 0.5861107, 110.0, 493, 460124, 657, 8.992229500000576
658, 8.658735646219382, 86.79466157358856, 104.48830840387956, 0.5857061499999999, 60.0, 406, 460530, 658, 7.481623699999545
659, 7.951215527818195, 86.52527525433503, 104.06974272915967, 0.5852723499999999, 125.0, 558, 461088, 659, 10.22775559999991
660, 8.738426396394598, 86.63599646206559, 104.20575278446591, 0.5846949999999999, 165.0, 725, 461813, 660, 13.294528899999932
661, 6.508989150573546, 86.60172115248903, 104.10142065488063, 0.5839453000000001, 175.0, 941, 462754, 661, 17.308326399999714
662, 7.372370031588247, 86.66275120180521, 104.30268543833968, 0.58309165, 250.0, 956, 463710, 662, 17.7002394000001
663, 6.9149951875640765, 86.5862143901617, 104.14069287530307, 0.5822568999999997, 250.0, 899, 464609, 663, 16.627533300000323
664, 5.985743969355442, 86.53141817787821, 104.03448151581047, 0.5815621000000002, 145.0, 645, 465254, 664, 11.88503589999982
665, 6.722966028529512, 86.56011146680844, 104.06773119142069, 0.5808915999999998, 185.0, 845, 466099, 665, 15.71882480000022
666, 10.107750134326626, 86.72078341332035, 104.32264647276506, 0.5802629500000002, 120.0, 552, 466651, 666, 10.292856400000346
667, 6.023556470870972, 86.53167195575227, 104.08057293676055, 0.5797958500000002, 85.0, 486, 467137, 667, 9.046610899999905
668, 5.120209205670289, 86.5508122562938, 104.0258553596578, 0.5790713499999999, 530.0, 1124, 468261, 668, 20.91557920000014
669, 4.719219333713095, 86.43299285590211, 103.89186178268022, 0.5783815, 55.0, 409, 468670, 669, 7.627240299999357
670, 8.132650265287534, 86.39177518732407, 103.86350656023212, 0.5780138499999998, 75.0, 408, 469078, 670, 7.61132809999981
671, 6.234478334442013, 86.6391339886162, 104.15934563107905, 0.5776281999999999, 55.0, 449, 469527, 671, 8.32398430000012
672, 9.631880047956752, 86.51846348766713, 104.12994890591122, 0.5772218499999998, 70.0, 454, 469981, 672, 8.689610399999765
673, 9.136420779804748, 87.56823407554197, 105.31704237444944, 0.5766188499999998, 180.0, 886, 470867, 673, 16.569041200000356
674, 10.144786362748334, 87.8209718949724, 105.72838664290929, 0.5760383499999999, 70.0, 404, 471271, 674, 7.602178699999968
675, 9.446916006918618, 87.66304594517666, 105.52452030510109, 0.57538585, 315.0, 1046, 472317, 675, 19.570695600000363
676, 7.282753669386246, 87.53793802757147, 105.25050568653538, 0.5746208500000003, 190.0, 654, 472971, 676, 12.221373800000038
677, 7.40689348643987, 87.72341849042483, 105.45459078244514, 0.5741546500000001, 55.0, 382, 473353, 677, 7.20005620000029
678, 7.709927796770673, 87.50941700016686, 105.2659141645519, 0.5737865499999998, 80.0, 436, 473789, 678, 8.251024199999847
679, 7.237658159081995, 87.48526864928249, 105.15296395322615, 0.5733014500000002, 195.0, 642, 474431, 679, 12.151977799999258
680, 9.7097150969459, 87.75972069853945, 105.61650939308917, 0.5728388500000001, 60.0, 386, 474817, 680, 7.329532699999618
681, 8.031364650527637, 87.46508726462339, 105.20585209773137, 0.57248965, 80.0, 390, 475207, 681, 7.473552899999959
682, 4.9429769121020675, 87.64848757824265, 105.31313009606787, 0.5721274000000001, 55.0, 415, 475622, 682, 7.8797363000003315
683, 5.898597328507968, 87.26989362468828, 104.92497880580062, 0.57178135, 50.0, 354, 475976, 683, 6.70886100000007
684, 11.564672059901058, 87.68611235618592, 105.5001342868805, 0.5712620500000001, 165.0, 800, 476776, 684, 15.200269399999343
685, 7.741491836009038, 87.40528124902862, 105.139343302193, 0.5707324000000001, 35.0, 377, 477153, 685, 7.160540000000765
686, 7.299319858978114, 87.48423552325391, 105.15651325916681, 0.5703341499999999, 90.0, 508, 477661, 686, 9.629681299999902
687, 8.351183880184745, 87.62578313104038, 105.39079773563078, 0.56979235, 115.0, 696, 478357, 687, 13.29509539999981
688, 6.514916336004098, 87.55247214257928, 105.27807832352563, 0.5690962, 215.0, 851, 479208, 688, 16.145859400000518
689, 8.172399113901326, 87.49538677460035, 105.28682657574399, 0.5684113, 135.0, 671, 479879, 689, 12.74820660000023
690, 7.917763577298463, 87.28239386360437, 105.02044206634417, 0.5677129000000002, 175.0, 881, 480760, 690, 16.79690269999992
691, 7.403437920672175, 86.9937834819011, 104.64716193856682, 0.567073, 90.0, 541, 481301, 691, 10.48410420000073
692, 5.620903426832832, 87.00860637921119, 104.53461299489138, 0.5666018499999997, 90.0, 506, 481807, 692, 9.75548930000059
693, 7.986388748829768, 87.11689035772733, 104.78488924209385, 0.5658814000000001, 305.0, 1095, 482902, 693, 20.94591379999929
694, 9.059102284281611, 87.07495430206583, 104.74319480824694, 0.5649071500000001, 360.0, 1070, 483972, 694, 20.396439799999825
695, 7.062427792747815, 86.97255919138591, 104.57526426951091, 0.56415565, 65.0, 600, 484572, 695, 11.5309086999996
696, 11.431078348654163, 86.99743218533925, 104.70199476508482, 0.5635216, 215.0, 809, 485381, 696, 15.616569899999377
697, 6.100196239412397, 87.0551760621422, 104.59774854573955, 0.56277865, 260.0, 842, 486223, 697, 16.266496399999596
698, 7.802446228312902, 87.08194986085272, 104.6552079775631, 0.5621437000000002, 120.0, 569, 486792, 698, 11.045354699999734
699, 9.122676781944271, 87.20700102133303, 104.98588877673905, 0.5615668, 210.0, 713, 487505, 699, 13.797041999999237
700, 7.730905776505527, 87.30464411425268, 105.05598974728333, 0.5609457999999995, 180.0, 667, 488172, 700, 12.884183099999973
701, 5.705407465395239, 87.01821496707876, 104.58907922174512, 0.5604273999999998, 65.0, 485, 488657, 701, 9.31754809999984
702, 5.905628983861725, 86.9473955718452, 104.5311981727337, 0.5597785, 170.0, 957, 489614, 702, 18.657264899999973
703, 6.647007874455104, 87.0492537284661, 104.67414508425892, 0.5590949500000001, 110.0, 562, 490176, 703, 10.847951900000226
704, 8.924988880100631, 86.51328358207782, 104.05415044371615, 0.5584928499999999, 135.0, 776, 490952, 704, 15.026068799999848
705, 6.713111026119956, 86.53227913577254, 104.08788899163515, 0.5578178500000002, 150.0, 724, 491676, 705, 14.131990799999585
706, 6.2110544859448025, 86.42788606777526, 103.93571745721917, 0.5570816499999999, 240.0, 912, 492588, 706, 17.66584739999962
707, 6.960823678617124, 86.54649477358218, 104.07630472819011, 0.5563675000000002, 140.0, 675, 493263, 707, 13.2044848000005
708, 6.941295676862896, 86.45903586975214, 103.92517245067516, 0.5555948499999998, 195.0, 1042, 494305, 708, 20.442745000000286
709, 5.234005930153905, 86.76879492751112, 104.27610077729096, 0.5549261499999999, 110.0, 444, 494749, 709, 8.704017799999747
710, 6.984786389424851, 86.57252666213749, 104.04378805110592, 0.55438255, 85.0, 764, 495513, 710, 15.166717799999788
711, 8.528499465051238, 86.32586148386275, 103.8573330203087, 0.5537727999999998, 120.0, 591, 496104, 711, 11.652490200000102
712, 6.01205219854176, 86.67241106673485, 104.11558036344597, 0.5532454000000001, 55.0, 581, 496685, 712, 11.478777399999672
713, 8.742016089026277, 86.58844539993687, 104.16765068706714, 0.5527103499999998, 80.0, 608, 497293, 713, 12.0737380999999
714, 8.016407599051794, 86.30046958597298, 103.83408726314534, 0.5521208500000002, 160.0, 702, 497995, 714, 13.769746699999814
715, 8.27260480423427, 86.47876530633077, 103.97186800158174, 0.5514120999999997, 150.0, 873, 498868, 715, 17.332942000000003
716, 9.54498132372275, 86.40264402389526, 103.94985087394714, 0.5506592500000004, 90.0, 800, 499668, 716, 15.845333500000379
717, 5.962732102250916, 85.96464507881252, 103.31110106939558, 0.5499860499999999, 180.0, 696, 500364, 717, 13.92789940000057
718, 11.41343589380267, 85.62187965214252, 102.98749713599682, 0.54944245, 130.0, 512, 500876, 718, 10.239096899999822
719, 12.196739205276105, 85.69631257437935, 103.20775775401765, 0.5489753500000001, 30.0, 526, 501402, 719, 10.525950000000194
720, 8.568763614216103, 85.47246090556622, 102.80407449654604, 0.5482440999999997, 275.0, 1099, 502501, 720, 21.871429799999532
721, 7.896669824296015, 85.56163917735599, 102.99867223153609, 0.5475196000000001, 30.0, 511, 503012, 721, 10.19779429999926
722, 6.354747938185778, 85.35924407855006, 102.57684025935055, 0.5470254999999998, 105.0, 587, 503599, 722, 11.80024069999945
723, 4.841857483823385, 85.65769359043666, 102.96402596064976, 0.5465093500000001, 110.0, 560, 504159, 723, 11.306569200000013
724, 7.275285510064075, 85.51173960078846, 102.7774887229457, 0.5460197500000001, 5.0, 528, 504687, 724, 10.564237700000376
725, 6.344869807011941, 85.66036048839295, 102.9829162099003, 0.5454378999999995, 210.0, 765, 505452, 725, 15.325250800000504
726, 5.617471711268259, 85.49553927931674, 102.79669790933299, 0.54470665, 255.0, 860, 506312, 726, 17.21035099999972
727, 7.433384638045987, 85.56323494623801, 102.90172992626533, 0.5439537999999995, 160.0, 813, 507125, 727, 16.24092329999985
728, 8.78071163648991, 85.64330121562767, 103.06871033872567, 0.5432914000000001, 180.0, 659, 507784, 728, 13.115829200000007
729, 8.604070487733772, 85.52604813585457, 102.85741276168046, 0.5425529499999997, 240.0, 982, 508766, 729, 19.61762069999986
730, 9.205414072480252, 85.51199059845298, 102.92036885087208, 0.5419436500000001, 25.0, 372, 509138, 730, 7.557564300000195
731, 5.879758701854282, 85.37890613132053, 102.6410735405816, 0.5415737499999999, 80.0, 450, 509588, 731, 9.073330700000042
732, 9.149541110526242, 85.94574039650222, 103.40276548310771, 0.5410386999999999, 130.0, 739, 510327, 732, 14.805997099999331
733, 7.655466153511572, 86.43111275058651, 103.90672965575463, 0.5402408500000002, 425.0, 1034, 511361, 733, 20.828613799999403
734, 9.445338707141927, 86.79818526508222, 104.52719480994959, 0.5394772000000002, 80.0, 663, 512024, 734, 13.54880090000006
735, 9.572060150202713, 86.60627121930264, 104.22481678295823, 0.5387418999999999, 370.0, 971, 512995, 735, 19.77065859999948
736, 12.528077996847777, 86.50722196849996, 104.14353186067883, 0.5381370999999999, 60.0, 373, 513368, 736, 7.545871600000282
737, 6.113714936830872, 86.50844394840311, 104.01339531754167, 0.5376511, 125.0, 707, 514075, 737, 14.344725599999947
738, 8.224783182276228, 86.25292363582369, 103.69384257374345, 0.5370282999999996, 135.0, 677, 514752, 738, 13.78207459999976
739, 8.637582163230862, 86.44856358626012, 103.96764875934527, 0.5361931, 325.0, 1179, 515931, 739, 23.909960099999807
740, 6.749463529052103, 86.59614387213016, 104.00464424432492, 0.53547895, 25.0, 408, 516339, 740, 8.349863499999628
741, 9.485371243833384, 86.4036984769454, 103.89199414460555, 0.5350055499999999, 175.0, 644, 516983, 741, 13.18702249999933
742, 9.248183990272414, 86.43386175715615, 103.99582450703642, 0.5343156999999996, 245.0, 889, 517872, 742, 18.328671100000065
743, 7.368035369395239, 86.49882799447676, 104.00203518372203, 0.5336946999999996, 35.0, 491, 518363, 743, 10.053091400000085
744, 9.096255014890922, 86.59752376403225, 104.15666395665127, 0.5332384, 120.0, 523, 518886, 744, 10.554394499999944
745, 6.382313751764321, 86.49013354327228, 103.97394057515213, 0.5328199, 75.0, 407, 519293, 745, 8.350162499999897
746, 6.616174988993112, 86.10915139733808, 103.49462062048758, 0.5321503000000002, 225.0, 1081, 520374, 746, 22.182398700000704
747, 6.179604189619896, 85.60562657641758, 102.87878365486291, 0.5313105999999999, 170.0, 785, 521159, 747, 16.11752869999964
748, 8.097536090188509, 85.77648394202498, 103.14916612645779, 0.5303340999999998, 335.0, 1385, 522544, 748, 28.197528100000454
749, 7.007412092637842, 85.51715632250709, 102.83499781754765, 0.5294642499999999, 130.0, 548, 523092, 749, 11.392241000000467
750, 6.321837113185754, 85.67303347859546, 102.96918320746477, 0.52898095, 110.0, 526, 523618, 750, 11.003332899999805
751, 10.911193860409496, 85.7716948592269, 103.20066290503149, 0.5284445500000002, 165.0, 666, 524284, 751, 13.83747080000012
752, 5.8277131050535775, 85.61626643208623, 102.89825566856607, 0.5279131000000001, 95.0, 515, 524799, 752, 10.726135500000055
753, 12.531377386493782, 85.69873153843831, 103.2632827601482, 0.5274630999999999, 60.0, 485, 525284, 753, 10.23584419999952
754, 7.956032682334761, 85.41252834238905, 102.71207885974084, 0.52694875, 135.0, 658, 525942, 754, 13.636284500000329
755, 7.097878014551247, 85.90391489833692, 103.28046157431365, 0.5263817500000002, 80.0, 602, 526544, 755, 12.521287999999913
756, 10.68990299842424, 85.59750696818034, 103.02923639085557, 0.5259488499999999, 70.0, 360, 526904, 756, 7.614314800000102
757, 7.174698587912971, 85.57312625493759, 102.90525861886832, 0.5255060500000003, 65.0, 624, 527528, 757, 12.995719300000019
758, 9.333824845364845, 85.66593772006699, 103.0833215295556, 0.5249993500000002, 75.0, 502, 528030, 758, 10.448997800000143
759, 9.999006002204759, 85.68037222726005, 103.13670924595424, 0.5246159499999998, 65.0, 350, 528380, 759, 7.4065497000001415
760, 7.625192252944908, 85.61360300119927, 102.94785381722707, 0.5241664, 150.0, 649, 529029, 760, 13.49395800000002
761, 5.530187375777591, 85.79515106066138, 103.10827403785908, 0.5236709500000002, 65.0, 452, 529481, 761, 9.70133420000002
762, 6.432965087919281, 84.54196481623201, 101.63170662089291, 0.5230463499999995, 185.0, 936, 530417, 762, 19.781639599999835
763, 6.317573087928058, 83.30918883394313, 100.16386237850895, 0.5222363500000001, 205.0, 864, 531281, 763, 18.06840269999975
764, 6.767771556872089, 83.32597379331236, 100.18318255850517, 0.5212521999999994, 645.0, 1323, 532604, 764, 28.3007705
765, 5.963342193595289, 83.32772413350769, 100.2005653935541, 0.5202851499999996, 265.0, 826, 533430, 765, 17.46611170000051
766, 8.13292643690676, 83.33294749113679, 100.25683931924083, 0.51962005, 60.0, 652, 534082, 766, 13.73528609999994
767, 5.375496858216938, 83.39742616733442, 100.23061515690212, 0.5189189499999997, 400.0, 906, 534988, 767, 19.565893300000425
768, 6.703557544452853, 83.31002840884896, 100.14462368987327, 0.5182016500000001, 85.0, 688, 535676, 768, 14.65341140000055
769, 6.750083890282087, 83.3877859459267, 100.28742398442449, 0.5174924499999997, 260.0, 888, 536564, 769, 18.709638199999972
770, 8.454237973874378, 83.40560429366593, 100.40566412280106, 0.5168309499999998, 95.0, 582, 537146, 770, 12.30242139999973
771, 9.30237537142772, 83.39748229070854, 100.33512793141577, 0.5162670999999999, 125.0, 671, 537817, 771, 14.20632310000019
772, 7.525839713014317, 83.08051241674457, 99.87694458605132, 0.5157122499999999, 75.0, 562, 538379, 772, 12.14025760000004
773, 8.601465184270866, 83.26489119642363, 100.124969212089, 0.5152307500000001, 80.0, 508, 538887, 773, 10.770878499999526
774, 10.364719963947076, 83.23914550629672, 100.13447263856597, 0.5147303499999998, 55.0, 604, 539491, 774, 12.861715600000025
775, 5.1803677588578605, 82.92279092765149, 99.6445964609154, 0.5140211500000003, 310.0, 972, 540463, 775, 20.832931900000403
776, 6.204418845192163, 82.58333837391136, 99.24392098676182, 0.5133582999999999, 90.0, 501, 540964, 776, 10.860265100000106
777, 7.468575379173356, 82.71499074553178, 99.49154584641084, 0.5128615000000001, 50.0, 603, 541567, 777, 12.988087200000336
778, 8.798917663894755, 82.58926500592914, 99.30772898676321, 0.51221845, 190.0, 826, 542393, 778, 17.6098764999997
779, 8.502986211065457, 82.85433454871675, 99.74335288736187, 0.5115232000000002, 120.0, 719, 543112, 779, 15.353740699999435
780, 8.585356449430257, 82.66835857982367, 99.43049157370984, 0.5108801500000001, 180.0, 710, 543822, 780, 15.182100800000626
781, 7.2964269504882395, 82.60584632158279, 99.30385236740112, 0.5102726499999997, 115.0, 640, 544462, 781, 14.012434799999937
782, 6.502026064212867, 82.7830375130721, 99.5032453281673, 0.5096989, 105.0, 635, 545097, 782, 13.689210999999887
783, 8.26831006070842, 82.69754415318586, 99.44769273840863, 0.5091026499999998, 105.0, 690, 545787, 783, 14.72637179999947
784, 5.533774631201883, 82.76316907841188, 99.43333989398707, 0.5083165000000004, 440.0, 1057, 546844, 784, 22.70001400000001
785, 6.998486957148847, 82.90432309608403, 99.69262171571003, 0.5075379999999995, 210.0, 673, 547517, 785, 14.451102099999844
786, 4.798336535692215, 82.39341533033154, 98.99022313371489, 0.5070573999999998, 50.0, 395, 547912, 786, 8.470232000000578
787, 6.735727158804662, 82.57289951225928, 99.27810908243664, 0.5066357500000002, 110.0, 542, 548454, 787, 11.619033500000114
788, 5.3941678497163, 82.65319911479213, 99.39295185920444, 0.5061006999999996, 100.0, 647, 549101, 788, 13.925339999999778
789, 9.106092996543714, 82.87563262253664, 99.6839015489214, 0.5056092999999999, 80.0, 445, 549546, 789, 9.548288099999809
790, 5.313057267108441, 82.40525124596215, 99.0974536946315, 0.5051034999999999, 125.0, 679, 550225, 790, 14.694439499999135
791, 7.351352559973886, 82.09577777121764, 98.70150556062397, 0.50455, 70.0, 551, 550776, 791, 11.861933600000157
792, 8.859076576813452, 82.04820860052385, 98.668239361978, 0.5039906500000001, 150.0, 692, 551468, 792, 14.891982500000267
793, 7.336175475505568, 81.93608097052723, 98.5568951908846, 0.5033169999999995, 165.0, 805, 552273, 793, 17.623009099999763
794, 6.6393591020544775, 81.97708084928468, 98.51201095324173, 0.50268745, 165.0, 594, 552867, 794, 13.08022340000025
795, 6.7078664016448375, 82.01725756846778, 98.64720397732398, 0.5021667999999998, 70.0, 563, 553430, 795, 12.258948600000622
796, 6.586294321808964, 81.93855452537537, 98.6538742184639, 0.50174065, 35.0, 384, 553814, 796, 8.328071900000396
797, 8.284861932583249, 81.97966768328841, 98.54797657679937, 0.5010454000000002, 245.0, 1161, 554975, 797, 25.610624099999768
798, 7.723234279469162, 81.75270050138984, 98.3160882496235, 0.5002183000000003, 305.0, 677, 555652, 798, 15.21868699999959
799, 5.562052669951396, 81.8337852912708, 98.31156666573935, 0.4996846000000002, 80.0, 509, 556161, 799, 11.056250499999805
800, 5.399997360789342, 81.93627147602766, 98.5013090777427, 0.4990968999999996, 170.0, 797, 556958, 800, 17.496807399999852
801, 8.097361444487424, 81.97477087876663, 98.58431050364922, 0.49843135, 175.0, 682, 557640, 801, 15.007311099999242
802, 6.4895868440895725, 81.83549833707283, 98.3368017278566, 0.49775769999999964, 180.0, 815, 558455, 802, 17.915444000000207
803, 5.95652040549618, 81.81408031942391, 98.35026897785635, 0.49716864999999977, 60.0, 494, 558949, 803, 10.81952629999978
804, 8.46089409018987, 81.98726286548181, 98.59634694887724, 0.4967128, 55.0, 519, 559468, 804, 11.426403100000243
805, 7.6482362944017686, 81.68206533984603, 98.17506653497523, 0.4961903499999998, 115.0, 642, 560110, 805, 14.248841800000264
806, 6.693950029932605, 80.9204539935275, 97.29432111500611, 0.495604, 170.0, 661, 560771, 806, 14.547188100000312
807, 7.131888375594549, 80.91775402087946, 97.2368657647876, 0.49503339999999973, 120.0, 607, 561378, 807, 13.575152100000196
808, 5.208338014318353, 80.9106784433679, 97.19334791842827, 0.4943476000000003, 190.0, 917, 562295, 808, 20.08799590000035
809, 7.660408753754184, 81.27603227785318, 97.75862866581076, 0.4935713499999997, 210.0, 808, 563103, 809, 17.854283499999838
810, 7.438248173962873, 81.12566964778078, 97.4941478000774, 0.49298859999999983, 75.0, 487, 563590, 810, 10.863153099999181
811, 6.895476964441129, 80.8756107031475, 97.2245112710651, 0.4924765, 115.0, 651, 564241, 811, 15.053326199999901
812, 6.911140372888523, 81.03964157585843, 97.48444857431888, 0.4918982500000002, 110.0, 634, 564875, 812, 18.07055440000022
813, 7.51310000760111, 81.01504193211879, 97.35635933544981, 0.49124350000000006, 160.0, 821, 565696, 813, 24.619487599999957
814, 6.626721614486899, 80.99794823205092, 97.31125850250639, 0.4904919999999999, 265.0, 849, 566545, 814, 25.318839800000205
815, 8.3223161432855, 81.02571573705117, 97.46901885204939, 0.4897936000000002, 115.0, 703, 567248, 815, 20.15086270000029
816, 5.7922518075691105, 81.2012473284188, 97.56322166744599, 0.4893179499999997, 50.0, 354, 567602, 816, 10.126340699999673
817, 6.9619607659018765, 81.18476156896475, 97.59776059364786, 0.4887176500000003, 355.0, 980, 568582, 817, 29.107250199999726
818, 4.991946162349562, 81.21016219017089, 97.53448036134087, 0.4881043, 125.0, 383, 568965, 818, 10.985942199999954
819, 8.681254551404557, 81.21341380905196, 97.68405701757526, 0.48762505000000017, 140.0, 682, 569647, 819, 22.037019299999884
820, 7.233745108952754, 80.41267381210672, 96.64173783004554, 0.48692035000000006, 185.0, 884, 570531, 820, 25.02702980000049
821, 5.961346225892438, 80.1298085350938, 96.29586131273611, 0.4861531000000004, 135.0, 821, 571352, 821, 23.891507700000147
822, 6.219076933818204, 80.16258139474051, 96.30389576503208, 0.48562615000000003, 60.0, 350, 571702, 822, 10.388099199999488
823, 6.511788377147283, 80.22114796134996, 96.46325897785448, 0.48510639999999966, 240.0, 805, 572507, 823, 26.816591900000276
824, 6.929958027676122, 80.24688254504946, 96.47513840258421, 0.48429639999999996, 315.0, 995, 573502, 824, 31.556751900000563
825, 6.744738774489885, 80.01372233891891, 96.1920923998127, 0.48353004999999977, 185.0, 708, 574210, 825, 23.98309490000065
826, 5.333174562150871, 79.85968371237817, 95.98333803200492, 0.48288430000000004, 210.0, 727, 574937, 826, 20.223481600000014
827, 5.8936149147464265, 80.24045554773132, 96.45215872010188, 0.4822556499999996, 170.0, 670, 575607, 827, 16.69043800000054
828, 6.946431581491925, 80.16921331132178, 96.35990162772892, 0.48145510000000014, 365.0, 1109, 576716, 828, 30.380930000000262
829, 7.818058822348359, 80.16412497702099, 96.38817573729015, 0.48065365000000004, 95.0, 672, 577388, 829, 16.884601899999325
830, 7.763186902111162, 80.27305742823435, 96.4949607712066, 0.47997550000000005, 345.0, 835, 578223, 830, 25.663295400000607
831, 6.394125532136612, 80.26973768065824, 96.54343585467282, 0.47941119999999987, 115.0, 419, 578642, 831, 15.54039769999963
832, 4.723195930905842, 80.16639912279346, 96.27912469625905, 0.4789737999999999, 105.0, 553, 579195, 832, 14.64603310000075
833, 10.843254379180475, 80.16264694372263, 96.48008903582615, 0.47846484999999994, 60.0, 578, 579773, 833, 15.559633799999574
834, 7.23023604994337, 79.72418278661267, 95.81970305043488, 0.4778393499999999, 175.0, 812, 580585, 834, 22.43826220000028
835, 9.482962861016532, 79.7116129652362, 95.86880459651769, 0.47699244999999996, 190.0, 1070, 581655, 835, 29.066536299999825
836, 5.095455741935123, 79.54024855546125, 95.56710800411194, 0.47628235, 85.0, 508, 582163, 836, 12.675761199999215
837, 7.205254582681472, 79.57815687043819, 95.65271690930044, 0.4756807000000001, 190.0, 829, 582992, 837, 23.108317900000657
838, 7.635288727437833, 79.64429742577542, 95.75411537443973, 0.47474290000000036, 295.0, 1255, 584247, 838, 32.33672600000045
839, 5.084226529949303, 79.63854781246856, 95.74908460666201, 0.47379384999999946, 230.0, 854, 585101, 839, 24.462039199999708
840, 6.784158822585702, 79.70601427686084, 95.83430115556543, 0.47291815000000004, 345.0, 1092, 586193, 840, 30.901388100000077
841, 7.353287338064267, 79.83268724751268, 95.94858502119015, 0.4721108500000002, 75.0, 702, 586895, 841, 17.804494399999385
842, 9.37547195112171, 79.51572613756196, 95.62014190289153, 0.47147365, 180.0, 714, 587609, 842, 20.376415600000655
843, 6.563251866099169, 79.56111191849574, 95.64543095269167, 0.4709764000000001, 40.0, 391, 588000, 843, 12.739674999999806
844, 8.41925600733397, 80.01077165629343, 96.22318385039378, 0.4706334999999999, 35.0, 371, 588371, 844, 11.935776999999689
845, 5.4536535813854226, 79.50739371723755, 95.4936846869735, 0.47016190000000013, 45.0, 677, 589048, 845, 21.52083279999988
846, 5.610693176061411, 79.61381030984437, 95.67478267652365, 0.46955979999999975, 125.0, 661, 589709, 846, 18.613312000000406
847, 6.106825736584142, 79.41714875187192, 95.48937240668705, 0.46885914999999995, 165.0, 896, 590605, 847, 25.229868200000055
848, 6.024613314146651, 79.41715267248321, 95.44409567849678, 0.4679942499999997, 220.0, 1026, 591631, 848, 30.575993899999958
849, 6.5548695860851875, 79.45602107692409, 95.46659205343103, 0.4672162, 175.0, 703, 592334, 849, 24.424760500000048
850, 7.9979560703212105, 79.3806919415177, 95.4741149695745, 0.4666672000000001, 95.0, 517, 592851, 850, 15.335460800000874
851, 9.869696462641972, 79.63771999658448, 95.89417966100727, 0.46616499999999983, 155.0, 599, 593450, 851, 17.910784200001217
852, 5.730340448124502, 79.50794319335571, 95.4999161794514, 0.46559484999999984, 185.0, 668, 594118, 852, 18.578411600001346
853, 6.742085843745093, 79.5302057285195, 95.61725569434952, 0.46506790000000003, 75.0, 503, 594621, 853, 14.37763029999951
854, 8.10924354256489, 79.5443582718189, 95.70754955365108, 0.4646543500000001, 95.0, 416, 595037, 854, 12.7797673999994
855, 6.670343369694059, 79.63978406976298, 95.72430450541519, 0.4641980499999999, 105.0, 598, 595635, 855, 18.847146899999643
856, 7.29201050313836, 79.4941304733621, 95.53377819126555, 0.46327150000000017, 625.0, 1461, 597096, 856, 42.425828999999794
857, 5.255903681017469, 79.41369186557753, 95.38899085741616, 0.4623067, 135.0, 683, 597779, 857, 19.007184800000687
858, 8.434608506772731, 79.40287526847803, 95.44138537396441, 0.4617127000000001, 135.0, 637, 598416, 858, 16.989280799998596
859, 5.2271834394524515, 79.53043280544757, 95.56606509452132, 0.4611915999999998, 125.0, 521, 598937, 859, 14.217126300000018
860, 8.988601736397971, 79.37282380603608, 95.52800465901693, 0.46072089999999993, 55.0, 525, 599462, 860, 13.742325700000947
861, 8.526881049358053, 79.6600763052702, 95.78459803014994, 0.4600238499999999, 265.0, 1024, 600486, 861, 30.726429700000153
862, 6.5746729868512315, 79.69274909143567, 95.69229181735061, 0.45931059999999996, 40.0, 561, 601047, 862, 16.57932819999951
863, 6.631224632912722, 79.95122162256486, 96.1297128139398, 0.45888265, 50.0, 390, 601437, 863, 11.52002259999972
864, 6.206996417746824, 79.59695221146727, 95.66130227481618, 0.4583628999999996, 180.0, 765, 602202, 864, 23.58124889999999
865, 7.418065855782458, 79.89427398115845, 96.06682043418132, 0.45724194999999973, 880.0, 1726, 603928, 865, 52.74974860000111
866, 9.090764303344177, 79.72699081363963, 95.85569284923041, 0.45622405000000005, 135.0, 536, 604464, 866, 14.215070399999604
867, 7.406494371678638, 79.87584190807124, 96.03694132370053, 0.45574794999999985, 50.0, 522, 604986, 867, 14.940201800000068
868, 7.924623699772284, 79.62255212175587, 95.72380985933192, 0.45522235000000016, 135.0, 646, 605632, 868, 19.670811400001185
869, 8.798104615476605, 79.75308340656268, 95.91741995104479, 0.4546463500000001, 210.0, 634, 606266, 869, 18.093052799998986
870, 6.542023053802204, 79.78908978158107, 95.90311364172905, 0.4539249999999997, 200.0, 969, 607235, 870, 26.66062420000162
871, 7.580429278813114, 79.83569864532964, 96.02222182734184, 0.45309925, 220.0, 866, 608101, 871, 23.010031899999376
872, 9.921087453591413, 79.84287176847941, 95.95824836282169, 0.4524877, 65.0, 493, 608594, 872, 12.514389599999049
873, 6.2456616107464065, 79.7192087770082, 95.75949932315008, 0.4517983, 305.0, 1039, 609633, 873, 26.050043299999743
874, 8.038609795536725, 80.04309657312209, 96.24651817198722, 0.4507727500000001, 175.0, 1240, 610873, 874, 31.392576700000063
875, 6.685818822340038, 80.0513640635903, 96.18638373673902, 0.4497008499999999, 310.0, 1142, 612015, 875, 28.78034049999951
876, 6.631083773197951, 80.11058648003473, 96.28545171667028, 0.4488832, 125.0, 675, 612690, 876, 16.594551899999715
877, 7.672320541184084, 80.16650592625263, 96.36582751769399, 0.4481375500000002, 210.0, 982, 613672, 877, 24.83446399999957
878, 6.242436393651052, 80.19049169339432, 96.3690632844777, 0.4472429499999997, 410.0, 1006, 614678, 878, 26.72567909999998
879, 7.049202792385485, 79.88686087243845, 95.99797137994416, 0.4465323999999998, 175.0, 573, 615251, 879, 16.118926700000884
880, 5.83517253308208, 80.1545593425596, 96.32158751931566, 0.44589744999999975, 340.0, 838, 616089, 880, 23.493865300000834
881, 8.334921915853537, 80.15040541899683, 96.33872120872826, 0.4452175, 145.0, 673, 616762, 881, 18.924525899999935
882, 6.5804816464954445, 80.07632569286311, 96.24687936372847, 0.4447220500000001, 75.0, 428, 617190, 882, 12.186666399999012
883, 6.450538656016661, 80.27261267567133, 96.49342102123097, 0.44433954999999975, 35.0, 422, 617612, 883, 11.745572199999515
884, 6.853601960739509, 80.19428027777502, 96.3673845862374, 0.4437064000000002, 235.0, 985, 618597, 884, 27.71016149999923
885, 7.832903131532512, 79.99430881429215, 96.12798524085689, 0.44285229999999953, 150.0, 913, 619510, 885, 25.70147960000031
886, 6.761666711836831, 80.30243060837931, 96.50143586343793, 0.44195905, 350.0, 1072, 620582, 886, 30.373872800000754
887, 6.496716938949213, 80.21630946833913, 96.30095132967321, 0.44129215, 50.0, 410, 620992, 887, 11.586288699998477
888, 5.86374311720372, 80.50385418840567, 96.71263789663891, 0.4408317999999999, 40.0, 613, 621605, 888, 17.446718400000464
889, 7.733253592065491, 80.45264631341266, 96.72693828962237, 0.44012619999999963, 135.0, 955, 622560, 889, 26.99589399999968
890, 7.080691645756878, 80.35500600655091, 96.58110425037704, 0.43933105, 145.0, 812, 623372, 890, 22.6768602000011
891, 6.395575510473813, 80.41141919304343, 96.67465737735525, 0.4387743999999998, 55.0, 425, 623797, 891, 12.006883000000016
892, 7.573034518952422, 80.58645523650736, 96.9028527102893, 0.4382987500000001, 150.0, 632, 624429, 892, 18.000619099999312
893, 6.764951094087348, 80.57920473550696, 96.86552537971711, 0.4375661499999999, 335.0, 996, 625425, 893, 28.57163059999948
894, 8.52703688523126, 80.30507714407784, 96.50019412570529, 0.43683445000000004, 165.0, 630, 626055, 894, 18.220236200000727
895, 7.135911539196968, 80.50254011958478, 96.7728120367211, 0.43617744999999997, 60.0, 830, 626885, 895, 23.59888890000002
896, 7.741044474991074, 80.71214603011016, 97.06314006732528, 0.4355213500000002, 155.0, 628, 627513, 896, 17.94870660000015
897, 7.374835851995036, 80.43609333835907, 96.72950229621988, 0.4348621, 185.0, 837, 628350, 897, 23.523457600000256
898, 9.706381019477437, 80.47902006754062, 96.74806416209151, 0.4341164500000003, 195.0, 820, 629170, 898, 23.103736900000513
899, 8.333750909512482, 80.51328221884359, 96.76539165193441, 0.4334022999999999, 215.0, 767, 629937, 899, 22.15251299999909
900, 6.8205516595417635, 79.6746692214725, 95.69491931345027, 0.43257250000000025, 425.0, 1077, 631014, 900, 31.087951299999986
901, 6.413697294742462, 79.6023634952378, 95.62248106876693, 0.43186194999999994, 70.0, 502, 631516, 901, 14.48174680000011
902, 7.662240752877679, 79.66275253775734, 95.73094176286422, 0.43127830000000017, 170.0, 795, 632311, 902, 23.146883100000196
903, 7.743388451183566, 79.52033043517092, 95.61225458455924, 0.4306388500000001, 110.0, 626, 632937, 903, 18.247337999999218
904, 6.3849903029036135, 79.39515853949453, 95.36683528567698, 0.43005250000000006, 135.0, 677, 633614, 904, 19.6408449999999
905, 9.2397358939163, 79.49598340318164, 95.64268944117342, 0.4294467999999999, 155.0, 669, 634283, 905, 19.18000690000008
906, 8.788308786135616, 79.59595735038647, 95.69237768745728, 0.42858504999999986, 260.0, 1246, 635529, 906, 35.70849310000085
907, 11.439540457043371, 79.45841861173763, 95.6067133289788, 0.4277845, 90.0, 533, 636062, 907, 15.576215799999773
908, 5.892396553826936, 79.41455706317993, 95.36550738630193, 0.42699430000000027, 230.0, 1223, 637285, 908, 35.34411349999937
909, 8.729198337837527, 79.69840608444889, 95.80421898428318, 0.4260371499999996, 165.0, 904, 638189, 909, 26.367563199999495
910, 8.17221639819865, 79.73914758934166, 95.91068980378925, 0.42539184999999985, 100.0, 530, 638719, 910, 15.364907899998798
911, 4.938032662806411, 79.4327706694603, 95.36999221642812, 0.42498054999999996, 45.0, 384, 639103, 911, 11.145121800000197
912, 6.9780725241329575, 79.49576054137037, 95.52418260833167, 0.4243766500000001, 155.0, 958, 640061, 912, 27.864728500000638
913, 8.585373815120413, 78.16562090653639, 93.96313853630653, 0.4234775499999998, 365.0, 1040, 641101, 913, 30.514389799998753
914, 5.520442473569086, 78.02259013766334, 93.67312497941275, 0.42278274999999993, 50.0, 504, 641605, 914, 15.078237399999125
915, 8.00785214172191, 78.27892357962472, 94.01118879558659, 0.42223465000000004, 130.0, 714, 642319, 915, 20.924492199999804
916, 7.813650873203585, 78.1789323894027, 93.96314916423722, 0.4213625500000004, 395.0, 1224, 643543, 916, 36.01275859999987
917, 7.2315590444422035, 78.20278645795727, 93.978324326041, 0.4205682999999999, 105.0, 541, 644084, 917, 16.071588099999644
918, 8.226092395731103, 78.11136504764188, 93.8914783812207, 0.4200220000000002, 120.0, 673, 644757, 918, 19.927677400000903
919, 8.537812856871518, 78.13709909742336, 93.94240074667853, 0.4194163000000002, 125.0, 673, 645430, 919, 20.042480399999477
920, 8.019252975253666, 78.24037153574983, 94.0121614614963, 0.4186648000000003, 515.0, 997, 646427, 920, 29.309583599999314
921, 7.264039703572885, 78.20515894913746, 93.99607142809042, 0.4177674999999998, 175.0, 997, 647424, 921, 29.556692000000112
922, 8.139566146001162, 78.07696418712858, 93.84000881338181, 0.4169709999999999, 210.0, 773, 648197, 922, 23.208260400000654
923, 10.34428983167106, 78.18854169834582, 94.03896431224432, 0.4162329999999997, 185.0, 867, 649064, 923, 25.836587600000712
924, 6.426529399518456, 77.91559408392224, 93.70491737978799, 0.4156412499999998, 45.0, 448, 649512, 924, 13.657884500000364
925, 10.303975649621623, 78.11508186127116, 93.98298888826429, 0.4150692999999999, 115.0, 823, 650335, 925, 24.553247499999998
926, 6.619311497420101, 78.00287283857855, 93.71147932679811, 0.41423230000000016, 620.0, 1037, 651372, 926, 31.059685700000045
927, 8.291588699399181, 78.04074529542869, 93.79531298642819, 0.41329134999999967, 425.0, 1054, 652426, 927, 31.55059439999968
928, 7.506345454496997, 77.98307738531203, 93.62195443652925, 0.4126280500000001, 95.0, 420, 652846, 928, 12.58393950000027
929, 7.128282426184244, 78.16022054917543, 93.92890525677699, 0.4122676, 75.0, 381, 653227, 929, 11.419028199999957
930, 7.030105858900637, 78.05021738256299, 93.76526350345252, 0.4118099500000001, 120.0, 636, 653863, 930, 19.273132899999837
931, 7.60858312857897, 78.09591405478953, 93.85800462743045, 0.4111426, 300.0, 847, 654710, 931, 25.29622500000005
932, 4.857373154823106, 78.03172126362342, 93.72689162392653, 0.41046669999999996, 210.0, 655, 655365, 932, 19.693053000000873
933, 8.243811195174725, 78.06625646524155, 93.82296489679014, 0.4098902499999999, 95.0, 626, 655991, 933, 18.840883400000166
934, 8.05845382578999, 78.19041845758696, 94.00759710563695, 0.40931199999999973, 105.0, 659, 656650, 934, 19.76066449999962
935, 8.618628994076975, 78.1401216886021, 93.95004474627859, 0.4087301499999999, 165.0, 634, 657284, 935, 18.983635599999616
936, 6.9283521813816495, 78.06528019657841, 93.8038878942419, 0.40814110000000003, 190.0, 675, 657959, 936, 20.634557700001096
937, 6.737386601886579, 78.08563840593611, 93.82522106715611, 0.4075223500000001, 195.0, 700, 658659, 937, 21.221985300000597
938, 5.871542801258158, 77.90348517169447, 93.59371351935376, 0.40691890000000025, 120.0, 641, 659300, 938, 19.402076799999122
939, 7.444787397134451, 77.80573608021678, 93.56009971712842, 0.40626594999999965, 220.0, 810, 660110, 939, 24.625789800000348
940, 7.5877462005669605, 78.00869251629646, 93.71873221837808, 0.40550679999999995, 180.0, 877, 660987, 940, 26.545827899999495
941, 7.952649599489043, 77.97943724837958, 93.70314319460999, 0.40474494999999994, 210.0, 816, 661803, 941, 25.0996600999988
942, 8.012991324564611, 77.99209679632384, 93.70877590694943, 0.40409470000000014, 70.0, 629, 662432, 942, 19.14020730000084
943, 6.409526154974698, 77.97865344936365, 93.7104940871367, 0.40352049999999984, 90.0, 647, 663079, 943, 19.791201800000636
944, 8.21028131550109, 77.87090696405481, 93.56045523043032, 0.40274335, 435.0, 1080, 664159, 944, 33.020940399999745
945, 7.452285855464838, 78.01695972133327, 93.75160687420819, 0.40192435000000004, 210.0, 740, 664899, 945, 22.362810999999056
946, 5.707099817341489, 78.06189102369316, 93.70810311444328, 0.4013816500000002, 35.0, 466, 665365, 946, 14.009758599999259
947, 7.957131115773628, 77.99943410939184, 93.77596812281115, 0.40084569999999975, 165.0, 725, 666090, 947, 22.574399400000402
948, 6.8871044756046365, 78.06896429645772, 93.80086745048055, 0.40034305, 30.0, 392, 666482, 948, 12.212092800000391
949, 8.991348114435283, 78.08316929343331, 93.84980154453149, 0.3998053000000002, 100.0, 803, 667285, 949, 24.70445370000016
950, 6.6409352324078625, 78.0484530741586, 93.79899025361573, 0.3992284000000001, 40.0, 479, 667764, 950, 14.750299700001051
951, 6.721056841660378, 77.91476489222327, 93.59002009547034, 0.39862584999999995, 190.0, 860, 668624, 951, 26.36200910000116
952, 9.038225655377932, 77.96875733093411, 93.69995717839099, 0.3980547999999999, 50.0, 409, 669033, 952, 12.651964700000462
953, 9.530051869887721, 78.07370730749697, 93.90403265135924, 0.39745585000000017, 280.0, 922, 669955, 953, 28.57222919999913
954, 8.563564033071152, 76.34479038620455, 91.7674865354531, 0.3966678999999999, 180.0, 829, 670784, 954, 25.678673599999456
955, 9.041381079839788, 76.29755280317298, 91.7529601201723, 0.3960117999999999, 145.0, 629, 671413, 955, 19.413874800000485
956, 6.440478229663948, 76.23898489712539, 91.53894856529779, 0.3952539999999997, 500.0, 1055, 672468, 956, 32.53470700000071
957, 4.85456353046217, 75.92565132807759, 91.17904448277741, 0.39459384999999997, 25.0, 412, 672880, 957, 12.777307199999996
958, 6.7329500748423605, 76.21629397312502, 91.54283781206415, 0.39404799999999995, 155.0, 801, 673681, 958, 24.892451199999414
959, 7.055125969069083, 76.27765961864111, 91.6680798737899, 0.39351159999999996, 90.0, 391, 674072, 959, 12.172368199999255
960, 10.68584732632888, 76.27478792290938, 91.6370812064723, 0.39316464999999984, 90.0, 380, 674452, 960, 11.91947220000111
961, 9.929187171339276, 76.47068674155915, 91.97643114371128, 0.3927677499999999, 50.0, 502, 674954, 961, 15.369132400001035
962, 5.48737373520404, 75.98311181216614, 91.24829508835481, 0.39229569999999986, 70.0, 547, 675501, 962, 16.927730400000655
963, 7.820942027871632, 76.27823021940863, 91.72753837560917, 0.3916297, 185.0, 933, 676434, 963, 29.017563900000823
964, 6.107533128465211, 76.27490847585034, 91.62218772078283, 0.39070539999999987, 485.0, 1121, 677555, 964, 34.69678709999971
965, 11.248474964889091, 76.33920949533444, 91.8385433669484, 0.3898085499999999, 255.0, 872, 678427, 965, 27.049631800000498
966, 8.089865540376021, 76.18767480244712, 91.541350803678, 0.3889625500000002, 295.0, 1008, 679435, 966, 31.641998199998852
967, 6.174663251394506, 76.23225779423629, 91.55533687659846, 0.38833300000000004, 30.0, 391, 679826, 967, 12.18261849999908
968, 4.391098348321496, 75.91878390050196, 91.12749665648073, 0.38799325, 50.0, 364, 680190, 968, 11.596717700000227
969, 7.070656752649192, 75.56903134214015, 90.8223734435196, 0.3873385, 205.0, 1091, 681281, 969, 34.615954000000784
970, 8.740184972843144, 75.66239774693324, 90.98167440744751, 0.38652534999999993, 110.0, 716, 681997, 970, 22.478251500000624
971, 5.948832866329123, 75.56046002347705, 90.75876973380505, 0.3859475499999999, 90.0, 568, 682565, 971, 17.868004199999632
972, 6.347506773096836, 75.61982985995463, 90.87630666012795, 0.3854201499999999, 75.0, 604, 683169, 972, 18.89282479999929
973, 8.08280176765034, 75.41684462930122, 90.58254089972608, 0.3847033000000001, 210.0, 989, 684158, 973, 31.244713899999624
974, 6.48002209131293, 75.457249320953, 90.62607328901407, 0.3838136499999996, 230.0, 988, 685146, 974, 31.158149900000353
975, 6.231891216116749, 75.70421392559128, 90.97544454099253, 0.3829411000000001, 360.0, 951, 686097, 975, 29.953331400000025
976, 5.854058350212083, 75.65729199301072, 90.86250097168204, 0.3820460500000003, 355.0, 1038, 687135, 976, 32.73798910000005
977, 5.149959190591668, 75.53154752495584, 90.6840357619725, 0.3814187500000001, 30.0, 356, 687491, 977, 11.276281000000381
978, 6.839459793729547, 75.66353898225007, 90.94901678768205, 0.3810762999999999, 30.0, 405, 687896, 978, 12.749620200000209
979, 7.553120516240597, 75.71808220564954, 90.97690149318953, 0.38060065, 70.0, 652, 688548, 979, 20.803234999999404
980, 8.074099892978188, 75.73628441241148, 91.03604561785143, 0.37999449999999996, 105.0, 695, 689243, 980, 22.148941400000695
981, 7.032562426451979, 75.58761614218525, 90.81582803209427, 0.3794077, 85.0, 609, 689852, 981, 19.218360299999404
982, 6.262986979258775, 74.94096371197473, 90.06812130607386, 0.37861569999999994, 445.0, 1151, 691003, 982, 36.45186889999968
983, 6.853295406692565, 74.903129374412, 90.0340963992374, 0.3776923000000001, 130.0, 901, 691904, 983, 28.555838700000095
984, 7.93818657537081, 74.8698075017914, 89.93272899258912, 0.37700289999999986, 80.0, 631, 692535, 984, 20.37258269999984
985, 9.8878214892076, 74.98722459442762, 90.15314904037787, 0.37649844999999993, 55.0, 490, 693025, 985, 15.665586299999632
986, 8.454048749625306, 74.94744728184953, 90.06956543097516, 0.37585135000000014, 155.0, 948, 693973, 986, 30.294411599999876
987, 6.767918247124728, 74.8299801456227, 89.92734281652113, 0.3750422500000002, 170.0, 850, 694823, 987, 27.363313500000004
988, 6.008801264519041, 74.93273628841747, 90.04532614621249, 0.3745013499999999, 50.0, 352, 695175, 988, 11.388523800000257
989, 7.33818755735674, 74.95796955346769, 90.0556282501034, 0.3739752999999998, 335.0, 817, 695992, 989, 25.854137399999672
990, 6.123142276706912, 74.81148355960013, 89.81751706587707, 0.3733497999999999, 130.0, 573, 696565, 990, 19.29812569999922
991, 7.304961959217724, 74.90916118421053, 90.04345501548366, 0.37266444999999976, 225.0, 950, 697515, 991, 30.75360670000009
992, 5.907743193907305, 74.85855170512163, 89.93969278877599, 0.37194399999999983, 170.0, 651, 698166, 992, 20.786549800001012
993, 6.982593116279584, 74.83958003026606, 89.9082843700419, 0.3709652499999999, 595.0, 1524, 699690, 993, 48.84408690000055
994, 11.802541676591686, 74.8495510182482, 90.03985364386376, 0.37011025000000003, 60.0, 376, 700066, 994, 12.487769000001208
995, 7.61472956570175, 74.13486936227109, 89.06788569020014, 0.3693916000000003, 380.0, 1221, 701287, 995, 38.87515469999926
996, 7.514273752434376, 74.09276196608229, 89.03257364529935, 0.3685280499999998, 130.0, 698, 701985, 996, 22.56887479999932
997, 6.765465794154156, 74.22705481572406, 89.14481286256893, 0.36799525, 55.0, 486, 702471, 997, 15.751867199998742
998, 8.345072607227573, 74.27317434368712, 89.23670682040128, 0.36753895000000014, 105.0, 528, 702999, 998, 17.03444689999924
999, 7.435783295051276, 74.07955926135905, 89.00263896497708, 0.3669305499999997, 225.0, 824, 703823, 999, 26.6860601999997
1000, 6.8849252376759225, 74.16680954126447, 89.12784035133129, 0.3662793999999998, 70.0, 623, 704446, 1000, 20.34886320000078
1001, 8.57139240174699, 74.16075146582818, 89.09918380692558, 0.36569214999999977, 120.0, 682, 705128, 1001, 22.096895599999698
1002, 5.366507305013019, 74.03703475629212, 88.88069372160304, 0.36513009999999996, 50.0, 567, 705695, 1002, 18.481930900001316
1003, 9.212557288883913, 73.8406973174124, 88.74700157088462, 0.36451854999999994, 135.0, 792, 706487, 1003, 25.8247367999993
1004, 7.321175423790952, 74.08255417189912, 88.97370110014955, 0.36386155, 115.0, 668, 707155, 1004, 21.729728899999827
1005, 8.098050227306919, 74.05601544836078, 89.04217458325763, 0.3633868, 40.0, 387, 707542, 1005, 12.844085599999744
1006, 6.543811670239675, 74.23888005739994, 89.14115097990566, 0.3627837999999997, 155.0, 953, 708495, 1006, 31.26419370000076
1007, 5.8176458239555355, 73.99628918217678, 88.91616664213292, 0.3621254499999998, 165.0, 510, 709005, 1007, 16.825884799998676
1008, 7.402175167671672, 74.03289571502398, 88.8697130892758, 0.3615125499999998, 210.0, 852, 709857, 1008, 28.13696180000079
1009, 7.787481597432371, 73.81172206559854, 88.68062245628218, 0.36066070000000006, 295.0, 1041, 710898, 1009, 33.942568100001154
1010, 6.106915384531021, 73.73952499947897, 88.6128218860161, 0.36000774999999985, 80.0, 410, 711308, 1010, 13.690781999999672
1011, 9.243337659331946, 73.80439145828102, 88.74166225164896, 0.35930530000000005, 185.0, 1151, 712459, 1011, 37.591959999999744
1012, 8.143897343776189, 73.931123316288, 88.81942620873451, 0.35855694999999976, 60.0, 512, 712971, 1012, 16.81301480000002
1013, 8.399430082855272, 73.7881637320799, 88.68171476850323, 0.35759215000000016, 485.0, 1632, 714603, 1013, 53.60806550000052
1014, 9.08495200791347, 73.94439016961931, 88.92049294575035, 0.35667909999999986, 20.0, 397, 715000, 1014, 13.376715700000204
1015, 4.785492905348107, 73.58609262411146, 88.35264224591462, 0.3560036499999999, 215.0, 1104, 716104, 1015, 36.80069410000033
1016, 5.604498362635633, 73.78050275306666, 88.61511471509267, 0.35502399999999995, 240.0, 1073, 717177, 1016, 35.328848999999536
1017, 6.218842557326102, 73.91549605172031, 88.81057637741863, 0.35421309999999995, 145.0, 729, 717906, 1017, 24.359990099999777
1018, 7.232234830127991, 73.77732750250368, 88.66790711539132, 0.35344404999999995, 255.0, 980, 718886, 1018, 32.68708969999898
1019, 8.239179120889714, 73.87626640365328, 88.80975203770055, 0.35277670000000005, 75.0, 503, 719389, 1019, 16.664844799999628
1020, 7.988654830324368, 73.63423437884474, 88.53845359021284, 0.35226459999999993, 20.0, 635, 720024, 1020, 21.149565200001234
1021, 5.125247737464424, 73.4510880433596, 88.2331215601701, 0.35179164999999996, 75.0, 416, 720440, 1021, 13.931600900001285
1022, 5.594182388632291, 73.33670731204444, 88.02845242579565, 0.3514366, 50.0, 373, 720813, 1022, 12.56726080000044
1023, 5.9026413988178374, 73.53039360046387, 88.30484649148269, 0.35091864999999994, 180.0, 778, 721591, 1023, 25.90050549999978
1024, 7.791866149933588, 73.41809939569042, 88.25668198062527, 0.3501221499999996, 260.0, 992, 722583, 1024, 33.5645786999994
1025, 6.412538493501191, 73.47886301036651, 88.215173573364, 0.34924645, 140.0, 954, 723537, 1025, 31.811647200000152
1026, 7.193522502842066, 73.416668247383, 88.20571507455298, 0.3485062000000001, 140.0, 691, 724228, 1026, 23.21030830000018
1027, 8.72485720386726, 73.47201058902547, 88.34320051797737, 0.34788430000000015, 180.0, 691, 724919, 1027, 23.18204970000079
1028, 7.236624878207796, 73.237631117229, 87.96239126824945, 0.34718679999999985, 200.0, 859, 725778, 1028, 28.600892100001147
1029, 7.945146755098154, 73.34075151388637, 88.16339788954859, 0.3465185500000001, 95.0, 626, 726404, 1029, 21.38087749999977
1030, 5.191099572319317, 73.33383039994673, 88.04403393677991, 0.3459249999999998, 210.0, 693, 727097, 1030, 23.291379599999345
1031, 7.368907367585414, 73.34375834800198, 88.1416136465457, 0.34513299999999997, 315.0, 1067, 728164, 1031, 35.80973190000077
1032, 8.265125721590273, 73.33707237572506, 88.13586412627122, 0.34413085000000027, 160.0, 1160, 729324, 1032, 39.20325489999959
1033, 5.94903440555328, 72.49155365930845, 87.02318440398125, 0.3430832499999996, 170.0, 1168, 730492, 1033, 39.43214759999864
1034, 8.756122854716601, 71.55646677896486, 86.07346610481858, 0.34205005, 420.0, 1128, 731620, 1034, 37.992938100000174
1035, 9.299812820189262, 71.60069236447734, 86.08355016605829, 0.3412076499999999, 155.0, 744, 732364, 1035, 25.074599399998988
1036, 8.037511120185139, 71.62872731366495, 86.1170055839959, 0.3405870999999999, 120.0, 635, 732999, 1036, 22.167157199999565
1037, 4.922870251410507, 71.28132337682388, 85.58901452802425, 0.34000300000000006, 130.0, 663, 733662, 1037, 19.42840239999896
1038, 6.234720093741061, 71.66781069978755, 86.1782898923184, 0.3394931500000001, 115.0, 470, 734132, 1038, 13.66694649999954
1039, 4.78713052864339, 71.35734740672844, 85.6927726418906, 0.339103, 80.0, 397, 734529, 1039, 11.821929599998839
1040, 6.618832939592809, 71.38784042147725, 85.73813523813583, 0.3386962, 155.0, 507, 735036, 1040, 14.872739399999773
1041, 7.12501742270063, 71.2794317077188, 85.64037619198069, 0.3381620499999998, 130.0, 680, 735716, 1041, 20.07475180000074
1042, 7.120671716719313, 71.26820611885712, 85.64385342019771, 0.3375405999999998, 120.0, 701, 736417, 1042, 20.46374830000059
1043, 7.4112534803036905, 71.23499666665488, 85.63124808712283, 0.33703884999999995, 65.0, 414, 736831, 1043, 11.992620200000601
1044, 9.219440422632356, 71.42956918980245, 85.89328892014933, 0.3365695000000001, 110.0, 629, 737460, 1044, 18.462564000001294
1045, 6.665303440025176, 71.30421922771075, 85.64331856938719, 0.33581484999999994, 510.0, 1048, 738508, 1045, 30.229395500000464
1046, 8.231604277969726, 71.3727026046077, 85.783913383001, 0.33505885, 110.0, 632, 739140, 1046, 18.43187020000005
1047, 6.670870930515378, 71.28644945063975, 85.63363930594893, 0.3342106000000003, 275.0, 1253, 740393, 1047, 36.735697099999015
1048, 6.9231735541820525, 71.07466738891601, 85.39807495117188, 0.33342174999999985, 120.0, 500, 740893, 1048, 14.739668000000165
1049, 6.992702350230284, 71.21062516763176, 85.64375554474307, 0.3330369999999999, 50.0, 355, 741248, 1049, 10.430234600000404
1050, 10.738436776187138, 71.36415469400431, 85.82601124260708, 0.3326373999999998, 180.0, 533, 741781, 1050, 15.929701699998986
1051, 9.95687424970499, 71.46386015558818, 85.88032210016826, 0.33209874999999994, 145.0, 664, 742445, 1051, 19.491034099999524
1052, 5.456175177369588, 70.97703087889118, 85.19099850124783, 0.33161769999999996, 10.0, 405, 742850, 1052, 12.14932410000074
1053, 6.307648790686318, 70.97315928998512, 85.24589611439222, 0.3311951499999999, 60.0, 534, 743384, 1053, 15.657587500001682
1054, 5.776922464889673, 71.28895884841236, 85.5887182434993, 0.3307739500000001, 30.0, 402, 743786, 1054, 11.731541400000424
1055, 7.1453279649071835, 71.0505179236917, 85.29966588113822, 0.33040944999999994, 25.0, 408, 744194, 1055, 12.13336160000108
1056, 5.892002271760625, 71.08686391930831, 85.32163482799865, 0.32991804999999985, 70.0, 684, 744878, 1056, 20.023579799999425
1057, 10.091266632241172, 71.04172101407438, 85.38276359970506, 0.3292772499999999, 130.0, 740, 745618, 1057, 22.24314140000024
1058, 9.492663128035408, 71.08289076066983, 85.45372565621253, 0.32873319999999995, 120.0, 469, 746087, 1058, 13.878818299999693
1059, 8.93679307739013, 71.24977449342316, 85.62161548464906, 0.3281549500000001, 190.0, 816, 746903, 1059, 24.034449299999324
1060, 6.96607083741901, 71.07692410367207, 85.42042928158658, 0.327556, 80.0, 515, 747418, 1060, 15.199124100001427
1061, 7.802641272629207, 71.21541872924229, 85.61565166689314, 0.32684725, 500.0, 1060, 748478, 1061, 31.205981400000383
1062, 7.339687905656664, 70.97565488313374, 85.30659968727514, 0.32619925, 30.0, 380, 748858, 1062, 11.26863989999947
1063, 7.141981391084879, 71.00504648117791, 85.30156129147827, 0.3253856499999999, 695.0, 1428, 750286, 1063, 42.393363999999565
1064, 6.98282969426573, 70.48406246913953, 84.66899940405, 0.32434254999999995, 180.0, 890, 751176, 1064, 26.765598399999362
1065, 6.956961487326326, 70.44084796570895, 84.62771980005779, 0.3236598999999999, 70.0, 627, 751803, 1065, 18.877866199998607
1066, 6.869151615992965, 70.53546500383476, 84.73291371537202, 0.3231964, 30.0, 403, 752206, 1066, 12.24670800000058
1067, 5.532745520253816, 70.28671732641035, 84.44996666908264, 0.3225686499999999, 300.0, 992, 753198, 1067, 29.846825600001466
1068, 9.0170477370998, 70.56428922269568, 84.86486647824728, 0.3218045500000001, 130.0, 706, 753904, 1068, 21.18165550000049
1069, 5.192156810489974, 70.29166586440698, 84.40315172380937, 0.3213063999999998, 25.0, 401, 754305, 1069, 12.103173699999388
1070, 6.597294801874252, 70.67922120689528, 84.90109296885046, 0.32079789999999986, 155.0, 729, 755034, 1070, 22.063425899999856
1071, 5.695713370860194, 70.4183331357235, 84.57827119964162, 0.32009364999999984, 165.0, 836, 755870, 1071, 25.250060099999246
1072, 7.135511505239792, 70.2771874444782, 84.4370805191933, 0.31954059999999995, 50.0, 393, 756263, 1072, 12.086762400000225
1073, 7.565287073375657, 70.49757322669029, 84.72818866372108, 0.31913335000000004, 115.0, 512, 756775, 1073, 15.537640399999873
1074, 6.731330334076945, 70.3656005081659, 84.55007376947898, 0.3184615, 160.0, 981, 757756, 1074, 29.649713599999814
1075, 5.955940350434518, 70.49133296461095, 84.6623252272471, 0.3176226999999999, 165.0, 883, 758639, 1075, 26.74666310000066
1076, 6.9192138559089535, 70.36720752042089, 84.56798705111123, 0.31671594999999997, 280.0, 1132, 759771, 1076, 34.601264700000684
1077, 8.406719902910368, 70.29252485795455, 84.43187963312323, 0.3159838, 105.0, 495, 760266, 1077, 15.409098599999197
1078, 6.339216033931364, 70.38487337346663, 84.65313178614566, 0.31550455000000005, 195.0, 570, 760836, 1078, 17.265554699999484
1079, 7.31768280247609, 70.22260084252308, 84.4128642618388, 0.3149478999999999, 115.0, 667, 761503, 1079, 20.5893673999999
1080, 7.6220383753325365, 70.17656654027225, 84.40927134652625, 0.31435704999999986, 70.0, 646, 762149, 1080, 19.781264299999748
1081, 9.857287388158717, 70.41903537938249, 84.5823670889122, 0.3137832999999999, 125.0, 629, 762778, 1081, 18.65028060000077
1082, 9.164529834802334, 69.91093911268773, 84.0009473776206, 0.31321945, 105.0, 624, 763402, 1082, 19.15599250000014
1083, 8.852501652731204, 70.22063741502441, 84.38811088550841, 0.31263130000000006, 210.0, 683, 764085, 1083, 20.93205610000041
1084, 7.145194877417577, 70.22082138977417, 84.39051373723318, 0.31194910000000003, 435.0, 833, 764918, 1084, 25.564729700001408
1085, 7.4148000881827665, 70.14318745009804, 84.26566364046519, 0.3112264000000001, 200.0, 773, 765691, 1085, 23.692361499999606
1086, 6.633339241579529, 70.15706134282819, 84.24984392956253, 0.3105374500000001, 95.0, 758, 766449, 1086, 23.034815099999832
1087, 5.512039831835233, 70.10592524443713, 84.19667962316413, 0.30970539999999996, 485.0, 1091, 767540, 1087, 33.343006799999785
1088, 8.20788380828567, 70.20389692099599, 84.36835224876855, 0.3087954999999999, 185.0, 931, 768471, 1088, 28.65760709999995
1089, 7.049454484300862, 70.22278972924579, 84.38109354233046, 0.30808359999999985, 155.0, 651, 769122, 1089, 20.135555200000454
1090, 7.36565670584712, 70.07260826755973, 84.14750947671779, 0.30754584999999995, 125.0, 544, 769666, 1090, 16.93120009999984
1091, 5.182574220360282, 70.0883631476744, 84.14923169141147, 0.30713274999999995, 75.0, 374, 770040, 1091, 11.4519693000002
1092, 7.976886905267001, 69.3354430820631, 83.28071700860255, 0.3066746499999998, 115.0, 644, 770684, 1092, 19.761820600000647
1093, 7.495198496316488, 69.56657345845149, 83.52459036020132, 0.3061508499999999, 50.0, 520, 771204, 1093, 16.020325700001194
1094, 6.070520968095922, 69.3168235191932, 83.27881516434672, 0.30534939999999977, 300.0, 1261, 772465, 1094, 39.009980099999666
1095, 6.199719121432923, 69.3554548040613, 83.29520501471185, 0.3044354499999999, 175.0, 770, 773235, 1095, 23.96994430000086
1096, 8.822357487233717, 69.51442731031732, 83.53397238432471, 0.3037874499999998, 125.0, 670, 773905, 1096, 20.83312660000047
1097, 7.272657369481305, 69.22223116987843, 83.11003313226215, 0.30322044999999986, 110.0, 590, 774495, 1097, 18.358487699999387
1098, 7.4517237999327275, 69.48412113295076, 83.43787641156445, 0.3027920499999999, 75.0, 362, 774857, 1098, 11.051736900000833
1099, 6.625109733957633, 69.65186876617702, 83.61211377034145, 0.30212064999999994, 570.0, 1130, 775987, 1099, 34.9255162999998
1100, 7.59756454783778, 69.47747746259806, 83.50412818439845, 0.30145104999999994, 50.0, 358, 776345, 1100, 11.199297399998613
1101, 5.364504946259993, 69.24190407800258, 83.15824941295924, 0.30098124999999976, 110.0, 686, 777031, 1101, 20.996225899998535
1102, 7.301045370793586, 69.41573016499768, 83.32516800638487, 0.30027699999999996, 155.0, 879, 777910, 1102, 27.25028370000109
1103, 8.394569184151731, 69.42623812061872, 83.40119098988615, 0.29959119999999984, 50.0, 645, 778555, 1103, 19.96070250000048
1104, 6.779311423029365, 69.45444840032935, 83.39022294406233, 0.29883115, 290.0, 1044, 779599, 1104, 32.42371380000077
1105, 5.549340697599732, 69.09846437177585, 82.97316066363386, 0.29806659999999996, 170.0, 655, 780254, 1105, 20.61481189999904
1106, 8.072570271226367, 68.69860631530845, 82.5835320946275, 0.2971175499999999, 385.0, 1454, 781708, 1106, 45.60293280000042
1107, 9.695470711815565, 68.84555858968744, 82.74884658305656, 0.29617929999999987, 60.0, 631, 782339, 1107, 20.037324900000385
1108, 10.298375477488133, 68.88001212731605, 82.78457828915172, 0.29549394999999984, 260.0, 892, 783231, 1108, 27.954395199998544
1109, 11.21511678211689, 68.92970055541993, 82.80764558105469, 0.2948112999999999, 80.0, 625, 783856, 1109, 19.886418699999922
1110, 6.801938465062747, 68.77024172188786, 82.6441433795829, 0.2941695999999999, 270.0, 801, 784657, 1110, 25.090208800000255
1111, 11.002424886467688, 68.86413763159868, 82.86934402370154, 0.2935220499999999, 110.0, 638, 785295, 1111, 20.2861783999997
1112, 8.261824093130349, 68.72955392565575, 82.58223173065629, 0.29277099999999984, 160.0, 1031, 786326, 1112, 32.40939629999957
1113, 10.57090246593878, 68.80353715156745, 82.70544075202262, 0.29180125, 445.0, 1124, 787450, 1113, 35.479483600000094
1114, 7.881566208561784, 69.04746845646909, 82.86737739161441, 0.29112444999999987, 55.0, 380, 787830, 1114, 12.243153600000369
1115, 8.210071229693687, 68.8879166176098, 82.79191119854266, 0.29049714999999987, 185.0, 1014, 788844, 1115, 33.288481100000354
1116, 7.894589702819004, 68.89053463792743, 82.83361542554033, 0.28966599999999987, 205.0, 833, 789677, 1116, 26.161213000001226
1117, 7.014728837052047, 68.17222509677329, 81.86897525476935, 0.28879345, 185.0, 1106, 790783, 1117, 34.81160850000015
1118, 7.305616586342472, 67.75276829504938, 81.42145987280009, 0.28792179999999995, 250.0, 831, 791614, 1118, 26.479432399999496
1119, 6.8756001213565465, 67.72760059833527, 81.38826990127563, 0.28733184999999994, 30.0, 480, 792094, 1119, 15.599408399999447
1120, 7.306851048407884, 68.0229702406916, 81.74271577802197, 0.28669825, 210.0, 928, 793022, 1120, 29.70062870000038
1121, 7.259149943954175, 67.85461530671624, 81.5534741944066, 0.28596970000000005, 175.0, 691, 793713, 1121, 22.37048749999849
1122, 9.839569004048187, 68.17820655440089, 81.99740118666503, 0.28537165, 140.0, 638, 794351, 1122, 20.466719200001535
1123, 7.574867274058814, 67.9801082698711, 81.67308340612999, 0.2844968499999999, 515.0, 1306, 795657, 1123, 42.20780279999963
1124, 6.25349018482181, 68.02246690789859, 81.68006887038548, 0.28373634999999997, 90.0, 384, 796041, 1124, 12.278435800000807
1125, 6.507357681970731, 67.95149987499376, 81.64262957122614, 0.28305369999999996, 500.0, 1133, 797174, 1125, 36.15913069999988
1126, 5.513037414044325, 68.10515244606813, 81.80563427041645, 0.2823971499999999, 40.0, 326, 797500, 1126, 10.536863499999527
1127, 6.223305484338198, 68.03278661519289, 81.68956485390663, 0.28202004999999986, 20.0, 512, 798012, 1127, 16.379599100000632
1128, 8.076276042683222, 68.15729458645865, 81.90575151544476, 0.2814921999999999, 215.0, 661, 798673, 1128, 21.395969799999875
1129, 6.636953510411884, 67.9175421640087, 81.59182038159535, 0.28070065, 470.0, 1098, 799771, 1129, 35.23264130000098
1130, 7.416284562039532, 68.3143206395601, 82.08026943708721, 0.2799329499999998, 130.0, 608, 800379, 1130, 19.793011800000386
1131, 7.668405837630705, 68.52051908250839, 82.29318956344846, 0.27943255, 35.0, 504, 800883, 1131, 16.3331732000006
1132, 8.702351507835818, 68.61243199704583, 82.47142568028958, 0.27902619999999995, 95.0, 399, 801282, 1132, 13.023656299999857
1133, 8.728683007852093, 68.47748435552462, 82.32552485227173, 0.27832554999999987, 315.0, 1158, 802440, 1133, 37.44294819999959
1134, 5.765986193640856, 68.42876361310482, 82.1570131778717, 0.27757405, 80.0, 512, 802952, 1134, 17.25769609999952
1135, 9.052814672044263, 68.61407780836198, 82.48697501543774, 0.27705969999999985, 100.0, 631, 803583, 1135, 21.29087459999937
1136, 8.643841913452855, 68.53572461495992, 82.40962541700708, 0.27636265, 165.0, 918, 804501, 1136, 29.6771176000002
1137, 8.444726947532374, 68.57683068352776, 82.43821470454924, 0.2757330999999999, 60.0, 481, 804982, 1137, 15.705873099999735
1138, 6.517054693017266, 68.51142221866267, 82.28658737522541, 0.2751530499999999, 215.0, 808, 805790, 1138, 26.418272799999613
1139, 7.766235014774463, 68.54308858867974, 82.33693774570277, 0.27454329999999993, 155.0, 547, 806337, 1139, 18.222189800000706
1140, 6.581758682301805, 68.40413092981818, 82.1621578310165, 0.27400375, 165.0, 652, 806989, 1140, 21.247475799998938
1141, 9.269603379047181, 68.51352307766298, 82.3417227056962, 0.27342595000000003, 155.0, 632, 807621, 1141, 20.840939600000638
1142, 9.437188842046709, 68.44663919321282, 82.2988890605883, 0.27286569999999977, 90.0, 613, 808234, 1142, 20.324511299999358
1143, 7.456531309719804, 68.46620854498113, 82.30490215264477, 0.27212635, 195.0, 1030, 809264, 1143, 33.747857100001056
1144, 9.221039854394373, 68.42708877445192, 82.2398277696713, 0.27148869999999986, 60.0, 387, 809651, 1144, 12.781650400000217
1145, 9.307475579184356, 67.84842610310034, 81.59829125158565, 0.27087804999999987, 355.0, 970, 810621, 1145, 31.88637799999924
1146, 9.31921665362155, 67.61347886266319, 81.23398275269008, 0.27019944999999984, 90.0, 538, 811159, 1146, 17.786575600001015
1147, 7.254567087962361, 67.48716030341778, 81.0064298268911, 0.26972425, 55.0, 518, 811677, 1147, 17.039755899999363
1148, 7.829961299933447, 67.46055375859979, 81.06839957933748, 0.2691307000000001, 270.0, 801, 812478, 1148, 26.166034700001546
1149, 9.492950454414453, 67.53747190472897, 81.19580581274842, 0.26843590000000006, 135.0, 743, 813221, 1149, 24.554029300001275
1150, 6.689723175521644, 67.62777927943638, 81.26016952877953, 0.26787475000000005, 85.0, 504, 813725, 1150, 16.790153300000384
1151, 7.065571042153893, 67.715347658483, 81.33187312428544, 0.2671866999999998, 235.0, 1025, 814750, 1151, 33.61171040000045
1152, 7.162976034113194, 67.51002814018563, 81.09680636288368, 0.26619985, 255.0, 1168, 815918, 1152, 38.33889309999904
1153, 9.65456473383104, 67.5309701054733, 81.27945197443044, 0.26538444999999994, 175.0, 644, 816562, 1153, 21.374120300000868
1154, 7.199682175872788, 67.71641587698332, 81.32981466477916, 0.26492724999999995, 45.0, 372, 816934, 1154, 12.302292699998361
1155, 7.568627198650078, 67.66106342242665, 81.30425116434051, 0.2643836499999999, 180.0, 836, 817770, 1155, 27.664242100001502
1156, 6.154130606553255, 67.69906194007069, 81.29339563278924, 0.2636955999999999, 150.0, 693, 818463, 1156, 22.976272400001108
1157, 7.594892657707452, 67.63844628298898, 81.28483200073242, 0.2630174499999998, 255.0, 814, 819277, 1157, 27.016967800000202
1158, 8.469592746099867, 68.0145356902443, 81.75657026203837, 0.26221735, 195.0, 964, 820241, 1158, 32.08815759999925
1159, 8.80661144191737, 68.9622077981425, 82.8755110824664, 0.26134930000000006, 330.0, 965, 821206, 1159, 31.66583990000072
1160, 8.861455105225728, 68.87392086085298, 82.7638696569623, 0.26039619999999986, 580.0, 1153, 822359, 1160, 38.55749239999932
1161, 10.467535680721413, 68.78470770694788, 82.64500574911794, 0.2594728, 260.0, 899, 823258, 1161, 29.791640899999038
1162, 7.307884953045609, 69.03408085284846, 82.98679891151957, 0.25884099999999993, 125.0, 505, 823763, 1162, 16.90728979999949
1163, 10.861382992562534, 68.93454613160195, 82.80020833164144, 0.2581808499999999, 315.0, 962, 824725, 1163, 31.634583200000634
1164, 8.334397238251325, 68.98587445881375, 82.88339072562553, 0.2571651999999999, 290.0, 1295, 826020, 1164, 43.15131659999861
1165, 9.251161484668652, 68.92087330893865, 82.80946793631902, 0.25635565000000005, 50.0, 504, 826524, 1165, 17.07595550000042
1166, 7.987160345653849, 68.93763113547497, 82.76961501714752, 0.25584310000000005, 120.0, 635, 827159, 1166, 21.43237279999994
1167, 8.339715111407921, 68.85720941028455, 82.70265311359489, 0.2552491, 180.0, 685, 827844, 1167, 22.953144000000975
1168, 7.159364655279578, 69.1116497638898, 83.06992545494667, 0.25466004999999986, 120.0, 624, 828468, 1168, 21.148256600001332
1169, 8.293043800078484, 69.03346953100088, 82.93899946147893, 0.25411464999999994, 50.0, 588, 829056, 1169, 19.874088500000653
1170, 6.469135445071407, 69.01369467199561, 82.92543294230305, 0.25362415, 50.0, 502, 829558, 1170, 16.982047800000146
1171, 8.398868590564515, 68.99074925583152, 82.86944286412842, 0.25316559999999994, 40.0, 517, 830075, 1171, 17.41531489999943
1172, 9.74921235356928, 68.89463643632696, 82.83218635092591, 0.2527047999999999, 45.0, 507, 830582, 1172, 17.084977299999082
1173, 5.669625417021093, 68.80666126689844, 82.60954987795095, 0.2522183499999999, 145.0, 574, 831156, 1173, 19.40139249999993
1174, 6.707707864620413, 68.85073084036509, 82.72853392759959, 0.25152804999999995, 400.0, 960, 832116, 1174, 32.658016499999576
1175, 6.835303755315739, 68.96883580065149, 82.86093937130426, 0.25086744999999994, 25.0, 508, 832624, 1175, 17.19409160000032
1176, 7.0500310561854205, 69.01076408770444, 82.89635205165945, 0.2503260999999999, 140.0, 695, 833319, 1176, 23.432593600000473
1177, 7.093055114331326, 68.9287358768955, 82.83110377736335, 0.24964344999999993, 150.0, 822, 834141, 1177, 27.93638699999974
1178, 8.140579258705642, 69.05824828684521, 82.891590940224, 0.24899364999999982, 60.0, 622, 834763, 1178, 21.12708449999991
1179, 10.670162806117078, 68.74918599536637, 82.6310228555955, 0.24856120000000004, 50.0, 339, 835102, 1179, 11.506296600000496
1180, 6.965999261551317, 68.79620691823189, 82.62627361594492, 0.24810220000000005, 120.0, 681, 835783, 1180, 23.418625399999655
1181, 7.037207563929524, 68.77943216418544, 82.58312315163037, 0.24747849999999988, 160.0, 705, 836488, 1181, 24.012426600000254
1182, 6.697012977116077, 68.80149236539515, 82.62248385414331, 0.2468475999999999, 165.0, 697, 837185, 1182, 23.69954990000042
1183, 6.978503194862863, 68.83670768668935, 82.69031923342267, 0.24603534999999985, 285.0, 1108, 838293, 1183, 37.42130290000023
1184, 8.247756380380178, 68.81329390979204, 82.7302899119893, 0.24485049999999975, 695.0, 1525, 839818, 1184, 52.00594949999868
1185, 6.43129624902645, 68.73460715463229, 82.56324505672276, 0.24392349999999996, 135.0, 535, 840353, 1185, 18.15727220000008
1186, 10.571447734016338, 68.34241608189718, 82.14286831574582, 0.24339429999999984, 80.0, 641, 840994, 1186, 21.897961799999393
1187, 6.750804314676787, 68.43128101765609, 82.23103403043346, 0.24278454999999996, 165.0, 714, 841708, 1187, 24.317781799998556
1188, 8.972022673213552, 68.51882074583766, 82.33052906551472, 0.24223329999999998, 120.0, 511, 842219, 1188, 17.513805300000968
1189, 8.534251153535807, 68.35283426313258, 82.11824605002332, 0.24170184999999994, 170.0, 670, 842889, 1189, 23.36512589999984
1190, 9.598896225198642, 68.45173228043076, 82.32987271402217, 0.24121179999999992, 75.0, 419, 843308, 1190, 14.540014000000156
1191, 7.381775868401047, 68.32895015746124, 82.01667213144228, 0.24073299999999986, 150.0, 645, 843953, 1191, 22.4246404000005
1192, 10.312441208114906, 68.45192625025454, 82.3192390430282, 0.24014709999999997, 115.0, 657, 844610, 1192, 22.762209700000312
1193, 9.75388495568464, 68.54505333402264, 82.38007681547705, 0.23954995000000004, 160.0, 670, 845280, 1193, 22.87033809999957
1194, 6.6545696357113915, 68.53562181107121, 82.34746158843625, 0.23872734999999998, 255.0, 1158, 846438, 1194, 40.06038489999992
1195, 10.894781770575257, 68.61472517186179, 82.4871062221906, 0.23779854999999978, 180.0, 906, 847344, 1195, 31.26100469999983
1196, 8.364443479239611, 68.76566756232667, 82.52596445241686, 0.23722794999999994, 80.0, 362, 847706, 1196, 12.38707869999962
1197, 7.817510761815761, 68.3334438730797, 82.05866006795185, 0.23677389999999998, 125.0, 647, 848353, 1197, 22.41559209999832
1198, 6.941744461538653, 68.42378421705597, 82.21878778766052, 0.2361961, 95.0, 637, 848990, 1198, 22.1294596000007
1199, 9.259402355644498, 68.4537014624524, 82.25296860494302, 0.23531679999999996, 365.0, 1317, 850307, 1199, 45.71945049999886
1200, 12.95399862538378, 68.75671578801563, 82.78471348900678, 0.23446944999999994, 110.0, 566, 850873, 1200, 19.599583000001076
1201, 8.33135378416312, 68.73410324484615, 82.60038154731363, 0.23394924999999994, 75.0, 590, 851463, 1201, 20.614445699999123
1202, 9.638584965561732, 68.72573131165731, 82.60025760536664, 0.23342769999999985, 85.0, 569, 852032, 1202, 19.895264799999495
1203, 9.247193307241242, 68.86629844078651, 82.69592462057595, 0.23276214999999995, 180.0, 910, 852942, 1203, 31.310771899999963
1204, 10.952567471264068, 68.66513541258882, 82.48981130243901, 0.23204169999999988, 155.0, 691, 853633, 1204, 24.25296530000014
1205, 7.544009985720239, 68.80184550675293, 82.69965496090597, 0.23141709999999982, 65.0, 697, 854330, 1205, 24.444384000000355
1206, 9.360194735419306, 68.94571862661066, 82.871561975985, 0.23087439999999995, 100.0, 509, 854839, 1206, 18.005735300001106
1207, 8.49005300661792, 69.0301941183339, 82.94018431290337, 0.23038659999999994, 120.0, 575, 855414, 1207, 20.3053837999978
1208, 7.869865901862123, 68.78321916115384, 82.61441749284248, 0.22969945000000005, 190.0, 952, 856366, 1208, 33.50613449999946
1209, 6.099686706878493, 68.79039492962289, 82.5825547280289, 0.22898709999999994, 105.0, 631, 856997, 1209, 22.47121860000334
1210, 8.721922272169184, 68.72306929395792, 82.59608961830676, 0.2279363499999998, 480.0, 1704, 858701, 1210, 58.92466919999788
1211, 6.590373638851124, 68.49280832445841, 82.24348758086758, 0.22699809999999992, 40.0, 381, 859082, 1211, 13.51862770000298
1212, 7.36926889027169, 68.79915110134621, 82.6507172899714, 0.22640454999999993, 150.0, 938, 860020, 1212, 32.54504209999868
1213, 7.9409930980678975, 68.15311273392253, 81.87671097330066, 0.22554055000000003, 350.0, 982, 861002, 1213, 34.36030759999994
1214, 7.900920360089283, 68.01942272843986, 81.77174506591031, 0.22481154999999994, 95.0, 638, 861640, 1214, 22.668777999999293
1215, 10.924849950489127, 68.13893171707518, 81.92705287217281, 0.22426074999999995, 115.0, 586, 862226, 1215, 20.961275099998602
1216, 10.215502688488582, 68.18838192079126, 81.98964563695395, 0.22362804999999986, 165.0, 820, 863046, 1216, 29.10939259999941
1217, 9.637571124275958, 68.18912068273565, 81.92943688091557, 0.2229696999999999, 180.0, 643, 863689, 1217, 22.749385999999504
1218, 7.292314260150306, 68.16082729895909, 81.83434649308522, 0.22250755, 65.0, 384, 864073, 1218, 13.782595200002106
1219, 8.51116751303088, 68.05529057861767, 81.76108656589341, 0.22183389999999992, 460.0, 1113, 865186, 1219, 39.14321680000285
1220, 6.1066100414071816, 67.9930028722594, 81.63422277518787, 0.2210436999999999, 155.0, 643, 865829, 1220, 23.080287299999327
1221, 8.52193098526453, 67.9531790562899, 81.6170889736035, 0.22042449999999997, 100.0, 733, 866562, 1221, 25.66803549999895
1222, 9.81124363027756, 68.19839918095133, 82.05347937086354, 0.21976344999999994, 100.0, 736, 867298, 1222, 25.873379699998623
1223, 11.303617493412842, 68.08810019314379, 81.93946823509022, 0.2191321, 125.0, 667, 867965, 1223, 23.808385800002725
1224, 7.472318330366403, 68.02074441197793, 81.71050143718217, 0.21840399999999996, 235.0, 951, 868916, 1224, 33.6464498000023
1225, 5.99351880589535, 68.09098141954028, 81.76586410890636, 0.21780819999999995, 75.0, 373, 869289, 1225, 13.576251600003161
1226, 8.15942604572539, 68.26561973946147, 82.09324099287366, 0.21710844999999993, 365.0, 1182, 870471, 1226, 41.742790800002695
1227, 9.396483985416028, 68.8109173750677, 82.69245732411618, 0.21630879999999988, 75.0, 595, 871066, 1227, 21.200300000000425
1228, 7.692111761432211, 68.40582251098921, 82.18283592080171, 0.21585025, 55.0, 424, 871490, 1228, 15.127744900000835
1229, 8.006310740896028, 68.74873476772073, 82.53781302226389, 0.21533049999999987, 70.0, 731, 872221, 1229, 25.760134299998754
1230, 8.79265981471051, 68.61058511558876, 82.44030163721966, 0.21446244999999992, 210.0, 1198, 873419, 1230, 43.0988279000012
1231, 8.8237180262966, 68.77378921508789, 82.6467889951623, 0.21350934999999996, 400.0, 920, 874339, 1231, 32.86364709999907
1232, 5.86832221179712, 68.70961447543785, 82.50873863345286, 0.21295809999999993, 20.0, 305, 874644, 1232, 10.970167899999069
1233, 7.6208854241510275, 68.61354557705117, 82.4639162336077, 0.21259719999999996, 35.0, 497, 875141, 1233, 18.033760300000722
1234, 8.520961553069931, 68.79926125563182, 82.6839345425186, 0.2119298499999999, 210.0, 986, 876127, 1234, 35.39722450000045
1235, 8.085860201138498, 68.55516785094262, 82.34701729917879, 0.21093849999999992, 245.0, 1217, 877344, 1235, 43.51774300000034
1236, 8.99230720961498, 68.68442128337709, 82.60155922410178, 0.2097536499999998, 725.0, 1416, 878760, 1236, 50.92404899999747
1237, 8.571126018896763, 68.6923456948901, 82.53682821034353, 0.2088046, 75.0, 693, 879453, 1237, 25.298892999999225
1238, 7.923579100268619, 68.5899593184147, 82.41671715346463, 0.20821869999999992, 95.0, 609, 880062, 1238, 22.058882400000584
1239, 7.800295803632538, 68.67887385175449, 82.50439924734076, 0.20770659999999996, 60.0, 529, 880591, 1239, 19.364939299997786
1240, 10.490058227151037, 68.75685046464535, 82.68599603657184, 0.20706264999999993, 345.0, 902, 881493, 1240, 32.76351109999814
1241, 7.171794205312853, 68.52968949658437, 82.29313789085879, 0.20632779999999995, 145.0, 731, 882224, 1241, 26.515808100000868
1242, 6.757700844244524, 68.67367429221983, 82.44960288734703, 0.20541969999999984, 320.0, 1287, 883511, 1242, 46.90400719999889
1243, 8.090168928387609, 68.60715577202122, 82.40906496813697, 0.20434735, 355.0, 1096, 884607, 1243, 39.76963180000166
1244, 9.223001916753631, 68.72304297448675, 82.55969505133724, 0.20327004999999995, 345.0, 1298, 885905, 1244, 47.01895919999879
1245, 9.916635973316088, 68.80318911977716, 82.68589276880832, 0.20215314999999992, 420.0, 1184, 887089, 1245, 43.32786770000166
1246, 7.834487024042863, 68.64349463364478, 82.50136357525133, 0.2012319999999998, 180.0, 863, 887952, 1246, 32.66463310000108
1247, 9.56428079809494, 68.73364935980902, 82.68609858838077, 0.20060874999999992, 110.0, 522, 888474, 1247, 19.119680399999197
1248, 8.751528114402037, 68.71357802795849, 82.6030984892262, 0.20006109999999996, 125.0, 695, 889169, 1248, 26.017195000000356
1249, 7.563261632306218, 68.54851847211236, 82.35793606034338, 0.1993077999999999, 185.0, 979, 890148, 1249, 36.50570660000085
1250, 9.951255932522718, 68.12453953405776, 81.91177592503489, 0.19849689999999987, 215.0, 823, 890971, 1250, 30.871566999998322
1251, 11.439344118016184, 68.38625655467527, 82.26148230828565, 0.197929, 50.0, 439, 891410, 1251, 16.093719699998474
1252, 8.371444091434267, 68.10219361825649, 81.79931788033667, 0.19755909999999993, 75.0, 383, 891793, 1252, 13.946118600000773
1253, 10.469824264463073, 68.08960316934493, 81.8340090276364, 0.1971104499999999, 135.0, 614, 892407, 1253, 22.578400900001725
1254, 8.252001276211953, 68.20348665038152, 81.93662285875918, 0.19653264999999995, 90.0, 670, 893077, 1254, 24.939631200002623
1255, 8.406108698509042, 67.85709797692677, 81.5024756658645, 0.19594764999999997, 130.0, 630, 893707, 1255, 23.237158899999486
1256, 8.140550916962345, 67.85195117203031, 81.62054973340217, 0.19548729999999995, 90.0, 393, 894100, 1256, 14.59642309999981
1257, 7.104122883780541, 68.1590895734735, 81.87836959268013, 0.19486539999999997, 225.0, 989, 895089, 1257, 36.939136699998926
1258, 8.764367769969226, 68.34398218431237, 82.13599608727984, 0.19416564999999994, 150.0, 566, 895655, 1258, 21.201208000002225
1259, 6.125959582732953, 68.0289460967409, 81.71580446683444, 0.1937529999999999, 50.0, 351, 896006, 1259, 13.298117700000148
1260, 7.594943769242831, 68.15448763260365, 81.88160317843078, 0.19329309999999994, 130.0, 671, 896677, 1260, 24.521892000000662
1261, 7.415869144264178, 67.90718178293812, 81.63064632703312, 0.19281204999999993, 50.0, 398, 897075, 1261, 14.700498499998503
1262, 8.080827613128902, 68.00082140127441, 81.58263884700675, 0.19244349999999993, 65.0, 421, 897496, 1262, 15.782816800001456
1263, 10.694679133308123, 68.25257090359725, 82.0382782309642, 0.19185535, 255.0, 886, 898382, 1263, 37.52506740000172
1264, 8.048980068009282, 68.05322078740774, 81.79321053916962, 0.19112229999999994, 180.0, 743, 899125, 1264, 28.66661390000081
1265, 10.440167061316053, 68.13927806337739, 81.95561826870842, 0.19051209999999996, 20.0, 613, 899738, 1265, 23.901811100000486
1266, 8.989071769143768, 67.41836750567259, 81.0091990466094, 0.18987805, 255.0, 796, 900534, 1266, 29.610039499999402
1267, 6.493809035560298, 67.27729043873535, 80.79400843653872, 0.18917469999999992, 230.0, 767, 901301, 1267, 28.34381050000229
1268, 9.029360936002298, 67.1335012290261, 80.69823019131748, 0.18821079999999996, 195.0, 1375, 902676, 1268, 51.42551769999773
1269, 8.960186928338066, 67.1607770293836, 80.68060450019983, 0.18735894999999997, 180.0, 518, 903194, 1269, 19.585585400000127
1270, 7.259630286857623, 67.00426183578071, 80.42618977257965, 0.1866353499999999, 365.0, 1090, 904284, 1270, 41.48473869999725
1271, 9.449077189340095, 67.14840502473267, 80.70121013384062, 0.18583794999999992, 180.0, 682, 904966, 1271, 27.31102529999771
1272, 9.11305740480046, 67.10844637602861, 80.61701092972972, 0.18507294999999988, 285.0, 1018, 905984, 1272, 37.919417500001146
1273, 7.108972674254144, 67.24292364214907, 80.83837601690009, 0.18443304999999993, 80.0, 404, 906388, 1273, 15.09390230000281
1274, 6.302339659452438, 67.11537631225586, 80.60929864501954, 0.18408249999999995, 20.0, 375, 906763, 1274, 14.057000000000698
1275, 6.826866277486006, 67.2254588391903, 80.7741770782882, 0.1835798499999999, 210.0, 742, 907505, 1275, 27.248700799998915
1276, 8.389437041003843, 67.02413305600008, 80.51643802808678, 0.18294579999999996, 95.0, 667, 908172, 1276, 24.473843699997815
1277, 7.108673794500864, 67.13691849291706, 80.63929334530698, 0.18222354999999993, 205.0, 938, 909110, 1277, 35.69371350000074
1278, 7.234633322404598, 67.18345751813663, 80.71055165157523, 0.1814666499999999, 220.0, 744, 909854, 1278, 28.200159500000154
1279, 8.69337343812932, 67.13234559765674, 80.66819191167663, 0.18067690000000003, 190.0, 1011, 910865, 1279, 38.27876710000055
1280, 6.7035577740130385, 67.01721356081408, 80.51900923529337, 0.17991234999999994, 110.0, 688, 911553, 1280, 26.892347100001643
1281, 8.326543096684668, 67.1134250494852, 80.63032944236646, 0.17922654999999993, 160.0, 836, 912389, 1281, 31.909745699998894
1282, 8.728303584121388, 67.16158125386436, 80.68698195959689, 0.17847009999999996, 335.0, 845, 913234, 1282, 32.314660600000934
1283, 10.164644946944382, 67.24013060110586, 80.89295227615922, 0.17760384999999992, 260.0, 1080, 914314, 1283, 41.18518509999922
1284, 7.556640395125432, 67.2803867196874, 80.79569857600606, 0.17685414999999993, 70.0, 586, 914900, 1284, 22.538124299997435
1285, 5.876037035912275, 67.37068440246583, 80.91917428588867, 0.17636544999999995, 145.0, 500, 915400, 1285, 19.095907799997804
1286, 7.78306413506886, 67.03884058800813, 80.57329914651555, 0.17585154999999988, 60.0, 642, 916042, 1286, 24.37980769999922
1287, 8.65920957975683, 67.38369192034195, 80.96271796533944, 0.17520669999999994, 130.0, 791, 916833, 1287, 30.30167529999744
1288, 10.911763168307914, 67.20488539730468, 80.81135614646249, 0.17452944999999992, 170.0, 714, 917547, 1288, 27.11630239999795
1289, 7.29833867647994, 67.29218827439787, 80.84992600919607, 0.17384859999999983, 135.0, 799, 918346, 1289, 30.51864619999833
1290, 8.900117709046272, 67.25534566758293, 80.89928534092047, 0.17315559999999988, 130.0, 741, 919087, 1290, 28.075132900001336
1291, 8.247625801018897, 67.1838193595754, 80.70045387400368, 0.17243289999999986, 240.0, 865, 919952, 1291, 33.44769539999834
1292, 7.134990264216826, 67.57695310715346, 81.21112679226822, 0.17181279999999996, 110.0, 513, 920465, 1292, 19.59524070000043
1293, 6.651779042870682, 67.55756508180126, 81.14587123464027, 0.17099964999999995, 285.0, 1294, 921759, 1293, 54.76906809999855
1294, 8.648770978958568, 67.59051750026694, 81.27407257323385, 0.17002224999999999, 215.0, 878, 922637, 1294, 34.40279019999798
1295, 8.687140207499601, 67.6100221719957, 81.23728207179478, 0.16914834999999995, 290.0, 1064, 923701, 1295, 41.11147379999966
1296, 11.935983600821988, 67.43052007214776, 81.16045054468616, 0.1683432999999999, 140.0, 725, 924426, 1296, 28.29181299999982
1297, 7.968780779791257, 67.42122379484631, 80.97039599342952, 0.16745004999999993, 360.0, 1260, 925686, 1297, 48.54796109999734
1298, 7.916433733082708, 67.48621579396126, 81.04489080547035, 0.16649739999999993, 115.0, 857, 926543, 1298, 33.23660590000145
1299, 8.880292467458828, 67.6440315287822, 81.30094914616765, 0.16569549999999994, 270.0, 925, 927468, 1299, 35.844303499998205
1300, 8.191190298513643, 67.52401846931095, 81.13539602642967, 0.16497684999999998, 115.0, 672, 928140, 1300, 26.168473300000187
1301, 10.988964705894595, 67.48113185849007, 81.16375357664226, 0.16436754999999995, 160.0, 682, 928822, 1301, 26.63233449999825
1302, 9.200197142562356, 67.4320487699647, 81.01587017722751, 0.16381224999999996, 70.0, 552, 929374, 1302, 21.497320500002388
1303, 8.842526755334646, 67.64085362438013, 81.32739130172439, 0.16309045000000005, 295.0, 1052, 930426, 1303, 41.563725899999554
1304, 7.649027537606099, 67.4981902378748, 81.0878787687941, 0.16245459999999992, 75.0, 361, 930787, 1304, 14.381204600002093
1305, 11.619395959826688, 67.63943561675056, 81.35564516461085, 0.16206534999999994, 60.0, 504, 931291, 1305, 19.672674299999926
1306, 12.247010525284544, 67.74441703639934, 81.56509377326552, 0.16146549999999998, 320.0, 829, 932120, 1306, 32.3668465999981
1307, 9.667301539683418, 67.53193993629816, 81.23260105935289, 0.16067304999999996, 200.0, 932, 933052, 1307, 36.40458419999777
1308, 8.320829645657943, 67.72358594344834, 81.35413070937335, 0.15998814999999997, 45.0, 590, 933642, 1308, 23.442048299999442
1309, 7.476350193649637, 67.6455822742968, 81.27027219683465, 0.15922044999999987, 310.0, 1116, 934758, 1309, 44.03330310000092
1310, 8.005546947988142, 67.87895886504016, 81.5899034387925, 0.1583969499999999, 180.0, 714, 935472, 1310, 27.691126199999417
1311, 9.708585402668158, 67.74359208942731, 81.40718775669903, 0.15765354999999986, 250.0, 938, 936410, 1311, 36.760028599997895
1312, 7.820492539771078, 67.56995571257256, 81.20368839757109, 0.1565492499999999, 315.0, 1516, 937926, 1312, 60.00589350000155
1313, 8.06634159791238, 67.74888264183859, 81.46213334463175, 0.15563529999999992, 120.0, 515, 938441, 1313, 20.417023099998914
1314, 9.381227818470695, 67.47671928185895, 81.11813427048389, 0.15509124999999996, 120.0, 694, 939135, 1314, 27.295418500001688
1315, 5.320839042698636, 67.40599327087402, 80.94433315501493, 0.15454944999999992, 110.0, 510, 939645, 1315, 20.484596900001634
1316, 6.016591616350276, 67.3567099068911, 80.9269230733391, 0.15402519999999997, 110.0, 655, 940300, 1316, 25.91658219999954
1317, 9.587540981696762, 66.797870356436, 80.30401585702678, 0.1534356999999999, 65.0, 655, 940955, 1317, 25.978420299998106
1318, 9.478523025750281, 67.1924070718405, 80.800990978321, 0.1528191999999999, 200.0, 715, 941670, 1318, 28.2597425999993
1319, 9.587932413959372, 66.87531593910553, 80.39684431208005, 0.15192504999999995, 320.0, 1272, 942942, 1319, 50.59307049999916
1320, 8.740595106303692, 66.90913860321045, 80.41430562591553, 0.15090264999999994, 255.0, 1000, 943942, 1320, 39.385224699999526
1321, 7.158362634518537, 66.82954698102228, 80.3024016478966, 0.14993064999999994, 255.0, 1160, 945102, 1321, 46.79757309999695
1322, 9.052233389637491, 66.86629705457716, 80.47091074534006, 0.14910894999999993, 135.0, 666, 945768, 1322, 26.722885300001508
1323, 10.578526755274549, 66.88109836037825, 80.43481654734747, 0.14825349999999995, 500.0, 1235, 947003, 1323, 49.364550000002055
1324, 8.13683639934357, 66.91130468813346, 80.38872622162722, 0.14732919999999994, 160.0, 819, 947822, 1324, 32.68574670000089
1325, 8.516745857550772, 67.06482160079702, 80.6387909429698, 0.14650209999999986, 380.0, 1019, 948841, 1325, 41.115768300001946
1326, 7.5461255772585885, 66.91799100783476, 80.36746006066303, 0.1457276499999999, 110.0, 702, 949543, 1326, 27.99749460000021
1327, 8.629675316820832, 66.57337600289242, 80.05982708153962, 0.14514939999999993, 85.0, 583, 950126, 1327, 23.60641620000024
1328, 7.248464380914954, 66.23721284421129, 79.57655804983229, 0.14452074999999995, 335.0, 814, 950940, 1328, 32.63066869999966
1329, 11.622790159894844, 66.40029192875394, 79.8156329105863, 0.1439883999999999, 55.0, 369, 951309, 1329, 14.825222999999824
1330, 8.288341814376546, 66.24028894322863, 79.60836684774365, 0.14351814999999998, 210.0, 676, 951985, 1330, 27.311973800002306
1331, 8.227473250152524, 66.61130483837607, 80.07693153838817, 0.14298129999999998, 65.0, 517, 952502, 1331, 20.936097300000256
1332, 8.515511074688582, 66.40154720070088, 79.77456914851096, 0.14249439999999994, 45.0, 565, 953067, 1332, 22.780573500000173
1333, 7.0504722629226535, 66.21140540602516, 79.52723976609397, 0.14184189999999997, 130.0, 885, 953952, 1333, 35.789008299998386
1334, 6.825540523976088, 66.35303399260614, 79.63058755095575, 0.14118804999999993, 20.0, 568, 954520, 1334, 23.086591399998724
1335, 9.95638579262824, 66.14592148642159, 79.53795108738568, 0.14062914999999995, 120.0, 674, 955194, 1335, 27.214556200000516
1336, 11.592790453214707, 66.33400231510669, 79.78804969977762, 0.13987449999999993, 300.0, 1003, 956197, 1336, 40.754331700001785
1337, 9.978362338684198, 66.43564468119186, 79.90932117969315, 0.13903389999999996, 255.0, 865, 957062, 1337, 34.86854409999796
1338, 7.006387033504553, 66.5187226271018, 79.91162115243765, 0.13829365, 130.0, 780, 957842, 1338, 31.705017000000225
1339, 6.681209287277742, 66.2927102105821, 79.68425094678206, 0.13766319999999999, 55.0, 621, 958463, 1339, 25.069947899999534
1340, 8.082682808067487, 66.52834194965244, 79.92773352202421, 0.1370214999999999, 225.0, 805, 959268, 1340, 32.6566356000003
1341, 11.083199458357495, 66.40556167466991, 79.93134163599935, 0.13630464999999994, 85.0, 788, 960056, 1341, 32.40992699999697
1342, 10.124823004957559, 67.36003650167714, 81.05421738555467, 0.13563954999999991, 95.0, 690, 960746, 1342, 28.01256839999769
1343, 7.557533620712413, 67.03797520382304, 80.53313294262954, 0.13507344999999996, 110.0, 568, 961314, 1343, 23.180961499998375
1344, 11.658386970144718, 67.11339539273409, 80.72077247845837, 0.1346508999999999, 85.0, 371, 961685, 1344, 15.364817900001071
1345, 7.727693528887568, 67.24646451788846, 80.77005944259619, 0.1342017999999999, 80.0, 627, 962312, 1345, 25.877376500000537
1346, 8.117564662837, 66.99720592567144, 80.50503032096398, 0.13341744999999994, 350.0, 1116, 963428, 1346, 45.741641399999935
1347, 7.098924572286736, 67.0799157704022, 80.58894248944365, 0.13253454999999992, 195.0, 846, 964274, 1347, 34.40189150000151
1348, 9.106305766162341, 67.12492849170297, 80.71377553801605, 0.13165704999999994, 490.0, 1104, 965378, 1348, 44.86287280000033
1349, 9.788141329876641, 67.21087425823248, 80.67362149676664, 0.13092219999999993, 130.0, 529, 965907, 1349, 21.7267709000007
1350, 7.365441185373092, 67.22536643496709, 80.78180892799801, 0.1303515999999999, 140.0, 739, 966646, 1350, 30.74397979999776
1351, 12.835420578884989, 67.02265680370046, 80.67528102647013, 0.12977784999999994, 55.0, 536, 967182, 1351, 21.92154080000182
1352, 8.962384121470384, 67.08944570310325, 80.58786484634508, 0.12915774999999996, 125.0, 842, 968024, 1352, 34.24635870000202
1353, 8.65986829415402, 67.16480027928071, 80.66728699628045, 0.12847284999999994, 145.0, 680, 968704, 1353, 27.476681899999676
1354, 6.700397032152908, 67.11071741065649, 80.61828551718412, 0.12769839999999993, 425.0, 1041, 969745, 1354, 43.16273209999781
1355, 7.262289226544652, 66.67156354747533, 80.08057518558226, 0.1267641999999999, 210.0, 1035, 970780, 1355, 42.707527599999594
1356, 9.765351097661016, 66.52144760945264, 80.02469081037185, 0.12580884999999997, 150.0, 1088, 971868, 1356, 44.923791499997606
1357, 10.629778969281924, 66.45934685499606, 80.01412904476692, 0.12509379999999995, 70.0, 501, 972369, 1357, 21.17908069999976
1358, 8.566558090562852, 66.53222755898089, 79.99934001526822, 0.12425679999999993, 295.0, 1359, 973728, 1358, 55.91434870000012
1359, 10.966338959891354, 66.65651931942, 80.17374422855579, 0.12326229999999992, 210.0, 851, 974579, 1359, 35.27910079999856
1360, 8.549688880243318, 66.33950198505799, 79.75366764154909, 0.12248154999999995, 240.0, 884, 975463, 1360, 36.994148400000995
1361, 7.474036620544993, 66.49447401693044, 79.87316731644728, 0.12175704999999995, 170.0, 726, 976189, 1361, 30.337549700001546
1362, 6.554989086500312, 66.73109330709002, 80.16660215664754, 0.12117609999999994, 125.0, 565, 976754, 1362, 23.62362409999696
1363, 7.90083895488697, 66.48227428660674, 79.90862217622644, 0.12053934999999993, 245.0, 850, 977604, 1363, 35.50188160000107
1364, 12.686840112089481, 66.65769459961584, 80.11220722097569, 0.11998674999999992, 80.0, 378, 977982, 1364, 15.83911789999911
1365, 7.664706016273311, 66.4007666405667, 79.74526047438718, 0.11965644999999994, 75.0, 356, 978338, 1365, 14.715442199998506
1366, 7.020248099443933, 66.57816695446559, 79.94824866420036, 0.11901969999999994, 145.0, 1059, 979397, 1366, 44.46793809999872
1367, 7.569586733234065, 65.97309163991089, 79.22890765125821, 0.11806929999999996, 540.0, 1053, 980450, 1367, 43.39875329999995
1368, 10.318272056248714, 65.99319883782094, 79.41884670107383, 0.11736684999999994, 185.0, 508, 980958, 1368, 21.5718624000001
1369, 9.306138670915528, 65.50843809875674, 78.70757970838923, 0.11684214999999996, 160.0, 658, 981616, 1369, 27.286233300001186
1370, 7.632267699151603, 65.68931642572551, 78.9383722524174, 0.11616174999999995, 200.0, 854, 982470, 1370, 35.6014224999999
1371, 9.715053144728113, 65.50389850359022, 78.8363476969713, 0.11548404999999996, 120.0, 652, 983122, 1371, 27.049343099999533
1372, 8.49867397087883, 65.63620175847346, 78.8098757077393, 0.11492469999999992, 75.0, 591, 983713, 1372, 26.06428120000055
1373, 9.946342168639086, 65.61392891598942, 78.94831981897781, 0.11440719999999992, 65.0, 559, 984272, 1373, 24.25436709999849
1374, 10.483516058684062, 65.68739242767022, 78.9624930076919, 0.11367279999999995, 330.0, 1073, 985345, 1374, 44.90224710000257
1375, 8.070929579581993, 65.65840057418801, 78.92384140495061, 0.11288979999999994, 105.0, 667, 986012, 1375, 27.82410329999766
1376, 8.296100516577456, 65.60333987965303, 78.81203718542415, 0.11216889999999992, 160.0, 935, 986947, 1376, 39.750116800001706
1377, 8.243802957992125, 65.64061551013484, 78.87079182052027, 0.11116224999999993, 505.0, 1302, 988249, 1377, 54.859892299999046
1378, 10.098812991430208, 65.40920097929418, 78.62606313988675, 0.11014299999999995, 390.0, 963, 989212, 1378, 41.445920499998465
1379, 8.704471929010117, 65.68258707451098, 78.87858661304821, 0.10941264999999992, 150.0, 660, 989872, 1379, 28.118016700002045
1380, 8.164500996200289, 65.17475009518373, 78.34694163724991, 0.10832139999999994, 745.0, 1765, 991637, 1380, 74.43686899999739
1381, 6.7996946731606105, 65.37070640700553, 78.52952185433234, 0.1071752499999999, 135.0, 782, 992419, 1381, 33.1832347999989
1382, 10.795353016332735, 65.12275338474709, 78.3397306490548, 0.10653894999999992, 110.0, 632, 993051, 1382, 26.90153089999876
1383, 6.269655424820153, 65.16439268452163, 78.29026113319973, 0.10595664999999994, 160.0, 662, 993713, 1383, 28.022041900003387
1384, 8.839123630701605, 65.40015762101359, 78.61529629835442, 0.10535724999999997, 135.0, 670, 994383, 1384, 28.694836799997574
1385, 8.57966805802384, 65.0799039192006, 78.16480877096883, 0.10461249999999996, 220.0, 985, 995368, 1385, 41.99137769999652
1386, 7.2586333391350735, 65.18382447604934, 78.30828227398703, 0.10365264999999993, 585.0, 1148, 996516, 1386, 48.48881970000002
1387, 9.834858034308075, 65.39510508688348, 78.6247330072642, 0.10294569999999992, 35.0, 423, 996939, 1387, 17.747381100001803
1388, 8.43527818867176, 65.17889264666668, 78.26894886916064, 0.10244799999999994, 125.0, 683, 997622, 1388, 29.01175549999971
1389, 9.56049622487591, 65.28021916232434, 78.50412527337132, 0.10169244999999995, 260.0, 996, 998618, 1389, 42.65710699999909
1390, 7.312429050862665, 65.26624180323864, 78.41161574841537, 0.10081134999999992, 85.0, 962, 999580, 1390, 41.076089900001534
