,loss,mae,mean_q,mean_eps,episode_reward,nb_episode_steps,nb_steps,episode,duration
0,0,0,0,0,60.0,415,415,0,0.8520441999999999
1, 0, 0, 0, 0, 290.0, 850, 1265, 1, 1.6210825
2, 0, 0, 0, 0, 60.0, 578, 1843, 2, 1.2700124000000006
3, 0, 0, 0, 0, 50.0, 669, 2512, 3, 1.3007600999999998
4, 0, 0, 0, 0, 120.0, 614, 3126, 4, 1.2779021000000004
5, 0, 0, 0, 0, 35.0, 401, 3527, 5, 0.9370281999999968
6, 0, 0, 0, 0, 135.0, 650, 4177, 6, 1.3893497000000004
7, 0, 0, 0, 0, 80.0, 542, 4719, 7, 1.190822599999997
8, 0, 0, 0, 0, 155.0, 806, 5525, 8, 1.682630500000002
9, 0, 0, 0, 0, 95.0, 712, 6237, 9, 1.4952444000000007
10, 0, 0, 0, 0, 100.0, 520, 6757, 10, 1.035062
11, 0, 0, 0, 0, 95.0, 535, 7292, 11, 1.0724848000000016
12, 0, 0, 0, 0, 95.0, 564, 7856, 12, 1.1689487000000014
13, 0, 0, 0, 0, 80.0, 491, 8347, 13, 1.0427431000000027
14, 0, 0, 0, 0, 95.0, 568, 8915, 14, 1.1704571000000001
15, 0, 0, 0, 0, 150.0, 575, 9490, 15, 1.4667815999999974
16, 0, 0, 0, 0, 210.0, 827, 10317, 16, 2.2246967999999967
17, 0, 0, 0, 0, 155.0, 653, 10970, 17, 1.5495088999999993
18, 0, 0, 0, 0, 30.0, 396, 11366, 18, 0.945381299999994
19, 0, 0, 0, 0, 65.0, 355, 11721, 19, 0.8468251999999978
20, 0, 0, 0, 0, 210.0, 960, 12681, 20, 2.0198813000000015
21, 0, 0, 0, 0, 75.0, 395, 13076, 21, 0.8253801999999979
22, 0, 0, 0, 0, 30.0, 497, 13573, 22, 1.0356505999999968
23, 0, 0, 0, 0, 50.0, 503, 14076, 23, 1.0370457000000002
24, 0, 0, 0, 0, 120.0, 556, 14632, 24, 1.214800799999999
25, 0, 0, 0, 0, 100.0, 579, 15211, 25, 1.2360315000000028
26, 0, 0, 0, 0, 90.0, 528, 15739, 26, 1.0456663999999947
27, 0, 0, 0, 0, 215.0, 1345, 17084, 27, 2.5829386000000056
28, 0, 0, 0, 0, 155.0, 465, 17549, 28, 0.9700340999999995
29, 0, 0, 0, 0, 30.0, 379, 17928, 29, 0.787222100000001
30, 0, 0, 0, 0, 535.0, 1222, 19150, 30, 2.3850709999999964
31, 0, 0, 0, 0, 120.0, 733, 19883, 31, 1.4263340999999983
32, 0, 0, 0, 0, 100.0, 383, 20266, 32, 0.7876349000000005
33, 0, 0, 0, 0, 130.0, 679, 20945, 33, 1.381200200000002
34, 0, 0, 0, 0, 75.0, 535, 21480, 34, 1.0950755
35, 0, 0, 0, 0, 75.0, 414, 21894, 35, 0.8606029999999976
36, 0, 0, 0, 0, 185.0, 803, 22697, 36, 1.5361629000000008
37, 0, 0, 0, 0, 50.0, 403, 23100, 37, 0.8182038000000063
38, 0, 0, 0, 0, 155.0, 777, 23877, 38, 1.531989700000004
39, 0, 0, 0, 0, 370.0, 809, 24686, 39, 1.5969344999999961
40, 0, 0, 0, 0, 320.0, 799, 25485, 40, 1.6065031999999988
41, 0, 0, 0, 0, 80.0, 386, 25871, 41, 0.8088018999999989
42, 0, 0, 0, 0, 135.0, 1002, 26873, 42, 2.0166386000000074
43, 0, 0, 0, 0, 210.0, 802, 27675, 43, 1.6060334999999952
44, 0, 0, 0, 0, 135.0, 632, 28307, 44, 1.3047360000000054
45, 0, 0, 0, 0, 110.0, 685, 28992, 45, 1.3444854999999905
46, 0, 0, 0, 0, 185.0, 572, 29564, 46, 1.1360443000000089
47, 0, 0, 0, 0, 125.0, 708, 30272, 47, 1.4208198000000039
48, 0, 0, 0, 0, 495.0, 1103, 31375, 48, 2.1368699000000078
49, 0, 0, 0, 0, 80.0, 442, 31817, 49, 0.8965328999999969
50, 0, 0, 0, 0, 150.0, 702, 32519, 50, 1.3858711999999969
51, 0, 0, 0, 0, 440.0, 969, 33488, 51, 1.9589722999999992
52, 0, 0, 0, 0, 55.0, 373, 33861, 52, 0.7628461999999985
53, 0, 0, 0, 0, 125.0, 640, 34501, 53, 1.2913668999999999
54, 0, 0, 0, 0, 50.0, 436, 34937, 54, 0.8640897000000081
55, 0, 0, 0, 0, 30.0, 414, 35351, 55, 0.8434372999999908
56, 0, 0, 0, 0, 70.0, 376, 35727, 56, 0.7557151000000033
57, 0, 0, 0, 0, 135.0, 669, 36396, 57, 1.320213300000006
58, 0, 0, 0, 0, 155.0, 695, 37091, 58, 1.3725572000000028
59, 0, 0, 0, 0, 155.0, 619, 37710, 59, 1.2273890000000023
60, 0, 0, 0, 0, 250.0, 1395, 39105, 60, 2.8189372000000077
61, 0, 0, 0, 0, 330.0, 1042, 40147, 61, 2.222537200000005
62, 0, 0, 0, 0, 110.0, 654, 40801, 62, 1.3395227999999975
63, 0, 0, 0, 0, 65.0, 475, 41276, 63, 0.996512899999999
64, 0, 0, 0, 0, 65.0, 606, 41882, 64, 1.2780002000000081
65, 0, 0, 0, 0, 240.0, 948, 42830, 65, 1.8711938999999944
66, 0, 0, 0, 0, 135.0, 653, 43483, 66, 1.2957431999999898
67, 0, 0, 0, 0, 210.0, 773, 44256, 67, 1.5444802000000095
68, 0, 0, 0, 0, 210.0, 913, 45169, 68, 1.7789093999999892
69, 0, 0, 0, 0, 75.0, 345, 45514, 69, 0.7065931000000063
70, 0, 0, 0, 0, 125.0, 454, 45968, 70, 0.9049630000000093
71, 0, 0, 0, 0, 110.0, 541, 46509, 71, 1.1018409999999932
72, 0, 0, 0, 0, 135.0, 641, 47150, 72, 1.2822008999999923
73, 0, 0, 0, 0, 135.0, 650, 47800, 73, 1.2815939999999983
74, 0, 0, 0, 0, 155.0, 623, 48423, 74, 1.2372826000000003
75, 0, 0, 0, 0, 150.0, 755, 49178, 75, 1.5030237
76, 0, 0, 0, 0, 55.0, 589, 49767, 76, 1.1805961000000025
77, 0, 0, 0, 0, 110.0, 619, 50386, 77, 1.2332341999999983
78, 0, 0, 0, 0, 35.0, 401, 50787, 78, 0.8076295999999985
79, 0, 0, 0, 0, 45.0, 505, 51292, 79, 1.020971799999998
80, 0, 0, 0, 0, 75.0, 508, 51800, 80, 1.0220867000000027
81, 0, 0, 0, 0, 320.0, 1218, 53018, 81, 2.3580094999999943
82, 0, 0, 0, 0, 210.0, 960, 53978, 82, 1.8973535000000084
83, 0, 0, 0, 0, 185.0, 769, 54747, 83, 1.5253340000000009
84, 0, 0, 0, 0, 200.0, 981, 55728, 84, 1.9761435000000063
85, 0, 0, 0, 0, 125.0, 514, 56242, 85, 1.0387496999999968
86, 0, 0, 0, 0, 240.0, 953, 57195, 86, 1.8965584000000035
87, 0, 0, 0, 0, 120.0, 671, 57866, 87, 1.3478522999999996
88, 0, 0, 0, 0, 155.0, 701, 58567, 88, 1.3994002000000023
89, 0, 0, 0, 0, 335.0, 841, 59408, 89, 1.6558529000000135
90, 0, 0, 0, 0, 120.0, 792, 60200, 90, 1.5541819999999973
91, 0, 0, 0, 0, 135.0, 751, 60951, 91, 1.4800449000000242
92, 0, 0, 0, 0, 65.0, 583, 61534, 92, 1.1755563000000109
93, 0, 0, 0, 0, 155.0, 733, 62267, 93, 1.4615077999999926
94, 0, 0, 0, 0, 120.0, 586, 62853, 94, 1.177368599999994
95, 0, 0, 0, 0, 55.0, 543, 63396, 95, 1.0984969999999805
96, 0, 0, 0, 0, 120.0, 659, 64055, 96, 1.2977724000000137
97, 0, 0, 0, 0, 225.0, 880, 64935, 97, 1.7080655999999976
98, 0, 0, 0, 0, 240.0, 1558, 66493, 98, 2.9463329999999814
99, 0, 0, 0, 0, 215.0, 872, 67365, 99, 1.6986889000000076
100, 0, 0, 0, 0, 60.0, 361, 67726, 100, 0.7283649000000025
101, 0, 0, 0, 0, 55.0, 512, 68238, 101, 1.0209127999999907
102, 0, 0, 0, 0, 90.0, 504, 68742, 102, 1.0144666999999856
103, 0, 0, 0, 0, 105.0, 622, 69364, 103, 1.2347481000000187
104, 0, 0, 0, 0, 140.0, 869, 70233, 104, 1.7606437999999969
105, 0, 0, 0, 0, 140.0, 683, 70916, 105, 1.4595751000000234
106, 0, 0, 0, 0, 410.0, 1100, 72016, 106, 2.1671479000000033
107, 0, 0, 0, 0, 35.0, 687, 72703, 107, 1.4411415999999804
108, 0, 0, 0, 0, 55.0, 616, 73319, 108, 1.241945099999981
109, 0, 0, 0, 0, 105.0, 617, 73936, 109, 1.1813922999999988
110, 0, 0, 0, 0, 155.0, 931, 74867, 110, 1.9621790000000203
111, 0, 0, 0, 0, 125.0, 691, 75558, 111, 1.4033079999999813
112, 0, 0, 0, 0, 150.0, 782, 76340, 112, 1.5640605000000107
113, 0, 0, 0, 0, 65.0, 510, 76850, 113, 1.0258387000000084
114, 0, 0, 0, 0, 210.0, 667, 77517, 114, 1.3358369000000039
115, 0, 0, 0, 0, 90.0, 668, 78185, 115, 1.3671037000000013
116, 0, 0, 0, 0, 5.0, 430, 78615, 116, 0.876059099999992
117, 0, 0, 0, 0, 355.0, 748, 79363, 117, 1.50941499999999
118, 0, 0, 0, 0, 80.0, 671, 80034, 118, 1.3613566999999875
119, 0, 0, 0, 0, 80.0, 629, 80663, 119, 1.2282623000000115
120, 0, 0, 0, 0, 155.0, 642, 81305, 120, 1.253024900000014
121, 0, 0, 0, 0, 50.0, 520, 81825, 121, 1.021153499999997
122, 0, 0, 0, 0, 90.0, 582, 82407, 122, 1.1500050999999871
123, 0, 0, 0, 0, 155.0, 569, 82976, 123, 1.1751749000000018
124, 0, 0, 0, 0, 120.0, 722, 83698, 124, 1.4298919000000012
125, 0, 0, 0, 0, 130.0, 678, 84376, 125, 1.3587692999999774
126, 0, 0, 0, 0, 45.0, 390, 84766, 126, 0.7817615999999816
127, 0, 0, 0, 0, 160.0, 762, 85528, 127, 1.5109774999999956
128, 0, 0, 0, 0, 185.0, 672, 86200, 128, 1.3430070999999941
129, 0, 0, 0, 0, 155.0, 690, 86890, 129, 1.4438386999999864
130, 0, 0, 0, 0, 55.0, 616, 87506, 130, 1.2959630000000004
131, 0, 0, 0, 0, 20.0, 616, 88122, 131, 1.2430953999999872
132, 0, 0, 0, 0, 120.0, 637, 88759, 132, 1.2778538000000026
133, 0, 0, 0, 0, 50.0, 458, 89217, 133, 0.9482714000000101
134, 0, 0, 0, 0, 180.0, 831, 90048, 134, 1.6334573999999975
135, 0, 0, 0, 0, 180.0, 690, 90738, 135, 1.3733853000000238
136, 0, 0, 0, 0, 75.0, 367, 91105, 136, 0.7566176999999925
137, 0, 0, 0, 0, 180.0, 809, 91914, 137, 1.59438209999999
138, 0, 0, 0, 0, 240.0, 894, 92808, 138, 1.7474940000000174
139, 0, 0, 0, 0, 120.0, 650, 93458, 139, 1.2983733000000086
140, 0, 0, 0, 0, 235.0, 948, 94406, 140, 1.8764593999999875
141, 0, 0, 0, 0, 80.0, 597, 95003, 141, 1.2043608000000177
142, 0, 0, 0, 0, 105.0, 647, 95650, 142, 1.3401719999999955
143, 0, 0, 0, 0, 130.0, 695, 96345, 143, 1.3975824999999986
144, 0, 0, 0, 0, 35.0, 405, 96750, 144, 0.8215973000000076
145, 0, 0, 0, 0, 135.0, 643, 97393, 145, 1.3105727999999885
146, 0, 0, 0, 0, 110.0, 438, 97831, 146, 0.8782534000000055
147, 0, 0, 0, 0, 125.0, 741, 98572, 147, 1.5053369000000032
148, 0, 0, 0, 0, 215.0, 724, 99296, 148, 1.4337964999999997
149, 838.9505794949001, 36.54665086534288, 63.26165525648329, 0.9099793000000003, 155.0, 750, 100046, 149, 2.181018899999998
150, 69.57085326218024, 41.62181953616258, 53.67492355718845, 0.9094977999999991, 385.0, 1025, 101071, 150, 8.831319699999995
151, 40.71797390815093, 41.440490606708, 51.371892285564385, 0.9085924000000007, 310.0, 987, 102058, 151, 8.286462600000021
152, 36.16626566176299, 41.299309600234444, 50.837448417935114, 0.9077563000000004, 225.0, 871, 102929, 152, 7.418863600000009
153, 38.16160632389179, 41.37481548475183, 50.749597770580344, 0.9071159499999998, 120.0, 552, 103481, 153, 4.733469000000014
154, 36.02236500997392, 41.369901485544034, 50.69552348908924, 0.9066974499999997, 70.0, 378, 103859, 154, 3.2556557999999995
155, 33.75284966032709, 41.33388347721579, 50.75488892751722, 0.9063482500000001, 75.0, 398, 104257, 155, 3.4638354999999876
156, 34.71239477125728, 41.1281385581078, 50.22568281624368, 0.9059806000000001, 20.0, 419, 104676, 156, 3.439340399999992
157, 34.841926242731795, 41.19749666769293, 50.394563650783105, 0.9055076499999998, 155.0, 632, 105308, 157, 5.517314999999996
158, 31.433365635791315, 41.210896575505835, 50.342007146269864, 0.9049303000000003, 55.0, 651, 105959, 158, 6.102478200000007
159, 30.079624560084277, 41.170346670021296, 50.32612810091735, 0.9044384500000001, 60.0, 442, 106401, 159, 4.023412099999973
160, 29.4597258963236, 41.151985289410845, 50.27954084815049, 0.9038705499999993, 155.0, 820, 107221, 160, 7.2112569000000235
161, 29.611176456079384, 41.1479068961553, 50.315241923325274, 0.9031924000000002, 130.0, 687, 107908, 161, 6.2063004999999976
162, 29.918618491498854, 41.181914969397695, 50.38397180513122, 0.9027081999999996, 80.0, 389, 108297, 162, 3.6117208000000005
163, 29.618211950346776, 41.148485164578545, 50.307169813243306, 0.9021295000000004, 460.0, 897, 109194, 163, 8.512393900000006
164, 28.90611349703547, 41.01695393088335, 50.111757076666976, 0.9015003999999999, 130.0, 501, 109695, 164, 4.252967800000022
165, 39.93965661459129, 42.19225282864419, 50.83415724400923, 0.9010332999999999, 15.0, 537, 110232, 165, 4.56602399999997
166, 32.8876225548867, 43.463195410565305, 51.79326962331405, 0.9002813500000005, 210.0, 1134, 111366, 166, 9.693742299999997
167, 29.371858251174825, 43.020973299440385, 51.432510555190525, 0.8995699000000003, 95.0, 447, 111813, 167, 3.849275299999988
168, 27.407729249941877, 43.40480374209703, 51.902278523614875, 0.8990906500000001, 90.0, 618, 112431, 168, 5.326575100000014
169, 27.847115204916687, 43.363000772539884, 51.842419005864954, 0.8985564999999998, 65.0, 569, 113000, 169, 4.801157700000033
170, 27.291227914639656, 43.2391039772539, 51.67929899455696, 0.8977568499999994, 550.0, 1208, 114208, 170, 10.319189100000017
171, 26.534858588435224, 43.215594127366316, 51.67754383056444, 0.8969337999999996, 125.0, 621, 114829, 171, 5.349863000000028
172, 25.468528367402985, 43.22118403216985, 51.44771204220029, 0.8964257500000001, 80.0, 508, 115337, 172, 4.392296700000031
173, 27.175055768754746, 43.163708443111844, 51.51027851104736, 0.8960351500000001, 60.0, 360, 115697, 173, 3.144536800000026
174, 26.96241068132677, 43.32715566079238, 51.92436070467165, 0.8956152999999996, 180.0, 573, 116270, 174, 5.074778899999956
175, 25.869703497731887, 43.30394880480523, 51.77429956851824, 0.8950663000000001, 105.0, 647, 116917, 175, 5.769025099999965
176, 26.287769394233578, 43.40425252445409, 51.84243708751241, 0.8945006500000001, 75.0, 610, 117527, 176, 5.300708900000018
177, 27.799570170120855, 43.488084555744585, 52.09238499608533, 0.8939260000000003, 110.0, 667, 118194, 177, 5.746513300000004
178, 27.928812419948866, 43.358355967842755, 51.95023604733261, 0.8934467500000002, 30.0, 398, 118592, 178, 3.5229775000000245
179, 24.79279043249888, 43.450594930779445, 51.93918482114191, 0.8929391499999997, 140.0, 730, 119322, 179, 6.386057199999982
180, 27.92545450466912, 43.229947883067204, 51.863101437857594, 0.8924131000000004, 30.0, 439, 119761, 180, 3.9286288000000127
181, 30.20361366426727, 43.68617403289609, 52.30602576234519, 0.8919937000000003, 30.0, 493, 120254, 181, 4.408208500000001
182, 18.72405450800632, 43.857643476445624, 52.39998331272856, 0.8913488500000004, 150.0, 940, 121194, 182, 8.526773100000014
183, 14.401324179094278, 43.7982269840537, 52.479695361307044, 0.8906653000000001, 80.0, 579, 121773, 183, 5.081046100000037
184, 15.404664071922094, 43.78270395414425, 52.55940528411031, 0.8899929999999996, 185.0, 915, 122688, 184, 8.098794300000009
185, 12.899577231130502, 43.8238925673449, 52.56127700545275, 0.88931755, 50.0, 586, 123274, 185, 5.276876400000049
186, 13.265688964298793, 43.770861809995, 52.3931620782163, 0.8888396499999999, 30.0, 476, 123750, 186, 4.307016000000033
187, 12.643744826851405, 43.55215348898028, 52.15923036481233, 0.8884247499999998, 55.0, 446, 124196, 187, 3.9684656999999675
188, 14.724895438665076, 43.57463878197006, 52.31623932077915, 0.8878685500000001, 90.0, 790, 124986, 188, 6.9949722000000065
189, 16.370779267052555, 43.86646928811622, 52.61685031881113, 0.8871611499999995, 210.0, 782, 125768, 189, 6.94401670000002
190, 13.46562248023859, 43.75447982486162, 52.46025718909602, 0.8865135999999999, 140.0, 657, 126425, 190, 5.864355499999988
191, 13.69240047984653, 43.74981298376013, 52.48038460060402, 0.8859142, 80.0, 675, 127100, 191, 6.051467699999989
192, 13.48359990119934, 43.79438345038931, 52.44219142258769, 0.8853431500000005, 155.0, 594, 127694, 192, 5.363932599999998
193, 15.282687193230737, 43.864815453638, 52.67450444668154, 0.8848981000000001, 135.0, 395, 128089, 193, 3.5810449999999605
194, 13.429998330771923, 43.63950731158256, 52.38269914984703, 0.8844323499999996, 105.0, 640, 128729, 194, 5.830226799999991
195, 14.756022270532812, 43.65261692241686, 52.36586645913456, 0.8838532000000001, 30.0, 647, 129376, 195, 5.829727200000036
196, 13.600206956455029, 43.72101196173757, 52.484327157738825, 0.8833834, 100.0, 397, 129773, 196, 3.5243608999999765
197, 16.839207812119987, 44.136394879290165, 53.041136435880006, 0.8829689499999995, 65.0, 524, 130297, 197, 4.754728900000032
198, 21.946621075187085, 44.530307200853045, 53.6550593622328, 0.8824978000000003, 125.0, 523, 130820, 198, 4.808309299999962
199, 22.46842807735665, 44.62807734073008, 53.81979289957379, 0.8819605000000001, 145.0, 671, 131491, 199, 6.147102899999993
200, 18.841550678589456, 44.545154760691744, 53.72271420607554, 0.8813318499999994, 210.0, 726, 132217, 200, 6.566077199999995
201, 19.748039668097217, 44.56606085861431, 53.729903256191925, 0.8807603500000001, 65.0, 544, 132761, 201, 4.95557359999998
202, 16.698403273917048, 44.51221565547177, 53.74035791966079, 0.8800358500000004, 535.0, 1066, 133827, 202, 9.641738100000055
203, 16.765886140935248, 44.46638323075278, 53.68445461422372, 0.8792339500000003, 155.0, 716, 134543, 203, 6.5216058000000885
204, 19.348530218042715, 44.65560982269364, 53.75870932860098, 0.8787330999999998, 65.0, 397, 134940, 204, 3.6846025999999483
205, 18.635958266567876, 44.38860976974686, 53.55646980087479, 0.8782079499999998, 210.0, 770, 135710, 205, 6.934758899999906
206, 19.402470508194945, 44.644698613744865, 53.932003060265274, 0.8775095500000003, 255.0, 782, 136492, 206, 7.1532733000000235
207, 18.916739472444508, 44.6002922265426, 53.77958374438079, 0.8769092500000005, 45.0, 552, 137044, 207, 5.012453599999958
208, 18.131195770605913, 44.574014217380714, 53.8713100189177, 0.876232, 550.0, 953, 137997, 208, 8.834804000000076
209, 17.1366169398263, 44.4807861225717, 53.77540247872372, 0.8754678999999999, 190.0, 745, 138742, 209, 6.8208091000000195
210, 18.664973299126878, 44.4628658458947, 53.61003320867365, 0.8746624000000006, 340.0, 1045, 139787, 210, 9.61515129999998
211, 10.599536647497139, 44.488213337113706, 53.51961670485623, 0.8738267500000002, 210.0, 812, 140599, 211, 7.515209900000059
212, 8.999520460052869, 44.58623643941547, 53.46680387810095, 0.8730090999999994, 290.0, 1005, 141604, 212, 9.29452839999999
213, 9.013339166912962, 44.47690885207232, 53.42952519304612, 0.8723120500000002, 120.0, 544, 142148, 213, 5.062063499999908
214, 10.225089380402624, 44.504056341854145, 53.46170071024954, 0.8717756499999997, 130.0, 648, 142796, 214, 6.07906939999998
215, 10.52930836864496, 44.530928807407136, 53.43995839824738, 0.8710651000000004, 130.0, 931, 143727, 215, 8.668421399999943
216, 9.13404403454754, 44.60787563146665, 53.55890444265419, 0.8703072999999997, 165.0, 753, 144480, 216, 7.073307399999976
217, 11.421119557803998, 44.57368260464181, 53.53518861960643, 0.8696115999999996, 210.0, 793, 145273, 217, 7.515718900000024
218, 9.800629428181335, 44.606556300699275, 53.59518211531813, 0.8689464999999998, 155.0, 685, 145958, 218, 6.51251400000001
219, 10.800050668530279, 44.60531647904619, 53.58053542281295, 0.8681887000000003, 440.0, 999, 146957, 219, 9.389017800000033
220, 7.940975018501282, 44.61373002406529, 53.689869022914344, 0.8673453999999993, 170.0, 875, 147832, 220, 8.322680200000036
221, 9.706313261016742, 44.56319908699877, 53.580469304005604, 0.8665885000000005, 195.0, 807, 148639, 221, 7.669615100000101
222, 10.447442594545567, 44.83354140275362, 53.942502969148144, 0.8659535499999996, 120.0, 604, 149243, 222, 5.8836589
223, 8.528864966722981, 44.63516232477968, 53.61381710361402, 0.8654428000000002, 60.0, 531, 149774, 223, 5.311668000000054
224, 11.57042707310114, 45.5081480790388, 54.73175471814273, 0.8649185499999998, 50.0, 634, 150408, 224, 6.088430199999948
225, 8.645544711264849, 46.05471517665604, 55.32287569961726, 0.8644410999999999, 35.0, 427, 150835, 225, 4.104501700000014
226, 10.360269688762898, 46.065207625544346, 55.3790050329164, 0.8639393499999998, 120.0, 688, 151523, 226, 6.647037399999931
227, 7.977811107334482, 46.07215111840575, 55.33181855189407, 0.8633160999999998, 120.0, 697, 152220, 227, 6.713371699999925
228, 9.998872634181051, 46.14336956642237, 55.471710433408816, 0.8625664000000002, 210.0, 969, 153189, 228, 9.260147800000027
229, 8.810658924650438, 46.23166519895245, 55.55618050704302, 0.8618576499999994, 65.0, 606, 153795, 229, 5.887296099999958
230, 10.633215353078675, 46.13134597245595, 55.465241895946775, 0.8614045000000001, 50.0, 401, 154196, 230, 3.8779731999999285
231, 9.923271746736482, 46.05395586723997, 55.329591441226654, 0.8607781000000009, 150.0, 991, 155187, 231, 9.64065579999999
232, 6.550309284044816, 46.06853106644777, 55.29225056450646, 0.8599325500000005, 180.0, 888, 156075, 232, 8.482929999999897
233, 10.045797826715017, 46.185636624288, 55.42230149651316, 0.8593016499999998, 155.0, 514, 156589, 233, 5.009093600000028
234, 9.041531878672618, 46.15474435247155, 55.43701386402154, 0.8586374499999992, 210.0, 962, 157551, 234, 9.352367000000072
235, 7.672522266418925, 46.19647826184435, 55.49284247112618, 0.85795525, 90.0, 554, 158105, 235, 5.440587199999982
236, 7.592527539597303, 46.13701400937627, 55.40851701492382, 0.8569463500000006, 655.0, 1688, 159793, 236, 16.34583639999994
237, 9.164865597113966, 45.61620671272278, 54.91451009273529, 0.8558267499999999, 350.0, 800, 160593, 237, 7.785854299999983
238, 9.076552738326951, 45.38863546972535, 54.620684204858826, 0.8552854, 20.0, 403, 160996, 238, 3.975177799999983
239, 5.714538068887905, 45.35904957187403, 54.495382803574806, 0.8545609000000002, 330.0, 1207, 162203, 239, 11.723228100000028
240, 7.858609973447128, 45.37845014176279, 54.63876838804041, 0.8537315499999999, 85.0, 636, 162839, 240, 6.287565500000028
241, 7.588031672323829, 45.46207136979604, 54.5795821117597, 0.8532612999999998, 5.0, 409, 163248, 241, 4.077477300000055
242, 8.85882274100655, 45.279292038182895, 54.430798233981335, 0.8528891500000002, 80.0, 418, 163666, 242, 4.159613700000023
243, 8.331040313738962, 45.42648336216698, 54.586604498974175, 0.8523955000000002, 120.0, 679, 164345, 243, 6.63599940000006
244, 7.439319352729531, 45.37263448389797, 54.57214444304166, 0.8517286000000002, 185.0, 803, 165148, 244, 8.042574699999932
245, 5.684121991223004, 45.31203261064124, 54.459377269053086, 0.8511935500000003, 45.0, 386, 165534, 245, 3.847081899999921
246, 8.651385005865022, 45.37068824668466, 54.523325569013394, 0.8508474999999999, 55.0, 383, 165917, 246, 3.820463299999915
247, 8.856626742214551, 45.397515025676256, 54.618738525881966, 0.8504235999999996, 120.0, 559, 166476, 247, 5.560361000000057
248, 8.71981317867766, 45.26032895308275, 54.44741725921631, 0.8499146500000001, 80.0, 572, 167048, 248, 5.575308699999937
249, 5.429349702774589, 45.37840065457927, 54.51012232766222, 0.84935575, 140.0, 670, 167718, 249, 6.732906200000002
250, 6.040945964706831, 45.45193320660552, 54.62948083798747, 0.8487820000000004, 125.0, 605, 168323, 250, 6.03145619999998
251, 6.37405662204577, 45.51991522802066, 54.743240687400785, 0.8482141, 140.0, 657, 168980, 251, 6.827617999999916
252, 6.5771256573822185, 45.31483172541079, 54.422445988309555, 0.8476079499999993, 155.0, 690, 169670, 252, 7.408712199999968
253, 6.308237276679006, 44.96379931986901, 54.04564032448438, 0.8468731000000006, 140.0, 943, 170613, 253, 9.675050700000043
254, 4.707319148496091, 44.71935049763275, 53.78815295268057, 0.8462457999999998, 135.0, 451, 171064, 254, 4.6631366999999955
255, 5.383336895917143, 44.67703762054443, 53.75713196481977, 0.8457908500000001, 80.0, 560, 171624, 255, 5.827234900000008
256, 7.179349677141348, 44.61566920781829, 53.72573276494173, 0.8453377, 80.0, 447, 172071, 256, 4.636852500000032
257, 8.027576685631038, 44.777395145166295, 53.83185978424855, 0.8449785999999998, 50.0, 351, 172422, 257, 3.5793173000000706
258, 5.807828713534614, 44.77086787069997, 53.8952750456498, 0.8446253500000004, 50.0, 434, 172856, 258, 4.546064299999898
259, 7.548090068728683, 44.74055299438677, 53.88907294308524, 0.8438806000000009, 185.0, 1221, 174077, 259, 13.368785399999979
260, 6.553814383952514, 44.77526053434573, 53.887365678822775, 0.8430413500000004, 80.0, 644, 174721, 260, 6.446456900000044
261, 6.488902464177873, 44.610570141827615, 53.68923772176107, 0.8424478, 135.0, 675, 175396, 261, 6.813464000000067
262, 7.514695463425074, 44.812696349315154, 54.03186600513947, 0.8419685499999999, 100.0, 390, 175786, 262, 3.8909916999999723
263, 5.525077017035181, 44.732853948717285, 53.79604976981349, 0.8411846500000002, 440.0, 1352, 177138, 263, 13.646770199999992
264, 6.48683398100374, 44.733816939921034, 53.894421152492924, 0.8402743000000006, 180.0, 671, 177809, 264, 6.8194248999999445
265, 6.7002181305885316, 44.81833562011719, 53.90502961425781, 0.8396911, 130.0, 625, 178434, 265, 7.464751700000079
266, 7.612654306611718, 44.762798312147694, 53.91680205926387, 0.8388014499999993, 150.0, 1352, 179786, 266, 14.014859399999978
267, 5.978086405682507, 44.57123567477468, 53.53658121528355, 0.8380026999999997, 80.0, 423, 180209, 267, 4.43977910000001
268, 5.362024681863532, 44.704083886610725, 53.747413324676785, 0.8375581000000005, 80.0, 565, 180774, 268, 5.954650500000071
269, 5.648921790402414, 44.715806115135976, 53.781928845641986, 0.8367701499999999, 395.0, 1186, 181960, 269, 12.204979999999978
270, 5.974445993865578, 44.73173753312491, 53.89629277349676, 0.8360047000000002, 100.0, 515, 182475, 270, 5.352691200000095
271, 5.287061240443264, 44.734753914338995, 53.88019130660827, 0.8355862000000002, 95.0, 415, 182890, 271, 4.348292499999957
272, 6.709025492101752, 44.77205024839072, 53.90358536405713, 0.8350556499999999, 200.0, 764, 183654, 272, 7.9720444000000725
273, 5.472695963452672, 44.670427583540565, 53.75844406556966, 0.8343437499999999, 165.0, 818, 184472, 273, 8.608094599999959
274, 3.8888101491105296, 44.917410150818206, 54.018774162168086, 0.8336444499999994, 200.0, 736, 185208, 274, 7.694743500000072
275, 7.922025195210452, 44.737237337514784, 53.86371175179351, 0.8330338, 120.0, 621, 185829, 275, 6.511913100000015
276, 4.4018911303682895, 44.726879047897626, 53.85005871154977, 0.8324681499999999, 160.0, 636, 186465, 276, 6.9801764999999705
277, 5.026151010579856, 44.80195408849535, 53.95989239700442, 0.8318498500000004, 180.0, 738, 187203, 277, 7.738170900000114
278, 7.404887245199348, 44.79962620795528, 53.902699743343305, 0.8313400000000002, 30.0, 395, 187598, 278, 4.251773299999968
279, 3.788697295885071, 44.495365759641444, 53.576105887324694, 0.8308755999999996, 120.0, 637, 188235, 279, 6.718828799999983
280, 6.277877412897766, 44.599037141253234, 53.6970808964626, 0.8302356999999997, 210.0, 785, 189020, 280, 8.267877799999951
281, 3.4506844933056713, 44.68450923306037, 53.77440567396174, 0.8296110999999996, 135.0, 603, 189623, 281, 6.356188599999996
282, 3.924854748849739, 45.02519629066556, 54.15673172798602, 0.8291084500000002, 55.0, 514, 190137, 282, 5.452173200000061
283, 5.2684919137521495, 45.49758881897802, 54.750653793844215, 0.8285131000000001, 160.0, 809, 190946, 283, 8.592213800000081
284, 5.826322645747681, 45.60301469838, 54.932084682598784, 0.8278803999999997, 175.0, 597, 191543, 284, 6.326245499999914
285, 4.715611860512346, 45.55474759623639, 54.778331069838984, 0.8272917999999999, 225.0, 711, 192254, 285, 7.637655999999879
286, 6.349111693058378, 45.65624546047289, 54.984821080460954, 0.8265124, 170.0, 1021, 193275, 286, 10.944002299999966
287, 4.8202926904668795, 45.53593523341667, 54.769817088253944, 0.8258059000000002, 105.0, 549, 193824, 287, 5.877473500000178
288, 9.492752299090933, 45.688203743871696, 55.146579655293884, 0.8253815499999997, 20.0, 394, 194218, 288, 4.243564399999968
289, 4.583397405890517, 45.678006904183064, 54.90334389736521, 0.8248518999999999, 185.0, 783, 195001, 289, 8.387563399999863
290, 4.181715642783179, 45.63519538064775, 54.89902980292021, 0.8241076000000005, 215.0, 871, 195872, 290, 9.358641799999987
291, 5.773925137553703, 45.59091190424832, 54.90896710049022, 0.8233196500000005, 210.0, 880, 196752, 291, 9.623798999999963
292, 3.722804757101195, 45.68172079419333, 54.9981688968719, 0.8226401499999997, 95.0, 630, 197382, 292, 6.790418199999976
293, 3.5904063185199813, 45.67258713386856, 54.92985579384391, 0.8220457000000003, 150.0, 691, 198073, 293, 7.546120500000143
294, 4.935484843187598, 45.64609057969781, 54.89034008314885, 0.8215088500000001, 125.0, 502, 198575, 294, 5.570072900000014
295, 9.327019841973163, 45.69337672177796, 55.09282643416466, 0.8209598499999995, 185.0, 718, 199293, 295, 7.769626199999948
296, 8.371129361001291, 45.53466437255568, 54.771476636353995, 0.8204481999999998, 60.0, 419, 199712, 296, 4.544071800000211
297, 5.106287615204399, 45.55381284578882, 54.81112327479353, 0.8199032499999998, 155.0, 792, 200504, 297, 8.531500000000051
298, 7.252198098886703, 45.761377362832725, 55.11253298917337, 0.8192125000000001, 135.0, 743, 201247, 298, 8.024555299999975
299, 5.92892902314663, 45.60959851741791, 54.90082545280457, 0.8185181500000003, 155.0, 800, 202047, 299, 8.743209100000058
300, 3.153776915045455, 45.68003171682358, 54.900763203700386, 0.8179853500000002, 35.0, 384, 202431, 300, 4.159215299999914
301, 3.1640843707542126, 45.60028290886944, 54.843847794966265, 0.8175799, 80.0, 517, 202948, 301, 5.702393800000209
302, 9.795227644820807, 45.67440030390165, 55.05757391573203, 0.8170799499999997, 40.0, 594, 203542, 302, 6.663793500000111
303, 3.8966802669319547, 45.66776770618763, 55.023578450747344, 0.8165903499999999, 30.0, 494, 204036, 303, 5.539703500000087
304, 4.893163089548145, 45.49950356698251, 54.72938098391971, 0.8161183000000002, 165.0, 555, 204591, 304, 6.232226699999956
305, 8.331576626067331, 45.852296868735564, 55.37802846732561, 0.8156295999999997, 65.0, 531, 205122, 305, 5.804609300000038
306, 5.999705586853945, 45.738960143776055, 55.08795512267058, 0.8149276000000004, 240.0, 1029, 206151, 306, 11.319697299999916
307, 5.747104578371187, 45.74313265143089, 55.064911606242354, 0.8140937499999995, 155.0, 824, 206975, 307, 9.136833700000125
308, 3.3452559505274753, 45.649511343596, 54.89545722355116, 0.8134511500000002, 60.0, 604, 207579, 308, 6.620984199999839
309, 5.635772290968709, 45.65779723610766, 54.97652294112156, 0.8127757000000003, 280.0, 897, 208476, 309, 9.997704200000044
310, 5.238695177234912, 45.58900001777638, 54.89047634174013, 0.8120584000000002, 80.0, 697, 209173, 310, 7.847247000000152
311, 4.748084282470164, 45.66274934018393, 54.94854027023436, 0.8114598999999999, 110.0, 633, 209806, 311, 7.020069400000011
312, 6.561550046690378, 46.64316437514186, 56.170993489956636, 0.8108807500000003, 120.0, 654, 210460, 312, 7.422809299999926
313, 5.184023948219734, 46.95002610121316, 56.58376225417222, 0.8104204000000002, 25.0, 369, 210829, 313, 4.154638400000067
314, 4.294488314624942, 46.949395743172495, 56.510645576145336, 0.80990245, 135.0, 782, 211611, 314, 8.786893899999995
315, 7.268572802216499, 47.00511190260964, 56.65244920774438, 0.8092373500000002, 155.0, 696, 212307, 315, 7.938972699999795
316, 4.9171137056904985, 47.144997415341045, 56.77047518601805, 0.8085195999999996, 215.0, 899, 213206, 316, 10.110285400000066
317, 5.750858814699744, 47.14143901745294, 56.74073201155165, 0.8077271499999996, 245.0, 862, 214068, 317, 9.700457799999867
318, 4.412627615084584, 47.07628951616735, 56.71191208474588, 0.8070710499999996, 180.0, 596, 214664, 318, 6.671571000000085
319, 4.336575513312576, 46.97967252818816, 56.6023488234307, 0.8065085500000003, 90.0, 654, 215318, 319, 7.40822060000005
320, 6.506919336706013, 47.22887943812779, 56.93813636086204, 0.8060410000000001, 65.0, 385, 215703, 320, 4.474546099999998
321, 3.0451195237122635, 46.95015858135502, 56.45281903283909, 0.8055900999999994, 65.0, 617, 216320, 321, 7.127430799999956
322, 3.364318406322237, 47.11221854614489, 56.66843771934509, 0.8050748500000002, 45.0, 528, 216848, 322, 6.010925499999985
323, 6.538005984265221, 47.081652458069364, 56.71565980920193, 0.8043571000000006, 390.0, 1067, 217915, 323, 12.793279600000005
324, 5.41450893695794, 46.956473272739174, 56.52100720538773, 0.8034742000000001, 425.0, 895, 218810, 324, 10.571467900000016
325, 5.220354511016333, 47.0716077868698, 56.67539120076751, 0.8027100999999994, 240.0, 803, 219613, 325, 9.277710899999875
326, 5.13918006710982, 47.28882644808036, 56.85818832938964, 0.8019937000000001, 180.0, 789, 220402, 326, 9.69090140000003
327, 4.924879691141461, 47.380722535859555, 57.029355460350665, 0.8013933999999996, 80.0, 545, 220947, 327, 6.278388899999982
328, 6.908506825352195, 47.40868858359326, 57.09026473144005, 0.8008349500000003, 155.0, 696, 221643, 328, 8.168415699999969
329, 5.816803907854951, 47.34261073654504, 57.047668079678104, 0.8002715499999999, 50.0, 556, 222199, 329, 6.620354600000155
330, 7.448448033316034, 47.581055665351975, 57.32513522295885, 0.7998616000000001, 15.0, 355, 222554, 330, 4.065033200000016
331, 4.67709956105671, 47.24861838337133, 56.85652603758605, 0.7994651500000003, 75.0, 526, 223080, 331, 6.049736400000029
332, 4.56489356513272, 47.32679461076926, 56.95907651349832, 0.7987537000000005, 410.0, 1055, 224135, 332, 12.012491599999976
333, 5.720579808336178, 47.43207906766702, 57.05307718233298, 0.79768945, 250.0, 1310, 225445, 333, 14.812765500000069
334, 4.927941762693396, 47.31675644733772, 56.96654019290454, 0.7968043000000002, 90.0, 657, 226102, 334, 7.5769718999999895
335, 4.69684620250638, 47.43379071134985, 57.12792898171605, 0.7961122000000005, 230.0, 881, 226983, 335, 10.450584800000115
336, 5.425279543559943, 47.456977639269475, 57.115305112013175, 0.7955650000000002, 15.0, 335, 227318, 336, 3.989240199999813
337, 4.390814784022813, 47.452092072225035, 57.086378256079534, 0.79505695, 225.0, 794, 228112, 337, 9.22469799999999
338, 4.649973433637905, 47.29599518897473, 56.90790604186737, 0.7943994999999996, 105.0, 667, 228779, 338, 7.756347000000005
339, 3.266785119355905, 47.40034565123001, 57.00079686570876, 0.7939175500000002, 75.0, 404, 229183, 339, 4.726444799999854
340, 4.617550968694258, 47.28217729448198, 56.96285627897795, 0.7934860000000001, 70.0, 555, 229738, 340, 6.378227100000004
341, 4.81270872226522, 47.02994284600568, 56.6532919760862, 0.7928694999999999, 190.0, 815, 230553, 341, 9.49451269999986
342, 3.2302698077655387, 46.745391177034925, 56.286625840198035, 0.7923461500000001, 45.0, 348, 230901, 342, 4.094441400000051
343, 4.9770494185958665, 46.839066165665805, 56.429589571090176, 0.7917840999999997, 210.0, 901, 231802, 343, 10.498297399999956
344, 5.511481116246144, 46.79366326110651, 56.33103156311224, 0.7910879500000004, 110.0, 646, 232448, 344, 7.666858499999989
345, 4.177466822318622, 46.7560693090398, 56.28189948520315, 0.7905241, 65.0, 607, 233055, 345, 7.191836799999919
346, 6.306474394865665, 46.8184634500044, 56.45418136822584, 0.7899166000000002, 110.0, 743, 233798, 346, 8.87377760000004
347, 4.673928860399424, 46.50742484886609, 56.0255861731724, 0.7894103500000001, 20.0, 382, 234180, 347, 4.422474100000045
348, 3.0716950978659376, 46.66015990052042, 56.197449512723125, 0.7888829499999996, 225.0, 790, 234970, 348, 10.472742500000095
349, 4.435865369747025, 46.806246171917834, 56.418230112533124, 0.7882966000000001, 75.0, 513, 235483, 349, 6.378162900000007
350, 4.4836244851429345, 46.72161770034549, 56.24973752000001, 0.7875536500000008, 380.0, 1138, 236621, 350, 13.7046413999999
351, 3.2574644173303295, 46.63041225312248, 56.14067356927054, 0.7868147500000001, 85.0, 504, 237125, 351, 6.146292799999856
352, 5.064135534268928, 46.66790892209621, 56.24883558019737, 0.7862765500000001, 155.0, 692, 237817, 352, 8.597717399999965
353, 5.616751978765124, 46.70007661344753, 56.199897220344376, 0.7856632, 140.0, 671, 238488, 353, 8.19994029999998
354, 3.337518380065659, 46.68012325248527, 56.186055360726975, 0.7850030500000006, 175.0, 796, 239284, 354, 9.64354759999992
355, 3.27605682052154, 46.61664832312272, 56.10034362821252, 0.7841593000000001, 290.0, 1079, 240363, 355, 13.181718799999999
356, 4.419188299115449, 46.53537221456435, 56.01150930695107, 0.7833871, 145.0, 637, 241000, 356, 7.791394600000103
357, 6.013936143894532, 46.64887718508498, 56.20009696037007, 0.78278815, 180.0, 694, 241694, 357, 8.492917100000113
358, 7.141594241431781, 46.579009530203685, 56.17412796020508, 0.7823183500000002, 10.0, 350, 242044, 358, 4.273451499999965
359, 5.92927829924679, 46.512437987437444, 56.01774453018118, 0.7819655499999999, 35.0, 434, 242478, 359, 5.254752499999995
360, 4.593307252191916, 46.60519608288276, 56.05100366856025, 0.7814935000000002, 125.0, 615, 243093, 360, 7.883178900000075
361, 3.1272978103791833, 46.50586331228678, 55.91984065584064, 0.7809787000000001, 105.0, 529, 243622, 361, 6.642573900000116
362, 4.309716038405895, 46.501051227251686, 55.982746299107866, 0.7803086499999995, 415.0, 960, 244582, 362, 12.09597359999998
363, 3.2319713616472425, 46.564932388009375, 56.02528655876234, 0.7795058499999998, 260.0, 824, 245406, 363, 10.143143799999962
364, 4.590284730828539, 46.53126911241181, 56.03889178061972, 0.7789145499999994, 80.0, 490, 245896, 364, 6.127668399999948
365, 4.3858428862033145, 46.513663408347625, 55.99805949501574, 0.7783291000000003, 425.0, 811, 246707, 365, 9.980356999999913
366, 5.149916873650805, 46.6569071407786, 56.2140794509073, 0.7776522999999997, 140.0, 693, 247400, 366, 9.55496560000006
367, 3.030947524628908, 46.61578018104522, 56.07701317578595, 0.7770133000000001, 215.0, 727, 248127, 367, 9.767721299999948
368, 5.008719351701279, 46.55741560673653, 56.072216230063944, 0.7761610000000005, 320.0, 1167, 249294, 368, 14.556524500000023
369, 6.931960312736242, 46.59798298325649, 56.170712393383646, 0.7753262500000001, 200.0, 688, 249982, 369, 8.942430400000148
370, 4.246014925754051, 46.28945863148722, 55.74052699433127, 0.7747434999999997, 190.0, 607, 250589, 370, 7.630759300000136
371, 4.936339106410742, 46.15908344153202, 55.59913102930243, 0.7741733500000004, 225.0, 660, 251249, 371, 8.601892900000166
372, 3.79981095702618, 46.22623067359402, 55.6115256933568, 0.7734493000000003, 395.0, 949, 252198, 372, 11.761973500000067
373, 3.5375624293372745, 46.311539268493654, 55.72285205296108, 0.7728332500000001, 80.0, 420, 252618, 373, 5.345267000000149
374, 3.376258154247062, 46.2960801278995, 55.71267055927011, 0.7721856999999998, 475.0, 1019, 253637, 374, 12.974979900000108
375, 3.8500184714431307, 46.22233629536319, 55.61199702225722, 0.7711727499999999, 260.0, 1232, 254869, 375, 17.592830699999922
376, 4.699642193907836, 46.33798494878805, 55.88374408685936, 0.7704275499999997, 130.0, 424, 255293, 376, 5.725662099999909
377, 5.115034866532901, 46.39693627706388, 55.85243679006756, 0.7697201500000003, 315.0, 1148, 256441, 377, 15.18151610000018
378, 5.487595402723532, 46.31401480698004, 55.7426371245723, 0.7687791999999992, 210.0, 943, 257384, 378, 12.56891840000003
379, 2.843275153078139, 46.35171633153348, 55.75006874831947, 0.7680884500000001, 120.0, 592, 257976, 379, 8.010630099999844
380, 5.987270519718324, 46.30875997933728, 55.78933298657512, 0.76736035, 500.0, 1026, 259002, 380, 14.165320599999859
381, 3.896589258416209, 46.46866712191651, 55.915825339499264, 0.7665471999999998, 500.0, 781, 259783, 381, 10.55402499999991
382, 2.5204452993608917, 46.3894585568183, 55.80629336136291, 0.7660189000000002, 60.0, 393, 260176, 382, 6.015877699999919
383, 5.869836384919047, 46.05145197864334, 55.4740969750189, 0.7655212, 120.0, 713, 260889, 383, 9.585625500000106
384, 3.7251995708249925, 46.04267111254624, 55.41040659330252, 0.7648610499999998, 120.0, 754, 261643, 384, 10.23304690000009
385, 6.442446171273639, 46.1482419540633, 55.66476241154457, 0.76434085, 80.0, 402, 262045, 385, 5.497624599999881
386, 3.747736478058222, 46.105573021778255, 55.428533008031934, 0.763822, 165.0, 751, 262796, 386, 10.656188000000157
387, 4.881980981998174, 46.100282309144085, 55.539295735193924, 0.7631334999999998, 135.0, 779, 263575, 387, 10.82477330000006
388, 5.696318211434064, 46.07545696541115, 55.53496092337149, 0.7625399500000001, 80.0, 540, 264115, 388, 7.451996700000109
389, 5.095900461864471, 45.92341492919922, 55.27529088134766, 0.7620156999999995, 120.0, 625, 264740, 389, 8.496968899999956
390, 5.859781704377845, 46.0740794284847, 55.430836325003675, 0.7612804000000002, 390.0, 1009, 265749, 390, 13.624999200000047
391, 5.2994210697615864, 45.92855935347708, 55.37168270879562, 0.7605783999999997, 55.0, 551, 266300, 391, 7.650371599999971
392, 4.586449933541079, 46.03058352632788, 55.355528139600565, 0.7598943999999997, 260.0, 969, 267269, 392, 13.19252789999996
393, 7.062540394977263, 45.98807316709929, 55.476022257791875, 0.7592931999999996, 80.0, 367, 267636, 393, 5.162665199999992
394, 3.1043694099715475, 45.85124271256583, 55.123743675193005, 0.7587752500000003, 210.0, 784, 268420, 394, 10.876301600000033
395, 4.231778909953741, 45.99641942012648, 55.40527221741464, 0.7579778499999996, 210.0, 988, 269408, 395, 13.480604200000016
396, 4.724353538011786, 46.18190918735523, 55.65850843017425, 0.7571750499999997, 155.0, 796, 270204, 396, 11.177347800000007
397, 6.39314354803865, 46.76408038280527, 56.352970378332856, 0.7563457000000001, 285.0, 1047, 271251, 397, 14.645592000000079
398, 4.167728257198212, 46.676735166904464, 56.14603803116112, 0.7555915000000002, 80.0, 629, 271880, 398, 9.982492099999945
399, 8.138585595336725, 46.74519730334012, 56.32900793687352, 0.7550699499999997, 35.0, 530, 272410, 399, 7.5068223000002945
400, 3.1552894629134753, 46.6892746928071, 56.174346097853785, 0.7546735000000002, 65.0, 351, 272761, 400, 4.6441170000002785
401, 5.968495737102483, 46.76120708507365, 56.2740276736646, 0.7542280000000001, 210.0, 639, 273400, 401, 8.399106899999879
402, 3.176440145215293, 46.67567592777618, 56.106105688733365, 0.75348055, 275.0, 1022, 274422, 402, 13.613643300000149
403, 2.717234534396828, 46.654009967685035, 56.138716617648264, 0.7528330000000001, 125.0, 417, 274839, 403, 5.682922800000142
404, 4.283961177662467, 46.63339225451151, 56.14857849930272, 0.7524077499999998, 45.0, 528, 275367, 404, 8.518350100000134
405, 5.3184540356055665, 46.66258715360593, 56.21561266825749, 0.7518893500000001, 60.0, 624, 275991, 405, 9.55072119999977
406, 6.816265616094632, 46.906664876425495, 56.52715745129247, 0.7513489000000002, 105.0, 577, 276568, 406, 9.207040699999652
407, 3.1993508973532148, 46.69155072609274, 56.13357162475586, 0.7508579499999996, 50.0, 514, 277082, 407, 7.467684100000042
408, 5.752658797628713, 46.5795235372446, 56.09358066061269, 0.7503886000000004, 65.0, 529, 277611, 408, 7.898725600000034
409, 5.051240268504359, 46.697059193595514, 56.26040226253655, 0.7499858500000001, 55.0, 366, 277977, 409, 5.175417500000094
410, 3.8571506092634906, 46.719624988427, 56.19983355602126, 0.7494615999999996, 185.0, 799, 278776, 410, 11.551681400000234
411, 7.055998649045806, 46.6483324867646, 56.16886122435748, 0.7487479, 355.0, 787, 279563, 411, 10.51335169999993
412, 4.4697279459319095, 46.64188062953124, 56.22521242724066, 0.7480297, 160.0, 809, 280372, 412, 10.221384899999975
413, 2.654436705915618, 46.18056226978251, 55.51705796016622, 0.7474960000000002, 60.0, 377, 280749, 413, 4.788290099999813
414, 4.989427954723234, 46.252054852124886, 55.652100856702695, 0.74701945, 120.0, 682, 281431, 414, 8.869843800000126
415, 4.3277178056868895, 46.15786343951558, 55.58877838489621, 0.7462868499999993, 150.0, 946, 282377, 415, 11.984532800000125
416, 6.593207337720938, 46.29725458957027, 55.78866189463318, 0.7454192500000005, 195.0, 982, 283359, 416, 12.422793600000205
417, 3.768641397992883, 46.23675237034327, 55.63351263531919, 0.7446610000000002, 180.0, 703, 284062, 417, 8.891502700000274
418, 6.1808105829457745, 46.38873442328085, 55.88414014798892, 0.74404855, 120.0, 658, 284720, 418, 8.421941900000093
419, 4.9085119538766175, 46.271035311693815, 55.73357447455911, 0.74358415, 35.0, 374, 285094, 419, 4.791420099999868
420, 3.4347452130227434, 46.12378210675453, 55.47156171467778, 0.7431305500000002, 75.0, 634, 285728, 420, 8.034636699999737
421, 8.299532413183261, 46.275194224102606, 55.80082752162927, 0.7425540999999998, 130.0, 647, 286375, 421, 8.549600499999997
422, 4.4017225622660545, 46.26328236205573, 55.69360997879058, 0.7420348000000002, 65.0, 507, 286882, 422, 6.5549277000000075
423, 5.365794344869586, 46.23459948928113, 55.68497175181082, 0.7413967, 435.0, 911, 287793, 423, 11.704634100000021
424, 3.626076717008541, 46.2589983530389, 55.66238229924982, 0.7406253999999997, 150.0, 803, 288596, 424, 11.308023199999752
425, 4.774322761603482, 46.209566443005976, 55.6575701908512, 0.7401011500000001, 65.0, 362, 288958, 425, 5.427326200000152
426, 5.383567643855012, 46.28514922939317, 55.669568281048036, 0.7396308999999996, 115.0, 683, 289641, 426, 10.270280899999761
427, 4.225681827831979, 46.035880857783766, 55.38420334430602, 0.7390819000000003, 150.0, 537, 290178, 427, 8.007995900000424
428, 6.146074276729133, 45.6144214271732, 54.974966576967766, 0.7384906, 180.0, 777, 290955, 428, 11.77510089999987
429, 4.690005005426872, 45.584560414390914, 54.88726784526438, 0.7377994, 210.0, 759, 291714, 429, 11.264434899999742
430, 3.0289586186408997, 45.48721374480831, 54.73729558319215, 0.7372355500000001, 95.0, 494, 292208, 430, 7.4525948999998946
431, 6.086196887105423, 45.7082734362085, 55.07907515857661, 0.7367261499999995, 180.0, 638, 292846, 431, 9.505315500000052
432, 3.8191302544871966, 45.57150089899699, 54.82679748535156, 0.7361690500000002, 45.0, 600, 293446, 432, 8.87360039999976
433, 5.550615354981875, 45.6707373280679, 55.06341879598556, 0.7356758499999999, 150.0, 496, 293942, 433, 7.503850500000226
434, 5.704565909871411, 45.46446453371355, 54.74013329321338, 0.7352294499999996, 105.0, 496, 294438, 434, 7.461162999999942
435, 5.312924026687179, 45.570110572924456, 54.85943361127205, 0.7345360000000001, 220.0, 1045, 295483, 435, 17.059044399999948
436, 3.6730453347385192, 45.62930667557905, 54.88834946306091, 0.7337592999999999, 85.0, 681, 296164, 436, 11.162368700000115
437, 4.686889520181077, 45.58763736682934, 54.87132633125389, 0.7332890499999998, 35.0, 364, 296528, 437, 5.543451200000163
438, 5.143249200934713, 45.57185441450639, 54.91930609963157, 0.73287775, 55.0, 550, 297078, 438, 9.08402840000008
439, 9.791497596549988, 45.77143710327148, 55.373786602783206, 0.7323489999999996, 120.0, 625, 297703, 439, 9.729853700000149
440, 4.611115685005335, 45.64064740112532, 54.94846544861238, 0.7315849000000006, 170.0, 1073, 298776, 440, 16.3339289999999
441, 4.442946690775205, 45.52940610675268, 54.7983688723199, 0.7307389000000005, 230.0, 807, 299583, 441, 12.568860699999732
442, 4.275888462606942, 45.659554436902425, 54.95870638637076, 0.7301736999999999, 65.0, 449, 300032, 442, 6.833486600000015
443, 4.387446377422952, 45.086828384751, 54.32324951101558, 0.7294833999999991, 255.0, 1085, 301117, 443, 16.48712569999998
444, 3.5556224016472697, 45.051544937220484, 54.22135743769732, 0.7286783499999999, 65.0, 704, 301821, 444, 11.354694000000109
445, 4.252037350564276, 45.04898023395286, 54.29136968184147, 0.7279529500000003, 415.0, 908, 302729, 445, 13.850827499999923
446, 5.7401760137657964, 45.221029500653664, 54.51375614289314, 0.7271955999999998, 150.0, 775, 303504, 446, 12.249560900000233
447, 3.794119207708685, 45.17402576264881, 54.34962922419054, 0.7264972000000001, 180.0, 777, 304281, 447, 11.868768600000294
448, 3.7162206782905876, 45.19032112209276, 54.39881646496126, 0.72583435, 180.0, 696, 304977, 448, 10.733350199999677
449, 4.443302424839378, 45.145279637914506, 54.35858288507392, 0.7249046500000004, 615.0, 1370, 306347, 449, 21.124501599999803
450, 3.9851716335616376, 45.17120476515629, 54.36032935335385, 0.7238052999999991, 565.0, 1073, 307420, 450, 16.656865900000412
451, 2.4089534199917098, 45.1544278044965, 54.40447399601555, 0.7231033, 100.0, 487, 307907, 451, 7.773486600000069
452, 4.283221733034436, 45.12564608006696, 54.34376842523712, 0.7225398999999998, 180.0, 765, 308672, 452, 12.043036500000198
453, 2.658642090378782, 45.01638924108969, 54.193745432673275, 0.7219292500000001, 60.0, 592, 309264, 453, 9.148578399999678
454, 5.002364162464165, 45.170776881060554, 54.4616200993362, 0.7212920499999996, 220.0, 824, 310088, 454, 12.711650799999916
455, 6.793353208416217, 45.793882080522245, 55.19283251455073, 0.7204883500000002, 295.0, 962, 311050, 455, 14.857384400000228
456, 6.867009518368874, 45.931977286857645, 55.37418814150163, 0.7198817499999997, 45.0, 386, 311436, 456, 6.160999499999889
457, 3.7657652400066945, 45.745533482212515, 55.093957817189384, 0.7193701000000006, 215.0, 751, 312187, 457, 11.897768100000121
458, 7.540859571320521, 45.81925567893482, 55.24297030142127, 0.7187229999999999, 145.0, 687, 312874, 458, 10.781393000000207
459, 2.801145040750832, 45.83088206982153, 55.11432355560218, 0.7182504999999999, 70.0, 363, 313237, 459, 5.732576700000209
460, 3.4072817833050615, 45.8888505488067, 55.25510535935771, 0.71766145, 210.0, 946, 314183, 460, 14.884637199999815
461, 4.7370615541245895, 45.97925013062582, 55.43890631129976, 0.7170800499999996, 15.0, 346, 314529, 461, 5.459792900000139
462, 7.471309386341422, 45.816699205003346, 55.27044808327615, 0.7166746000000004, 80.0, 555, 315084, 462, 8.963532100000066
463, 4.110137127975865, 45.847072678852854, 55.175019907757516, 0.7162034500000002, 65.0, 492, 315576, 463, 8.006035399999746
464, 3.4964201852832875, 45.8897106412233, 55.25121041074593, 0.7156764999999996, 180.0, 679, 316255, 464, 10.88906199999974
465, 4.59312858227113, 45.79993229509288, 55.18994521526217, 0.7150690000000002, 115.0, 671, 316926, 465, 10.586239700000078
466, 7.4022481298517615, 45.96976909637451, 55.455498377482094, 0.7145780500000001, 30.0, 420, 317346, 466, 6.682209300000068
467, 4.190638321740874, 45.687921377890866, 55.02607833014594, 0.7141541499999997, 130.0, 522, 317868, 467, 7.934208399999989
468, 4.6275080031388764, 45.79617697975852, 55.15493362228592, 0.7137459999999999, 105.0, 385, 318253, 468, 5.423089300000356
469, 9.85154252614664, 45.8571411663553, 55.308146786897076, 0.7133140000000001, 155.0, 575, 318828, 469, 8.010041400000318
470, 6.255666248349449, 45.78095930075344, 55.19530009499079, 0.7126997499999994, 155.0, 790, 319618, 470, 12.757354300000316
471, 4.745169869665779, 45.88597932502405, 55.26577723488879, 0.7120427500000001, 180.0, 670, 320288, 471, 10.908547500000168
472, 3.7265940307333225, 45.94065465958808, 55.26728042019562, 0.7114703499999996, 105.0, 602, 320890, 472, 9.663014000000203
473, 3.574883010190444, 45.90292549133301, 55.23837285185065, 0.7107800500000001, 260.0, 932, 321822, 473, 14.758231400000113
474, 3.803588125746925, 46.15842042781916, 55.62764086830654, 0.7100807499999997, 100.0, 622, 322444, 474, 9.837497399999847
475, 6.679939339131158, 45.97394706736656, 55.43233397400495, 0.7094764000000003, 180.0, 721, 323165, 475, 11.505799999999908
476, 6.541750645217984, 46.008076990743085, 55.39521546889428, 0.7088130999999999, 180.0, 753, 323918, 476, 12.213637800000015
477, 4.039328535996288, 45.98076198269291, 55.33663723760135, 0.7082128000000004, 90.0, 581, 324499, 477, 9.35695910000004
478, 4.7210606632398315, 45.92827745347697, 55.31681883364694, 0.7077700000000001, 80.0, 403, 324902, 478, 6.466907800000172
479, 4.055970424025842, 46.04408065586874, 55.44886434894718, 0.7070958999999993, 455.0, 1095, 325997, 479, 17.467944500000158
480, 5.006132464104456, 46.13013202301593, 55.55747208711245, 0.7062886000000002, 210.0, 699, 326696, 480, 11.30088029999979
481, 5.195337917987218, 45.94974807808302, 55.36566230290616, 0.7053773500000001, 290.0, 1326, 328022, 481, 21.04667100000006
482, 7.488084991481326, 46.15658568635993, 55.5990144292149, 0.7045353999999998, 125.0, 545, 328567, 482, 8.995608700000048
483, 3.49158545049294, 46.0496733083665, 55.42413653967515, 0.7039324, 180.0, 795, 329362, 483, 12.85978810000006
484, 3.0826029030831306, 45.98146439995958, 55.34506842504928, 0.70332895, 135.0, 546, 329908, 484, 9.070313499999884
485, 5.01219851666033, 46.124965881288745, 55.52792031056172, 0.7026170500000002, 385.0, 1036, 330944, 485, 17.712982600000032
486, 3.309964445222368, 46.042870755134146, 55.38979100039431, 0.7019065, 110.0, 543, 331487, 486, 8.038535500000307
487, 4.249016772611783, 46.01005198405339, 55.37330489525428, 0.70142815, 110.0, 520, 332007, 487, 7.900856400000066
488, 4.404104303847695, 45.97432398925516, 55.34333747010537, 0.7007797000000001, 145.0, 921, 332928, 488, 18.734958600000027
489, 4.75663685062597, 46.08013121494027, 55.49284120426621, 0.6998814999999999, 225.0, 1075, 334003, 489, 21.273030899999867
490, 5.474591478165881, 46.089863777160645, 55.5028594444538, 0.69913675, 105.0, 580, 334583, 490, 10.868597200000295
491, 3.3458343932702057, 46.0927579022836, 55.4633102071458, 0.6986273499999998, 20.0, 552, 335135, 491, 9.58393279999973
492, 5.2626113247556185, 46.19107337639882, 55.65268434011019, 0.6980045500000002, 165.0, 832, 335967, 492, 13.881988699999965
493, 5.08604921351324, 46.127849407024215, 55.53834503906983, 0.6974802999999998, 45.0, 333, 336300, 493, 5.463357900000119
494, 5.15776399685893, 46.043105055934696, 55.44452701539032, 0.6967499500000004, 210.0, 1290, 337590, 494, 20.959092800000235
495, 4.58531126611441, 46.12610297527128, 55.45824375893306, 0.6959840499999996, 60.0, 412, 338002, 495, 8.149003900000025
496, 5.236066818378771, 46.02052463459063, 55.47153366064723, 0.6955142500000003, 130.0, 632, 338634, 496, 12.810495199999878
497, 2.8984838641852466, 46.153099657415034, 55.50764660782866, 0.6949022499999999, 110.0, 728, 339362, 497, 12.72248239999999
498, 2.8505856227032855, 46.4136905339603, 55.82746045263016, 0.6940553500000004, 185.0, 1154, 340516, 498, 19.336478599999737
499, 5.43412661066292, 46.89734037548092, 56.484920068835535, 0.6932822499999997, 30.0, 564, 341080, 499, 9.698767800000041
500, 6.971003215112375, 46.79815611770849, 56.390693670634825, 0.6927463000000003, 130.0, 627, 341707, 500, 10.867835699999887
501, 8.365299565526538, 46.8669638633728, 56.50446075048202, 0.6921833500000001, 105.0, 624, 342331, 501, 10.978068800000074
502, 6.160843802078941, 46.77940258662519, 56.3077500397582, 0.6914359000000001, 340.0, 1037, 343368, 502, 17.528607700000066
503, 4.855784021296912, 46.98806143076406, 56.57879770677642, 0.69065065, 155.0, 708, 344076, 503, 10.609095499999967
504, 4.770269806505668, 46.873722585042316, 56.39590073540097, 0.69014305, 80.0, 420, 344496, 504, 6.500009500000033
505, 5.124953318789898, 46.84882021300565, 56.37463761576826, 0.6895252000000002, 245.0, 953, 345449, 505, 14.43642809999983
506, 4.82882078908957, 46.96623138036483, 56.52138892931816, 0.6889208499999999, 45.0, 390, 345839, 506, 5.924040700000205
507, 5.6764111115325315, 46.90606923231674, 56.530079898873716, 0.6885280000000003, 15.0, 483, 346322, 507, 7.330764700000145
508, 4.928930020886041, 46.53147281584192, 55.990139330671134, 0.6881459500000002, 20.0, 366, 346688, 508, 5.619365600000037
509, 4.9285772984279665, 46.878065670237824, 56.42387788945978, 0.6876446499999997, 170.0, 748, 347436, 509, 11.624859800000195
510, 6.397585873312728, 47.00329453579215, 56.602875092972155, 0.6868242999999998, 245.0, 1075, 348511, 510, 16.41281710000021
511, 6.144107798931047, 46.9085111132592, 56.45666240197293, 0.6860664999999997, 105.0, 609, 349120, 511, 9.312037299999702
512, 4.255584046751212, 46.62439637002265, 56.11337937881697, 0.6852497500000001, 240.0, 1206, 350326, 512, 18.308924299999944
513, 4.32071435180037, 46.263341031175976, 55.66727542877197, 0.68436865, 360.0, 752, 351078, 513, 11.65152820000003
514, 5.131461808587065, 46.11127399217965, 55.51328645838369, 0.6838484500000002, 35.0, 404, 351482, 514, 6.459383699999762
515, 3.8149861222161223, 46.14152295979706, 55.54198488343041, 0.6833394999999995, 140.0, 727, 352209, 515, 11.215822099999968
516, 4.574169144746792, 46.16632862774974, 55.514968986055294, 0.6827864500000002, 45.0, 502, 352711, 516, 7.7847804000002725
517, 6.06324453327078, 46.164166822666076, 55.615488500129885, 0.6822653499999999, 120.0, 656, 353367, 517, 10.106653800000004
518, 5.5792477613537566, 46.31568628587063, 55.814589032587016, 0.6816839499999998, 180.0, 636, 354003, 518, 9.794930199999726
519, 3.414070913896841, 46.102042035495536, 55.4614756752463, 0.68109175, 140.0, 680, 354683, 519, 10.473160100000314
520, 5.092060896731515, 46.31483605071789, 55.73644789484621, 0.6806088999999997, 55.0, 393, 355076, 520, 6.449631899999986
521, 5.707735066012824, 46.30670111688667, 55.792354780577035, 0.6799960000000005, 220.0, 969, 356045, 521, 16.222566399999778
522, 5.108874708562348, 46.21186787809305, 55.66755982773814, 0.67937905, 65.0, 402, 356447, 522, 6.761411800000133
523, 6.768165553978981, 46.15192420686244, 55.606397518441696, 0.6790348, 55.0, 363, 356810, 523, 6.0975085000000036
524, 4.126706770130859, 46.068539322534285, 55.43636674484187, 0.6785578000000003, 155.0, 697, 357507, 524, 11.715771800000311
525, 7.516536390212009, 46.290864393963076, 55.780388731297435, 0.6780227499999999, 55.0, 492, 357999, 525, 8.21381330000031
526, 4.416813786115662, 46.18812310051801, 55.58182767877407, 0.6775263999999998, 120.0, 611, 358610, 526, 10.249787899999774
527, 4.386700096467457, 46.161481612911984, 55.490701807440644, 0.6769459000000001, 150.0, 679, 359289, 527, 11.499516699999731
528, 3.9369064716336966, 46.427572635272604, 55.8273634214659, 0.6761408499999992, 410.0, 1110, 360399, 528, 18.67184690000022
529, 5.42760858327787, 46.641045889558534, 56.1103904467997, 0.6751990000000004, 260.0, 983, 361382, 529, 16.60242930000004
530, 6.515278982675344, 46.51472999965263, 56.023883457735806, 0.6744767500000003, 80.0, 622, 362004, 530, 10.467640900000333
531, 4.743192847574122, 46.513325287265026, 55.964963579802536, 0.6739907500000001, 140.0, 458, 362462, 531, 7.741810499999701
532, 8.007472100537582, 46.564825361667395, 56.1259857262979, 0.6734624499999995, 135.0, 716, 363178, 532, 12.153212000000167
533, 3.730695566697006, 46.590522621434495, 56.00253605511035, 0.6727843, 160.0, 791, 363969, 533, 13.302966299999753
534, 8.079662458260056, 46.555323121720896, 56.11465709397376, 0.6721371999999997, 35.0, 647, 364616, 534, 10.894761800000197
535, 3.5160193936692345, 46.51150834825304, 55.899201908818, 0.6716030500000002, 60.0, 540, 365156, 535, 9.101087100000314
536, 5.890252728672588, 46.590167326085705, 56.048788519466626, 0.6711305500000001, 95.0, 510, 365666, 536, 8.59707380000009
537, 4.007418901799551, 46.46970100652159, 55.89354785595065, 0.6705567999999994, 170.0, 765, 366431, 537, 12.934244699999908
538, 4.907150262070321, 46.49720201299926, 55.97791964176409, 0.66990025, 140.0, 694, 367125, 538, 11.780527800000073
539, 5.119651637855681, 46.54454324464787, 55.997086537496735, 0.6692112999999997, 215.0, 837, 367962, 539, 14.138093800000206
540, 4.117540537126664, 46.565854381274626, 55.99891621253394, 0.6685232500000001, 135.0, 692, 368654, 540, 11.684224300000096
541, 4.950062459013318, 46.75826192843939, 56.28242707599473, 0.6679953999999997, 20.0, 481, 369135, 541, 8.16292569999996
542, 6.347619924417536, 46.48261927868644, 55.960164872068546, 0.6670945, 365.0, 1521, 370656, 542, 25.92630519999966
543, 5.4166129226668165, 46.30622105496374, 55.69304847133998, 0.6661157500000002, 160.0, 654, 371310, 543, 11.04770950000011
544, 4.965238846467106, 46.269953867356726, 55.66895057107801, 0.6655325500000001, 105.0, 642, 371952, 544, 10.91629069999999
545, 10.459609069880635, 46.25933771957586, 55.848804026474184, 0.6650249499999995, 65.0, 486, 372438, 545, 8.279156499999772
546, 4.963272383668233, 46.5786438652532, 56.04699976527276, 0.66462535, 65.0, 402, 372840, 546, 6.9945292000002155
547, 5.439164407464562, 46.32988582792736, 55.72134987563683, 0.6640192000000004, 375.0, 945, 373785, 547, 16.055473999999776
548, 5.634637065804922, 46.30497167321012, 55.71204338182411, 0.6632780500000004, 325.0, 702, 374487, 548, 11.923672099999749
549, 4.662347980468504, 46.329235257384596, 55.72335752261582, 0.6627529000000001, 90.0, 465, 374952, 549, 7.9102671999999075
550, 3.35936838388443, 46.43459408763995, 55.82466467712151, 0.6623249499999998, 180.0, 486, 375438, 550, 8.41076860000021
551, 5.1279457760055145, 46.35942718670227, 55.73365836768433, 0.6616049499999997, 415.0, 1114, 376552, 551, 19.003590099999656
552, 7.468975845622022, 46.41332743150899, 55.870325334923436, 0.6606612999999998, 430.0, 983, 377535, 552, 16.736793300000045
553, 3.116397005261539, 46.16279639206923, 55.464900276877664, 0.6598724500000002, 130.0, 770, 378305, 553, 13.149044900000263
554, 3.6215595965349943, 46.20877346389051, 55.571545797305426, 0.6591632499999998, 125.0, 806, 379111, 554, 13.66826379999975
555, 6.490460959015321, 46.30082038888665, 55.76177123337441, 0.6584302000000002, 185.0, 823, 379934, 555, 14.039267299999665
556, 3.3960317582181356, 46.696081039280564, 56.09002137415617, 0.6578280999999998, 125.0, 515, 380449, 556, 8.840654300000097
557, 5.048657881260487, 46.859502837879845, 56.400137015914005, 0.65721925, 370.0, 838, 381287, 557, 14.302904000000126
558, 3.707412366639391, 46.834635154713204, 56.29172330318773, 0.6565275999999994, 155.0, 699, 381986, 558, 11.86624299999994
559, 8.095217907569698, 46.889700946292365, 56.54970186078871, 0.65588005, 180.0, 740, 382726, 559, 12.80806369999982
560, 4.799526407811712, 46.806898978189075, 56.30591615443491, 0.6553337499999997, 50.0, 474, 383200, 560, 8.15569830000004
561, 6.0159849164712345, 46.85012493954125, 56.41631672590002, 0.6546916000000004, 180.0, 953, 384153, 561, 16.271100399999796
562, 3.4001418887352455, 46.8691353019403, 56.33093179975237, 0.65408635, 105.0, 392, 384545, 562, 6.82826520000026
563, 7.775558211503828, 46.88255285709462, 56.48673551640612, 0.6535715499999998, 125.0, 752, 385297, 563, 12.969962600000144
564, 6.414367598130108, 46.853685459281415, 56.41582728970435, 0.6525914500000007, 210.0, 1426, 386723, 564, 24.406910000000153
565, 5.285750564168124, 46.92818031914415, 56.49390222988564, 0.6516936999999999, 135.0, 569, 387292, 565, 9.84320039999966
566, 4.874057832413171, 46.86127131084013, 56.331347078402366, 0.6510573999999996, 170.0, 845, 388137, 566, 14.572656099999676
567, 6.8680047187833075, 46.88260909081745, 56.42437427158629, 0.6503311000000002, 180.0, 769, 388906, 567, 13.322440599999936
568, 3.8019228235628346, 46.917707178236896, 56.384140191315375, 0.6497226999999998, 65.0, 583, 389489, 568, 10.223822800000107
569, 5.607600259024705, 46.72775996573529, 56.22305334670034, 0.6490081000000004, 255.0, 1005, 390494, 569, 17.504049699999996
570, 4.766604143512647, 46.54333858264147, 55.99903328426431, 0.6481377999999995, 445.0, 929, 391423, 570, 16.633360599999833
571, 5.326636773658145, 46.48256315734716, 55.9174359300812, 0.6475339, 120.0, 413, 391836, 571, 7.281529800000044
572, 6.7984834741010145, 46.50194923769503, 56.018393889353185, 0.6470406999999999, 105.0, 683, 392519, 572, 11.950259799999913
573, 3.75079974697368, 46.45077665725557, 55.819250065265315, 0.6465061000000002, 30.0, 505, 393024, 573, 8.828989500000262
574, 4.637150121761628, 46.621192013914104, 56.10981427246811, 0.6460488999999999, 150.0, 511, 393535, 574, 9.062301099999786
575, 5.849789240952927, 46.40995570591518, 55.83077561341716, 0.6454220499999997, 145.0, 882, 394417, 575, 15.418483799999649
576, 6.674163980360187, 46.62572425640285, 56.16859804297173, 0.6448041999999999, 35.0, 491, 394908, 576, 8.765893799999958
577, 4.855283904178389, 46.581934830238076, 56.02681944836145, 0.6443483499999999, 125.0, 522, 395430, 577, 9.155924599999707
578, 6.306562696205718, 46.54217838287354, 56.058740403311596, 0.6434834500000002, 440.0, 1400, 396830, 578, 25.14131270000007
579, 5.660383589699197, 46.62832705369636, 56.105812676273175, 0.6425519499999995, 310.0, 670, 397500, 579, 11.89356480000015
580, 11.786732204985327, 46.578243232354886, 56.17186983620248, 0.6421028499999999, 45.0, 328, 397828, 580, 5.74330800000007
581, 6.752498396526037, 46.675920763262226, 56.24621757219136, 0.6417289000000002, 115.0, 503, 398331, 581, 8.982375800000227
582, 3.648578387705919, 46.66958291595686, 56.04726141084808, 0.6413211999999999, 65.0, 403, 398734, 582, 7.195822100000441
583, 3.646646160973733, 46.608960201065855, 56.01642272006943, 0.6409139500000001, 160.0, 502, 399236, 583, 8.863030100000287
584, 5.443910025867037, 46.435864101357176, 55.88736952065323, 0.6402974499999999, 410.0, 868, 400104, 584, 15.462623999999778
585, 6.7024990509415785, 45.687057499552886, 54.948560834485434, 0.6395198499999997, 290.0, 860, 400964, 585, 15.242783699999563
586, 7.008548994399724, 45.658039643099315, 54.901689415815106, 0.6388457500000002, 170.0, 638, 401602, 586, 11.499355699999796
587, 3.8038962514898214, 45.81214708151276, 55.07411214821937, 0.6382967499999996, 60.0, 582, 402184, 587, 10.335467299999436
588, 6.945257886601933, 45.79477161299846, 55.10274421010271, 0.6374606500000001, 225.0, 1276, 403460, 588, 22.73960420000003
589, 4.016778397694103, 45.77758677356298, 55.013541952807586, 0.6365161000000004, 200.0, 823, 404283, 589, 14.713910399999804
590, 5.664831639674512, 45.8085467619546, 55.15634694261332, 0.6357349000000001, 220.0, 913, 405196, 590, 16.520307499999944
591, 4.791275435770319, 45.69508717511151, 54.95707069509445, 0.6349577500000003, 180.0, 814, 406010, 591, 14.719891599999755
592, 5.560937070802076, 45.62365453160224, 54.882330130581835, 0.63441055, 80.0, 402, 406412, 592, 7.263068700000076
593, 5.698616514832646, 45.80545036396439, 55.054893559075914, 0.6338885499999997, 235.0, 758, 407170, 593, 13.950320200000533
594, 5.6003429073367945, 45.69879424795044, 55.01985361174585, 0.6333310000000001, 130.0, 481, 407651, 594, 8.683306299999458
595, 5.324535422560953, 45.799977281754636, 55.0880179598324, 0.6328256499999997, 120.0, 642, 408293, 595, 11.745769199999813
596, 5.71920040226255, 45.784667439117165, 55.108571540282774, 0.6322807000000003, 150.0, 569, 408862, 596, 10.386380899999494
597, 5.8029528488738045, 45.74900408689605, 55.073471519652074, 0.6316282, 155.0, 881, 409743, 597, 15.796885400000065
598, 4.249384587233314, 45.8008018986353, 55.00845857235783, 0.6310017999999998, 30.0, 511, 410254, 598, 9.282309199999872
599, 8.800303619226504, 45.85250527283241, 55.237490875967616, 0.6305630500000001, 80.0, 464, 410718, 599, 8.529802200000631
600, 5.125245310914887, 45.85551519440746, 55.12111118772416, 0.6300792999999999, 115.0, 611, 411329, 600, 11.22966819999965
601, 5.458199752832022, 45.60953534118772, 54.87977851657417, 0.6293471500000004, 150.0, 1016, 412345, 601, 18.520433699999558
602, 4.096146416415436, 45.68922095215336, 54.92810255746341, 0.6285555999999995, 110.0, 743, 413088, 602, 13.588628900000003
603, 6.5431871754657935, 45.747726801430304, 55.09256853057117, 0.62776, 245.0, 1025, 414113, 603, 18.928628800000297
604, 7.8323932928075735, 45.65786810810431, 54.96788998452139, 0.6270525999999995, 105.0, 547, 414660, 604, 10.160455100000036
605, 4.632177268713713, 45.833663986950384, 55.1298587380386, 0.6264374500000002, 55.0, 820, 415480, 605, 15.051140499999747
606, 5.218461881443884, 45.85808991981079, 55.1201027318051, 0.6258033999999998, 55.0, 589, 416069, 606, 10.909571500000311
607, 5.839423125381852, 45.763109510714784, 55.05058638108577, 0.6250491999999997, 240.0, 1087, 417156, 607, 20.022662700000183
608, 8.697756200725493, 45.84571757814053, 55.17012621852884, 0.6243831999999998, 80.0, 393, 417549, 608, 7.264670700000352
609, 6.123836300784997, 45.63007614638779, 54.92763889578236, 0.6238378000000004, 180.0, 819, 418368, 609, 15.293433000000732
610, 4.512268801289508, 45.66490096037609, 54.86823928093595, 0.62326495, 35.0, 454, 418822, 610, 8.583093100000042
611, 7.225557809719792, 45.9065624707705, 55.21639836298955, 0.6227834499999995, 155.0, 616, 419438, 611, 11.500262499999735
612, 5.412087540369977, 45.68403787783553, 54.93757798515305, 0.6220535500000002, 210.0, 1006, 420444, 612, 18.92370430000028
613, 3.8489601595945335, 45.608739805544474, 54.83234522627923, 0.6214014999999999, 90.0, 443, 420887, 613, 8.406837900000028
614, 6.26951773008055, 45.52376810583738, 54.7777079365041, 0.6207476500000001, 135.0, 1010, 421897, 614, 18.9494179000003
615, 3.7410239240237853, 45.63789944288727, 54.85684012485028, 0.6200010999999994, 120.0, 649, 422546, 615, 12.244002399999772
616, 3.3734788908939093, 45.56462931000026, 54.750716932403655, 0.61940395, 120.0, 678, 423224, 616, 12.802006700000675
617, 4.493545432732655, 45.63639981930073, 54.904537166693274, 0.6183968500000002, 480.0, 1560, 424784, 617, 29.413896000000022
618, 5.709132302065785, 45.67914634758956, 54.910162515708215, 0.6173159499999995, 165.0, 842, 425626, 618, 15.913662299999487
619, 7.031363181177622, 45.65504369491186, 54.941826111231094, 0.6165860500000001, 210.0, 780, 426406, 619, 14.849689900000158
620, 7.444479720373923, 45.758582116413486, 55.15604109447861, 0.6158889999999997, 125.0, 769, 427175, 620, 14.802203100000042
621, 6.272248419478072, 45.5320269077492, 54.81776620248012, 0.6152104000000002, 210.0, 739, 427914, 621, 14.195032200000242
622, 6.42890916230238, 45.53519367700509, 54.80289780763769, 0.6144224499999994, 190.0, 1012, 428926, 622, 19.144944399999986
623, 4.995770997720347, 45.58830990303312, 54.91966643139408, 0.6136021000000002, 410.0, 811, 429737, 623, 15.481982099999186
624, 6.262481657709655, 45.94065324922175, 55.34906962456831, 0.6130022499999995, 0.0, 522, 430259, 624, 9.89810259999922
625, 5.28618452172069, 46.080651451559625, 55.404643960667954, 0.6123695500000003, 415.0, 884, 431143, 625, 16.854581799999323
626, 5.5988048537185895, 46.12805467534948, 55.48797071951407, 0.6117287499999997, 80.0, 540, 431683, 626, 10.367661999999655
627, 5.842987280465349, 46.17852616971713, 55.56941850040824, 0.6110479000000002, 310.0, 973, 432656, 627, 18.599867099999756
628, 6.584932751178321, 46.15253390626722, 55.54205057187896, 0.6103548999999997, 60.0, 567, 433223, 628, 11.187196199999562
629, 6.8498581531576646, 46.10568171336239, 55.495401867170976, 0.6098005000000003, 180.0, 665, 433888, 629, 12.867200200000298
630, 6.3953843477889984, 46.06793609768553, 55.444103418394576, 0.6091335999999999, 165.0, 817, 434705, 630, 15.751234100000147
631, 6.996759530479339, 46.056178545596, 55.42663577634897, 0.6084644499999999, 165.0, 670, 435375, 631, 12.955714000000626
632, 5.1713304769725195, 46.033580769323876, 55.397708946349354, 0.6076819000000003, 545.0, 1069, 436444, 632, 20.64393420000033
633, 4.914225209280849, 45.9996382522583, 55.319728212356566, 0.6068408500000003, 200.0, 800, 437244, 633, 16.569061799999872
634, 5.099036559865281, 46.13145972586967, 55.45376943253182, 0.6062144499999998, 105.0, 592, 437836, 634, 13.849478699999963
635, 7.679174535041145, 46.080251544742715, 55.540768225144745, 0.6054814, 240.0, 1037, 438873, 635, 20.680146100000456
636, 7.885762422512739, 45.93707849225427, 55.33074772935308, 0.6048568, 45.0, 351, 439224, 636, 6.522151799999847
637, 3.9655741345824196, 45.97017471723358, 55.2879883948991, 0.6043303, 220.0, 819, 440043, 637, 15.117264800000157
638, 5.25987152463382, 45.13056161512507, 54.25052490009651, 0.6036562000000001, 120.0, 679, 440722, 638, 12.330194199999823
639, 6.274492432851167, 45.002069861341866, 54.18315250429756, 0.6029348499999996, 195.0, 924, 441646, 639, 17.557223499999964
640, 7.0788661878909505, 44.937365110077124, 54.10450504609268, 0.6022108000000002, 120.0, 685, 442331, 640, 12.472044000000096
641, 5.643448030808296, 45.18749077498418, 54.341362654667485, 0.6017400999999999, 55.0, 361, 442692, 641, 6.503784399999859
642, 6.7913298143244, 45.13888623719757, 54.31679875601108, 0.6013756, 105.0, 449, 443141, 642, 8.142796799999815
643, 6.9872721549387204, 44.87667429555349, 54.00850099054742, 0.60067765, 370.0, 1102, 444243, 643, 20.266878200000065
644, 5.59476491896015, 45.05988107958147, 54.19338533955236, 0.5999585500000003, 70.0, 496, 444739, 644, 10.090562000000318
645, 5.2356878059272915, 44.99122105234677, 54.13982247421422, 0.5992988500000002, 410.0, 970, 445709, 645, 18.855351100000007
646, 4.102366460483004, 44.918088282974, 54.05444292489923, 0.5986648000000001, 35.0, 439, 446148, 646, 8.523946199999955
647, 5.619420176021533, 45.0062373605105, 54.17488540989338, 0.59828545, 85.0, 404, 446552, 647, 7.520411100000274
648, 5.12169058693915, 44.96861441476005, 54.10698696214325, 0.5975523999999995, 330.0, 1225, 447777, 648, 22.438373500000125
649, 5.836641359947414, 45.03308297384634, 54.162727019366095, 0.5967104500000001, 105.0, 646, 448423, 649, 11.989984999999251
650, 5.264725483218698, 44.92185172281767, 54.03780972957611, 0.5961461499999997, 35.0, 608, 449031, 650, 11.320455699999911
651, 6.463886075913906, 45.02021563053131, 54.16463701725006, 0.5955125500000003, 380.0, 800, 449831, 651, 15.334924300000239
652, 5.501592126267342, 44.74040857613561, 53.8506964625351, 0.5949829, 60.0, 377, 450208, 652, 7.198179899999559
653, 4.2003379212561205, 44.7766105860052, 53.79727302806478, 0.5943020499999996, 340.0, 1136, 451344, 653, 20.910984300000564
654, 7.081422635971645, 44.81125606687265, 53.973865105687075, 0.59328865, 575.0, 1116, 452460, 654, 20.686583400000018
655, 8.475288778184408, 44.9676941167467, 54.13527596714985, 0.5925250000000002, 85.0, 581, 453041, 655, 11.322587300000123
656, 7.010980608547933, 44.77746199432915, 53.90366445349518, 0.5919593499999997, 155.0, 676, 453717, 656, 12.666390399999727
657, 3.5878296233951916, 44.783259223010745, 53.86160284013891, 0.5914441, 80.0, 469, 454186, 657, 8.949881999999889
658, 3.6904254220709016, 44.555697960189626, 53.51243448378165, 0.5910553000000002, 35.0, 395, 454581, 658, 7.5001092000002245
659, 5.825543318659032, 44.738116786673714, 53.82758319616599, 0.5904954999999996, 155.0, 849, 455430, 659, 15.833256900000379
660, 6.015765671765334, 44.80821580635874, 53.924526509485744, 0.5898398499999999, 95.0, 608, 456038, 660, 11.684317799999917
661, 5.179409726420952, 44.85786952951747, 53.95081675272205, 0.5891508999999997, 95.0, 923, 456961, 661, 17.541308200000458
662, 7.852189606765929, 44.77032951255897, 53.90433302229664, 0.5883544, 235.0, 847, 457808, 662, 15.953701200000069
663, 5.836744043185855, 44.84758215239554, 53.92484444674503, 0.5876910999999997, 90.0, 627, 458435, 663, 11.791383499999938
664, 6.557843790690209, 44.989031561027, 54.10164538998298, 0.5868973000000001, 315.0, 1137, 459572, 664, 21.78353150000021
665, 5.93597970740134, 44.67321309322069, 53.829128271792115, 0.5861178999999999, 100.0, 595, 460167, 665, 11.331537600000047
666, 8.213725983036044, 44.35627448645821, 53.391009727533714, 0.5856035500000001, 50.0, 548, 460715, 666, 10.437267199999951
667, 9.361309324876089, 44.35093901768204, 53.500147543662834, 0.5851391499999999, 105.0, 484, 461199, 667, 9.165071700000226
668, 3.9699863050896003, 44.03381790023252, 52.908532510320825, 0.5846225500000002, 90.0, 664, 461863, 668, 13.027664899999763
669, 7.120047348870477, 44.313265371249386, 53.33224155056861, 0.5840308000000003, 175.0, 651, 462514, 669, 12.667987800000446
670, 3.919515764072211, 44.10701491675987, 53.089935298334495, 0.5833476999999996, 285.0, 867, 463381, 670, 16.810351099999934
671, 4.691470169659817, 44.130650611646246, 53.12901953957297, 0.5825863000000002, 190.0, 825, 464206, 671, 15.6745020999997
672, 5.926239573138376, 44.308640387750444, 53.30467583030783, 0.5817965500000002, 185.0, 930, 465136, 672, 17.757179900000665
673, 5.34746530198418, 44.31120714170743, 53.38511241811567, 0.5811238000000001, 90.0, 565, 465701, 673, 10.84170180000001
674, 3.874450519468103, 44.25433692932129, 53.204831580510216, 0.5805860499999996, 45.0, 630, 466331, 674, 12.241858800000045
675, 5.784776665666978, 44.31062149486954, 53.31909335019777, 0.5799897999999999, 160.0, 695, 467026, 675, 13.414560700000038
676, 4.942441324950268, 44.29982703531273, 53.28300347669262, 0.5793561999999998, 65.0, 713, 467739, 676, 13.71275660000083
677, 6.851879379272638, 44.29164609710965, 53.348735543316124, 0.5787320500000002, 180.0, 674, 468413, 677, 13.028968800000257
678, 5.688513846731715, 44.31935149687409, 53.349021966272915, 0.5781146499999998, 175.0, 698, 469111, 678, 13.474261100000149
679, 7.413558033120467, 44.25758348273102, 53.366653645532374, 0.5775723999999999, 55.0, 507, 469618, 679, 9.931100199999491
680, 7.608122325524107, 44.957920490611684, 54.045420124004416, 0.5769977500000001, 135.0, 770, 470388, 680, 15.041712199999893
681, 4.530662607552821, 45.41277489187093, 54.608654177056906, 0.5764073499999998, 125.0, 542, 470930, 681, 10.466741100000036
682, 5.617211346396539, 45.45012661710261, 54.70611085917429, 0.5759964999999999, 60.0, 371, 471301, 682, 8.777324299999236
683, 6.757506063007865, 45.374853295728194, 54.60924268754061, 0.5753939499999999, 245.0, 968, 472269, 683, 24.422666700000264
684, 6.407921169461799, 45.37333399783201, 54.6273487977876, 0.5747144500000001, 110.0, 542, 472811, 684, 12.584112400000777
685, 3.48908322019196, 45.31735259671755, 54.49266905724248, 0.5741861500000002, 80.0, 632, 473443, 685, 15.34288689999994
686, 5.189271556312202, 45.42762396396735, 54.611498025747444, 0.5736384999999996, 55.0, 585, 474028, 686, 13.55371439999999
687, 5.738408195607606, 45.37234593844344, 54.601222373039676, 0.5730701500000002, 140.0, 678, 474706, 687, 16.80201820000002
688, 5.619833178501928, 45.45009918932645, 54.75152667063587, 0.57257425, 90.0, 424, 475130, 688, 10.116010299999289
689, 7.079926573212554, 45.47798274590717, 54.739343993644404, 0.5721066999999997, 60.0, 615, 475745, 689, 14.411078200000702
690, 6.189258019846899, 45.381346111533084, 54.67547119046435, 0.57146545, 205.0, 810, 476555, 690, 19.019429599999967
691, 5.168039029410498, 45.4532426918308, 54.63659408042161, 0.5708664999999997, 120.0, 521, 477076, 691, 12.25074659999973
692, 6.794197343229767, 45.39005441819468, 54.641213378598614, 0.57040885, 85.0, 496, 477572, 692, 11.74607239999932
693, 6.370577112927924, 45.51109628607757, 54.80145085467039, 0.5699390500000001, 85.0, 548, 478120, 693, 13.09257020000041
694, 8.53271139491385, 45.537972875701776, 54.87720625332238, 0.5693625999999995, 65.0, 733, 478853, 694, 19.506455699999606
695, 5.931399608596221, 45.34832006067663, 54.51645635858282, 0.5687110000000001, 140.0, 715, 479568, 695, 16.717075300000033
696, 5.932998426208222, 45.292588034191645, 54.521217777922345, 0.5681228499999997, 130.0, 592, 480160, 696, 16.287981699999364
697, 5.34733553518132, 44.97809205364755, 54.14063701468151, 0.5673781000000002, 395.0, 1063, 481223, 697, 27.430500500000562
698, 5.219393942483712, 44.93881140632191, 54.06025196491987, 0.5665865499999995, 140.0, 696, 481919, 698, 18.830714400000033
699, 4.708299552407592, 44.90137564349784, 54.05372627330179, 0.5659390000000001, 225.0, 743, 482662, 699, 18.450024300000223
700, 5.297714354056967, 44.98977344826867, 54.11668740365273, 0.5652437499999996, 210.0, 802, 483464, 700, 20.56744500000059
701, 6.75165982750538, 45.107699993245994, 54.34496308238057, 0.5646843999999999, 105.0, 441, 483905, 701, 11.15114210000047
702, 6.329750345523992, 45.07229947937148, 54.24034301279909, 0.5640836499999998, 205.0, 894, 484799, 702, 23.201254900000094
703, 5.319250009229996, 44.941895821584254, 54.09409621779476, 0.5633155000000004, 190.0, 813, 485612, 703, 20.212719500000276
704, 5.01544184659619, 44.99051930859249, 54.18292876488165, 0.5626882, 45.0, 581, 486193, 704, 14.677335000000312
705, 4.570357225376376, 45.119696845858314, 54.260912693968606, 0.5620834000000003, 185.0, 763, 486956, 705, 19.792760100000123
706, 6.26214440271888, 44.95050685506472, 54.15340518375758, 0.5612927499999999, 390.0, 994, 487950, 706, 26.136841999999888
707, 4.754467663611387, 45.02553088592129, 54.18557353901204, 0.5605363000000003, 110.0, 687, 488637, 707, 17.42069619999984
708, 5.0750990049405535, 44.89197234983568, 53.978756310103776, 0.55994995, 105.0, 616, 489253, 708, 16.065673099999913
709, 6.709217164902329, 44.894200363600184, 54.03992625330225, 0.5594391999999999, 80.0, 519, 489772, 709, 13.118968699999641
710, 6.408302806586423, 44.69918266600404, 53.800871840011915, 0.5589684999999999, 70.0, 527, 490299, 710, 13.316448200000195
711, 6.488269078445909, 44.54042201533671, 53.56626819658883, 0.5584825, 80.0, 553, 490852, 711, 14.464410199999293
712, 9.349069029997603, 44.48279298641197, 53.60978446106304, 0.5579965, 65.0, 527, 491379, 712, 13.531509800000094
713, 6.0019834230736935, 44.71206610651299, 53.82451754277295, 0.5573048500000001, 270.0, 1010, 492389, 713, 26.88154729999951
714, 4.290025779768213, 44.53745777704945, 53.53621183421514, 0.5566861000000001, 50.0, 365, 492754, 714, 9.748157299999548
715, 5.9258468005794604, 44.629340638252806, 53.745346800189154, 0.5562329500000002, 145.0, 642, 493396, 715, 16.952302300000156
716, 7.404700790987091, 44.63281643301025, 53.705415944407754, 0.5554652499999997, 260.0, 1064, 494460, 716, 28.6817403999994
717, 4.552311660162316, 44.63609902579626, 53.65479611072621, 0.5546674000000001, 145.0, 709, 495169, 717, 18.581138999999894
718, 3.9543951863583664, 44.56890139107506, 53.575443554229246, 0.5540666499999998, 200.0, 626, 495795, 718, 15.9929618999995
719, 7.2247207670954605, 44.70632343515879, 53.859423268380475, 0.5535163000000002, 95.0, 597, 496392, 719, 15.34132849999969
720, 7.568166693375876, 44.48082307860372, 53.57294070689547, 0.5530753, 45.0, 383, 496775, 720, 10.605147000000215
721, 6.816224385375407, 44.66226640957505, 53.75826837909755, 0.5526014499999997, 110.0, 670, 497445, 721, 19.05658239999957
722, 6.667901808331752, 44.51090277748546, 53.64450603792037, 0.5520650500000001, 75.0, 522, 497967, 722, 14.642606599999453
723, 4.928080208337633, 44.53375715017319, 53.57871017605066, 0.55159975, 140.0, 512, 498479, 723, 14.207542099999955
724, 7.203967527838415, 44.602136356408515, 53.72235374815726, 0.5511812499999997, 45.0, 418, 498897, 724, 11.176310800000465
725, 3.8459827711902044, 44.55197239744252, 53.53850948399511, 0.5505755500000004, 200.0, 928, 499825, 725, 24.870696599999974
726, 6.771146038496816, 45.152390387988, 54.295920375691416, 0.5499248499999999, 85.0, 518, 500343, 726, 14.488024799999948
727, 7.076624581979071, 45.34011235341105, 54.57597535867186, 0.5494028500000002, 60.0, 642, 500985, 727, 18.01748459999999
728, 6.253424925827049, 45.452765069972365, 54.701595832810284, 0.5483998000000005, 690.0, 1587, 502572, 728, 42.636692400000356
729, 5.069627990281336, 45.48548912791024, 54.75041990927187, 0.5473805500000001, 135.0, 678, 503250, 729, 18.689370000000054
730, 5.753851000467936, 45.44142260908269, 54.74142444636546, 0.5467446999999996, 175.0, 735, 503985, 730, 20.4629903999994
731, 7.683055757330014, 45.35112496400491, 54.61661184262007, 0.54623845, 110.0, 390, 504375, 731, 10.85528820000036
732, 4.642578960522089, 45.385525509203596, 54.5789128441014, 0.5456696499999999, 230.0, 874, 505249, 732, 24.149149799999577
733, 5.285458161606122, 45.37070949198836, 54.62757915561482, 0.54506395, 105.0, 472, 505721, 733, 13.169763500000045
734, 5.6158606323404845, 45.5994792332159, 54.89448619379061, 0.5446108000000002, 185.0, 535, 506256, 734, 15.44293479999942
735, 7.411809530870874, 45.508114568614424, 54.809962795832966, 0.5439672999999996, 145.0, 895, 507151, 735, 25.63227259999985
736, 6.068759615117211, 45.45029499381122, 54.69572686853923, 0.5430556000000004, 365.0, 1131, 508282, 736, 31.710057100000085
737, 6.507228921883578, 45.482556932653104, 54.72245632245119, 0.5422897000000001, 50.0, 571, 508853, 737, 16.136738400000468
738, 4.669984128911915, 45.47138292684495, 54.67009619346955, 0.5417465500000002, 70.0, 636, 509489, 738, 17.648246099999596
739, 4.302590210468341, 45.498209101208566, 54.701586510773005, 0.5412321999999998, 20.0, 507, 509996, 739, 14.228628100000606
740, 5.174295872915536, 46.154847716030325, 55.493341314165214, 0.5407304500000001, 85.0, 608, 510604, 740, 17.299458000000413
741, 5.917586922339904, 46.04035475315192, 55.50198238079364, 0.54028135, 45.0, 390, 510994, 741, 10.923155499999666
742, 5.330726139180895, 46.01855172429766, 55.3699518101556, 0.5398034499999996, 140.0, 672, 511666, 742, 18.226448900000833
743, 7.835658461892421, 46.23814419618587, 55.63204789899059, 0.5393264499999999, 75.0, 388, 512054, 743, 10.468310100000053
744, 3.669301442824061, 45.83497130057224, 55.13886090626703, 0.53884855, 105.0, 674, 512728, 744, 18.648588000000018
745, 10.69730282396815, 46.130434439732475, 55.64295541323148, 0.53821765, 80.0, 728, 513456, 745, 21.113964699999997
746, 4.155129865491511, 46.01021869118149, 55.26945479496105, 0.5376236500000001, 45.0, 592, 514048, 746, 16.589173800000026
747, 9.741470561116882, 46.21451336602336, 55.68347713204015, 0.5370930999999997, 55.0, 587, 514635, 747, 16.78650959999959
748, 3.8638913219681745, 45.989536039757006, 55.27772637569543, 0.53659135, 75.0, 528, 515163, 748, 14.746460299999853
749, 8.087164578025968, 46.08667638075536, 55.56177780117683, 0.5361499000000001, 65.0, 453, 515616, 749, 12.750423299999966
750, 8.845463873386015, 46.24285398941906, 55.6882772179949, 0.5355099999999996, 390.0, 969, 516585, 750, 27.20284470000024
751, 9.497969360326662, 46.25742728529649, 55.68546747850065, 0.5347292500000002, 105.0, 766, 517351, 751, 21.5880001000005
752, 9.584297909652262, 46.00399797692147, 55.425895946392366, 0.5340889000000001, 165.0, 657, 518008, 752, 18.941127799999776
753, 10.400417730896013, 46.083498843541335, 55.49631709578388, 0.5335579, 115.0, 523, 518531, 753, 15.65013480000016
754, 6.608534787269811, 46.23345937177787, 55.60459846100541, 0.5328630999999996, 260.0, 1021, 519552, 754, 28.275468400000136
755, 4.809473432311882, 46.17743897951145, 55.56340238661472, 0.5320900000000001, 50.0, 697, 520249, 755, 19.51802150000003
756, 6.740467299780827, 46.06940347946957, 55.44027634602477, 0.5314460499999997, 130.0, 734, 520983, 756, 21.43260999999984
757, 9.50631048284215, 46.28012669425018, 55.78170885847288, 0.5308147, 160.0, 669, 521652, 757, 19.177385500000128
758, 6.188225780110105, 46.18920944574943, 55.597487066003126, 0.5300001999999995, 360.0, 1141, 522793, 758, 33.46994730000006
759, 5.557128320856576, 46.115936791269405, 55.50293663761072, 0.5289737500000004, 380.0, 1140, 523933, 759, 32.91798789999939
760, 6.4839797831003985, 46.177965867538575, 55.60593897747341, 0.5281813000000002, 80.0, 621, 524554, 760, 19.26850639999975
761, 5.544430761776389, 45.93705018023227, 55.22874372563464, 0.52773265, 105.0, 376, 524930, 761, 10.764947200000279
762, 5.940673667506331, 46.17747493580807, 55.57230733606937, 0.5271318999999995, 295.0, 959, 525889, 762, 27.705244000000675
763, 6.027162890923157, 46.18534328696433, 55.60580967249495, 0.5263799500000002, 180.0, 712, 526601, 763, 20.301584300000286
764, 6.081233867010487, 46.322612731562934, 55.781070828920434, 0.5256149499999998, 270.0, 988, 527589, 764, 29.058870100000604
765, 7.338053906897733, 46.1757162686052, 55.63433026910007, 0.5248702000000001, 110.0, 667, 528256, 765, 19.491248799999994
766, 6.539322557898677, 46.16913043578159, 55.585100814642594, 0.5241038499999999, 235.0, 1036, 529292, 766, 29.886882499999956
767, 4.945925745009272, 46.02328256806139, 55.33029176731302, 0.52337035, 80.0, 594, 529886, 767, 18.090844699999252
768, 4.215685922925862, 46.976200839123095, 56.493113263935534, 0.5226922000000003, 390.0, 913, 530799, 768, 28.06803310000032
769, 6.6598346452228725, 47.12209539501755, 56.74999863571591, 0.5218925499999999, 185.0, 864, 531663, 769, 26.14021109999976
770, 4.354197178766565, 47.110930803910044, 56.603125229622556, 0.5212720000000001, 80.0, 515, 532178, 770, 15.538484299999254
771, 6.22258290865769, 47.195418172412445, 56.79944789674547, 0.5207162500000001, 335.0, 720, 532898, 771, 21.077110500000344
772, 5.065930679770066, 47.0197545574363, 56.57592446807813, 0.5201073999999999, 180.0, 633, 533531, 772, 18.344671600000765
773, 5.373506217530578, 47.081216095359466, 56.63761087081488, 0.5193986500000001, 415.0, 942, 534473, 773, 26.926076200000352
774, 3.8264854769750762, 47.14880408838116, 56.6681368483088, 0.5186336499999996, 220.0, 758, 535231, 774, 20.72128370000064
775, 4.188486099256735, 47.25112466169402, 56.8261566856954, 0.5180454999999999, 150.0, 549, 535780, 775, 14.831672600000275
776, 4.867327636886727, 47.02607712312178, 56.571016346324576, 0.5174024499999996, 215.0, 880, 536660, 776, 22.802290900000116
777, 5.971435594244379, 47.06941624477167, 56.62544913603881, 0.5166694000000001, 180.0, 749, 537409, 777, 20.13164930000039
778, 5.986533313367865, 47.04546511533449, 56.63674705560259, 0.5160195999999997, 140.0, 695, 538104, 778, 19.307555299999876
779, 5.226273089607182, 47.25195356140547, 56.855257596494695, 0.5153725, 135.0, 743, 538847, 779, 21.470970499999567
780, 4.510438289912345, 47.249978087532504, 56.79676359203086, 0.5147460999999998, 155.0, 649, 539496, 780, 19.632169599999543
781, 5.969613601084284, 47.39106831468385, 57.0601743048635, 0.5140364500000003, 565.0, 928, 540424, 781, 27.99911390000034
782, 4.0810134591169005, 47.53772202583208, 57.185046894183806, 0.5133231999999999, 135.0, 657, 541081, 782, 20.047937600000296
783, 7.180494540533487, 47.56386759737705, 57.28729741928425, 0.5126045500000003, 210.0, 940, 542021, 783, 27.936840599999414
784, 3.81515677713127, 47.41558497019082, 56.9942275434134, 0.5119574499999998, 70.0, 498, 542519, 784, 14.926675100000466
785, 6.072565007060115, 47.60706691492072, 57.29824803781301, 0.5112181000000002, 505.0, 1145, 543664, 785, 34.69627910000054
786, 4.643298069813421, 47.628762108939036, 57.27581288574865, 0.5103626499999996, 375.0, 756, 544420, 786, 23.392163299999993
787, 6.32033383433862, 47.52195258981117, 57.216187931167624, 0.5097493, 60.0, 607, 545027, 787, 18.99295439999969
788, 4.3139500707558955, 47.524972732303134, 57.16314436749714, 0.5091624999999999, 180.0, 697, 545724, 788, 21.29841370000031
789, 4.119994978838302, 47.45107998106836, 57.064983490974676, 0.5085419500000002, 45.0, 682, 546406, 789, 20.92653810000047
790, 5.715868709063864, 47.53981123868442, 57.13725781622734, 0.5080582, 60.0, 393, 546799, 790, 12.147614800000156
791, 6.819509805442307, 47.663056013019684, 57.46173049423523, 0.5074992999999995, 230.0, 849, 547648, 791, 26.573498499999914
792, 7.015896621003615, 47.57475585431124, 57.32847926046996, 0.5069138499999999, 75.0, 452, 548100, 792, 14.321875999999975
793, 5.120570374570776, 47.553339690467475, 57.19979735100939, 0.5064138999999999, 155.0, 659, 548759, 793, 19.864391400000386
794, 6.38824778043904, 47.63849594583913, 57.3216414119092, 0.5055301000000002, 390.0, 1305, 550064, 794, 41.64671420000013
795, 3.89528655513677, 47.738317306468026, 57.405100386663776, 0.5046710499999997, 125.0, 604, 550668, 795, 21.224960499999725
796, 4.077607379372664, 47.68614907452441, 57.38412486999992, 0.5041135, 140.0, 635, 551303, 796, 21.02454149999994
797, 4.969817426069518, 47.65313673905724, 57.305134769709134, 0.5035856499999999, 150.0, 538, 551841, 797, 18.467948700000306
798, 5.793763793790239, 47.63945036419367, 57.362204942864885, 0.5028125500000004, 400.0, 1180, 553021, 798, 38.24381750000066
799, 6.098982491932901, 47.75069216739984, 57.39380920080491, 0.5019899499999997, 320.0, 648, 553669, 799, 21.27197690000048
800, 5.9401760710121385, 47.84019015858842, 57.58176170330189, 0.5013356500000001, 140.0, 806, 554475, 800, 26.76621199999954
801, 4.108027539136658, 47.820933074229146, 57.52036748097898, 0.5006876499999998, 100.0, 634, 555109, 801, 21.85978989999967
802, 5.417637887320061, 47.80617279556023, 57.54677081930226, 0.5001022000000003, 215.0, 667, 555776, 802, 22.549932699999772
803, 6.455407471167874, 47.6570388954806, 57.39593785067639, 0.4993538499999998, 355.0, 996, 556772, 803, 33.7388990999998
804, 4.73251871917754, 47.66981670301254, 57.343895742338, 0.49838005000000013, 505.0, 1168, 557940, 804, 39.02613040000051
805, 7.686596720808131, 47.90570231044994, 57.70917444369372, 0.4973648500000002, 565.0, 1088, 559028, 805, 34.95218230000046
806, 5.729616110035327, 47.80680240728916, 57.54082035814595, 0.49655934999999995, 165.0, 702, 559730, 806, 22.45789479999985
807, 5.421631682097264, 47.5876116545304, 57.2049657434657, 0.49599505000000016, 60.0, 552, 560282, 807, 16.603975100000753
808, 6.22829493559614, 47.67129397090477, 57.41169322291507, 0.49532005000000007, 190.0, 948, 561230, 808, 31.537607299999763
809, 6.777346296938439, 47.73186843370484, 57.48917793155129, 0.4943732500000003, 270.0, 1156, 562386, 809, 38.14757439999994
810, 5.786951571301935, 47.635269213668344, 57.34208725667202, 0.4935353499999996, 100.0, 706, 563092, 810, 24.59862179999982
811, 4.784464390209464, 47.728231223684844, 57.41722851737601, 0.49294314999999994, 70.0, 610, 563702, 811, 21.708643400000255
812, 4.28534571329202, 47.61343860414763, 57.2485724277877, 0.49226274999999975, 165.0, 902, 564604, 812, 30.37563720000071
813, 5.570880295866848, 47.613167563344135, 57.32253228001498, 0.4913425000000001, 315.0, 1143, 565747, 813, 34.886815199999546
814, 6.00090133119088, 47.706865744957554, 57.473232351449816, 0.4905356499999999, 135.0, 650, 566397, 814, 15.466364900000372
815, 6.878936274971776, 47.84003812919543, 57.64293156596064, 0.4900113999999999, 70.0, 515, 566912, 815, 12.52093049999894
816, 7.773477070279492, 47.823224195461826, 57.6051701666082, 0.4895478999999999, 35.0, 515, 567427, 816, 12.274211999998442
817, 5.782249069615147, 47.78285694592105, 57.51814748579254, 0.48904210000000015, 105.0, 609, 568036, 817, 14.61382070000036
818, 5.1855201120812, 47.64143544731411, 57.3058623618268, 0.48845080000000013, 215.0, 705, 568741, 818, 16.506341500000417
819, 4.801992757927354, 47.6253534410058, 57.3067420517526, 0.48783834999999975, 160.0, 656, 569397, 819, 16.17284959999961
820, 6.268347830142191, 47.69246139641441, 57.411194204385104, 0.4872447999999999, 150.0, 663, 570060, 820, 15.799242200000663
821, 8.99310335686261, 47.65174843428971, 57.43820723001059, 0.4866692499999998, 125.0, 616, 570676, 821, 14.649269800000184
822, 5.223438960918368, 47.6301644535388, 57.2852369688325, 0.48596725000000024, 200.0, 944, 571620, 822, 22.383275700000013
823, 6.91971377812603, 47.89821827061722, 57.67517622856245, 0.4853124999999999, 35.0, 511, 572131, 823, 12.434848400000192
824, 7.378943208585058, 47.63484039033675, 57.42605220951633, 0.484831, 150.0, 559, 572690, 824, 13.13971390000006
825, 10.453150439737499, 47.73722628579623, 57.51388237441795, 0.48433105, 155.0, 552, 573242, 825, 13.129078300000401
826, 5.78557588501286, 47.699236181128114, 57.48072087528141, 0.48378789999999977, 170.0, 655, 573897, 826, 15.5025882000009
827, 8.18240042603933, 47.79923467282896, 57.592248172162265, 0.48317725000000017, 100.0, 702, 574599, 827, 17.038861900000484
828, 4.655612739150371, 47.64469755332888, 57.2746913248476, 0.4824486999999998, 160.0, 917, 575516, 828, 21.784375600000203
829, 10.329526771701623, 47.91452044353972, 57.810274667496294, 0.481807, 15.0, 509, 576025, 829, 12.059572000000117
830, 6.958619420168572, 47.68466200682794, 57.4340214083809, 0.4811657499999999, 175.0, 916, 576941, 830, 22.102663600000596
831, 4.978934613507772, 47.70935352252263, 57.380261619256075, 0.48021400000000014, 245.0, 1199, 578140, 831, 28.855198799999926
832, 5.1435013801762555, 47.79518459782456, 57.50988134470853, 0.4794368499999999, 45.0, 528, 578668, 832, 12.64326489999985
833, 5.102068861806496, 47.86167104533642, 57.57718501339069, 0.4788878500000001, 165.0, 692, 579360, 833, 16.640893499999947
834, 8.910521124795224, 47.813445396793696, 57.648082599825074, 0.47811294999999976, 230.0, 1030, 580390, 834, 24.92789029999949
835, 6.369882271634905, 47.72388100875052, 57.34283431203742, 0.47743569999999985, 35.0, 475, 580865, 835, 11.381664900000033
836, 5.095298061560291, 47.698174552030345, 57.39200396870458, 0.4769317, 115.0, 645, 581510, 836, 15.89515559999927
837, 10.148204633633833, 47.92504068323084, 57.750972892142634, 0.47647494999999995, 40.0, 370, 581880, 837, 9.24077909999869
838, 7.105574974147321, 47.70983357275365, 57.431233995773745, 0.4758769000000001, 180.0, 959, 582839, 838, 23.594435500001055
839, 4.206067847857072, 47.714172400197675, 57.36579785500803, 0.47516634999999985, 90.0, 620, 583459, 839, 15.12575409999954
840, 3.9990580278186543, 47.7687417558096, 57.44948573806911, 0.4744238499999999, 345.0, 1030, 584489, 840, 24.99147389999962
841, 5.716950374245644, 47.70740917005037, 57.38764035676655, 0.4737466000000001, 90.0, 475, 584964, 841, 11.717272899999443
842, 6.386865347286864, 47.693543558743734, 57.41972628550314, 0.47317465, 195.0, 796, 585760, 842, 19.551687699999093
843, 7.671454505807549, 47.79850579436714, 57.57997916294978, 0.4725122499999998, 85.0, 676, 586436, 843, 17.057401899999604
844, 7.772916083947896, 47.62485767789553, 57.29263443402074, 0.47188900000000006, 125.0, 709, 587145, 844, 17.61306009999862
845, 4.810342804394213, 47.63031654227716, 57.26204384553148, 0.4711743999999997, 245.0, 879, 588024, 845, 21.73253720000139
846, 6.3997496340110605, 47.6663913556203, 57.45852143862593, 0.4705273, 125.0, 559, 588583, 846, 14.115564299998368
847, 5.71983291420921, 47.80145265857053, 57.53024291367851, 0.46972584999999994, 590.0, 1222, 589805, 847, 30.890762600000016
848, 5.959632476441174, 47.67334015515386, 57.346054016597684, 0.46877905000000003, 245.0, 882, 590687, 848, 22.34850709999955
849, 5.74797658423807, 47.776634689916605, 57.50268086676673, 0.46798344999999986, 275.0, 886, 591573, 849, 22.454903699999704
850, 4.796585439268114, 47.82242927960474, 57.51816215105932, 0.4672072, 170.0, 839, 592412, 850, 20.71079809999901
851, 5.409724600680953, 47.856673204482775, 57.58489465496428, 0.4662365500000003, 640.0, 1318, 593730, 851, 33.406350100000054
852, 6.9714323642867555, 47.80331362963193, 57.55522537983851, 0.46541529999999987, 55.0, 507, 594237, 852, 12.691324399998848
853, 7.615185712926959, 47.77867414790428, 57.587121638198575, 0.4648204000000002, 155.0, 815, 595052, 853, 20.686630300000616
854, 4.2604345106270936, 47.77133338869983, 57.46139937684736, 0.4642178499999999, 115.0, 524, 595576, 854, 14.143085100000462
855, 6.114539547344794, 47.713099493677035, 57.413901007000426, 0.46370620000000007, 165.0, 613, 596189, 855, 15.321428299999752
856, 4.189410482866091, 47.72514185175165, 57.357475647339236, 0.46313065000000014, 120.0, 666, 596855, 856, 16.560820499998954
857, 5.8305850814118285, 47.80351974797804, 57.555772908898284, 0.4625213499999996, 160.0, 688, 597543, 857, 17.07088499999918
858, 6.694169211533724, 47.76303477567785, 57.49567329556334, 0.4619822499999998, 95.0, 510, 598053, 858, 13.13548179999998
859, 4.545345659855408, 47.77059705045588, 57.45525406979883, 0.46151469999999994, 105.0, 529, 598582, 859, 13.348605899998802
860, 5.233295595008422, 47.79138822504543, 57.52031660436946, 0.46085590000000026, 185.0, 935, 599517, 860, 24.25631659999999
861, 6.741383866179081, 47.59679740288354, 57.31936312548687, 0.4599680499999998, 375.0, 1038, 600555, 861, 26.953530500000852
862, 5.045196697487937, 47.57040316046616, 57.20455614809294, 0.4591585, 170.0, 761, 601316, 862, 19.55485679999947
863, 3.682553910668109, 47.31424731357842, 56.88680436201156, 0.45867474999999996, 20.0, 314, 601630, 863, 8.276234599999952
864, 6.391666619179843, 47.61533808779788, 57.336340185400246, 0.4582337499999997, 155.0, 666, 602296, 864, 16.934529799998927
865, 3.8081221255243465, 47.536620211857624, 57.24266814160091, 0.45776664999999983, 55.0, 372, 602668, 865, 9.494051600000603
866, 4.728616419703441, 47.562217590504126, 57.21398007959351, 0.45735985000000007, 20.0, 532, 603200, 866, 13.624554300000455
867, 5.2159415147478745, 47.48835335607114, 57.181263421468685, 0.4567478499999999, 245.0, 828, 604028, 867, 21.49527230000058
868, 6.933065904318824, 47.4671010833774, 57.15067948164998, 0.45596890000000007, 210.0, 903, 604931, 868, 23.51042310000048
869, 8.299901391499311, 47.537447681577184, 57.27511047002837, 0.45539110000000005, 55.0, 381, 605312, 869, 10.085655400000178
870, 6.896827219582801, 47.54483610261476, 57.28616971844669, 0.45480745000000006, 225.0, 916, 606228, 870, 23.636772400001064
871, 5.009909816182874, 47.57902772691515, 57.21056465572781, 0.4539092499999998, 255.0, 1080, 607308, 871, 27.437966400000732
872, 6.02605079464595, 47.62081637270457, 57.275918915751085, 0.4532509, 45.0, 383, 607691, 872, 9.732243700000254
873, 4.012720169789972, 47.56437899217074, 57.224594067094664, 0.4527639999999996, 200.0, 699, 608390, 873, 17.88247010000123
874, 7.735420087232905, 47.63285962230754, 57.48729559700444, 0.4522109499999998, 110.0, 530, 608920, 874, 13.81681109999954
875, 5.7193906455194385, 47.592914671618956, 57.24407973329337, 0.4516493499999999, 155.0, 718, 609638, 875, 18.40052250000008
876, 6.6416488010627015, 47.35193578700564, 57.00379990717657, 0.4510625500000001, 95.0, 586, 610224, 876, 15.753471899999568
877, 5.278550694018551, 47.24700601416898, 56.84295893946531, 0.45027595, 345.0, 1162, 611386, 877, 30.94348429999991
878, 6.957337878927647, 47.25880621613869, 56.91203523088408, 0.44940970000000013, 265.0, 763, 612149, 878, 19.634373799999594
879, 3.9670809960165103, 47.12151023855076, 56.67069192168377, 0.4487112999999998, 175.0, 789, 612938, 879, 20.921006300000954
880, 7.990376495960763, 47.293127587291316, 56.93482953448628, 0.44818209999999997, 75.0, 387, 613325, 880, 10.148116100001062
881, 6.876438159336586, 47.19626398784359, 56.73982761545879, 0.4477127500000001, 125.0, 656, 613981, 881, 17.442233399999168
882, 7.088786432472016, 47.20460403159157, 56.87602016156898, 0.44722359999999994, 40.0, 431, 614412, 882, 11.595311900000524
883, 5.9687845736451735, 47.25104149374316, 56.902442373017436, 0.4465445500000002, 315.0, 1078, 615490, 883, 28.208653399999093
884, 5.54264135590586, 47.19345651892267, 56.77813816665364, 0.4458429999999998, 105.0, 481, 615971, 884, 12.581061000000773
885, 6.304666620153478, 47.23379489764496, 56.87973991790209, 0.44535790000000003, 90.0, 597, 616568, 885, 15.81588340000053
886, 7.4896345016296735, 47.28593649473522, 56.94252318137155, 0.4446883, 420.0, 891, 617459, 886, 23.140662499999962
887, 7.328867683340522, 47.28496840732549, 56.933014424641925, 0.44394310000000026, 180.0, 765, 618224, 887, 19.957416700000977
888, 5.515608431523265, 47.32535481156507, 56.927372141375635, 0.4430921499999998, 350.0, 1126, 619350, 888, 30.05378980000023
889, 6.068396112968013, 47.2523887771921, 56.87398735518308, 0.4424108499999999, 20.0, 388, 619738, 889, 10.198721299999306
890, 5.439874115824402, 46.982796391595464, 56.52978319413355, 0.44187580000000004, 370.0, 801, 620539, 890, 21.04246989999956
891, 8.09009821530743, 46.86715152020056, 56.48595971145866, 0.4409339500000004, 440.0, 1292, 621831, 891, 34.63245049999932
892, 4.002785888454082, 46.777974047618876, 56.2216205093518, 0.4401990999999998, 60.0, 341, 622172, 892, 9.165846100000635
893, 7.357799524339763, 46.8528175238407, 56.40979650670832, 0.4397486500000001, 125.0, 660, 622832, 893, 18.23479899999984
894, 10.02048110624575, 46.90525820356238, 56.57623546364253, 0.43917535, 130.0, 614, 623446, 894, 16.301182699999117
895, 5.767027880790486, 46.80801316874476, 56.32447476258963, 0.43861419999999984, 55.0, 633, 624079, 895, 16.416719800001374
896, 6.877280918485302, 46.83503283853606, 56.35893772155281, 0.43787214999999996, 230.0, 1016, 625095, 896, 26.45378290000008
897, 6.889133772342712, 46.83435718809962, 56.40316057011626, 0.4370823999999998, 145.0, 739, 625834, 897, 19.88955899999928
898, 7.258725343226098, 46.83131649464737, 56.37433380550809, 0.43645825, 125.0, 648, 626482, 898, 16.894779400001426
899, 6.554115693189634, 46.78888450784886, 56.34417148926338, 0.4358705499999997, 110.0, 658, 627140, 899, 17.46101170000111
900, 5.672866619960532, 46.866836026718055, 56.38839361055301, 0.43516269999999996, 165.0, 915, 628055, 900, 24.447925999998915
901, 6.718287971528137, 46.92622578190822, 56.49724790535721, 0.4345214499999998, 55.0, 510, 628565, 901, 13.579148700000587
902, 4.436282654253001, 46.78815687933857, 56.25828688691185, 0.43411330000000004, 80.0, 397, 628962, 902, 10.409952699999849
903, 7.894713609171329, 46.693556440637465, 56.25093333172383, 0.4337020000000001, 85.0, 517, 629479, 903, 14.460268699998778
904, 5.443313627180972, 46.67074442385947, 56.11646410606047, 0.4331538999999997, 125.0, 701, 630180, 904, 20.96302839999953
905, 6.276736489831517, 46.807235151794615, 56.26973646260157, 0.4326868, 80.0, 337, 630517, 905, 9.805186899999171
906, 5.708498813781731, 46.7200491273558, 56.191625994177265, 0.4322233000000001, 110.0, 693, 631210, 906, 20.435694899999362
907, 9.376912747509778, 46.81941690444946, 56.544740257263186, 0.4317314499999997, 65.0, 400, 631610, 907, 14.156672000000981
908, 5.686616528704185, 46.80315214645031, 56.305097990997076, 0.4312611999999999, 125.0, 645, 632255, 908, 19.88765030000104
909, 4.642704198583759, 46.67016154286675, 56.11710967400646, 0.43080399999999996, 45.0, 371, 632626, 909, 19.239454000000478
910, 5.908683400774172, 46.716899126965856, 56.20485554555016, 0.4301622999999997, 375.0, 1055, 633681, 910, 32.890613999999914
911, 6.782208802075837, 46.5839022163331, 56.07617192005548, 0.4294589500000002, 55.0, 508, 634189, 911, 14.62994880000042
912, 5.516047833122658, 46.84766334054716, 56.3720149965386, 0.42862824999999954, 715.0, 1338, 635527, 912, 40.24440350000077
913, 5.378455095552708, 46.819124172685484, 56.33462453195465, 0.4276067499999998, 210.0, 932, 636459, 913, 31.107572599999912
914, 7.061645853997497, 46.76807400960564, 56.30075006192048, 0.42692364999999993, 70.0, 586, 637045, 914, 17.418522199999643
915, 4.474401764890277, 46.85383698187376, 56.29870924824163, 0.42638634999999997, 110.0, 608, 637653, 915, 17.660468900001433
916, 5.557648490454272, 46.78832549931272, 56.30135852713798, 0.42582070000000005, 155.0, 649, 638302, 916, 18.567879500000345
917, 9.367660668790807, 46.7872094884165, 56.432840374154104, 0.42524110000000015, 85.0, 639, 638941, 917, 16.819426199999725
918, 6.888277253041619, 46.89338452621905, 56.38345805694065, 0.42466059999999967, 110.0, 651, 639592, 918, 16.944953899999746
919, 6.477295908605168, 46.765149961912996, 56.277233865063266, 0.42416154999999994, 90.0, 458, 640050, 919, 11.915313499999684
920, 5.6268157277167745, 46.40469823800204, 55.86665326524244, 0.4235387499999999, 155.0, 926, 640976, 920, 24.60179219999918
921, 5.518954122276438, 46.48887371396215, 55.91806125494824, 0.42282819999999993, 80.0, 653, 641629, 921, 16.907680500000424
922, 5.863119965689188, 46.484819402858726, 55.89325831270335, 0.42216804999999996, 185.0, 814, 642443, 922, 21.374734399998488
923, 7.548625780860099, 46.522852945532996, 56.006908211509675, 0.4211744500000002, 585.0, 1394, 643837, 923, 36.956415200000265
924, 6.593136985854405, 46.418523241833945, 55.858784117349764, 0.42039955, 20.0, 328, 644165, 924, 8.745289799999227
925, 6.224181650157921, 46.345064426949605, 55.72430699717306, 0.42002739999999994, 95.0, 499, 644664, 925, 13.093094199999541
926, 6.322050377764665, 46.492776065836175, 55.95688608662247, 0.4196269000000001, 50.0, 391, 645055, 926, 11.6008542999989
927, 6.102363274737541, 46.44856667842261, 55.941165026496435, 0.4191525999999997, 135.0, 663, 645718, 927, 20.34740299999976
928, 5.787811126298038, 46.37966310232878, 55.8313490152359, 0.41862384999999996, 125.0, 512, 646230, 928, 15.381021099999998
929, 4.628143884459798, 46.44413760516434, 55.826854226978256, 0.41817835000000014, 65.0, 478, 646708, 929, 14.135658199998943
930, 7.605115975971732, 46.58214624132429, 56.118142716544014, 0.41764824999999967, 175.0, 700, 647408, 930, 20.839281200000187
931, 6.9463552577154974, 46.44308192341716, 55.985303354787305, 0.4168828, 185.0, 1001, 648409, 931, 30.393774800000756
932, 6.3960846752111165, 46.39516109630374, 55.83483168245093, 0.41621229999999976, 45.0, 489, 648898, 932, 15.062166499999876
933, 7.663793681957627, 46.39619964125466, 55.934056718470686, 0.41583295, 60.0, 354, 649252, 933, 11.36865729999954
934, 6.38290868061909, 46.329491030219145, 55.749799090660424, 0.41538025000000006, 140.0, 652, 649904, 934, 20.4395209000013
935, 5.293278938867399, 46.67809688239698, 56.175709478113035, 0.41474709999999965, 120.0, 755, 650659, 935, 22.815570300001127
936, 11.605656770568098, 46.95125332549589, 56.727119752510106, 0.41422824999999985, 50.0, 398, 651057, 936, 11.886799500000052
937, 7.865107784743983, 46.7141781645461, 56.311971835054145, 0.41376745, 180.0, 626, 651683, 937, 18.888565900000685
938, 4.021603557947688, 46.6432316766531, 56.058397130378616, 0.41329585000000013, 75.0, 422, 652105, 938, 13.07535740000094
939, 6.726361980091553, 46.76166993744519, 56.2813223624716, 0.41292955, 65.0, 392, 652497, 939, 11.620107900000221
940, 6.112988149242832, 46.84831787413477, 56.35728958147771, 0.41236930000000005, 195.0, 853, 653350, 940, 25.86404339999899
941, 5.404879980548028, 46.81694170711962, 56.36534399020891, 0.4116187000000002, 225.0, 815, 654165, 941, 24.67481080000107
942, 4.909801263499526, 46.763004379698685, 56.26621158109697, 0.41084919999999997, 165.0, 895, 655060, 942, 27.3299578999995
943, 7.641838751433481, 46.76375180710729, 56.39920463408503, 0.40999915000000015, 225.0, 994, 656054, 943, 28.646749600000476
944, 7.736153025738405, 46.81553881592546, 56.40853283386498, 0.40903839999999964, 225.0, 1141, 657195, 944, 40.43650410000009
945, 7.703466973860156, 46.795499658584596, 56.30755615234375, 0.40812895, 235.0, 880, 658075, 945, 34.02283119999993
946, 5.43801844569002, 46.76942654463678, 56.27815164882896, 0.4071803500000003, 360.0, 1228, 659303, 946, 40.6878504999986
947, 3.5844211756815145, 46.7067968768838, 56.17843955711082, 0.40644549999999974, 50.0, 405, 659708, 947, 14.391552000000956
948, 4.732895808194086, 46.982384581197344, 56.51597434407933, 0.4058789500000002, 345.0, 854, 660562, 948, 41.76752080000006
949, 5.1047590302715244, 47.04664058138329, 56.596694575758804, 0.4050081999999997, 490.0, 1081, 661643, 949, 51.29592330000014
950, 7.142910988419421, 47.152567164217025, 56.75329178320903, 0.40401909999999996, 395.0, 1117, 662760, 950, 55.12725329999921
951, 6.577726853436576, 47.138762861977746, 56.81134274897685, 0.40310380000000023, 195.0, 917, 663677, 951, 41.83378569999877
952, 8.669961406295247, 47.13293417797813, 56.77287073376812, 0.40240675, 110.0, 632, 664309, 952, 35.58904540000003
953, 4.802831982630296, 47.047881403869745, 56.5644439888368, 0.40188880000000005, 90.0, 519, 664828, 953, 29.648927600001116
954, 9.594301158106145, 47.258411339351106, 56.920876478662294, 0.4013024500000001, 175.0, 784, 665612, 954, 39.32702459999928
955, 6.539319870847519, 47.09805865272833, 56.65036313287143, 0.4006625499999999, 190.0, 638, 666250, 955, 30.651678600001105
956, 5.542589993969051, 47.13532420567104, 56.67835381117121, 0.40008879999999986, 140.0, 637, 666887, 956, 32.481051200000365
957, 8.309539331409091, 47.110898833886345, 56.74895943773319, 0.3991599999999999, 460.0, 1427, 668314, 957, 68.74081219999971
958, 7.462957755417751, 47.13230525592895, 56.72216715503471, 0.39799044999999966, 405.0, 1172, 669486, 958, 58.05887609999991
959, 5.313102006003624, 47.08967203047217, 56.65112897826404, 0.3973154499999998, 25.0, 328, 669814, 959, 15.600619000000734
960, 7.324297992224546, 46.79654025048325, 56.40350704389749, 0.3969496, 50.0, 485, 670299, 960, 23.551267600001665
961, 7.14573970143431, 46.73245138409494, 56.25722142863156, 0.3964572999999999, 45.0, 609, 670908, 961, 30.19847429999936
962, 6.859339686439318, 46.64322909747853, 56.09908651464126, 0.3958772499999999, 165.0, 680, 671588, 962, 33.11920939999982
963, 4.596041544340551, 46.630578196567036, 56.141790980878085, 0.3954056500000001, 75.0, 368, 671956, 963, 17.21976839999843
964, 4.903201623952815, 46.60474691585619, 56.038656079039285, 0.39497545000000006, 65.0, 588, 672544, 964, 29.332646200000454
965, 5.775117669710327, 46.75257554295401, 56.26758249976701, 0.394435, 160.0, 613, 673157, 965, 30.95142080000005
966, 9.14347141948778, 46.80709398327619, 56.33365100579048, 0.3938481999999999, 150.0, 691, 673848, 966, 32.94253220000064
967, 8.552815878554318, 46.81867426724419, 56.40286678093907, 0.39324114999999993, 125.0, 658, 674506, 967, 33.02803549999953
968, 6.878383587925665, 46.805414773005175, 56.39103247313832, 0.39268, 105.0, 589, 675095, 968, 27.718070400000215
969, 4.726909514933948, 46.77016824112888, 56.23387258379291, 0.3921980500000002, 110.0, 482, 675577, 969, 20.88344440000037
970, 5.636903779978955, 46.797917822499336, 56.25497283710823, 0.3916755999999999, 100.0, 679, 676256, 970, 35.072200699998575
971, 5.603099133141703, 46.737621088987794, 56.238720496715715, 0.3908826999999996, 385.0, 1083, 677339, 971, 53.158832600000096
972, 10.152787907614242, 46.67529245542662, 56.28956643258047, 0.3902247999999999, 70.0, 379, 677718, 972, 18.274977899998703
973, 7.228160352455043, 46.64484231923324, 56.145978960434746, 0.38981889999999997, 40.0, 523, 678241, 973, 24.429061299999375
974, 8.600260439887643, 46.633194593282845, 56.204366185114935, 0.3893495500000001, 110.0, 520, 678761, 974, 25.07662479999999
975, 6.95925685587701, 46.72018163187521, 56.264880143202745, 0.38866510000000004, 555.0, 1001, 679762, 975, 47.09787129999859
976, 4.520342760970668, 46.50660243110051, 55.91570033724346, 0.3879878500000001, 70.0, 504, 680266, 976, 23.1413223999989
977, 6.061535149630235, 46.21488307252222, 55.60651853133221, 0.3875405499999998, 25.0, 490, 680756, 977, 23.196031800000128
978, 9.979220841789054, 46.31884276771034, 55.8478046959271, 0.3871522, 110.0, 373, 681129, 978, 18.16013860000021
979, 9.060405463407763, 46.312541766244856, 55.77430755193116, 0.3865451499999996, 385.0, 976, 682105, 979, 48.004233399999066
980, 5.98098488724524, 46.27102143498143, 55.61497365551359, 0.38594080000000003, 50.0, 367, 682472, 980, 17.762313600000198
981, 4.943849508442096, 46.27554987437689, 55.5996309098639, 0.3853836999999998, 330.0, 871, 683343, 981, 42.35376189999988
982, 4.145191042013681, 46.190860704359764, 55.56542615835589, 0.38475729999999986, 115.0, 521, 683864, 982, 25.297805199999857
983, 6.4661254903778955, 46.16413817094199, 55.64626394683991, 0.38416464999999994, 105.0, 796, 684660, 983, 38.019382000000405
984, 5.48308948255011, 46.232232557024275, 55.62624262128558, 0.38349144999999996, 105.0, 700, 685360, 984, 33.78110639999977
985, 6.6344544363108655, 46.351622356180236, 55.78715266996217, 0.38289835000000005, 150.0, 618, 685978, 985, 25.74843139999939
986, 5.751833936594652, 46.21457736660736, 55.653651266387016, 0.38244205, 75.0, 396, 686374, 986, 20.05265159999908
987, 6.399895995582273, 46.400917932001086, 55.90553401527605, 0.38209195, 55.0, 382, 686756, 987, 18.715568400000848
988, 7.250051900723998, 46.36577988717455, 55.86638196047768, 0.3815920000000002, 75.0, 729, 687485, 988, 34.73530149999897
989, 8.222132326483525, 46.376326565815106, 55.79919396156789, 0.38099799999999995, 35.0, 591, 688076, 989, 30.390142000000196
990, 4.946944306019074, 46.24207240051866, 55.59928797743608, 0.3804557499999998, 70.0, 614, 688690, 990, 29.62224679999963
991, 6.904135425664974, 46.34950658437368, 55.77812182304942, 0.37994635000000004, 105.0, 518, 689208, 991, 22.819266000000425
992, 6.560190931629536, 46.25862637565646, 55.65092775186597, 0.37930105000000036, 580.0, 916, 690124, 992, 47.607744700000694
993, 5.3166485202829, 46.23085891045078, 55.613309218647, 0.3784941999999999, 160.0, 877, 691001, 993, 45.48228740000013
994, 6.903584028578411, 46.31152622416868, 55.78886971231234, 0.37756855000000017, 375.0, 1180, 692181, 994, 55.332978399999774
995, 6.281424983095202, 46.18359370415814, 55.60713436797965, 0.3765133000000001, 570.0, 1165, 693346, 995, 56.838647200000196
996, 6.6451767027438535, 46.31954269718688, 55.71863954400919, 0.3757671999999999, 80.0, 493, 693839, 996, 25.573359099998925
997, 5.244343014994076, 46.30412002376743, 55.70633099295876, 0.37528795000000015, 35.0, 572, 694411, 997, 25.903819600000134
998, 5.337691091501745, 46.24544862521592, 55.65398142927437, 0.37469575, 125.0, 744, 695155, 998, 37.60260650000055
999, 6.409447334993344, 46.27725841652634, 55.72979043080257, 0.3739397499999996, 305.0, 936, 696091, 999, 46.45509300000049
1000, 6.781045439648599, 46.33358910694214, 55.750583358432934, 0.3731459500000001, 340.0, 828, 696919, 1000, 42.39382300000034
1001, 6.682352789410796, 46.239311535775165, 55.670211014084245, 0.37201645000000005, 575.0, 1682, 698601, 1001, 84.54129690000082
1002, 9.02827446750352, 46.31372940111235, 55.85894490034554, 0.370972, 160.0, 639, 699240, 1002, 31.86002279999957
1003, 9.006782815464446, 46.24771778940862, 55.71631091349834, 0.37031815000000007, 225.0, 814, 700054, 1003, 44.26078099999904
1004, 10.616387679681036, 45.67630568569146, 55.00904738046591, 0.36972010000000005, 90.0, 515, 700569, 1004, 25.12803039999926
1005, 6.390748057171311, 45.70778683612221, 54.97554855597647, 0.3692147499999998, 80.0, 608, 701177, 1005, 32.33676809999997
1006, 6.740603883947428, 45.67865280461979, 55.004747900344036, 0.36858744999999987, 115.0, 786, 701963, 1006, 40.61963520000063
1007, 7.029386627372253, 45.82477636514139, 55.1856343681564, 0.3679182999999999, 160.0, 701, 702664, 1007, 37.977000200000475
1008, 6.073066079297236, 45.76111634390695, 55.05608007158552, 0.3672878499999999, 185.0, 700, 703364, 1008, 32.014201399999365
1009, 8.220391281916385, 45.71908150388484, 55.00424945898224, 0.3667163500000001, 55.0, 570, 703934, 1009, 17.915000499999223
1010, 8.064715458345228, 45.64152005587869, 54.99235060247529, 0.3662290000000001, 130.0, 513, 704447, 1010, 15.962437500000306
1011, 7.102695435027438, 45.65584471094327, 54.99881423589751, 0.3657123999999999, 170.0, 635, 705082, 1011, 19.22636969999985
1012, 6.443371480519955, 45.76255077264248, 55.08251720330654, 0.36498790000000003, 245.0, 975, 706057, 1012, 29.288973499998974
1013, 6.585809409309629, 45.81107278738573, 55.14957496202109, 0.36413649999999964, 360.0, 917, 706974, 1013, 28.282502000000022
1014, 7.824337701429425, 45.72746194007911, 55.082152102329744, 0.3634462, 130.0, 617, 707591, 1014, 18.46201479999945
1015, 6.452009064199463, 45.76354824189217, 55.1023098422635, 0.3628895499999998, 105.0, 620, 708211, 1015, 18.793336900000213
1016, 4.7640282781121845, 45.67215179037232, 54.89160225146624, 0.36237385, 35.0, 526, 708737, 1016, 16.36476340000081
1017, 7.000482762328952, 45.72235362223151, 55.053056779154886, 0.3619027000000001, 75.0, 521, 709258, 1017, 15.639821799999481
1018, 6.173163248406302, 45.84532978714153, 55.198063465856734, 0.3613334499999998, 115.0, 744, 710002, 1018, 25.226744199999303
1019, 6.1757865821374756, 46.08994209435957, 55.44815159860705, 0.36057654999999994, 230.0, 938, 710940, 1019, 32.36277669999981
1020, 6.4731835794764025, 46.093460522024294, 55.492422427211544, 0.35986509999999994, 120.0, 643, 711583, 1020, 21.647769499999413
1021, 5.979774526226544, 46.1851891103641, 55.54733863727067, 0.35911135, 620.0, 1032, 712615, 1021, 35.471440400000574
1022, 5.740855308629434, 46.15550897113629, 55.52941839619577, 0.3582343000000003, 370.0, 917, 713532, 1022, 31.029381500000454
1023, 8.32789174590468, 46.136223556028675, 55.60595806543665, 0.3574431999999999, 165.0, 841, 714373, 1023, 28.783023399999365
1024, 8.725922860430328, 46.13791441131424, 55.49777048760718, 0.35673714999999995, 185.0, 728, 715101, 1024, 24.839719499999774
1025, 7.520999837689273, 46.14370002884963, 55.68726772322188, 0.35603739999999995, 215.0, 827, 715928, 1025, 27.930814499999542
1026, 8.521468516858153, 46.14830931921498, 55.543171902920335, 0.3552211000000001, 225.0, 987, 716915, 1026, 33.77412430000004
1027, 6.556879367397286, 46.203743698080274, 55.62666076779677, 0.3546046, 45.0, 383, 717298, 1027, 12.954405799999222
1028, 7.3642032890362135, 46.093022152229594, 55.45548174116347, 0.3541406500000001, 100.0, 648, 717946, 1028, 21.934284099999786
1029, 4.597146774446014, 46.15963428463556, 55.476577049863025, 0.35359480000000004, 10.0, 565, 718511, 1029, 19.87536580000051
1030, 7.345629923166084, 46.147847054461685, 55.58214284971735, 0.3529508499999997, 155.0, 866, 719377, 1030, 29.519635600001493
1031, 5.845141284212115, 45.94433589776357, 55.26995811575935, 0.35225874999999995, 110.0, 672, 720049, 1031, 23.446467300000222
1032, 8.718858518213501, 46.001386512636515, 55.42967213136363, 0.35178444999999997, 125.0, 382, 720431, 1032, 13.005442599998787
1033, 7.461430327617768, 45.85902915192987, 55.18837325167948, 0.3513556000000001, 95.0, 571, 721002, 1033, 19.382909899999504
1034, 7.279904208026336, 46.08551449113007, 55.498148604246516, 0.3506679999999999, 290.0, 957, 721959, 1034, 33.02747389999968
1035, 6.801106616901307, 45.88650535977502, 55.27956551565251, 0.3499498000000001, 25.0, 639, 722598, 1035, 21.76905909999914
1036, 8.668525187544665, 46.07993141510202, 55.42390648823864, 0.34937605000000005, 100.0, 636, 723234, 1036, 21.60770709999997
1037, 5.44715783358724, 46.001758128036684, 55.32803311760043, 0.34872534999999977, 135.0, 810, 724044, 1037, 28.62922830000025
1038, 5.6575121392779595, 46.052580959392046, 55.41244573670256, 0.3480269499999999, 115.0, 742, 724786, 1038, 25.13488739999957
1039, 7.647319722047931, 46.02591089966147, 55.43805929998477, 0.34735689999999975, 160.0, 747, 725533, 1039, 25.49697930000002
1040, 5.303448782303707, 45.9994680962595, 55.34590323311942, 0.34668999999999994, 180.0, 735, 726268, 1040, 25.7367878999994
1041, 4.21389490941616, 45.89216441324312, 55.16218201101643, 0.346195, 60.0, 365, 726633, 1041, 12.402232200000071
1042, 7.834056193846488, 46.03633261835852, 55.48619507264721, 0.34556635000000036, 275.0, 1032, 727665, 1042, 35.98694989999967
1043, 5.679147694043923, 46.05523363058118, 55.38753585539003, 0.34485355, 140.0, 552, 728217, 1043, 18.99471209999865
1044, 6.0219716950996744, 45.98740879531878, 55.345973899068824, 0.3442096000000001, 285.0, 879, 729096, 1044, 30.422482600000876
1045, 5.436295896792374, 45.995203201001445, 55.34306896075654, 0.34353235000000004, 65.0, 626, 729722, 1045, 22.190369699999792
1046, 6.101734286387458, 46.10246233175729, 55.45708888905649, 0.3427790500000002, 290.0, 1048, 730770, 1046, 35.88243820000025
1047, 5.965816810921482, 46.29920413252236, 55.69930981622226, 0.34199694999999997, 95.0, 690, 731460, 1047, 24.444830099999308
1048, 4.648935950565149, 46.2212093323076, 55.60147158137097, 0.3415159, 60.0, 379, 731839, 1048, 13.27925789999972
1049, 5.325504888233351, 46.08315416681909, 55.443748884169985, 0.34093090000000004, 180.0, 921, 732760, 1049, 31.849747000000207
1050, 7.553795413884944, 46.16329416340004, 55.6381639392677, 0.3402918999999997, 90.0, 499, 733259, 1050, 17.889364800001204
1051, 6.221100293296863, 46.263899522843666, 55.64879794439669, 0.3397779999999999, 65.0, 643, 733902, 1051, 22.180788100000427
1052, 10.392066260248352, 46.24166537553836, 55.93103107372364, 0.3392955999999999, 50.0, 429, 734331, 1052, 14.912569100000837
1053, 9.038608879550564, 46.23195805898527, 55.66325756631247, 0.33873355, 200.0, 820, 735151, 1053, 28.863553000001048
1054, 5.615239586946518, 46.31259065693475, 55.73570451761613, 0.3381939999999999, 80.0, 379, 735530, 1054, 13.213186699998914
1055, 5.100986126414437, 46.21546268376516, 55.5661466530948, 0.3375279999999997, 260.0, 1101, 736631, 1055, 38.401086199999554
1056, 7.755841803609156, 46.24923446981665, 55.70458923516639, 0.3365276499999999, 385.0, 1122, 737753, 1056, 39.13364690000162
1057, 6.695404791920825, 46.325389115105324, 55.73777086440831, 0.3354643000000001, 280.0, 1241, 738994, 1057, 43.517115399999966
1058, 6.793839241320495, 46.2719809303821, 55.70810182432958, 0.33449049999999997, 405.0, 923, 739917, 1058, 32.38073049999912
1059, 6.2910423188621305, 46.77028666762307, 56.31471235922576, 0.3336283, 245.0, 993, 740910, 1059, 35.0968541000002
1060, 8.043764535481861, 46.76165459069718, 56.325749900903595, 0.332821, 155.0, 801, 741711, 1060, 28.114289900000585
1061, 6.593094205802061, 46.802494161269244, 56.358145427970996, 0.33213925, 165.0, 714, 742425, 1061, 25.361337499998626
1062, 4.510018864426241, 46.67555594700639, 56.09725999319425, 0.3316505499999999, 75.0, 372, 742797, 1062, 13.230315900000278
1063, 7.5211361336259985, 46.71857974262282, 56.21986710586488, 0.33090849999999994, 220.0, 1277, 744074, 1063, 44.56832589999976
1064, 7.091681401172969, 46.81897835809227, 56.38631441403441, 0.32986450000000006, 500.0, 1043, 745117, 1064, 36.83901060000062
1065, 7.717109323136296, 46.80045918306153, 56.407071336898596, 0.3289050999999999, 195.0, 1089, 746206, 1065, 38.43831909999972
1066, 5.5118838997024096, 46.76452142126451, 56.27373861867847, 0.3280114, 355.0, 897, 747103, 1066, 31.84078000000045
1067, 5.199757757887446, 46.670035439918486, 56.10571498353018, 0.32720995, 300.0, 884, 747987, 1067, 31.010415499999
1068, 5.945927746721969, 46.789288868199506, 56.356672306650694, 0.32628834999999967, 435.0, 1164, 749151, 1068, 41.62270349999926
1069, 8.237348949193954, 46.76254446411133, 56.38764745076497, 0.3255957999999999, 45.0, 375, 749526, 1069, 13.333225999998831
1070, 8.881244525903522, 46.85167303557443, 56.45932907255569, 0.3251998, 30.0, 505, 750031, 1070, 18.007841099999496
1071, 6.628667834669169, 46.57974674062031, 56.08029489982419, 0.3246773500000001, 125.0, 656, 750687, 1071, 23.300585999999385
1072, 7.557420985637104, 46.42412258936617, 55.97685737848779, 0.32395104999999996, 100.0, 958, 751645, 1072, 34.26654539999981
1073, 9.232821413340128, 46.66418435884559, 56.25449916176174, 0.3231059500000002, 140.0, 920, 752565, 1073, 33.04787039999974
1074, 4.162069035541759, 46.52961172802537, 55.930771532260806, 0.32224599999999987, 275.0, 991, 753556, 1074, 35.501114400000006
1075, 5.517119984006937, 46.66607790485794, 56.16622013217407, 0.32160835, 90.0, 426, 753982, 1075, 15.287133599998924
1076, 5.176869894562273, 46.48828275567496, 55.920922879463184, 0.32105980000000006, 75.0, 793, 754775, 1076, 28.283068299999286
1077, 7.882578095538551, 46.536355414567744, 56.12129935540367, 0.3204244000000001, 100.0, 619, 755394, 1077, 22.208036500000162
1078, 4.48143267929554, 46.473519122783955, 55.880215536264274, 0.3199995999999999, 25.0, 325, 755719, 1078, 11.743150800000876
1079, 8.507906490201986, 46.52378107832916, 56.058890605386964, 0.3196719999999999, 110.0, 403, 756122, 1079, 14.396489599999768
1080, 4.526686222907296, 46.48008496277314, 55.85773342390706, 0.31919139999999985, 120.0, 665, 756787, 1080, 23.84612820000075
1081, 7.886717396501399, 46.604403251720264, 56.17916687517935, 0.31851234999999994, 145.0, 844, 757631, 1081, 30.02667339999971
1082, 6.8199221812445545, 46.42346678547476, 55.888406692154106, 0.3177410499999998, 190.0, 870, 758501, 1082, 31.179236100000708
1083, 5.789490293656782, 46.59420342564686, 56.03287594970492, 0.31682799999999994, 455.0, 1159, 759660, 1083, 42.11503950000042
1084, 5.123016386547833, 47.28871598480441, 56.926960835558305, 0.31598919999999997, 345.0, 705, 760365, 1084, 25.816030599999067
1085, 7.9422258980797995, 48.024095829087074, 57.83023749939119, 0.31531554999999994, 145.0, 792, 761157, 1085, 29.062446199999613
1086, 9.009671737272528, 47.89947221007528, 57.761086833326125, 0.31478139999999993, 50.0, 395, 761552, 1086, 15.009347200000775
1087, 9.095416553007297, 48.11377847282541, 57.95244385627915, 0.3144204999999999, 105.0, 407, 761959, 1087, 14.944473599998673
1088, 5.324440056256281, 47.91549726314958, 57.676535623115406, 0.3138012999999999, 170.0, 969, 762928, 1088, 34.81562529999974
1089, 3.953866984116312, 48.05816453727987, 57.753909674161534, 0.3131191, 75.0, 547, 763475, 1089, 20.14769410000008
1090, 11.651675651910939, 48.1173687920121, 58.085300027066644, 0.3125529999999999, 200.0, 711, 764186, 1090, 25.86243999999897
1091, 6.104682919510582, 47.91007533803717, 57.67984216277664, 0.31183345000000007, 140.0, 888, 765074, 1091, 32.98460469999918
1092, 7.168656798074772, 48.07137246730524, 57.87500710425439, 0.31091409999999975, 500.0, 1155, 766229, 1092, 42.3989801000007
1093, 6.806740490057124, 47.960247635041306, 57.784155653627124, 0.3101261499999999, 100.0, 596, 766825, 1093, 21.703015799999775
1094, 5.696647090935939, 47.93532079840105, 57.6828759599861, 0.3096964, 20.0, 359, 767184, 1094, 13.247890299999199
1095, 5.885912437089597, 47.97082475240757, 57.77174917499671, 0.30929455, 95.0, 534, 767718, 1095, 19.36696970000048
1096, 7.828765056598588, 48.126313469438415, 57.979160979826986, 0.3086398, 420.0, 921, 768639, 1096, 34.05383190000066
1097, 6.293936717268935, 47.93622575755714, 57.67178642723701, 0.3080196999999999, 45.0, 457, 769096, 1097, 16.709374100000787
1098, 5.235002939387918, 47.95763480819016, 57.62974109843438, 0.3075039999999999, 185.0, 689, 769785, 1098, 25.45421019999958
1099, 5.841671251743049, 48.237323439601575, 58.04916364020044, 0.3067025499999998, 185.0, 1092, 770877, 1099, 40.19523780000054
1100, 4.241446174242917, 48.12630502828658, 57.86345821855495, 0.3058821999999999, 130.0, 731, 771608, 1100, 27.036041499999556
1101, 5.704503577380691, 48.2369308194103, 58.066617906217516, 0.30512034999999976, 170.0, 962, 772570, 1101, 35.311369100001684
1102, 6.844740109592991, 48.1068721230892, 57.944440119866336, 0.30426175000000005, 140.0, 946, 773516, 1102, 34.998992000000726
1103, 5.373661871266413, 48.26217040862424, 58.023629245987856, 0.30361195, 60.0, 498, 774014, 1103, 18.849239899998793
1104, 7.212703001605073, 48.256099513742925, 58.100621902801464, 0.30285594999999993, 320.0, 1182, 775196, 1104, 44.82814489999873
1105, 8.156991144007241, 48.4266226996075, 58.39138308980248, 0.30200724999999995, 55.0, 704, 775900, 1105, 25.937452199999825
1106, 8.692015844207686, 48.23305807704419, 58.14665781713165, 0.30148705000000003, 130.0, 452, 776352, 1106, 16.819273600000088
1107, 10.353185374767923, 48.223180417872186, 58.04055943275566, 0.3009821499999998, 150.0, 670, 777022, 1107, 24.892920300000696
1108, 7.45928437230728, 48.30159830277966, 58.20311114608601, 0.30051324999999995, 95.0, 372, 777394, 1108, 13.891874599999937
1109, 7.790345521115321, 48.22309466770717, 58.07170247743787, 0.29989855000000004, 450.0, 994, 778388, 1109, 37.29157139999916
1110, 6.09294103495013, 48.27598347587846, 58.07760352045637, 0.2990561499999999, 345.0, 878, 779266, 1110, 32.71439259999897
1111, 5.980353064147499, 48.199381206472054, 57.97574670303968, 0.29836359999999995, 95.0, 661, 779927, 1111, 24.669018599999617
1112, 5.579425607813467, 47.79036981563757, 57.482397657337756, 0.29783889999999996, 20.0, 505, 780432, 1112, 18.857854199999565
1113, 4.987463287701682, 47.7431043957907, 57.416279850308854, 0.29732815, 115.0, 630, 781062, 1113, 23.64402289999998
1114, 4.57879076696181, 47.92395336487714, 57.64454313486564, 0.2966162499999998, 195.0, 952, 782014, 1114, 35.96464969999943
1115, 8.75278312118563, 48.04490942278266, 57.94702530529526, 0.2959120000000001, 125.0, 613, 782627, 1115, 22.97926860000007
1116, 6.876404925176026, 47.88095198402788, 57.65938326754905, 0.2953224999999998, 90.0, 697, 783324, 1116, 26.36090399999921
1117, 7.599598386783319, 47.83740109054621, 57.60942474714112, 0.2946349, 120.0, 831, 784155, 1117, 31.383283799999845
1118, 4.526961053834494, 47.83355614633271, 57.51942591956168, 0.2940233499999999, 95.0, 528, 784683, 1118, 20.03687589999936
1119, 4.058555828514796, 47.807849322825255, 57.45637503864751, 0.2935593999999999, 75.0, 503, 785186, 1119, 18.875931700000365
1120, 5.710085314651901, 47.93166383005941, 57.69237052340604, 0.2929105000000001, 195.0, 939, 786125, 1120, 35.640057600001455
1121, 6.357289542349017, 47.94144950177162, 57.70577991808121, 0.29217924999999995, 145.0, 686, 786811, 1121, 26.057074700000157
1122, 5.1869957989752296, 47.95706960296631, 57.67598202514648, 0.29142055000000006, 205.0, 1000, 787811, 1122, 37.86727939999946
1123, 6.188761395763586, 47.85275522867838, 57.61781420994326, 0.29031175, 430.0, 1464, 789275, 1123, 55.60425579999901
1124, 5.747875580345233, 47.88846377343246, 57.57404228289103, 0.28943469999999993, 75.0, 485, 789760, 1124, 18.475026800000705
1125, 5.868096827436759, 47.653353481186166, 57.32174845434434, 0.28881370000000006, 295.0, 895, 790655, 1125, 34.190431299999545
1126, 6.06851205625923, 47.55852443429999, 57.245747188787085, 0.2881130500000001, 165.0, 662, 791317, 1126, 25.435395900000003
1127, 5.557694534348327, 47.57421576958796, 57.18546836012988, 0.2875168000000001, 160.0, 663, 791980, 1127, 25.108644500000082
1128, 5.940951209253987, 47.584142718955825, 57.230554274514795, 0.28684, 310.0, 841, 792821, 1128, 32.14489390000017
1129, 6.810406426815877, 47.69747874840877, 57.44920151248543, 0.28602864999999994, 290.0, 962, 793783, 1129, 37.20323090000056
1130, 5.703923042662844, 47.495519402783785, 57.132889707645255, 0.2852200000000001, 270.0, 835, 794618, 1130, 31.812925399999585
1131, 5.554231604379652, 47.580503229630125, 57.21672385177888, 0.28459494999999996, 120.0, 554, 795172, 1131, 21.14491840000119
1132, 6.24001095246214, 47.59636408010692, 57.30038999296705, 0.2841778, 55.0, 373, 795545, 1132, 14.22306700000081
1133, 4.794679434905103, 47.68711811096355, 57.33912333470567, 0.28384209999999993, 80.0, 373, 795918, 1133, 14.377628799999002
1134, 8.847960234484958, 47.397337379695486, 57.06512497955898, 0.2835311499999999, 25.0, 318, 796236, 1134, 12.282711300000301
1135, 8.17217902186545, 47.53723601944414, 57.2637215536915, 0.28309419999999996, 155.0, 653, 796889, 1135, 25.415246700000353
1136, 7.220368595951695, 47.62484959865388, 57.32864281135642, 0.28250830000000005, 90.0, 649, 797538, 1136, 25.069576300000335
1137, 7.21684802669114, 47.627764500051306, 57.37177174333213, 0.28190575000000007, 185.0, 690, 798228, 1137, 26.548187899999903
1138, 6.972814763691674, 47.65735283041539, 57.39686360951499, 0.2812365999999999, 265.0, 797, 799025, 1138, 31.031193999999232
1139, 5.939166732363178, 47.44430379082541, 57.08119224044688, 0.2803257999999999, 255.0, 1227, 800252, 1139, 47.42168709999896
1140, 5.630544296936086, 46.58060624811909, 55.99119488555606, 0.2794100499999999, 125.0, 808, 801060, 1140, 31.072882700000264
1141, 6.332617612680973, 46.625933474886374, 56.08463201331417, 0.2786652999999999, 235.0, 847, 801907, 1141, 32.90959510000175
1142, 5.934558227063477, 46.64596798039284, 56.142750816184936, 0.27785574999999985, 200.0, 952, 802859, 1142, 36.79332780000186
1143, 5.207907700519157, 46.72427718717288, 56.21758643256293, 0.2770830999999998, 180.0, 765, 803624, 1143, 30.027632799999992
1144, 4.41109701136694, 46.59703303420025, 56.074567131374195, 0.27657324999999994, 105.0, 368, 803992, 1144, 14.100246399997559
1145, 5.050369064832776, 46.494139381241844, 55.946804956697804, 0.2761812999999999, 120.0, 503, 804495, 1145, 19.56002570000055
1146, 5.8389053042158325, 46.6298471089282, 56.148663414849175, 0.2757483999999999, 55.0, 459, 804954, 1146, 17.54367859999911
1147, 6.198213661425776, 46.423300625601605, 55.89752398930853, 0.27522774999999994, 140.0, 698, 805652, 1147, 27.102824300000066
1148, 4.320021321093544, 46.49219056043991, 55.92082915977598, 0.2745973, 120.0, 703, 806355, 1148, 27.35165799999959
1149, 5.486734550754918, 46.5608588422654, 56.03772243874611, 0.27404739999999994, 45.0, 519, 806874, 1149, 20.325999600001524
1150, 5.9673395677335455, 46.65347775584138, 56.130160777613405, 0.27340479999999995, 145.0, 909, 807783, 1150, 36.025182499997754
1151, 11.098260009544237, 46.55303656441825, 56.128998456682474, 0.2727595, 85.0, 525, 808308, 1151, 20.549344700000802
1152, 6.440132676960171, 46.57363892689404, 56.02563566128111, 0.27204985000000004, 345.0, 1052, 809360, 1152, 41.38035260000106
1153, 8.00234815158226, 46.6385257240578, 56.194966052020035, 0.2712727000000001, 220.0, 675, 810035, 1153, 26.938701500002935
1154, 6.400655907120196, 47.01632912469596, 56.54799933522284, 0.2707029999999999, 155.0, 591, 810626, 1154, 23.109364600000845
1155, 4.325774255514299, 46.97250045855224, 56.45910278832881, 0.2700887499999998, 145.0, 774, 811400, 1155, 30.444912700000714
1156, 9.827486694857047, 47.071454842159554, 56.7976509628412, 0.2694447999999999, 130.0, 657, 812057, 1156, 23.467845600000146
1157, 5.839283144586359, 47.08992888649445, 56.680117410540724, 0.2687670999999999, 260.0, 849, 812906, 1157, 29.044965999997657
1158, 5.754271183174569, 46.904925864934924, 56.4328497081995, 0.26780905, 230.0, 1280, 814186, 1158, 43.27322769999955
1159, 6.291620994320579, 47.013232736466094, 56.54681947205606, 0.26677360000000006, 510.0, 1021, 815207, 1159, 34.88702750000084
1160, 6.343886910431218, 46.994981177369056, 56.563696872421175, 0.26569854999999976, 475.0, 1368, 816575, 1160, 46.83096160000059
1161, 6.0129729967043914, 46.99005688731016, 56.53833443838085, 0.26426799999999995, 725.0, 1811, 818386, 1161, 61.677937499996915
1162, 7.927943526380727, 47.03993541691579, 56.63008298030516, 0.2631884499999999, 155.0, 588, 818974, 1162, 20.200216699999146
1163, 8.739872897895731, 47.137848688958535, 56.77644474315397, 0.2627496999999999, 95.0, 387, 819361, 1163, 13.398735599999782
1164, 5.230423603739057, 46.95545405796596, 56.501791098458426, 0.2623392999999999, 15.0, 525, 819886, 1164, 18.30480979999993
1165, 9.619086795920383, 47.130970270762184, 56.827013415490796, 0.26172729999999983, 80.0, 835, 820721, 1165, 28.562568099998316
1166, 5.427370973286175, 47.062813889899225, 56.61281880489012, 0.2610207999999999, 180.0, 735, 821456, 1166, 25.404025399999227
1167, 6.380723539147459, 47.08589500500528, 56.64441472056581, 0.26026839999999984, 130.0, 937, 822393, 1167, 32.18068530000164
1168, 6.983479440166329, 47.210352017442325, 56.78766003154643, 0.25955469999999986, 175.0, 649, 823042, 1168, 22.629516900000453
1169, 5.232812422273219, 47.14431160561111, 56.706681062916196, 0.25877799999999984, 480.0, 1077, 824119, 1169, 36.87326630000098
1170, 7.44256933447534, 47.18873940526912, 56.87004588304368, 0.2580390999999999, 85.0, 565, 824684, 1170, 19.490273600000364
1171, 7.26922358720176, 47.136437924140324, 56.79701767642941, 0.25727634999999976, 490.0, 1130, 825814, 1171, 39.05189579999933
1172, 5.841598743455658, 47.2683690375206, 56.874708523202095, 0.25635295, 245.0, 922, 826736, 1172, 32.08855600000243
1173, 4.600213962895465, 47.12334156036377, 56.64924567847083, 0.25558344999999993, 435.0, 788, 827524, 1173, 27.266810199998872
1174, 4.109414643966234, 47.04908717026445, 56.58267794743141, 0.25505919999999993, 40.0, 377, 827901, 1174, 13.229194800002006
1175, 6.346251333615442, 47.169307924512864, 56.776577394825416, 0.2544678999999999, 530.0, 937, 828838, 1175, 32.44022650000261
1176, 5.409135542678739, 46.950018492696806, 56.5247781309363, 0.2538163, 105.0, 511, 829349, 1176, 17.808196499998303
1177, 5.430797051044299, 47.39685081089058, 57.00733934446823, 0.25304454999999987, 595.0, 1204, 830553, 1177, 41.69677049999882
1178, 6.772732817684956, 47.77159846522348, 57.50458384186421, 0.25226289999999996, 90.0, 533, 831086, 1178, 18.591210099999444
1179, 6.344932114624458, 47.7287182896774, 57.48755056961723, 0.25187814999999986, 35.0, 322, 831408, 1179, 11.315404100001615
1180, 8.731232347369705, 47.8831452118508, 57.62164099568729, 0.2513129499999999, 290.0, 934, 832342, 1180, 32.512393600001815
1181, 6.054424686337288, 47.852316599230186, 57.59306386586147, 0.2506005999999999, 130.0, 649, 832991, 1181, 22.732558799998515
1182, 7.241633914360269, 47.76909080852162, 57.52130425193093, 0.24991254999999993, 315.0, 880, 833871, 1182, 30.96967720000248
1183, 5.391364348902861, 47.83533797292093, 57.52870619413671, 0.24928660000000002, 35.0, 511, 834382, 1183, 18.079788499999268
1184, 5.463976444573558, 47.81802777429322, 57.53816895029653, 0.24887754999999998, 55.0, 398, 834780, 1184, 13.930763499996829
1185, 6.434765531289291, 47.850097098196066, 57.55285284985071, 0.24826779999999993, 175.0, 957, 835737, 1185, 33.426133899996785
1186, 6.791793830081036, 47.812740920217415, 57.59356514378598, 0.24740964999999995, 180.0, 950, 836687, 1186, 33.498384700000315
1187, 5.867902749992964, 47.835671902916204, 57.51022360707057, 0.24662845000000005, 230.0, 786, 837473, 1187, 27.78500310000163
1188, 5.091578865319979, 47.695054320038345, 57.43352097057905, 0.24600025000000003, 65.0, 610, 838083, 1188, 21.57686879999892
1189, 6.512566051651742, 47.71788786073004, 57.48769187632447, 0.24514344999999996, 440.0, 1294, 839377, 1189, 45.55297140000039
1190, 6.451345142100584, 47.74329402739989, 57.4699533962311, 0.2441403999999999, 415.0, 935, 840312, 1190, 33.407447699999466
1191, 5.353845055614199, 47.37971943446568, 56.988986841837566, 0.24353065000000002, 70.0, 420, 840732, 1191, 14.789138100000855
1192, 5.8695699586073555, 47.383309458414715, 56.97228115844727, 0.24317289999999991, 75.0, 375, 841107, 1192, 13.450682999999117
1193, 8.348702026411187, 47.54892347605955, 57.332110106177595, 0.2427944499999999, 65.0, 466, 841573, 1193, 16.72030149999773
1194, 7.248895376330276, 47.415429457178654, 57.18130298110674, 0.24234624999999999, 200.0, 530, 842103, 1194, 19.02168309999979
1195, 6.45796894761149, 47.556692749577465, 57.26957535274811, 0.24181029999999998, 150.0, 661, 842764, 1195, 23.381310400000075
1196, 5.969033839662231, 47.46285989281778, 57.129339097698576, 0.24112090000000003, 320.0, 871, 843635, 1196, 31.277174599999853
1197, 6.680082324881669, 47.49766551667129, 57.20812726088739, 0.24009715000000015, 265.0, 1404, 845039, 1197, 49.78018090000114
1198, 5.275622911856803, 47.365493687962, 56.970937593800485, 0.23930649999999995, 50.0, 353, 845392, 1198, 12.595959199999925
1199, 4.034294849189606, 47.21565399380679, 56.75740287317097, 0.23898475, 50.0, 362, 845754, 1199, 13.005725300001359
1200, 5.006313563631824, 47.569991738730174, 57.23140289921604, 0.23864319999999994, 60.0, 397, 846151, 1200, 14.003736099999514
1201, 5.138579868824352, 47.5570504104723, 57.21715381649498, 0.2382751, 25.0, 421, 846572, 1201, 15.127313699998922
1202, 6.288025023687079, 47.66134541892768, 57.42081853788193, 0.2377242999999999, 280.0, 803, 847375, 1202, 29.057184699999198
1203, 3.8500260859423134, 47.483933532652436, 57.06708805107632, 0.2371428999999999, 185.0, 489, 847864, 1203, 17.207737400000042
1204, 6.610993011711309, 47.5202313386477, 57.1917377496377, 0.23664204999999996, 130.0, 624, 848488, 1204, 22.345281499998237
1205, 5.932897103650795, 47.57894674714628, 57.30904732550774, 0.23610384999999992, 180.0, 572, 849060, 1205, 20.535503199997038
1206, 5.3030136055800705, 47.44251011529253, 57.056058076862435, 0.23540815, 295.0, 974, 850034, 1206, 34.97135590000107
1207, 7.449353210230148, 47.51889970789405, 57.2547517586753, 0.2345401, 280.0, 955, 850989, 1207, 34.57981870000003
1208, 3.987445412192777, 47.53141348543223, 57.12011390819884, 0.23380254999999997, 150.0, 684, 851673, 1208, 24.557576700000936
1209, 5.604238861813921, 47.67017199135766, 57.391586994302685, 0.23312934999999999, 80.0, 812, 852485, 1209, 29.08191219999935
1210, 6.334937837928479, 47.24568124282865, 56.91945439544172, 0.2325196, 130.0, 543, 853028, 1210, 20.305108000000473
1211, 7.583079938952987, 47.69536765846046, 57.458491173592414, 0.23197555, 65.0, 666, 853694, 1211, 24.00177700000131
1212, 5.596484292011994, 47.61318497290978, 57.26189943460318, 0.23144184999999995, 60.0, 520, 854214, 1212, 18.6814415000008
1213, 4.917863179026062, 47.60855813774508, 57.260047521764214, 0.23078619999999989, 120.0, 937, 855151, 1213, 33.686804299999494
1214, 5.444585503912488, 47.520980866389955, 57.23147652544519, 0.22992759999999998, 170.0, 971, 856122, 1214, 35.154797600000165
1215, 4.8563714389985595, 47.660361512140796, 57.342517440969296, 0.22917385000000004, 155.0, 704, 856826, 1215, 25.433830499998294
1216, 7.750435582384321, 47.63862234813803, 57.37365931314305, 0.2285362, 190.0, 713, 857539, 1216, 25.897641999999905
1217, 9.157617012691695, 47.61747122293453, 57.50795359115811, 0.22772619999999993, 545.0, 1087, 858626, 1217, 39.60840999999709
1218, 6.038411529768597, 47.59380262895064, 57.2860441866788, 0.22698954999999993, 130.0, 550, 859176, 1218, 20.0962729999992
1219, 6.407008091718618, 47.59210747732243, 57.314664053964904, 0.22651839999999987, 95.0, 497, 859673, 1219, 18.69942380000066
1220, 6.746190101090775, 48.02343760562527, 57.76219124433459, 0.22587219999999983, 390.0, 939, 860612, 1220, 34.555328200000076
1221, 5.304708616643769, 48.18702973041338, 57.9887773354302, 0.2250567999999999, 145.0, 873, 861485, 1221, 31.710714200002258
1222, 7.363343365176144, 48.181506722499954, 58.08138439850535, 0.22448259999999992, 50.0, 403, 861888, 1222, 14.73437670000203
1223, 5.8154496685220085, 48.25867263997188, 58.06292282557878, 0.22386204999999987, 260.0, 976, 862864, 1223, 35.85525160000179
1224, 7.76175044747124, 48.2559609931812, 58.20759997005351, 0.22303809999999982, 240.0, 855, 863719, 1224, 31.61486370000057
1225, 6.242959876580719, 48.37568731140672, 58.192000733760366, 0.22214034999999996, 275.0, 1140, 864859, 1225, 41.515262800003256
1226, 4.732613173404992, 48.32849827136024, 58.14460079387083, 0.2213618499999999, 60.0, 590, 865449, 1226, 21.58568799999921
1227, 6.609540045840069, 48.26938170646001, 58.148103643621056, 0.2208645999999999, 90.0, 515, 865964, 1227, 18.959776100000454
1228, 5.98557690374161, 48.30317987402735, 58.09820792767767, 0.2202395499999999, 210.0, 874, 866838, 1228, 32.120902800001204
1229, 5.712327920261657, 48.22120643384529, 58.07044998515736, 0.2195492499999999, 70.0, 660, 867498, 1229, 24.149384300002566
1230, 7.685839180939782, 48.41025577891957, 58.281753676653565, 0.21908889999999995, 65.0, 363, 867861, 1230, 13.313011800000822
1231, 5.612756754330961, 48.31614307292457, 58.181492456726275, 0.21850840000000002, 210.0, 927, 868788, 1231, 34.217171100000996
1232, 5.8979178061884525, 48.25295462698307, 58.109597536003065, 0.21780504999999997, 180.0, 636, 869424, 1232, 23.59390629999689
1233, 5.963148578486172, 48.47000704563505, 58.34446649828392, 0.21719350000000004, 105.0, 723, 870147, 1233, 26.954702899998665
1234, 8.050791607761472, 48.99663199465139, 59.0211370900191, 0.21662379999999998, 55.0, 543, 870690, 1234, 19.996727900001133
1235, 7.90410536611923, 48.99034036963877, 59.0255062295933, 0.21615669999999995, 40.0, 495, 871185, 1235, 18.39690889999838
1236, 5.781639915916358, 48.917917092022726, 58.84982224475549, 0.2154713499999999, 260.0, 1028, 872213, 1236, 37.848235999997996
1237, 5.899385199226322, 48.84646349238128, 58.763382739396725, 0.2146923999999999, 80.0, 703, 872916, 1237, 27.213547299998027
1238, 9.717720639089059, 49.14646117440586, 59.26649181596164, 0.21416724999999995, 25.0, 464, 873380, 1238, 17.66350590000002
1239, 6.546861788388766, 48.96717659019221, 58.94932593506946, 0.21350349999999998, 455.0, 1011, 874391, 1239, 37.39406759999838
1240, 4.692167317726358, 48.945123241578216, 58.837021548777244, 0.2127916, 130.0, 571, 874962, 1240, 21.165807599998516
1241, 6.192953200843356, 48.92959612575146, 58.8896650856788, 0.21204414999999996, 180.0, 1090, 876052, 1241, 40.54679440000109
1242, 3.792384515704693, 48.85840732166285, 58.75769862347581, 0.21121299999999996, 150.0, 757, 876809, 1242, 28.482861799999228
1243, 6.671080244008742, 48.98845471542137, 58.978459089876324, 0.21053169999999993, 50.0, 757, 877566, 1243, 28.171505100002832
1244, 6.500905752329058, 48.937990251340366, 58.936964670817055, 0.20978064999999987, 180.0, 912, 878478, 1244, 34.181919700000435
1245, 6.041377715196051, 49.1207467266247, 59.11339883941212, 0.20899404999999985, 245.0, 836, 879314, 1245, 30.989052499997342
1246, 4.9696033145042735, 48.9089512060071, 58.80448326785704, 0.20831769999999994, 125.0, 667, 879981, 1246, 25.187929900002928
1247, 3.6375366080142295, 48.75582489978513, 58.63830385945162, 0.20782540000000002, 80.0, 427, 880408, 1247, 15.916277100001025
1248, 4.147340926578019, 48.62709159993414, 58.520951690958505, 0.20739205, 110.0, 536, 880944, 1248, 20.236480499999743
1249, 4.052952668214107, 48.66744768799111, 58.52117675480671, 0.20676249999999996, 230.0, 863, 881807, 1249, 32.996429899998475
1250, 3.268872475810349, 48.63604128360748, 58.47573801279068, 0.20623014999999995, 30.0, 320, 882127, 1250, 12.018996999999217
1251, 9.220910839310294, 48.631003099550625, 58.679016903307314, 0.2058579999999999, 110.0, 507, 882634, 1251, 19.210192099999404
1252, 4.962313357283765, 48.59260384541638, 58.472880687353744, 0.2053436499999999, 35.0, 636, 883270, 1252, 24.3130244999993
1253, 6.120172171254416, 48.557161576554584, 58.43554161277977, 0.2046412, 200.0, 925, 884195, 1253, 35.21004979999998
1254, 5.704569343648614, 48.606996613761986, 58.46903537440216, 0.20371554999999994, 245.0, 1132, 885327, 1254, 42.55231609999828
1255, 5.086355401959987, 48.57750761478085, 58.429285883800645, 0.20268459999999988, 285.0, 1159, 886486, 1255, 44.00919690000228
1256, 3.575199470264571, 48.72009679521833, 58.613807569231305, 0.20200554999999992, 5.0, 350, 886836, 1256, 13.277647400002024
1257, 4.429127412775479, 48.651168486155534, 58.54067609447092, 0.20154249999999999, 145.0, 679, 887515, 1257, 25.587669299999106
1258, 5.717896409804024, 48.650280630732155, 58.55412337291671, 0.20093815, 145.0, 664, 888179, 1258, 25.25921179999932
1259, 5.902134372242566, 48.56806913573166, 58.466311915167445, 0.20037834999999993, 50.0, 580, 888759, 1259, 22.020123900001636
1260, 5.770255445182556, 48.61255647987127, 58.49729314446449, 0.1998869499999999, 60.0, 512, 889271, 1260, 19.63151089999883
1261, 3.5645530889403885, 48.684160509589, 58.48006555354795, 0.1994954499999999, 50.0, 358, 889629, 1261, 13.907610100002785
1262, 6.07719062308723, 48.740164988458496, 58.690726000036896, 0.19901574999999988, 145.0, 708, 890337, 1262, 26.99332779999895
1263, 5.993295000080039, 48.84580034186079, 58.80819224412529, 0.19826739999999995, 230.0, 955, 891292, 1263, 36.40854539999782
1264, 5.003682794965112, 48.784488474760245, 58.710665149775814, 0.1972463499999999, 480.0, 1314, 892606, 1264, 50.51323889999912
1265, 7.135775043762156, 48.76760264805385, 58.73698863812855, 0.19625184999999995, 365.0, 896, 893502, 1265, 34.09714789999998
1266, 7.508746231320626, 48.749571962801824, 58.7010088909203, 0.19543420000000003, 155.0, 921, 894423, 1266, 35.22548000000097
1267, 8.959315086917993, 48.91994531531083, 59.01013927889946, 0.19478034999999994, 120.0, 532, 894955, 1267, 20.243608299999323
1268, 6.074399603957301, 48.72533526726963, 58.695354210289544, 0.1942677999999999, 135.0, 607, 895562, 1268, 23.645597399998223
1269, 5.489009033893138, 48.83391954382309, 58.78361032175463, 0.19362699999999994, 255.0, 817, 896379, 1269, 31.711783099999593
1270, 6.746660582584211, 48.73219501451514, 58.67245963524128, 0.19286784999999987, 215.0, 870, 897249, 1270, 33.282256399998005
1271, 5.373357424155418, 48.63144420959789, 58.52971890306226, 0.1923026499999999, 40.0, 386, 897635, 1271, 14.814727000000858
1272, 4.626484897154138, 48.87366416237571, 58.8041802393086, 0.19183689999999995, 95.0, 649, 898284, 1272, 24.851754999999685
1273, 6.150714978428093, 48.82520934215303, 58.832228206121385, 0.19111329999999999, 235.0, 959, 899243, 1273, 37.164202800002386
1274, 4.878702002451305, 48.887961652201994, 58.814811066658265, 0.19040274999999993, 130.0, 620, 899863, 1274, 23.81636609999987
1275, 6.317745392068024, 48.64344149958478, 58.55425312571282, 0.18987714999999994, 150.0, 548, 900411, 1275, 21.292262999999366
1276, 8.989861840842458, 48.53493269294847, 58.432191900571596, 0.1892826999999999, 95.0, 773, 901184, 1276, 29.911183700001857
1277, 6.396900796957609, 48.54694895196545, 58.50181305879927, 0.18869589999999994, 25.0, 531, 901715, 1277, 20.67036779999762
1278, 3.627695765287157, 48.52158694797092, 58.31513280717154, 0.18828684999999987, 60.0, 378, 902093, 1278, 14.584981600000901
1279, 6.422122177377943, 48.64309023064135, 58.61512440552205, 0.18762534999999997, 205.0, 1092, 903185, 1279, 42.04543869999907
1280, 7.448459596122344, 48.61353459395762, 58.561337106058915, 0.18684819999999996, 50.0, 635, 903820, 1280, 24.438842799998383
1281, 6.020848111620656, 48.654845795808015, 58.61058200977467, 0.18625869999999994, 140.0, 675, 904495, 1281, 26.09253080000053
1282, 5.997094249929445, 48.615026278591365, 58.50739612027107, 0.18555085000000002, 350.0, 898, 905393, 1282, 34.80562680000003
1283, 6.75311019403093, 48.698964391435894, 58.639791769139904, 0.18493254999999997, 40.0, 476, 905869, 1283, 18.158038400000805
1284, 7.567844905351338, 48.575769942762, 58.55136482492809, 0.1842993999999999, 205.0, 931, 906800, 1284, 38.306577299998025
1285, 3.9676686403130965, 48.50810970684055, 58.33034283588628, 0.183385, 320.0, 1101, 907901, 1285, 48.37063080000007
1286, 3.726526543058477, 48.471035442521085, 58.27305762817023, 0.1827369999999999, 10.0, 339, 908240, 1286, 14.352007999998023
1287, 4.949507662890161, 48.55669148375348, 58.398176280463616, 0.18228924999999993, 160.0, 656, 908896, 1287, 29.599302299997362
1288, 5.077265690954832, 48.63363479614258, 58.563861653254584, 0.18170154999999996, 145.0, 650, 909546, 1288, 25.334601899998233
1289, 4.212552382860865, 48.595804050990516, 58.476682782854354, 0.18117279999999997, 110.0, 525, 910071, 1289, 20.575215100001515
1290, 6.927261684078541, 47.984398679035465, 57.78245254260738, 0.1806413499999999, 170.0, 656, 910727, 1290, 25.843100699999923
1291, 8.664455633494072, 48.250709146261215, 58.229152858257294, 0.18017334999999987, 15.0, 384, 911111, 1291, 15.072691500001383
1292, 6.0010240612145, 48.01197980309501, 57.76747000447384, 0.1795572999999999, 160.0, 985, 912096, 1292, 38.62564949999796
1293, 6.322867689253409, 48.07259969516297, 57.89784788597872, 0.17865189999999992, 485.0, 1027, 913123, 1293, 40.23690830000123
1294, 5.317755195434832, 48.302121661311794, 58.10750049034472, 0.1779368499999999, 115.0, 562, 913685, 1294, 21.95666010000059
1295, 5.023956622965559, 48.091886212012014, 57.88760334098649, 0.1774585, 135.0, 501, 914186, 1295, 20.147894000001543
1296, 6.329618703181094, 48.08099082253196, 57.939162814978395, 0.17686179999999996, 140.0, 825, 915011, 1296, 32.94561390000308
1297, 5.826690890916326, 48.11147505414778, 57.8873492924854, 0.17617869999999994, 165.0, 693, 915704, 1297, 27.5546179999983
1298, 8.16307979215527, 48.234682156088574, 58.18154742200952, 0.17537274999999988, 325.0, 1098, 916802, 1298, 43.05256900000313
1299, 5.765860826245746, 48.23961797039835, 58.05728149000321, 0.17446374999999992, 165.0, 922, 917724, 1299, 36.64138589999857
1300, 6.164000091181835, 48.116005785659574, 57.96315533313789, 0.17382249999999988, 50.0, 503, 918227, 1300, 19.853014500000427
1301, 8.573012297606152, 48.01722182649554, 57.92296049089143, 0.17335854999999997, 80.0, 528, 918755, 1301, 20.980814100003045
1302, 5.003910949142392, 48.16259800566042, 57.93759856255579, 0.17264439999999995, 350.0, 1059, 919814, 1302, 42.14650339999935
1303, 6.882120924203831, 48.05889919888891, 57.85540072416874, 0.17177814999999982, 235.0, 866, 920680, 1303, 34.424052099999244
1304, 6.205438392896689, 48.25455856750899, 58.10390098212546, 0.17098704999999997, 435.0, 892, 921572, 1304, 35.355316900000616
1305, 5.141077781637461, 48.175205977679475, 58.00764645261717, 0.17022024999999993, 465.0, 812, 922384, 1305, 32.19665099999838
1306, 4.874040479024394, 48.172076278357785, 57.96619349878609, 0.16935355, 605.0, 1114, 923498, 1306, 44.57310349999898
1307, 6.15793310703776, 48.21686031131683, 58.0284669499567, 0.16857414999999998, 75.0, 618, 924116, 1307, 24.511338699998305
1308, 5.033369506730665, 48.09019973531894, 57.89220519254999, 0.16808049999999997, 70.0, 479, 924595, 1308, 19.09974290000173
1309, 8.220613671192366, 48.276778882788136, 58.245832191881284, 0.16740054999999998, 355.0, 1032, 925627, 1309, 41.28396959999736
1310, 6.620934576372203, 48.21378779657108, 58.00751658075863, 0.16658694999999993, 150.0, 776, 926403, 1310, 32.00100130000283
1311, 4.329484617474226, 48.24267919091184, 57.94946680105791, 0.16600464999999998, 40.0, 518, 926921, 1311, 20.60173819999909
1312, 7.243551559847222, 48.16083011782266, 57.96502119028148, 0.1656054999999999, 25.0, 369, 927290, 1312, 14.749740600000223
1313, 3.8891644633130023, 48.14437995709871, 57.889180283797415, 0.16526844999999996, 65.0, 380, 927670, 1313, 15.352255400001013
1314, 5.252974180289365, 48.299864805729015, 58.14088022074568, 0.16485219999999992, 100.0, 545, 928215, 1314, 22.241843799998605
1315, 5.660568391239358, 48.186651457929315, 57.977712680218595, 0.16409889999999988, 225.0, 1129, 929344, 1315, 44.940317000000505
1316, 8.493000588372901, 48.14156509964555, 58.00249873973705, 0.16328709999999994, 115.0, 675, 930019, 1316, 27.039323799999693
1317, 5.438379320669845, 47.71302209877106, 57.398227510873575, 0.16242310000000004, 285.0, 1245, 931264, 1317, 50.175225100003445
1318, 6.067366170037309, 47.71460758959264, 57.429394542540855, 0.16143715, 275.0, 946, 932210, 1318, 37.9331076999988
1319, 6.264177831230079, 47.69656134639531, 57.46869444981807, 0.16053354999999986, 390.0, 1062, 933272, 1319, 42.93181000000186
1320, 4.965193303561998, 47.68328542529412, 57.38322096770664, 0.15957865000000002, 290.0, 1060, 934332, 1320, 42.96032209999976
1321, 6.290986955597451, 47.70088208012464, 57.44499587140432, 0.15851124999999994, 355.0, 1312, 935644, 1321, 53.12374550000095
1322, 3.631328947462107, 47.61150346546674, 57.28414156411125, 0.15762969999999993, 90.0, 647, 936291, 1322, 26.176582500000222
1323, 3.8705166689272206, 47.624617109737635, 57.26676531516358, 0.15712344999999994, 130.0, 478, 936769, 1323, 19.45563140000013
1324, 4.85042380865278, 47.738480114114694, 57.443944301511266, 0.1564515999999999, 295.0, 1015, 937784, 1324, 41.70689889999994
1325, 5.5548079888408965, 47.77208578296799, 57.5332545162946, 0.155458, 180.0, 1193, 938977, 1325, 48.272716200001014
1326, 7.40110089675282, 47.83794869764562, 57.60985053873566, 0.15436719999999987, 360.0, 1231, 940208, 1326, 50.5015446000034
1327, 3.6163052257945, 48.00302343817629, 57.70270120932455, 0.15365079999999995, 35.0, 361, 940569, 1327, 14.716268399999535
1328, 5.557498373725461, 48.158263442893244, 57.9642012464989, 0.15300729999999993, 525.0, 1069, 941638, 1328, 43.60810529999799
1329, 6.3975678335704576, 48.22541228394624, 58.05257580029675, 0.15185844999999995, 570.0, 1484, 943122, 1329, 60.64286379999976
1330, 11.18728134988899, 48.45560781989299, 58.42471671305912, 0.15103089999999994, 40.0, 355, 943477, 1330, 14.836165799999435
1331, 4.355646785638342, 48.20939303680461, 57.9859221641884, 0.15054129999999988, 210.0, 733, 944210, 1331, 30.357573300003423
1332, 5.583590726858465, 48.201726403822356, 58.062879921484154, 0.14981229999999993, 160.0, 887, 945097, 1332, 36.500128899999254
1333, 5.806072130118411, 48.29176783361355, 58.101181174526694, 0.14898474999999994, 210.0, 952, 946049, 1333, 39.156057000000146
1334, 6.5986993524103, 48.30835301880089, 58.22333158972292, 0.14802264999999987, 510.0, 1186, 947235, 1334, 48.83309839999856
1335, 5.382270117231586, 48.36585219271548, 58.17491662824476, 0.14728914999999995, 30.0, 444, 947679, 1335, 18.304755499997555
1336, 6.768451679628415, 48.2137310755392, 57.99047770667169, 0.14685805, 135.0, 514, 948193, 1336, 21.122984999998152
1337, 5.405117164055507, 48.17145309830668, 57.89767715148161, 0.14644719999999994, 85.0, 399, 948592, 1337, 16.422183299997414
1338, 6.811418056166814, 48.3660238026145, 58.33010323804296, 0.14589189999999994, 165.0, 835, 949427, 1338, 34.624118499999895
1339, 5.8648653838530755, 47.97119422507497, 57.739708374383525, 0.14521104999999995, 100.0, 678, 950105, 1339, 28.25990130000355
1340, 7.779258957790567, 47.3794051095949, 57.08017134429715, 0.14427144999999997, 500.0, 1410, 951515, 1340, 59.77140370000052
1341, 5.329861475509755, 47.31162772234748, 56.92598443424001, 0.14325444999999995, 125.0, 850, 952365, 1341, 35.723427699998865
1342, 5.498778952902417, 47.374776094954534, 57.06186679814825, 0.1426001499999999, 75.0, 604, 952969, 1342, 25.152220100000704
1343, 6.4947842054948, 47.4411565324306, 57.16060071901029, 0.14192019999999997, 205.0, 907, 953876, 1343, 37.73679579999953
1344, 3.716733779264735, 47.15523373492352, 56.689019042176085, 0.14133879999999996, 20.0, 385, 954261, 1344, 16.00357509999958
1345, 4.24441708582623, 47.321255303675834, 56.906259495782365, 0.1406836, 210.0, 1071, 955332, 1345, 44.92858029999843
1346, 5.517127779761343, 47.39368283662865, 57.05642241539715, 0.13970124999999994, 225.0, 1112, 956444, 1346, 49.582514799996716
1347, 5.466659920517145, 47.32402160564538, 56.97718583053249, 0.13885749999999994, 190.0, 763, 957207, 1347, 31.422240600000805
1348, 5.236904616592117, 47.235129303646524, 56.8249832276375, 0.13812354999999996, 270.0, 868, 958075, 1348, 35.57841290000215
1349, 3.4800416291971517, 47.22984132223982, 56.78871636119315, 0.13745619999999992, 160.0, 615, 958690, 1349, 25.35190650000004
1350, 5.935630069118299, 47.35104003509918, 56.982851589912975, 0.1369715499999999, 75.0, 462, 959152, 1350, 18.98276889999761
1351, 5.176912259788655, 47.19652077973779, 56.82890360248623, 0.13646214999999998, 100.0, 670, 959822, 1351, 27.587565800000448
1352, 4.03650332506101, 47.44713253907964, 57.124561970393856, 0.1358721999999999, 215.0, 641, 960463, 1352, 27.140917900000204
1353, 6.6230413143703455, 47.64708749161965, 57.38158764764277, 0.13523994999999994, 105.0, 764, 961227, 1353, 31.948180799998227
1354, 5.892228751204639, 47.79985182792617, 57.56998637320637, 0.1342342, 475.0, 1471, 962698, 1354, 61.4191361000012
1355, 4.747532530897116, 47.53296761919362, 57.20889567589575, 0.13334004999999993, 50.0, 516, 963214, 1355, 21.863124899999093
1356, 3.6780668119889124, 47.69183050452142, 57.35540157238458, 0.1329139, 50.0, 431, 963645, 1356, 18.4277605999996
1357, 7.940118043913866, 47.787366707565894, 57.549962180001394, 0.13246164999999996, 55.0, 574, 964219, 1357, 24.05653639999946
1358, 4.771493207521278, 47.81269661352432, 57.5565996030209, 0.13189644999999994, 120.0, 682, 964901, 1358, 28.760955899997498
1359, 3.204503181116546, 47.69702307196224, 57.33980168174295, 0.13128354999999997, 135.0, 680, 965581, 1359, 28.903357700000925
1360, 6.179555790337424, 47.65125553766887, 57.43628049214681, 0.13070754999999992, 80.0, 600, 966181, 1360, 25.29289129999961
1361, 4.896046021728763, 47.66979646985173, 57.33072019177814, 0.13001184999999996, 290.0, 946, 967127, 1361, 40.57797690000007
1362, 9.443088859165613, 47.792169658260825, 57.66184342242062, 0.12928149999999994, 135.0, 677, 967804, 1362, 28.52980210000169
1363, 7.3624287797067005, 47.84265173118533, 57.64584993406106, 0.12874104999999994, 60.0, 524, 968328, 1363, 22.22216820000176
1364, 5.772167951340163, 47.74092365216605, 57.42659316083047, 0.12807864999999993, 250.0, 948, 969276, 1364, 40.51641010000094
1365, 4.636308940677076, 47.73934061029121, 57.46647622748805, 0.12736989999999995, 90.0, 627, 969903, 1365, 26.579921399999876
1366, 4.537746419265056, 49.76763483470454, 59.88896150469281, 0.1266575499999999, 110.0, 956, 970859, 1366, 40.771230399997876
1367, 5.609730415376919, 49.92836622033978, 60.12683191125138, 0.12605499999999994, 65.0, 383, 971242, 1367, 16.28160129999742
1368, 4.861857867106756, 49.88494070041317, 60.034638057213805, 0.12537279999999995, 450.0, 1133, 972375, 1368, 48.43852699999843
1369, 6.63994506044405, 49.93568342101245, 60.190030513548194, 0.12448809999999993, 395.0, 833, 973208, 1369, 35.67065730000104
1370, 4.94105792795513, 49.92860921016525, 60.026232677416154, 0.12383739999999997, 150.0, 613, 973821, 1370, 27.01916279999932
1371, 5.789674760027757, 49.89050679367026, 60.04374130998163, 0.12338739999999997, 35.0, 387, 974208, 1371, 16.452480600000854
1372, 5.103757325956666, 50.028495655150785, 60.17011683089555, 0.12293019999999992, 160.0, 629, 974837, 1372, 26.724029500001052
1373, 5.695559122650461, 50.03634387507583, 60.275101939114656, 0.12235014999999995, 125.0, 660, 975497, 1373, 28.80556350000188
1374, 5.813284932810614, 49.88913154893249, 60.01717637040233, 0.12175839999999997, 145.0, 655, 976152, 1374, 28.051328999998077
1375, 5.168861504412212, 49.92526014878153, 60.09399724764018, 0.12110949999999994, 235.0, 787, 976939, 1375, 34.60213859999931
1376, 3.5498502832403522, 50.003843279196175, 60.11707712846977, 0.12045204999999991, 120.0, 674, 977613, 1376, 29.11190660000284
1377, 5.786527505492578, 50.00667314373079, 60.139345119038566, 0.11987424999999993, 100.0, 610, 978223, 1377, 26.849832899999456
1378, 4.437603353575204, 49.94693749604031, 60.10597446486647, 0.11925639999999994, 225.0, 763, 978986, 1378, 32.977706699999544
1379, 4.8843649716771065, 49.98489457865033, 60.16520840450886, 0.11848599999999992, 375.0, 949, 979935, 1379, 41.37342870000066
1380, 6.819876324464506, 50.420708493347476, 60.77870499521223, 0.11761389999999991, 150.0, 989, 980924, 1380, 42.773808799996914
1381, 7.717388106775152, 50.647982154888496, 61.070512373213845, 0.11692539999999987, 15.0, 541, 981465, 1381, 23.516826899998705
1382, 3.2672564817886602, 50.50438333310579, 60.67522755673057, 0.11633994999999993, 160.0, 760, 982225, 1382, 32.557000799999514
1383, 4.584229024995953, 50.52385372655091, 60.77605423872678, 0.11572299999999996, 150.0, 611, 982836, 1383, 26.684660399998393
1384, 7.7883054697504175, 50.55132873126009, 60.91318593190672, 0.11516274999999995, 95.0, 634, 983470, 1384, 27.608437900002173
1385, 6.504936118490204, 50.528327406879974, 60.87583476189469, 0.11448279999999994, 280.0, 877, 984347, 1385, 37.9770423000009
1386, 7.284760663576326, 50.52435155860128, 60.861037814774704, 0.11357739999999993, 475.0, 1135, 985482, 1386, 49.15592330000072
1387, 7.476723731381638, 50.606300211309495, 60.97120733728829, 0.11252529999999993, 435.0, 1203, 986685, 1387, 51.80147070000021
1388, 5.496599100909795, 50.67445857661545, 60.98448730881806, 0.11170134999999995, 95.0, 628, 987313, 1388, 27.32679569999891
1389, 4.543413062975642, 50.572252238086705, 60.80608215113737, 0.11110419999999994, 165.0, 699, 988012, 1389, 30.853895000000193
1390, 5.163800390734642, 50.34561569951162, 60.585458835633865, 0.11057544999999988, 65.0, 476, 988488, 1390, 20.749968100000842
1391, 6.208738150974038, 50.52212204067864, 60.883811030148536, 0.11012814999999992, 60.0, 518, 989006, 1391, 22.388816500002577
1392, 3.460619590114691, 50.41645248778566, 60.620537215364195, 0.10951929999999999, 255.0, 835, 989841, 1392, 36.32635659999869
1393, 4.80209361591677, 49.975815885648956, 60.103707824166364, 0.10891494999999997, 55.0, 508, 990349, 1393, 21.94798660000015
1394, 5.7967926769040705, 49.731284981074296, 59.93601352361244, 0.1084005999999999, 100.0, 635, 990984, 1394, 28.104056000000128
1395, 8.393931359830328, 49.64912318862247, 59.80914081226695, 0.10784754999999994, 135.0, 594, 991578, 1395, 25.87320749999708
1396, 3.4167226115991545, 49.73396310187005, 59.7806994945972, 0.10740699999999996, 65.0, 385, 991963, 1396, 16.793143699997017
1397, 8.06636957362076, 49.73046833900228, 59.91956198863903, 0.10680354999999996, 220.0, 956, 992919, 1397, 41.638626300002215
1398, 7.89467055913723, 49.66132157875077, 59.815024896658464, 0.10595304999999997, 195.0, 934, 993853, 1398, 40.965321499999845
1399, 3.9121583260832327, 49.831678095318026, 59.86823624656314, 0.10530594999999993, 50.0, 504, 994357, 1399, 22.217303299999912
1400, 4.384612342770453, 49.61787339198737, 59.685424291351694, 0.10471464999999991, 210.0, 810, 995167, 1400, 35.979362000001856
1401, 3.578497473330848, 49.66055779942686, 59.77105579153325, 0.10408059999999994, 70.0, 599, 995766, 1401, 26.54214150000189
1402, 7.767323002964258, 49.717527869895655, 59.879418097602, 0.10356804999999993, 45.0, 540, 996306, 1402, 23.57531580000068
1403, 8.950192265886871, 49.674055592113774, 59.91905256191363, 0.10291734999999994, 320.0, 906, 997212, 1403, 39.96778769999946
1404, 6.077245881800414, 49.62805385561174, 59.79253969604674, 0.10220769999999994, 125.0, 671, 997883, 1404, 29.745971299998928
1405, 5.485292471111095, 49.66451551870335, 59.791979786808504, 0.10131894999999991, 395.0, 1304, 999187, 1405, 57.85009229999923
