,loss,mae,mean_q,mean_eps,episode_reward,nb_episode_steps,nb_steps,episode,duration
0,0,0,0,0,105.0,532,532,0,1.0968680000000006
1, 0, 0, 0, 0, 95.0, 399, 931, 1, 0.7932921999999998
2, 0, 0, 0, 0, 550.0, 1212, 2143, 2, 2.4652019000000003
3, 0, 0, 0, 0, 110.0, 614, 2757, 3, 1.1996772999999994
4, 0, 0, 0, 0, 215.0, 798, 3555, 4, 1.5181302999999993
5, 0, 0, 0, 0, 150.0, 761, 4316, 5, 1.4653102999999987
6, 0, 0, 0, 0, 60.0, 512, 4828, 6, 1.0653949999999988
7, 0, 0, 0, 0, 180.0, 807, 5635, 7, 1.5274651000000006
8, 0, 0, 0, 0, 605.0, 1744, 7379, 8, 3.595808999999999
9, 0, 0, 0, 0, 15.0, 489, 7868, 9, 0.9846904999999992
10, 0, 0, 0, 0, 190.0, 757, 8625, 10, 1.5120058999999983
11, 0, 0, 0, 0, 155.0, 688, 9313, 11, 1.4383410999999988
12, 0, 0, 0, 0, 210.0, 774, 10087, 12, 1.8163181000000002
13, 0, 0, 0, 0, 180.0, 720, 10807, 13, 1.8431794000000004
14, 0, 0, 0, 0, 210.0, 818, 11625, 14, 1.7344526999999985
15, 0, 0, 0, 0, 290.0, 1003, 12628, 15, 1.9444747000000007
16, 0, 0, 0, 0, 210.0, 870, 13498, 16, 1.804804599999997
17, 0, 0, 0, 0, 120.0, 650, 14148, 17, 1.3532841999999974
18, 0, 0, 0, 0, 65.0, 704, 14852, 18, 1.370985999999995
19, 0, 0, 0, 0, 125.0, 544, 15396, 19, 1.1001626999999985
20, 0, 0, 0, 0, 185.0, 830, 16226, 20, 1.6250047999999992
21, 0, 0, 0, 0, 105.0, 716, 16942, 21, 1.3764605000000003
22, 0, 0, 0, 0, 105.0, 512, 17454, 22, 0.9993614999999991
23, 0, 0, 0, 0, 65.0, 520, 17974, 23, 1.0336230999999998
24, 0, 0, 0, 0, 180.0, 859, 18833, 24, 1.799787600000002
25, 0, 0, 0, 0, 180.0, 880, 19713, 25, 1.7510329999999996
26, 0, 0, 0, 0, 60.0, 470, 20183, 26, 0.9194758000000007
27, 0, 0, 0, 0, 40.0, 455, 20638, 27, 0.897556999999999
28, 0, 0, 0, 0, 370.0, 1325, 21963, 28, 2.493314600000005
29, 0, 0, 0, 0, 50.0, 404, 22367, 29, 0.7903027999999992
30, 0, 0, 0, 0, 80.0, 623, 22990, 30, 1.2602840999999998
31, 0, 0, 0, 0, 285.0, 876, 23866, 31, 1.755794200000004
32, 0, 0, 0, 0, 430.0, 1405, 25271, 32, 2.7018230999999986
33, 0, 0, 0, 0, 35.0, 502, 25773, 33, 0.984251399999998
34, 0, 0, 0, 0, 270.0, 934, 26707, 34, 1.8239925999999969
35, 0, 0, 0, 0, 35.0, 619, 27326, 35, 1.2949234000000018
36, 0, 0, 0, 0, 155.0, 1001, 28327, 36, 1.9981039999999979
37, 0, 0, 0, 0, 80.0, 424, 28751, 37, 0.8327334000000093
38, 0, 0, 0, 0, 30.0, 583, 29334, 38, 1.1714710999999909
39, 0, 0, 0, 0, 240.0, 984, 30318, 39, 1.908183799999989
40, 0, 0, 0, 0, 105.0, 652, 30970, 40, 1.2758036999999973
41, 0, 0, 0, 0, 165.0, 854, 31824, 41, 1.762280000000004
42, 0, 0, 0, 0, 120.0, 711, 32535, 42, 1.4329800999999946
43, 0, 0, 0, 0, 220.0, 940, 33475, 43, 1.9066854000000006
44, 0, 0, 0, 0, 50.0, 502, 33977, 44, 1.0521224000000018
45, 0, 0, 0, 0, 135.0, 568, 34545, 45, 1.2050418000000036
46, 0, 0, 0, 0, 105.0, 655, 35200, 46, 1.454748500000008
47, 0, 0, 0, 0, 235.0, 843, 36043, 47, 1.8201430000000016
48, 0, 0, 0, 0, 120.0, 708, 36751, 48, 1.5041291
49, 0, 0, 0, 0, 105.0, 629, 37380, 49, 1.3557528000000048
50, 0, 0, 0, 0, 340.0, 1040, 38420, 50, 2.1488729000000006
51, 0, 0, 0, 0, 105.0, 384, 38804, 51, 0.8430578000000111
52, 0, 0, 0, 0, 135.0, 684, 39488, 52, 1.4328474
53, 0, 0, 0, 0, 60.0, 393, 39881, 53, 0.8862596999999965
54, 0, 0, 0, 0, 60.0, 387, 40268, 54, 0.8421775999999994
55, 0, 0, 0, 0, 170.0, 667, 40935, 55, 1.4017072000000041
56, 0, 0, 0, 0, 285.0, 801, 41736, 56, 1.6356351999999958
57, 0, 0, 0, 0, 210.0, 895, 42631, 57, 1.869804000000002
58, 0, 0, 0, 0, 75.0, 400, 43031, 58, 0.8761769999999984
59, 0, 0, 0, 0, 30.0, 582, 43613, 59, 1.2398333999999949
60, 0, 0, 0, 0, 135.0, 695, 44308, 60, 1.5589815999999956
61, 0, 0, 0, 0, 65.0, 585, 44893, 61, 1.3440060000000074
62, 0, 0, 0, 0, 445.0, 1343, 46236, 62, 2.8628856999999925
63, 0, 0, 0, 0, 155.0, 800, 47036, 63, 1.6602225000000033
64, 0, 0, 0, 0, 105.0, 697, 47733, 64, 1.4379044000000079
65, 0, 0, 0, 0, 105.0, 597, 48330, 65, 1.4257651000000067
66, 0, 0, 0, 0, 65.0, 541, 48871, 66, 1.3705977000000047
67, 0, 0, 0, 0, 210.0, 760, 49631, 67, 1.7227232999999984
68, 0, 0, 0, 0, 275.0, 976, 50607, 68, 1.9252211999999957
69, 0, 0, 0, 0, 115.0, 642, 51249, 69, 1.343168899999995
70, 0, 0, 0, 0, 440.0, 866, 52115, 70, 1.8415644999999898
71, 0, 0, 0, 0, 215.0, 974, 53089, 71, 1.950018700000001
72, 0, 0, 0, 0, 120.0, 701, 53790, 72, 1.392689599999997
73, 0, 0, 0, 0, 190.0, 863, 54653, 73, 1.7281097000000045
74, 0, 0, 0, 0, 120.0, 641, 55294, 74, 1.2910897000000006
75, 0, 0, 0, 0, 290.0, 1349, 56643, 75, 2.63187529999999
76, 0, 0, 0, 0, 390.0, 1162, 57805, 76, 2.346079099999997
77, 0, 0, 0, 0, 60.0, 518, 58323, 77, 1.0696646999999757
78, 0, 0, 0, 0, 210.0, 806, 59129, 78, 1.6184947000000136
79, 0, 0, 0, 0, 35.0, 397, 59526, 79, 0.7996305000000064
80, 0, 0, 0, 0, 5.0, 488, 60014, 80, 1.0088719000000026
81, 0, 0, 0, 0, 80.0, 489, 60503, 81, 1.0441526999999837
82, 0, 0, 0, 0, 110.0, 512, 61015, 82, 1.0537861999999905
83, 0, 0, 0, 0, 175.0, 774, 61789, 83, 1.595765
84, 0, 0, 0, 0, 210.0, 816, 62605, 84, 1.67564950000002
85, 0, 0, 0, 0, 45.0, 590, 63195, 85, 1.238986699999998
86, 0, 0, 0, 0, 105.0, 703, 63898, 86, 1.5433619999999735
87, 0, 0, 0, 0, 135.0, 763, 64661, 87, 1.5647693999999888
88, 0, 0, 0, 0, 35.0, 392, 65053, 88, 0.7889657000000057
89, 0, 0, 0, 0, 90.0, 556, 65609, 89, 1.132044900000011
90, 0, 0, 0, 0, 195.0, 937, 66546, 90, 1.8769021999999893
91, 0, 0, 0, 0, 65.0, 596, 67142, 91, 1.2087778000000071
92, 0, 0, 0, 0, 110.0, 567, 67709, 92, 1.1454611000000057
93, 0, 0, 0, 0, 120.0, 792, 68501, 93, 1.6054580999999928
94, 0, 0, 0, 0, 380.0, 719, 69220, 94, 1.4782486999999946
95, 0, 0, 0, 0, 120.0, 629, 69849, 95, 1.26165069999999
96, 0, 0, 0, 0, 210.0, 863, 70712, 96, 1.6932031999999992
97, 0, 0, 0, 0, 95.0, 583, 71295, 97, 1.1861325999999792
98, 0, 0, 0, 0, 160.0, 751, 72046, 98, 1.5078610999999853
99, 0, 0, 0, 0, 155.0, 692, 72738, 99, 1.4394677999999885
100, 0, 0, 0, 0, 225.0, 966, 73704, 100, 2.044960599999996
101, 0, 0, 0, 0, 180.0, 778, 74482, 101, 1.5899770999999987
102, 0, 0, 0, 0, 155.0, 673, 75155, 102, 1.3215201999999806
103, 0, 0, 0, 0, 290.0, 1383, 76538, 103, 2.6999429999999904
104, 0, 0, 0, 0, 135.0, 768, 77306, 104, 1.5564957999999933
105, 0, 0, 0, 0, 90.0, 596, 77902, 105, 1.2594637999999918
106, 0, 0, 0, 0, 110.0, 615, 78517, 106, 1.2679583000000036
107, 0, 0, 0, 0, 110.0, 791, 79308, 107, 1.6318397000000004
108, 0, 0, 0, 0, 215.0, 637, 79945, 108, 1.3283670000000143
109, 0, 0, 0, 0, 65.0, 539, 80484, 109, 1.1966255000000103
110, 0, 0, 0, 0, 180.0, 769, 81253, 110, 1.6621774999999843
111, 0, 0, 0, 0, 230.0, 961, 82214, 111, 1.9413054000000045
112, 0, 0, 0, 0, 45.0, 424, 82638, 112, 0.9217612000000202
113, 0, 0, 0, 0, 165.0, 815, 83453, 113, 1.7352127999999993
114, 0, 0, 0, 0, 45.0, 584, 84037, 114, 1.3025214999999832
115, 0, 0, 0, 0, 110.0, 613, 84650, 115, 1.2377506999999923
116, 0, 0, 0, 0, 135.0, 640, 85290, 116, 1.2530332999999985
117, 0, 0, 0, 0, 60.0, 414, 85704, 117, 0.8409319999999809
118, 0, 0, 0, 0, 85.0, 506, 86210, 118, 1.0517859999999928
119, 0, 0, 0, 0, 155.0, 751, 86961, 119, 1.5285113000000194
120, 0, 0, 0, 0, 185.0, 713, 87674, 120, 1.420256199999983
121, 0, 0, 0, 0, 135.0, 654, 88328, 121, 1.4069743000000017
122, 0, 0, 0, 0, 210.0, 805, 89133, 122, 1.6783233000000166
123, 0, 0, 0, 0, 120.0, 607, 89740, 123, 1.3598084999999855
124, 0, 0, 0, 0, 235.0, 1047, 90787, 124, 2.2487285999999926
125, 0, 0, 0, 0, 55.0, 576, 91363, 125, 1.2437031999999988
126, 0, 0, 0, 0, 265.0, 948, 92311, 126, 2.011159399999997
127, 0, 0, 0, 0, 45.0, 394, 92705, 127, 0.8533472999999958
128, 0, 0, 0, 0, 240.0, 970, 93675, 128, 2.1130153999999948
129, 0, 0, 0, 0, 15.0, 532, 94207, 129, 1.2098215000000039
130, 0, 0, 0, 0, 50.0, 514, 94721, 130, 1.2292553999999996
131, 0, 0, 0, 0, 45.0, 393, 95114, 131, 0.8566648000000043
132, 0, 0, 0, 0, 380.0, 812, 95926, 132, 1.7265783
133, 0, 0, 0, 0, 425.0, 900, 96826, 133, 1.862034599999987
134, 0, 0, 0, 0, 210.0, 692, 97518, 134, 1.5203108000000043
135, 0, 0, 0, 0, 100.0, 595, 98113, 135, 1.2611431000000266
136, 0, 0, 0, 0, 225.0, 1169, 99282, 136, 2.6610589999999945
137, 72.80303576372671, 15.097343983857527, 22.234840006068133, 0.8199369999999998, 190.0, 788, 100070, 137, 2.5609361000000206
138, 19.085155177684058, 14.18210018248785, 18.02995742729732, 0.8191189000000002, 300.0, 840, 100910, 138, 7.566636999999986
139, 12.938677630990238, 14.15335654889123, 17.582035166530286, 0.8178319000000002, 45.0, 590, 101500, 139, 5.642302299999983
140, 13.646126949018047, 14.123581174112136, 17.475205404527724, 0.8167428999999999, 155.0, 620, 102120, 140, 6.018460299999987
141, 10.670990987866206, 14.068303594950208, 17.30752536112281, 0.8154478, 210.0, 819, 102939, 141, 7.687794200000013
142, 12.253457001039198, 14.085723161697388, 17.27558780550123, 0.8141958999999998, 80.0, 572, 103511, 142, 5.614567600000015
143, 13.437917167414062, 14.10344830681296, 17.200497063761535, 0.8126560000000003, 170.0, 1139, 104650, 143, 10.749631599999987
144, 12.47271326424967, 14.043353600298955, 17.132853241919072, 0.8110179999999999, 135.0, 681, 105331, 144, 6.611851100000024
145, 9.398490068293938, 14.079649581717003, 17.045036696667033, 0.8096905000000001, 135.0, 794, 106125, 145, 7.721118100000012
146, 11.398564933610443, 14.04895024651649, 16.9978157133064, 0.8083053999999995, 150.0, 745, 106870, 146, 6.899765700000046
147, 10.32970952642431, 14.046908981349237, 17.026412896443876, 0.8065782999999999, 425.0, 1174, 108044, 147, 11.256636200000003
148, 10.744633845221449, 14.039796340591916, 17.00321764322557, 0.8050123000000001, 110.0, 566, 108610, 148, 5.370832000000007
149, 8.04867694816734, 13.9774112448068, 16.883466099878415, 0.8040286000000001, 55.0, 527, 109137, 149, 4.704262299999982
150, 10.57160977013677, 13.95218293306639, 16.84771953966978, 0.8029287999999996, 90.0, 695, 109832, 150, 6.290833100000043
151, 9.35821576763249, 14.160490862228585, 17.056586638936455, 0.8017308999999998, 110.0, 636, 110468, 151, 5.883905599999991
152, 6.420133018220393, 14.195005364950886, 17.0995692204837, 0.8002161999999995, 290.0, 1047, 111515, 152, 8.8117393
153, 5.949229152697437, 14.1043347187762, 17.051165297346294, 0.7987014999999997, 110.0, 636, 112151, 153, 5.480679699999996
154, 4.813331632043936, 14.164673156086625, 17.142947072895065, 0.7974441999999997, 110.0, 761, 112912, 154, 6.662843500000008
155, 5.30828752669378, 14.128642944881978, 17.018718825656897, 0.7963066, 120.0, 503, 113415, 155, 4.579133200000001
156, 6.562116344394924, 14.060523097919967, 17.036960233532408, 0.7951384000000001, 210.0, 795, 114210, 156, 6.911756400000002
157, 3.7101457008948695, 14.13313230734605, 17.051033683923574, 0.7939549000000001, 80.0, 520, 114730, 157, 4.652672699999982
158, 9.489805133156636, 14.107995502053434, 17.12817910954922, 0.7930602999999997, 80.0, 474, 115204, 158, 4.036779500000023
159, 4.641832736869381, 14.042453756071117, 16.943857241983284, 0.7921080999999999, 135.0, 584, 115788, 159, 5.195741999999996
160, 4.036072445023087, 14.071135870782577, 17.009441379309596, 0.7903828000000007, 420.0, 1333, 117121, 160, 12.231043400000033
161, 6.404755714717531, 14.054411964011761, 17.012595353771584, 0.7885044999999995, 135.0, 754, 117875, 161, 7.651622099999997
162, 8.34485136163276, 14.09308503820822, 17.04165944261122, 0.7873056999999997, 130.0, 578, 118453, 162, 5.987722500000018
163, 5.588737903798328, 14.076068129258998, 17.054985927133, 0.7861734999999996, 155.0, 680, 119133, 163, 7.245449399999984
164, 4.618712533526776, 14.111928166004649, 17.069130905887537, 0.7847407000000003, 225.0, 912, 120045, 164, 9.472728200000006
165, 9.328226022410506, 14.692266287403138, 17.917432673192817, 0.7833519999999997, 170.0, 631, 120676, 165, 6.515547000000026
166, 8.635019405117594, 14.697849275676775, 17.886931243800717, 0.7823539000000002, 50.0, 478, 121154, 166, 5.127008999999987
167, 7.997912247425301, 14.703169335288685, 17.912689819230266, 0.7812739000000004, 325.0, 722, 121876, 167, 7.694971500000008
168, 8.870382195117006, 14.73277071536801, 17.997757971989508, 0.7797844000000002, 330.0, 933, 122809, 168, 9.847100800000021
169, 7.894705518104691, 14.89575595080718, 18.131156327223938, 0.7785460000000001, 85.0, 443, 123252, 169, 4.61593240000002
170, 8.122694517454887, 14.732689641426823, 17.915389513728595, 0.7775235999999995, 230.0, 693, 123945, 170, 7.319295899999986
171, 5.18000140847831, 14.765178318681388, 18.016085015220202, 0.7765083999999999, 65.0, 435, 124380, 171, 4.52126949999996
172, 6.178407571407464, 14.750310743772067, 17.898723728840167, 0.7756489000000003, 115.0, 520, 124900, 172, 5.559905999999955
173, 6.6359955516741564, 14.75996824110374, 17.998007906648017, 0.7744347999999994, 170.0, 829, 125729, 173, 8.690404000000001
174, 6.565292243667729, 14.860450755166744, 18.1129886774727, 0.7728742, 150.0, 905, 126634, 174, 9.395415800000023
175, 5.113099468580211, 14.846453399543302, 18.081219127379267, 0.7714621000000004, 50.0, 664, 127298, 175, 7.063084600000025
176, 7.638319562457447, 14.813001246213718, 18.09439950853806, 0.7697673999999999, 345.0, 1219, 128517, 176, 13.095588999999961
177, 6.234758324158474, 14.810609514319053, 18.113856369116174, 0.7677559000000003, 245.0, 1016, 129533, 177, 10.609572800000024
178, 8.41734400536451, 14.869902882311079, 18.142529714438652, 0.7663230999999997, 185.0, 576, 130109, 178, 6.220506
179, 6.803973686676207, 14.8166579066668, 17.879561638869877, 0.7652367999999999, 100.0, 631, 130740, 179, 6.785917599999948
180, 6.3330071616499675, 14.858249656134625, 17.962825005342538, 0.7636185999999996, 705.0, 1167, 131907, 180, 12.634673600000042
181, 7.4600221632700885, 14.800043503039985, 17.874098344502716, 0.7622136999999998, 55.0, 394, 132301, 181, 4.26269769999999
182, 6.301770399532456, 14.858212509708128, 17.999638619630232, 0.7612380999999999, 290.0, 690, 132991, 182, 7.4194179999999506
183, 7.795952193399334, 14.900275876346868, 18.040418640112343, 0.7597720000000007, 265.0, 939, 133930, 183, 10.205255500000021
184, 9.115690053505485, 14.925805523535002, 18.05853332450463, 0.7582806999999999, 150.0, 718, 134648, 184, 8.11074050000002
185, 7.076088816356553, 15.007581736162255, 18.115885076596754, 0.7568218000000002, 455.0, 903, 135551, 185, 9.722129300000006
186, 7.090055418878362, 15.009552875463513, 18.126263441555743, 0.7553880999999999, 130.0, 690, 136241, 186, 7.579008799999997
187, 6.576128810210346, 14.927364963631442, 18.0200232591865, 0.7535305000000003, 380.0, 1374, 137615, 187, 14.923880199999985
188, 6.7364373642121445, 15.01442721368389, 18.13725607240746, 0.7517242000000003, 95.0, 633, 138248, 188, 6.979519499999924
189, 9.296238542834589, 14.939276021374159, 17.961438192808924, 0.7507189000000001, 15.0, 484, 138732, 189, 5.320068300000003
190, 9.737923682212829, 14.942077697753906, 18.15795587412516, 0.7499458, 45.0, 375, 139107, 190, 4.171424900000034
191, 6.597899138434859, 14.898180451274904, 18.05482213753314, 0.7491727000000002, 100.0, 484, 139591, 191, 5.4129760999999235
192, 4.954045718796899, 14.691256197813516, 17.745174341112655, 0.7481592999999997, 130.0, 642, 140233, 192, 7.182034599999952
193, 4.095021947833259, 14.149178526374731, 17.133909112951727, 0.7467804999999996, 415.0, 890, 141123, 193, 9.880597599999987
194, 4.604657336347031, 14.183384092889652, 17.168072960593484, 0.7450884999999999, 255.0, 990, 142113, 194, 11.075172100000032
195, 6.500115614985042, 14.169292073103167, 17.18014959297998, 0.7432318, 325.0, 1073, 143186, 195, 12.139565699999935
196, 5.23947846249605, 14.12306579301656, 17.034020215332152, 0.7418134000000001, 85.0, 503, 143689, 196, 5.717774399999939
197, 7.2224552900888925, 14.311150814786316, 17.330203696101023, 0.7405704999999998, 340.0, 878, 144567, 197, 9.797281999999996
198, 6.7841566838212195, 14.16390358864724, 17.113861764157498, 0.7391809000000004, 65.0, 666, 145233, 198, 7.620051999999987
199, 4.285815786258341, 14.202789099932891, 17.120876504869884, 0.7382160999999996, 20.0, 406, 145639, 199, 4.652678500000093
200, 4.0672836880305985, 14.139318961919326, 17.07462906559586, 0.7374646, 80.0, 429, 146068, 200, 4.9490815999999995
201, 3.9053010184431702, 14.184404701471676, 17.118269560118428, 0.7358418999999998, 425.0, 1374, 147442, 201, 15.595730899999921
202, 3.9406210620896984, 14.164030084706317, 17.132225925753815, 0.7337142999999999, 185.0, 990, 148432, 202, 11.292468599999893
203, 2.7678248315598024, 14.171734809875488, 17.0602258817114, 0.7324668999999999, 65.0, 396, 148828, 203, 4.546220600000083
204, 4.312097482363383, 14.136649251302083, 17.049242362976074, 0.7317730000000001, 55.0, 375, 149203, 204, 4.345485800000006
205, 4.678979575121642, 14.347562688811118, 17.314709854672493, 0.7311214000000001, 20.0, 349, 149552, 205, 3.992216899999903
206, 8.140638776268737, 14.315386001495407, 17.3658321143269, 0.7302069999999999, 160.0, 667, 150219, 206, 7.713228100000038
207, 5.374576472305047, 14.494358909805555, 17.547536974113896, 0.7290190000000001, 70.0, 653, 150872, 207, 7.5206106000000545
208, 4.771435569248518, 14.437929549645283, 17.441106750472354, 0.7280002000000004, 90.0, 479, 151351, 208, 5.539748000000031
209, 4.371600868958152, 14.454689666616613, 17.456530933990354, 0.7264719999999999, 410.0, 1219, 152570, 209, 13.899627099999975
210, 5.4758949816090405, 14.530617119656942, 17.59860561147998, 0.7245891999999999, 125.0, 873, 153443, 210, 10.021616499999936
211, 4.538979577170363, 14.431064761918167, 17.4219912611205, 0.7232815, 85.0, 580, 154023, 211, 6.642352899999992
212, 5.937947220120911, 14.550113304120273, 17.601413574576938, 0.7219927, 230.0, 852, 154875, 212, 9.840330300000005
213, 3.515991452172934, 14.61344300866803, 17.60826074243268, 0.7207498, 70.0, 529, 155404, 213, 5.922717000000034
214, 2.2825388531326443, 14.491429854083705, 17.474518893538296, 0.7197408999999998, 130.0, 592, 155996, 214, 6.843731400000024
215, 4.898740739457093, 14.490660686661286, 17.538683838381292, 0.7184943999999996, 240.0, 793, 156789, 215, 9.418463599999995
216, 3.8129325530874665, 14.603441642473587, 17.589414129993433, 0.7167781000000001, 440.0, 1114, 157903, 216, 13.23696629999995
217, 4.4427523138069684, 14.553504880070063, 17.52660378642466, 0.7149142000000005, 155.0, 957, 158860, 217, 11.289743200000089
218, 4.93978629358569, 14.503605443604139, 17.521596453141193, 0.7136119, 30.0, 490, 159350, 218, 5.864987100000008
219, 5.234979670623253, 14.581543233327357, 17.622424630909503, 0.7125967000000001, 215.0, 638, 159988, 219, 7.5696686
220, 5.016399368299887, 15.713597518795138, 19.015392983614742, 0.7112035, 165.0, 910, 160898, 220, 10.863699999999994
221, 5.133699194280257, 15.746766763625384, 19.04443570521238, 0.7093837000000004, 535.0, 1112, 162010, 221, 13.503339500000038
222, 2.2154588234093455, 15.667109418798375, 18.88100564921344, 0.7078969, 150.0, 540, 162550, 222, 6.523343999999952
223, 3.192986508377078, 15.730535899720541, 19.004259140026278, 0.7068205000000003, 105.0, 656, 163206, 223, 7.8127033999999185
224, 2.415202956909299, 15.728764364675815, 18.939873264601584, 0.7058854, 65.0, 383, 163589, 224, 4.522271799999999
225, 5.571777194699071, 15.674482453781572, 18.962234524749515, 0.7051995999999998, 80.0, 379, 163968, 225, 4.592018399999915
226, 4.400920205601191, 15.694432242441986, 19.067435086783718, 0.7040619999999996, 70.0, 885, 164853, 226, 10.573875999999927
227, 2.230352326776042, 15.848146368414808, 19.082154294629117, 0.7028497000000002, 60.0, 462, 165315, 227, 5.358169100000055
228, 5.54177557651713, 15.815279766193871, 19.07169280700313, 0.7020630999999999, 115.0, 412, 165727, 228, 4.824479300000007
229, 3.535472597174801, 15.783952777934186, 19.070437649605978, 0.7009255000000004, 145.0, 852, 166579, 229, 10.281400800000029
230, 5.774304891620795, 15.714733922368245, 18.980191591297057, 0.6993063999999998, 130.0, 947, 167526, 230, 11.527807100000018
231, 2.41650288725935, 15.771966593025896, 18.979541802934325, 0.6979257999999999, 100.0, 587, 168113, 231, 7.182086400000003
232, 4.165612148484964, 15.80698973008956, 19.051239987899518, 0.6967711000000001, 135.0, 696, 168809, 232, 8.641619900000023
233, 4.338833864844911, 15.832922285746752, 19.10112843242118, 0.6955912000000002, 180.0, 615, 169424, 233, 7.632773400000019
234, 5.235164507544583, 15.838396886555698, 19.187217387649937, 0.6946623999999997, 30.0, 417, 169841, 234, 5.257725700000037
235, 2.930713249261688, 16.315354881495455, 19.680735648113444, 0.6933006999999995, 325.0, 1096, 170937, 235, 13.185493700000052
236, 4.946335762982291, 16.362275333184886, 19.756936901590418, 0.6913765000000001, 270.0, 1042, 171979, 236, 12.668274600000018
237, 2.314679262203139, 16.355609161246722, 19.69777252256955, 0.6898060000000001, 195.0, 703, 172682, 237, 8.659674799999948
238, 5.706474951713493, 16.354413675634486, 19.78286459571437, 0.6886261000000001, 95.0, 608, 173290, 238, 7.432224000000019
239, 4.368099529066203, 16.392597627247312, 19.801921739499754, 0.6872040999999997, 210.0, 972, 174262, 239, 12.192173299999922
240, 2.374402757645363, 16.4663050586269, 19.7930982198034, 0.6857245000000004, 95.0, 672, 174934, 240, 8.398769199999947
241, 4.275273298805241, 16.384922040346076, 19.77686967179927, 0.6843123999999998, 135.0, 897, 175831, 241, 10.946891800000003
242, 2.0925282350585697, 16.40661361046748, 19.74626220379331, 0.6831658000000003, 55.0, 377, 176208, 242, 5.0081467999998495
243, 7.846546214612233, 16.45526450217804, 19.921717368109377, 0.6825151, 80.0, 346, 176554, 243, 4.39771369999994
244, 5.248877738971682, 16.47782346906041, 19.89413396282309, 0.6815953000000001, 70.0, 676, 177230, 244, 8.540261699999974
245, 4.822945792235107, 16.38273004546448, 19.761004837247654, 0.6800455000000001, 535.0, 1046, 178276, 245, 12.843763999999965
246, 5.471262627188264, 16.4608276430665, 19.883148451803603, 0.6785362000000003, 135.0, 631, 178907, 246, 7.810149899999942
247, 2.128271276494896, 16.428636121559904, 19.812131851317872, 0.6775165000000002, 125.0, 502, 179409, 247, 6.303352199999836
248, 5.079238168099242, 16.253617864388687, 19.601093381898018, 0.6762222999999996, 355.0, 936, 180345, 248, 11.629010999999991
249, 3.319651250768999, 16.11764191366305, 19.38895424915727, 0.6748146999999999, 180.0, 628, 180973, 249, 7.906369199999972
250, 3.7812282006526337, 16.12385655500923, 19.46816534507104, 0.6734331999999997, 275.0, 907, 181880, 250, 11.342334299999948
251, 3.7384389273841463, 16.09881974002083, 19.41096874619511, 0.6722667999999999, 110.0, 389, 182269, 251, 4.99706389999983
252, 5.038817263319327, 16.08575703039613, 19.448824243837805, 0.6711237999999998, 195.0, 881, 183150, 252, 11.118672800000013
253, 2.297972703431832, 16.137790786459092, 19.446579745475283, 0.6699925000000001, 25.0, 376, 183526, 253, 4.75471790000006
254, 3.677856651984337, 16.138962601452338, 19.458526250792712, 0.6689161000000001, 120.0, 820, 184346, 254, 10.406595600000173
255, 3.333853709167778, 15.990252680805856, 19.274145494683523, 0.6677074, 40.0, 523, 184869, 255, 6.44418520000022
256, 4.984959047723641, 16.15418961453945, 19.591591325212033, 0.6668983, 45.0, 376, 185245, 256, 4.690575800000033
257, 2.2508401713608355, 16.162316071830592, 19.422003520586255, 0.6660802000000002, 120.0, 533, 185778, 257, 6.742683400000033
258, 5.737816398102812, 16.109632586875158, 19.465607307110613, 0.6649848999999999, 95.0, 684, 186462, 258, 8.664247900000191
259, 3.2770598167663976, 16.157922292415332, 19.437990917989858, 0.6639138999999998, 145.0, 506, 186968, 259, 6.52252129999988
260, 4.4250478296547735, 16.18007170061339, 19.532450980929816, 0.6621525999999994, 510.0, 1451, 188419, 260, 16.06895989999998
261, 4.0929313024205545, 16.124768406344998, 19.430899238586427, 0.6602887000000003, 55.0, 620, 189039, 261, 6.548592499999813
262, 4.279626062721465, 16.104278729739182, 19.514244175350814, 0.6590764, 180.0, 727, 189766, 262, 7.930191799999875
263, 3.297752079102728, 16.213251910739476, 19.585070865419176, 0.6576121000000001, 245.0, 900, 190666, 263, 11.618511399999988
264, 2.8379228711128235, 16.293707808035393, 19.6646036501284, 0.6561946000000003, 115.0, 675, 191341, 264, 8.966445799999974
265, 3.740081019881295, 16.215633072504183, 19.575716104449295, 0.6549967000000002, 45.0, 656, 191997, 265, 8.940465700000004
266, 4.168154206890497, 16.394523851619745, 19.810025179608267, 0.6538266999999998, 145.0, 644, 192641, 266, 8.598633999999947
267, 3.6953508741369374, 16.346882880361456, 19.732752252879894, 0.6529051000000001, 30.0, 380, 193021, 267, 5.048332600000094
268, 2.7729962892479167, 16.273379457518708, 19.620221724012485, 0.6520285000000003, 170.0, 594, 193615, 268, 8.116582599999902
269, 5.365684181532407, 16.37831501024768, 19.7771405923127, 0.6509115999999997, 195.0, 647, 194262, 269, 9.025348099999974
270, 2.390716780802512, 16.291643137139413, 19.624459856105616, 0.6497118999999999, 135.0, 686, 194948, 270, 9.295225000000073
271, 4.812708063245449, 16.352588067719974, 19.773624306127587, 0.6483267999999995, 205.0, 853, 195801, 271, 11.7705105
272, 2.8246080829291063, 16.31731775883092, 19.689590609244753, 0.6469947999999998, 135.0, 627, 196428, 272, 8.508798999999954
273, 2.5277422647757417, 16.346664865457928, 19.733662946759534, 0.6455205999999996, 645.0, 1011, 197439, 273, 13.99432980000006
274, 5.325471009639137, 16.417197340578497, 19.859311296510487, 0.6439959999999998, 100.0, 683, 198122, 274, 9.513446299999941
275, 2.1220829641142633, 16.307830842110565, 19.630950019151044, 0.6430005999999999, 80.0, 423, 198545, 275, 5.296084199999996
276, 6.168728192993983, 16.369469769715053, 19.81902419492073, 0.6419107000000001, 120.0, 788, 199333, 276, 9.498583199999985
277, 3.261845584210857, 16.35947206673935, 19.72172972042128, 0.6407353000000002, 80.0, 518, 199851, 277, 6.181722900000068
278, 4.117146347946731, 16.384406712145374, 19.782000720343678, 0.6392457999999999, 510.0, 1137, 200988, 278, 13.435092999999824
279, 6.9349910929131, 16.468689397994073, 19.931119569328562, 0.6377607999999999, 65.0, 513, 201501, 279, 6.0834946999998465
280, 4.600317538659341, 16.374762579497055, 19.845989121116606, 0.6368545, 55.0, 494, 201995, 280, 5.876145400000041
281, 6.576139273216373, 16.448057982229418, 19.9640536813692, 0.6356286999999998, 410.0, 868, 202863, 281, 9.779768900000136
282, 3.5398950165580096, 16.380228911443655, 19.74358417701162, 0.6339267999999996, 660.0, 1023, 203886, 282, 11.353987000000188
283, 4.1522704219379, 16.400070090655564, 19.782807171396723, 0.6319738, 565.0, 1147, 205033, 283, 15.822289100000035
284, 4.619438801199447, 16.342838659259936, 19.689445078538984, 0.6302952999999998, 145.0, 718, 205751, 284, 10.0849489000002
285, 5.370336535763831, 16.377316670678205, 19.790730212367862, 0.6291712, 85.0, 531, 206282, 285, 7.339923400000089
286, 5.743855945812134, 16.330161522459953, 19.742693266460886, 0.6279670000000003, 285.0, 807, 207089, 286, 10.793560699999944
287, 4.832646175956024, 16.4061057806015, 19.798032356710994, 0.6266287000000003, 190.0, 680, 207769, 287, 9.644760299999916
288, 5.568798311494269, 16.420176456811504, 19.830140900119567, 0.6254065000000001, 150.0, 678, 208447, 288, 9.376516999999922
289, 4.173756110050023, 16.42721294994901, 19.83062829376272, 0.6242625999999998, 30.0, 593, 209040, 289, 8.25833519999992
290, 6.509680087833355, 16.47408898671468, 19.990384070646193, 0.6231240999999997, 105.0, 672, 209712, 290, 9.278765499999963
291, 3.6313149490923973, 16.371617536225386, 19.7367675133299, 0.6221431000000002, 40.0, 418, 210130, 291, 5.703567499999963
292, 3.2981903384883853, 16.26417022149263, 19.677879522330734, 0.6210442000000003, 170.0, 803, 210933, 292, 11.083346399999982
293, 2.640877489914656, 16.319043881502164, 19.653093185142584, 0.6195916000000002, 230.0, 811, 211744, 293, 11.064903700000059
294, 6.47236720047374, 16.322928987615825, 19.73919562263783, 0.6185116, 55.0, 389, 212133, 294, 5.346279200000026
295, 4.790338062408359, 16.29887401225955, 19.7206352810527, 0.6177745000000001, 90.0, 430, 212563, 295, 5.7628259999999045
296, 4.194635361499224, 16.22702244591972, 19.62952864064163, 0.6164758000000004, 310.0, 1013, 213576, 296, 14.2861355
297, 1.9610084832003973, 16.18278626562322, 19.58710415849408, 0.6152859999999999, 30.0, 309, 213885, 297, 4.754283600000008
298, 3.0007402964996244, 16.363080896593036, 19.71367242246492, 0.6145776999999996, 35.0, 478, 214363, 298, 7.142183800000112
299, 3.082981791448732, 16.34915827127746, 19.705930837861295, 0.6132223000000001, 170.0, 1028, 215391, 299, 14.01455020000003
300, 2.9484660019069358, 16.320528905762256, 19.713882046361125, 0.6113763999999997, 415.0, 1023, 216414, 300, 14.148926800000027
301, 5.003162028852123, 16.29550762994755, 19.68560371455356, 0.6098473000000003, 55.0, 676, 217090, 301, 9.31235219999985
302, 5.231363860670834, 16.438436838698713, 19.86918440648954, 0.6085818999999999, 225.0, 730, 217820, 302, 10.094617800000151
303, 3.3012097005800505, 16.40798581053571, 19.770348855925768, 0.6075558999999999, 20.0, 410, 218230, 303, 5.896935100000064
304, 1.7991906015734587, 16.27369640128953, 19.580924157585418, 0.6061788999999995, 455.0, 1120, 219350, 304, 16.166942999999947
305, 5.6083924830389495, 16.328554881360716, 19.743565115111007, 0.6045777999999998, 120.0, 659, 220009, 305, 9.114640400000098
306, 5.941913178860852, 16.483643974874, 19.920585021824657, 0.6030567999999995, 545.0, 1031, 221040, 306, 14.277863000000025
307, 4.159944023457955, 16.47797975528255, 19.91507043374165, 0.6014080000000004, 260.0, 801, 221841, 307, 11.252382299999908
308, 4.3877809926671985, 16.435873406969076, 19.810157478377004, 0.6000697000000003, 120.0, 686, 222527, 308, 9.785774299999957
309, 4.868766553928948, 16.56520533054433, 20.045200708628265, 0.5990715999999999, 55.0, 423, 222950, 309, 5.8819422999999915
310, 2.994482680697842, 16.434497436674516, 19.839978174643942, 0.5982364, 90.0, 505, 223455, 310, 7.146634999999833
311, 3.4447774352102014, 16.468195747162078, 19.88378819819097, 0.5971384000000003, 180.0, 715, 224170, 311, 9.927930399999923
312, 4.379911240412129, 16.425086530049644, 19.83250954691569, 0.5954824000000001, 575.0, 1125, 225295, 312, 15.813633499999924
313, 3.034262093595969, 16.471277640416073, 19.889025216574197, 0.5939785000000001, 105.0, 546, 225841, 313, 7.902986700000156
314, 6.603810465952758, 16.409558574902956, 19.878363883658633, 0.5928958000000002, 145.0, 657, 226498, 314, 9.717382899999848
315, 4.964577189117448, 16.441860584703925, 19.89100825875332, 0.5919418000000001, 50.0, 403, 226901, 315, 5.76964020000014
316, 4.7571192859446745, 16.515266963290824, 19.95714498168725, 0.5905819, 265.0, 1108, 228009, 316, 15.947299599999951
317, 4.957770639439908, 16.458852051525582, 19.85751615849937, 0.5890311999999999, 55.0, 615, 228624, 317, 8.85163139999986
318, 2.321216882348566, 16.410995047705935, 19.755630021469987, 0.5873094999999999, 410.0, 1298, 229922, 318, 18.471776999999975
319, 4.447309229127999, 16.551830801376298, 19.982708154913347, 0.5855131, 110.0, 698, 230620, 319, 9.971098499999925
320, 1.5992395157747026, 16.486790447700315, 19.8585726231305, 0.5840361999999999, 315.0, 943, 231563, 320, 13.659693099999913
321, 4.143424978462051, 16.4770088648699, 19.88696669367631, 0.5825241999999999, 95.0, 737, 232300, 321, 10.998062299999901
322, 3.9679151116032494, 16.559953206317953, 20.004617461084298, 0.5811255999999998, 250.0, 817, 233117, 322, 11.927452200000062
323, 5.094028148937527, 16.58915324758805, 20.032130192152692, 0.5795361999999998, 220.0, 949, 234066, 323, 14.06109360000005
324, 4.4788059701124645, 16.596125607010272, 20.058783869091556, 0.5776812999999994, 525.0, 1112, 235178, 324, 17.04353930000002
325, 3.949671297254066, 16.63280906936162, 20.05764358939089, 0.5758849000000001, 135.0, 884, 236062, 325, 13.548013000000083
326, 2.2165320957792396, 16.61030577318168, 20.01369127344202, 0.5743602999999999, 260.0, 810, 236872, 326, 11.860410599999796
327, 6.273338880478902, 16.616813344747477, 20.12453291547385, 0.5727645999999998, 295.0, 963, 237835, 327, 14.532876700000088
328, 6.4887781226902, 16.644961054612384, 20.134235226899293, 0.571024, 230.0, 971, 238806, 328, 14.356965600000194
329, 1.5818502023523928, 16.491364545848857, 19.8723232792873, 0.5698287999999999, 30.0, 357, 239163, 329, 5.361419000000069
330, 5.936713445435366, 16.67229697256563, 20.12146158815387, 0.5689467999999999, 70.0, 623, 239786, 330, 9.50665980000008
331, 1.7216271333997581, 16.640913354738416, 20.012304730403685, 0.568018, 120.0, 409, 240195, 331, 6.231532799999968
332, 2.9834670478123284, 16.600823521614075, 20.049174709925577, 0.5671963, 65.0, 504, 240699, 332, 7.465561399999842
333, 5.34104099563184, 16.70974510783431, 20.230252240658473, 0.5660974000000001, 315.0, 717, 241416, 333, 10.839525899999899
334, 4.967439541970379, 16.75092334866524, 20.23435316324234, 0.5647321000000002, 125.0, 800, 242216, 334, 12.22096149999993
335, 5.836469884898372, 16.75255694708068, 20.261299048307528, 0.5633254000000002, 80.0, 763, 242979, 335, 11.372852100000046
336, 3.0662156603414648, 16.70910117474537, 20.141497933205773, 0.5617756, 445.0, 959, 243938, 336, 14.321084299999939
337, 2.674744922090086, 16.73837023898016, 20.191473683224448, 0.5603437, 205.0, 632, 244570, 337, 9.510251000000153
338, 3.8546465797204963, 16.670797090018567, 20.11829369431127, 0.5589532, 400.0, 913, 245483, 338, 13.82811189999984
339, 6.358417239219034, 16.793268645550572, 20.302716659287274, 0.5574943, 200.0, 708, 246191, 339, 10.793234099999836
340, 1.816796925864113, 16.604808124143688, 20.049562636892595, 0.5564952999999999, 75.0, 402, 246593, 340, 6.145345199999838
341, 2.442896550790374, 16.703423299344596, 20.113648682595386, 0.5553423999999999, 170.0, 879, 247472, 341, 13.187286300000096
342, 3.4294922668610845, 16.72326667013562, 20.163567181116097, 0.5538753999999999, 290.0, 751, 248223, 342, 11.488354300000083
343, 3.0005523046255114, 16.80791204664442, 20.30660708448622, 0.5521870000000001, 500.0, 1125, 249348, 343, 17.083399799999825
344, 4.510028490470383, 16.884092930459627, 20.384943539208738, 0.5501880999999997, 470.0, 1096, 250444, 344, 17.25600230000009
345, 5.011963875229424, 17.118656027912134, 20.686853464098945, 0.5486427999999999, 125.0, 621, 251065, 345, 9.648415799999839
346, 5.982260329379642, 17.142080849967897, 20.71182220801711, 0.5471622999999997, 275.0, 1024, 252089, 346, 15.796614299999874
347, 5.305191864221887, 17.15668354394301, 20.68715250267173, 0.5459067999999999, 35.0, 371, 252460, 347, 5.933707700000014
348, 5.785273492449161, 17.1515444466562, 20.774596670902138, 0.5452759, 65.0, 330, 252790, 348, 5.11313569999993
349, 3.238130064796426, 17.11237284951581, 20.6090082484567, 0.5445279999999999, 135.0, 501, 253291, 349, 8.486222200000157
350, 5.905322986642417, 17.145353597347096, 20.707777210697145, 0.5432067999999999, 235.0, 967, 254258, 350, 15.914046899999903
351, 5.842387565097154, 17.203686647600943, 20.798759290150233, 0.5417820999999998, 80.0, 616, 254874, 351, 9.723902499999895
352, 5.9319278033674925, 17.208058802534172, 20.77235487308329, 0.5405338, 265.0, 771, 255645, 352, 12.085028500000135
353, 4.60545061501006, 17.216549976796664, 20.836637032156005, 0.5392342000000001, 150.0, 673, 256318, 353, 10.713714800000162
354, 6.553735485743909, 17.23158055118152, 20.823967260973795, 0.5380237000000001, 190.0, 672, 256990, 354, 11.378005700000358
355, 4.615931419189312, 17.140176158030947, 20.710622801947125, 0.5368258000000001, 140.0, 659, 257649, 355, 11.027559699999983
356, 3.9668314470571673, 17.11009218564921, 20.627837030669493, 0.5356620999999999, 170.0, 634, 258283, 356, 10.01506879999988
357, 3.8157769759124687, 17.19685539055465, 20.77415189119143, 0.5345136999999999, 45.0, 642, 258925, 357, 10.23587469999984
358, 3.6822567013684164, 17.14010036073882, 20.700160538621724, 0.5330223999999997, 275.0, 1015, 259940, 358, 16.439311199999793
359, 1.7640633316976684, 17.55218912558581, 21.13360381757141, 0.5317686999999999, 60.0, 378, 260318, 359, 6.499344899999869
360, 3.4964290914857066, 17.725820541381836, 21.39218638075894, 0.5307327999999999, 185.0, 773, 261091, 360, 12.945817899999838
361, 5.62934522186132, 17.78432913387523, 21.460779044207406, 0.5297311000000001, 35.0, 340, 261431, 361, 5.8577540999999655
362, 5.434065719031626, 17.748643412413422, 21.421115878776266, 0.5289390999999998, 95.0, 540, 261971, 362, 8.862717200000134
363, 2.051439981483003, 17.7035729951756, 21.32187468005765, 0.5280346, 90.0, 465, 262436, 363, 7.4570849000001544
364, 4.651444420051974, 17.670032262535734, 21.34392226554828, 0.5268106000000002, 270.0, 895, 263331, 364, 14.5099809000003
365, 2.0158862099231007, 17.6908686764269, 21.329080393228185, 0.5256316, 75.0, 415, 263746, 365, 6.827381600000081
366, 6.232866042134273, 17.758423793746765, 21.514162785173898, 0.5248846, 65.0, 415, 264161, 366, 6.91980599999988
367, 5.605416932465317, 17.70829129998929, 21.361075058161656, 0.5237407, 310.0, 856, 265017, 367, 14.204941800000142
368, 4.641602537756662, 17.682038966421082, 21.36336369006978, 0.5221161999999998, 585.0, 949, 265966, 368, 15.666046699999697
369, 7.2127191144950356, 17.731600295611624, 21.37581719086028, 0.5205232, 160.0, 821, 266787, 369, 13.465133400000013
370, 3.4324886588052674, 17.687076057918638, 21.27522276406864, 0.5190615999999998, 255.0, 803, 267590, 370, 13.41778529999965
371, 4.073689385208228, 17.75029158976357, 21.444097225955428, 0.5175009999999999, 205.0, 931, 268521, 371, 15.324843899999905
372, 5.53806472009006, 17.738328976621414, 21.444969555595414, 0.5157829, 280.0, 978, 269499, 372, 15.79471969999986
373, 3.0716608613397605, 17.7116961489807, 21.345866732183172, 0.5144986, 105.0, 449, 269948, 373, 7.37117679999983
374, 2.7862594075890823, 17.63202519056409, 21.23512079272159, 0.5134752999999997, 150.0, 688, 270636, 374, 11.517265799999677
375, 3.6284571366065, 17.733629877515565, 21.366163315857655, 0.5119435, 410.0, 1014, 271650, 375, 17.030985499999588
376, 4.671846278181575, 17.74762668994098, 21.392496737547866, 0.510004, 375.0, 1141, 272791, 376, 19.114360900000065
377, 4.003865966512838, 17.78041063405116, 21.47973158385349, 0.5084784999999999, 120.0, 554, 273345, 377, 9.427389700000276
378, 4.5421312156603, 17.709115688617413, 21.3690412289057, 0.5071375, 310.0, 936, 274281, 378, 15.696192399999745
379, 2.5403762029438486, 17.647993852258697, 21.25416402118962, 0.5057415999999999, 55.0, 615, 274896, 379, 10.175824899999952
380, 6.3700996504804746, 17.70030709485882, 21.46564529999807, 0.5045734000000002, 140.0, 683, 275579, 380, 11.381012800000008
381, 2.3523611668497324, 17.65822878443927, 21.270663963080686, 0.5029165, 675.0, 1158, 276737, 381, 19.083986000000095
382, 5.336031356020205, 17.752747444964168, 21.435633751883437, 0.5013919, 60.0, 536, 277273, 382, 7.914123899999595
383, 4.106933113844168, 17.709970542852826, 21.382169172918196, 0.49990870000000004, 405.0, 1112, 278385, 383, 15.6851343000003
384, 6.4722003755124025, 17.70599960514086, 21.435149454230736, 0.4983202, 140.0, 653, 279038, 384, 11.292760700000144
385, 2.691135035485878, 17.700433050529867, 21.296743942212455, 0.4971637000000001, 105.0, 632, 279670, 385, 11.549557300000288
386, 4.806935685475441, 18.683617928960576, 22.580497870015716, 0.49580560000000024, 265.0, 877, 280547, 386, 15.980341599999974
387, 5.2650054015929655, 19.185432681244567, 23.166949901720713, 0.4942800999999999, 185.0, 818, 281365, 387, 15.255250200000319
388, 4.412097619240988, 19.446704206632326, 23.48487427571867, 0.4931812, 90.0, 403, 281768, 388, 7.997190000000046
389, 4.538165515673948, 19.21779530083955, 23.21090136204701, 0.4919743, 360.0, 938, 282706, 389, 16.845558999999867
390, 3.1904388533978354, 19.246718957434574, 23.195420075712246, 0.4903057000000002, 190.0, 916, 283622, 390, 16.06380590000026
391, 1.8108389449897657, 19.134209390931527, 23.0217566701579, 0.4891159, 85.0, 406, 284028, 391, 7.495988699999998
392, 6.270319469283629, 19.29290361013237, 23.31636345740592, 0.48811419999999967, 200.0, 707, 284735, 392, 12.12146040000016
393, 5.608438945303214, 19.324681242453657, 23.33819211804999, 0.4865023, 320.0, 1084, 285819, 393, 19.1341653999998
394, 3.609815107568803, 19.316127862200858, 23.291880726476567, 0.4848913000000001, 200.0, 706, 286525, 394, 12.0300443000001
395, 5.204328574316364, 19.310559904758122, 23.281734637141838, 0.48319930000000016, 395.0, 1174, 287699, 395, 20.5147436000002
396, 4.389858475243822, 19.28392812274994, 23.221316758324118, 0.48146949999999994, 65.0, 748, 288447, 396, 13.124969999999848
397, 4.701494922464967, 19.2564549044482, 23.265185062589545, 0.48020859999999993, 120.0, 653, 289100, 397, 11.495199800000137
398, 3.4935897338113757, 19.455700328916212, 23.443018447595296, 0.47854450000000004, 415.0, 1196, 290296, 398, 21.245361400000093
399, 6.886773945568021, 19.83000741580117, 23.9483181449999, 0.47608030000000034, 630.0, 1542, 291838, 399, 28.021885999999995
400, 3.536707196479701, 19.91720578986771, 23.99328681400844, 0.47398689999999966, 185.0, 784, 292622, 400, 14.633947400000125
401, 4.242716855465119, 19.78651208841302, 23.884039044833454, 0.4728078999999999, 110.0, 526, 293148, 401, 9.571740000000318
402, 4.666672560701267, 19.823979981511616, 23.91590715083573, 0.4715838999999999, 125.0, 834, 293982, 402, 15.454630599999746
403, 3.034607433115494, 19.891404604174426, 23.930912139079826, 0.4703095, 75.0, 582, 294564, 403, 10.642417399999886
404, 2.1003784679206072, 19.77070109274535, 23.823465870544975, 0.4692771999999999, 100.0, 565, 295129, 404, 10.638232699999662
405, 6.2362602033887145, 19.826118301747094, 23.983431154112093, 0.46801540000000014, 215.0, 837, 295966, 405, 16.148710600000413
406, 4.569571889921641, 19.801133505014274, 23.886358202420748, 0.4663846000000002, 230.0, 975, 296941, 406, 18.127176299999974
407, 2.7315843966142994, 19.852001957885932, 23.897755404158428, 0.4649302, 120.0, 641, 297582, 407, 12.439398800000163
408, 7.577392594334448, 19.75345336255573, 23.9097309140932, 0.4637485000000001, 145.0, 672, 298254, 408, 12.72456340000008
409, 3.6953602504796823, 19.79744138397984, 23.87633000006223, 0.4624993, 160.0, 716, 298970, 409, 13.344926700000087
410, 5.606580063301934, 19.823320922813757, 23.933329853477517, 0.4609468000000001, 295.0, 1009, 299979, 410, 18.840880299999753
411, 4.590318199307295, 19.83188751825677, 23.94890460603913, 0.4594258, 175.0, 681, 300660, 411, 12.947217099999762
412, 2.776251523843569, 19.87416829693225, 23.917269131564353, 0.4582324000000002, 125.0, 645, 301305, 412, 12.367610799999966
413, 4.624546817011868, 19.914053001933063, 24.050133472064008, 0.45680859999999995, 165.0, 937, 302242, 413, 17.64836299999979
414, 3.5091795845196265, 19.9036152495599, 23.959389093135805, 0.4555936000000001, 75.0, 413, 302655, 414, 7.927575000000161
415, 6.596658063357995, 19.98543757332696, 24.215314596670645, 0.45449289999999987, 155.0, 810, 303465, 415, 15.986195899999984
416, 3.992640799316648, 19.808570141333956, 23.824228888217352, 0.45323019999999986, 110.0, 593, 304058, 416, 11.529886600000282
417, 1.872043020760787, 19.885134094775854, 23.89412130960604, 0.4523643999999999, 60.0, 369, 304427, 417, 7.274053800000274
418, 3.1613027682015784, 19.87654316106272, 24.010986643696064, 0.45166239999999985, 30.0, 411, 304838, 418, 8.107520000000022
419, 5.054450612339015, 19.814941435246855, 23.91016568686511, 0.45075969999999993, 140.0, 592, 305430, 419, 11.46291629999996
420, 8.358536749325218, 19.95689223167744, 24.080397844314575, 0.44988850000000014, 55.0, 376, 305806, 420, 7.392769999999928
421, 4.029325211494319, 19.89985567297639, 24.026650703559486, 0.4490722000000001, 155.0, 531, 306337, 421, 10.470313700000133
422, 2.824410072577, 19.96509099731445, 24.02486495361328, 0.44803180000000004, 70.0, 625, 306962, 422, 12.217768100000285
423, 4.25721809768837, 19.84725366511815, 23.902602888099974, 0.4467664000000001, 200.0, 781, 307743, 423, 15.232394199999817
424, 3.8591991518467865, 19.993183417608275, 24.131947747812976, 0.4452589000000001, 255.0, 894, 308637, 424, 17.28346610000017
425, 3.7765170889573634, 19.954097926436596, 24.021828955874103, 0.4435605999999999, 185.0, 993, 309630, 425, 18.93225059999986
426, 3.9235491141676904, 19.867501209093177, 23.928144604226816, 0.44183889999999976, 315.0, 920, 310550, 426, 18.283320699999877
427, 6.53234966599193, 20.06087941972036, 24.290287948101973, 0.4403871999999998, 160.0, 693, 311243, 427, 13.960188099999868
428, 3.8329183287301745, 19.998585172208564, 24.11868069010882, 0.43893729999999975, 345.0, 918, 312161, 428, 18.384364000000005
429, 4.165178171321246, 19.974908741744787, 24.06713612015183, 0.4375783, 15.0, 592, 312753, 429, 11.854817599999933
430, 3.6800381728162654, 19.899543040060582, 23.959699829189763, 0.43673409999999996, 40.0, 346, 313099, 430, 7.129871699999967
431, 2.6265870553440003, 19.966433515452376, 24.034207028916043, 0.43579900000000027, 110.0, 693, 313792, 431, 13.767123500000253
432, 4.262830484290045, 19.975499564183647, 24.11528676770109, 0.4344381999999999, 210.0, 819, 314611, 432, 16.22520039999972
433, 4.169252471969424, 19.99372651113551, 24.089626117714758, 0.43248339999999996, 745.0, 1353, 315964, 433, 26.29341169999998
434, 2.5676774786681764, 20.002343866560196, 24.126906249258255, 0.43048809999999976, 190.0, 864, 316828, 434, 16.92922630000021
435, 3.7170005026459694, 19.970697833469934, 24.10608478818621, 0.4290804999999997, 105.0, 700, 317528, 435, 13.859537499999988
436, 4.2345775506297905, 19.88820124416381, 23.97899835678791, 0.42729670000000003, 400.0, 1282, 318810, 436, 25.669936700000108
437, 5.982844904801252, 19.999601249048723, 24.161868131068196, 0.42486760000000007, 770.0, 1417, 320227, 437, 28.362938600000234
438, 5.090480619008993, 20.182614924183795, 24.41798947050047, 0.4229461000000001, 175.0, 718, 320945, 438, 14.326887700000043
439, 6.343817389389628, 20.244772340463296, 24.437076073810147, 0.42165460000000016, 120.0, 717, 321662, 439, 15.206732899999679
440, 3.6260655685369647, 20.18673532969916, 24.32342735689078, 0.42040629999999996, 185.0, 670, 322332, 440, 13.763333800000055
441, 5.914498364145877, 20.21206041994899, 24.39016370003805, 0.4188106000000001, 465.0, 1103, 323435, 441, 22.55258879999974
442, 4.330556451950811, 20.135032789330733, 24.251335784008628, 0.41713389999999995, 205.0, 760, 324195, 442, 15.900111800000104
443, 6.417865743488074, 20.228480295453753, 24.48301672526768, 0.41581989999999996, 95.0, 700, 324895, 443, 14.803680699999859
444, 5.829012463122607, 20.221983667373657, 24.352393913269044, 0.4142899000000001, 340.0, 1000, 325895, 444, 20.556511099999625
445, 4.190898419076564, 20.21482183469222, 24.3631030857163, 0.4128535, 60.0, 596, 326491, 445, 12.475758599999608
446, 7.317323789270851, 20.275431244051507, 24.577069032001912, 0.41169700000000004, 120.0, 689, 327180, 446, 14.30992040000001
447, 4.884736299045012, 20.191280037776465, 24.33880115743956, 0.41046310000000014, 45.0, 682, 327862, 447, 14.781328600000052
448, 4.501097892101925, 20.18026001105601, 24.311134009734268, 0.40899790000000014, 185.0, 946, 328808, 448, 20.30717370000002
449, 3.220562213083616, 20.23132265144361, 24.3670393615421, 0.4070538999999999, 635.0, 1214, 330022, 449, 26.378459399999883
450, 4.498333510859768, 20.356508999599257, 24.566699115693822, 0.4053249999999998, 125.0, 707, 330729, 450, 15.134322099999736
451, 7.9761981466148475, 20.508181586446643, 24.774090967299063, 0.40397769999999994, 130.0, 790, 331519, 451, 17.485937099999774
452, 2.893296250015409, 20.369575370698286, 24.50544695318098, 0.40265829999999997, 155.0, 676, 332195, 452, 14.787224900000183
453, 5.3490562951576495, 20.266376229306804, 24.362014650595913, 0.4015917999999999, 105.0, 509, 332704, 453, 11.144024799999897
454, 5.531425160554851, 20.441105906788895, 24.632060494771817, 0.4002112, 565.0, 1025, 333729, 454, 22.091470299999855
455, 3.99130621709603, 20.452271665356935, 24.642645604641228, 0.3986614, 110.0, 697, 334426, 455, 15.29223120000006
456, 4.428397005276902, 20.332798640568416, 24.521401593020627, 0.3971331999999999, 185.0, 1001, 335427, 456, 21.638311799999883
457, 7.055614388211828, 20.38457806791273, 24.662292311419947, 0.3952269999999999, 370.0, 1117, 336544, 457, 22.824366800000007
458, 5.076574696536789, 20.41430593615201, 24.5670073403785, 0.3935053000000002, 180.0, 796, 337340, 458, 15.067736700000296
459, 4.997910589394132, 20.512696005465717, 24.73844990024905, 0.3920284000000001, 180.0, 845, 338185, 459, 15.34702359999983
460, 5.9709607795072435, 20.420946210540688, 24.640374709970914, 0.3902878, 420.0, 1089, 339274, 460, 17.966363300000012
461, 6.576065774955594, 20.547634364071875, 24.78752703409422, 0.38859039999999995, 225.0, 797, 340071, 461, 14.832481200000075
462, 1.865905318262395, 20.74929590648031, 24.94743978566137, 0.3875076999999999, 70.0, 406, 340477, 462, 9.228974499999822
463, 5.7966265156090175, 20.720969653590117, 25.031145760421413, 0.38593089999999997, 540.0, 1346, 341823, 463, 30.90254330000016
464, 6.244568405286595, 20.727206234806584, 25.018016794756303, 0.38379519999999995, 280.0, 1027, 342850, 464, 24.648705499999778
465, 2.636507088708102, 20.744549464206305, 24.970448766435897, 0.3821653, 235.0, 784, 343634, 465, 18.587039500000174
466, 3.646871791958018, 20.658610992094058, 24.87709907768047, 0.38044269999999997, 395.0, 1130, 344764, 466, 26.481126099999983
467, 4.487724231145729, 20.771456210412712, 25.011502172981945, 0.3787515999999999, 150.0, 749, 345513, 467, 17.769735200000014
468, 5.0321156659639925, 20.674096568938225, 24.993007822520173, 0.3772962999999998, 150.0, 868, 346381, 468, 14.992108899999948
469, 2.9526790407570926, 20.67912944157918, 24.88727012981068, 0.37592109999999995, 205.0, 660, 347041, 469, 10.646324900000309
470, 2.122138362960971, 20.758947330972422, 24.96693175771962, 0.37491309999999994, 105.0, 460, 347501, 470, 7.261965899999723
471, 5.24671911685479, 20.688387148556735, 24.939252664628416, 0.3734533, 185.0, 1162, 348663, 471, 18.5712639999997
472, 4.827772428906015, 20.733753142031755, 25.013976641676642, 0.3717739, 210.0, 704, 349367, 472, 11.330143200000293
473, 5.824913893072378, 20.801417867342632, 25.177536768572672, 0.3705355, 200.0, 672, 350039, 473, 10.76209229999995
474, 9.961040090443865, 20.743140779832785, 25.093263668800468, 0.36908649999999993, 280.0, 938, 350977, 474, 14.872853899999882
475, 7.90559684500812, 20.80084110591226, 25.11938466568907, 0.36764110000000005, 165.0, 668, 351645, 475, 10.641559499999858
476, 4.896643728883624, 20.692634054644756, 24.914009697940372, 0.3664513, 215.0, 654, 352299, 476, 10.522200899999916
477, 6.560781686429972, 20.76611752403609, 25.094936083962857, 0.36509679999999994, 210.0, 851, 353150, 477, 13.504752800000006
478, 7.603350352556581, 20.725667155138446, 24.998236712104724, 0.36322569999999993, 165.0, 1228, 354378, 478, 19.45913359999986
479, 3.577275400341822, 20.684439598397816, 24.899471613947075, 0.36139959999999993, 290.0, 801, 355179, 479, 12.887289899999814
480, 9.889501008625388, 20.773574305785694, 25.100936183860586, 0.36018009999999984, 125.0, 554, 355733, 480, 8.945282500000303
481, 3.5879903099364157, 20.657344724167935, 24.87606324089898, 0.35889579999999977, 215.0, 873, 356606, 481, 14.147736500000065
482, 3.90604345075524, 20.763908956518126, 24.98250985265377, 0.35775189999999996, 65.0, 398, 357004, 482, 6.4302303999998
483, 4.136126676973633, 20.728611899408087, 24.959486983157085, 0.3565665999999999, 295.0, 919, 357923, 483, 15.433809399999973
484, 10.381298528442652, 20.784564728173205, 25.13615443683661, 0.3546127, 430.0, 1252, 359175, 484, 21.22039219999988
485, 5.616461173780424, 20.76576305020595, 25.03643716946997, 0.3522384999999999, 365.0, 1386, 360561, 485, 23.68687369999998
486, 3.779472597332196, 20.850927568120916, 25.109442427060838, 0.35035299999999997, 115.0, 709, 361270, 486, 12.01863400000002
487, 5.004295214629028, 20.93275351640655, 25.249430405221336, 0.34934589999999993, 90.0, 410, 361680, 487, 7.179675800000041
488, 4.106890009400007, 20.82073647988809, 25.075079203425226, 0.3481443999999999, 235.0, 925, 362605, 488, 15.976423899999645
489, 5.719666991139403, 20.881209802155446, 25.213649326739926, 0.34685739999999976, 110.0, 505, 363110, 489, 8.859960199999477
490, 2.6866157507376065, 20.908158614143492, 25.186333330346162, 0.3455524000000001, 330.0, 945, 364055, 490, 16.209578999999394
491, 3.5778043940167046, 20.85294590901574, 25.165306909197476, 0.34362099999999984, 140.0, 1201, 365256, 491, 20.650128500000392
492, 3.6157733037439233, 20.87836864272655, 25.15711553398492, 0.34217739999999985, 80.0, 403, 365659, 492, 6.878987200000665
493, 3.793343513936171, 20.88287385816042, 25.14233888718128, 0.3408633999999998, 340.0, 1057, 366716, 493, 18.190291400000206
494, 6.392653689990784, 20.961121599920865, 25.365843103343042, 0.33925959999999994, 210.0, 725, 367441, 494, 12.6464004999998
495, 7.504677773694267, 20.868749615195746, 25.266161415126774, 0.33809230000000007, 140.0, 572, 368013, 495, 9.799243299999944
496, 3.880568603012816, 20.931637481960507, 25.248176823838254, 0.33671619999999997, 245.0, 957, 368970, 496, 16.447505099999944
497, 5.80123746375389, 20.807159575294047, 25.14659813712625, 0.3352429, 170.0, 680, 369650, 497, 11.677827099999377
498, 2.652231999549735, 20.873134919940643, 25.104671510098516, 0.33387579999999994, 430.0, 839, 370489, 498, 14.629406400000335
499, 3.567472194351496, 20.857506614760783, 25.119746579721607, 0.3323952999999999, 290.0, 806, 371295, 499, 13.885381900000539
500, 3.6161784607874576, 20.829338418213588, 25.13029628833437, 0.33072309999999977, 250.0, 1052, 372347, 500, 18.10974249999981
501, 2.9814004031746957, 20.797457347520854, 25.04443265997579, 0.32921559999999994, 170.0, 623, 372970, 501, 10.908470500000476
502, 4.577219478919934, 20.955288824874362, 25.230538627538788, 0.3282544, 45.0, 445, 373415, 502, 7.732457600000089
503, 3.919982409819144, 20.84857026191607, 25.158479902842274, 0.3273282999999999, 25.0, 584, 373999, 503, 10.232933799999955
504, 5.472827509098743, 20.852703627778187, 25.23225032790071, 0.3261718, 150.0, 701, 374700, 504, 12.468880500000523
505, 3.649898482015334, 20.88346771638556, 25.146349111554454, 0.32486859999999995, 65.0, 747, 375447, 505, 12.810458100000687
506, 5.3153515395190984, 20.871827676561143, 25.17495565985003, 0.3231433, 550.0, 1170, 376617, 506, 20.41924029999973
507, 4.190532192059859, 20.902756794606606, 25.213403743834007, 0.32151879999999994, 145.0, 635, 377252, 507, 11.082515900000544
508, 1.7829284957735394, 20.85578500249455, 25.116852843352547, 0.32060619999999995, 50.0, 379, 377631, 508, 6.768283899999915
509, 5.733129679630125, 20.889486966814314, 25.209373175828976, 0.31966659999999997, 170.0, 665, 378296, 509, 11.713878499999737
510, 6.640145725916204, 20.84798052026041, 25.225224135056983, 0.3184957, 65.0, 636, 378932, 510, 11.299566900000173
511, 6.326767880707174, 20.943544290903453, 25.342116956968564, 0.3170907999999999, 195.0, 925, 379857, 511, 16.340378800000508
512, 5.636255848127375, 21.199880479243298, 25.595743861624864, 0.31548339999999986, 215.0, 861, 380718, 512, 15.466952400000082
513, 6.195586277900638, 21.2229510113402, 25.666264582757577, 0.31395159999999994, 145.0, 841, 381559, 513, 14.968085299999984
514, 3.9537563196518137, 21.164595549961305, 25.45555429938454, 0.3126222999999999, 110.0, 636, 382195, 514, 11.181311500000447
515, 6.7826497789599705, 21.252009051477806, 25.66999780622303, 0.31120749999999986, 270.0, 936, 383131, 515, 16.403771600000255
516, 3.5785660643435127, 21.17180201212565, 25.498156042518854, 0.30964959999999997, 185.0, 795, 383926, 516, 14.21627989999979
517, 4.6700394535080445, 21.228925382445322, 25.56467292362349, 0.3082527999999999, 140.0, 757, 384683, 517, 13.536000799999783
518, 5.590112663525264, 21.1959869439623, 25.583550708483806, 0.3067579, 295.0, 904, 385587, 518, 16.33286290000069
519, 3.5338864006050583, 21.165883771834835, 25.489847671051727, 0.3051630999999999, 210.0, 868, 386455, 519, 15.490681500000392
520, 3.2149434831599004, 21.217063343192166, 25.538069723470652, 0.3038338, 105.0, 609, 387064, 520, 10.961757000000034
521, 3.2406188998462433, 21.11743617252088, 25.428840630545743, 0.3025125999999999, 195.0, 859, 387923, 521, 15.437043800000538
522, 3.843362683644929, 21.158173567879082, 25.47422547971202, 0.3011068, 125.0, 703, 388626, 522, 12.754253699999936
523, 4.971900077025388, 21.173998234318752, 25.57886626985338, 0.29992329999999995, 165.0, 612, 389238, 523, 11.047568400000273
524, 5.420441658780954, 21.2354099024122, 25.625897059930818, 0.2988910000000001, 145.0, 535, 389773, 524, 9.70884930000011
525, 3.7234417240251285, 21.309032682492496, 25.66479075681498, 0.2973609999999998, 260.0, 1165, 390938, 525, 21.076829999999973
526, 6.117848394463198, 21.320989508113005, 25.73813278127786, 0.2956302999999999, 210.0, 758, 391696, 526, 13.851541600000019
527, 2.931134021526668, 21.2590965539217, 25.56440821290016, 0.2943720999999999, 135.0, 640, 392336, 527, 11.702271199999814
528, 7.391439739702037, 21.34443848580122, 25.76960833929479, 0.29287449999999987, 295.0, 1024, 393360, 528, 18.751128900000367
529, 4.299875629002823, 21.26043696178816, 25.58959362769002, 0.29126529999999995, 135.0, 764, 394124, 529, 13.918126999999913
530, 2.0279867074925164, 21.391106631939227, 25.702319077711838, 0.28999269999999994, 215.0, 650, 394774, 530, 12.28210450000006
531, 5.911764163276544, 21.332607620889533, 25.697235767149003, 0.28849959999999997, 240.0, 1009, 395783, 531, 18.81707860000006
532, 4.330718553157797, 21.363114271283287, 25.746272719625185, 0.2868003999999999, 185.0, 879, 396662, 532, 16.034803900000043
533, 1.8899011996484572, 21.32042991232827, 25.6236245844803, 0.285535, 50.0, 527, 397189, 533, 9.80294799999956
534, 3.664183432417184, 21.3218871787622, 25.719213271262902, 0.2840041000000001, 490.0, 1174, 398363, 534, 21.479639700000007
535, 4.810665246782299, 21.307065846188962, 25.710308906660977, 0.28236339999999993, 75.0, 649, 399012, 535, 11.959046799999669
536, 2.53182562302505, 21.46397369899107, 25.82067639640208, 0.28145889999999985, 35.0, 356, 399368, 536, 6.677791900000557
537, 2.776300219614901, 21.339011664845835, 25.669819039196224, 0.2802429999999999, 225.0, 995, 400363, 537, 18.46819669999968
538, 3.7151730015939552, 21.392092708974157, 25.772517485765633, 0.27832600000000013, 320.0, 1135, 401498, 538, 21.216271499999493
539, 6.316871319000202, 21.396730293957365, 25.825172525437267, 0.2768122, 115.0, 547, 402045, 539, 10.163569399999687
540, 3.8035112092854413, 21.44799227823738, 25.81022474856777, 0.27573040000000004, 130.0, 655, 402700, 540, 12.3967760000005
541, 2.7547476631165906, 21.392606036229566, 25.758060883391988, 0.2745072999999999, 180.0, 704, 403404, 541, 13.205306500000006
542, 4.900347872151758, 21.45957768843478, 25.836558851886384, 0.27347139999999986, 65.0, 447, 403851, 542, 8.537890600000537
543, 6.834081067342391, 21.48220126577753, 25.935693967644468, 0.27260739999999994, 95.0, 513, 404364, 543, 9.500661600000058
544, 2.026592006240994, 21.414577696058487, 25.747150077911968, 0.27140049999999993, 160.0, 828, 405192, 544, 15.488832000000002
545, 5.397182597555937, 21.43343409390541, 25.878038971059155, 0.26967340000000006, 275.0, 1091, 406283, 545, 20.566081899999517
546, 6.328832983611323, 21.517403890731487, 25.968058165421724, 0.268057, 130.0, 705, 406988, 546, 13.601910100000168
547, 5.749251430119637, 21.51053097326431, 25.9156379543, 0.26665569999999994, 230.0, 852, 407840, 547, 16.41279250000025
548, 6.140761419866092, 21.420755744197546, 25.855159144583947, 0.2649006999999998, 525.0, 1098, 408938, 548, 20.850904900000387
549, 6.827354323453532, 21.44340197625988, 25.929637760459308, 0.2634616, 125.0, 501, 409439, 549, 9.699838699999418
550, 2.581042259878027, 21.44746990089645, 25.800973241200705, 0.2622592, 125.0, 835, 410274, 550, 15.869996499999615
551, 5.945623133730128, 21.73890998432175, 26.294366471561386, 0.2610703, 120.0, 486, 410760, 551, 9.592882500000087
552, 1.9668958479711287, 21.611596062069847, 25.938140969527396, 0.2602738, 50.0, 399, 411159, 552, 7.72997899999973
553, 2.172019534036924, 21.646648370503076, 26.01763451685671, 0.25958529999999996, 40.0, 366, 411525, 553, 7.019992800000182
554, 6.881712804064154, 21.64696883201599, 26.14593626158578, 0.25799589999999983, 430.0, 1400, 412925, 554, 26.76422839999941
555, 4.176528793653685, 21.6435514438652, 26.055293218342367, 0.2562849999999999, 80.0, 501, 413426, 555, 9.75222550000035
556, 5.50926356676915, 21.673932433454958, 26.15306606031444, 0.2555056, 45.0, 365, 413791, 556, 6.9558875000002445
557, 3.1902155010863695, 21.656098123806625, 26.09534562879534, 0.25421229999999995, 260.0, 1072, 414863, 557, 20.54340560000037
558, 4.49685488031206, 21.696527562589726, 26.11639387342665, 0.25272099999999986, 90.0, 585, 415448, 558, 10.997382800000196
559, 4.841302614081962, 21.763673182542338, 26.242410277612578, 0.2512242999999999, 195.0, 1078, 416526, 559, 20.841876700000284
560, 1.7918057178550544, 21.68132949257917, 26.079022994015943, 0.2499174999999999, 30.0, 374, 416900, 560, 7.2406245000001945
561, 4.018590124661544, 21.715380918750885, 26.16025207291788, 0.2487367, 195.0, 938, 417838, 561, 18.12178969999968
562, 1.9883612093780745, 21.560101272543168, 25.914653095813083, 0.24754779999999993, 70.0, 383, 418221, 562, 7.502587699999822
563, 3.208215446724807, 21.642787156855395, 26.075261515893306, 0.24631659999999997, 200.0, 985, 419206, 563, 19.284245900000315
564, 5.958061037882601, 21.9008785362845, 26.42002276707545, 0.24411699999999986, 365.0, 1459, 420665, 564, 28.232950499999788
565, 4.408079029152417, 22.056503428200077, 26.562421938357787, 0.2418696999999999, 230.0, 1038, 421703, 565, 20.287704200000007
566, 6.036768948032961, 22.040797925257422, 26.61669311313839, 0.24011649999999993, 190.0, 910, 422613, 566, 17.834809799999675
567, 5.451887815102433, 22.003292760343843, 26.56614814103128, 0.2381760999999998, 355.0, 1246, 423859, 567, 24.322752900000523
568, 4.26639731597251, 22.047668237407404, 26.558961087776773, 0.23603859999999996, 375.0, 1129, 424988, 568, 22.31861740000022
569, 2.109240602152597, 22.054544880946263, 26.51745293798779, 0.23435110000000003, 215.0, 746, 425734, 569, 14.944325200000094
570, 6.313594497246307, 22.07886659769722, 26.65016438289242, 0.23302809999999985, 190.0, 724, 426458, 570, 14.398160499999904
571, 5.3457828776726135, 21.99077792845207, 26.51286376513361, 0.23170509999999997, 165.0, 746, 427204, 571, 14.823898200000258
572, 6.93137205405814, 22.084769481174067, 26.6240428644154, 0.23044599999999993, 135.0, 653, 427857, 572, 12.905044000000089
573, 5.388647896555548, 21.97083035486187, 26.52995598958638, 0.22925709999999985, 45.0, 668, 428525, 573, 13.387713899999653
574, 6.794306525599587, 22.076478399232375, 26.623650706091592, 0.22807539999999998, 130.0, 645, 429170, 574, 12.855012699999861
575, 5.827054984537939, 22.227269280315188, 26.75798809399878, 0.2259081999999999, 475.0, 1763, 430933, 575, 35.1862086000001
576, 3.052229587910236, 22.404150260799472, 26.96037599314814, 0.22372119999999995, 100.0, 667, 431600, 576, 13.547975100000258
577, 3.9372987942082998, 22.27320383788508, 26.824666338259192, 0.22232799999999997, 135.0, 881, 432481, 577, 17.69886829999996
578, 7.1340284206756825, 22.337819869925337, 26.985739856231504, 0.22094470000000005, 125.0, 656, 433137, 578, 13.213830700000472
579, 2.8684220640343687, 22.285408255618442, 26.793237320227004, 0.2196694, 205.0, 761, 433898, 579, 15.312393900000643
580, 3.91693464694801, 22.242193211109267, 26.77382602166692, 0.2181996999999999, 260.0, 872, 434770, 580, 17.704963700000008
581, 3.452053224131317, 22.289577542551307, 26.831334347756492, 0.21632769999999993, 400.0, 1208, 435978, 581, 24.287356000000727
582, 2.630898756250867, 22.35205399017989, 26.92129372322508, 0.21440169999999995, 275.0, 932, 436910, 582, 18.879959699999745
583, 5.368611449629881, 22.383927098820717, 26.975945471186506, 0.21300219999999997, 105.0, 623, 437533, 583, 12.905465799999547
584, 6.975742753683811, 22.381837243125553, 26.98813602280995, 0.2119878999999999, 50.0, 504, 438037, 584, 10.444778699999915
585, 2.0336409933213653, 22.342817587930647, 26.855641187865878, 0.2108754999999999, 120.0, 732, 438769, 585, 14.952015100000608
586, 5.0452040515603525, 22.332813968355694, 26.96452689095149, 0.20964969999999994, 85.0, 630, 439399, 586, 12.87373639999987
587, 4.185655198978284, 22.239897112450745, 26.78626742467089, 0.20805219999999994, 370.0, 1145, 440544, 587, 23.204065900000387
588, 4.043598727886543, 22.134100933282593, 26.694751600084558, 0.20644299999999993, 200.0, 643, 441187, 588, 13.29678689999946
589, 3.2954032344510185, 22.1334211978766, 26.60587577136886, 0.20551239999999993, 30.0, 391, 441578, 589, 8.077126099999987
590, 5.112948943932826, 22.114526591693373, 26.7030428365579, 0.20443869999999992, 190.0, 802, 442380, 590, 16.418106299999636
591, 5.126156476699514, 22.06285414773129, 26.6316467373261, 0.2022750999999999, 545.0, 1602, 443982, 591, 32.68940720000046
592, 3.820336332510715, 22.076472218638134, 26.55288775133869, 0.2002410999999999, 100.0, 658, 444640, 592, 13.577611099999558
593, 3.5836279255102625, 22.134009728064903, 26.644403798239573, 0.19932129999999992, 80.0, 364, 445004, 593, 7.4102656999994
594, 4.5159394246519815, 22.165621736705702, 26.71182397868009, 0.19792089999999998, 350.0, 1192, 446196, 594, 24.575454200000422
595, 5.257036733030821, 22.05765813837637, 26.6063568514346, 0.1956609999999999, 405.0, 1319, 447515, 595, 27.33030729999973
596, 2.9361608752719937, 22.131635296228264, 26.661357920022276, 0.19392129999999994, 115.0, 614, 448129, 596, 12.958818500000234
597, 3.4560045931931764, 22.057460891632807, 26.569269972755794, 0.19261269999999994, 195.0, 840, 448969, 597, 17.703612799999974
598, 2.8174323493357583, 22.069131231814488, 26.549156553647588, 0.19126359999999995, 105.0, 659, 449628, 598, 13.918149199999789
599, 5.095639782433195, 22.041556861013028, 26.577684111195833, 0.18957429999999995, 300.0, 1218, 450846, 599, 25.43178739999985
600, 5.671961252618095, 22.038348568349644, 26.64474533468053, 0.18785709999999994, 130.0, 690, 451536, 600, 14.496717900000476
601, 2.9260447808447805, 22.043685953120242, 26.516051942976876, 0.18663579999999994, 170.0, 667, 452203, 601, 14.233976800000164
602, 5.498390478485849, 22.036670564550214, 26.552056118450334, 0.1852219, 230.0, 904, 453107, 602, 19.091329299999416
603, 3.6394019139791296, 21.990774009366444, 26.523661388915002, 0.18375849999999994, 165.0, 722, 453829, 603, 15.157096899999488
604, 3.8353223852688374, 21.96147887444807, 26.435584890553848, 0.18214209999999992, 275.0, 1074, 454903, 604, 22.67153529999996
605, 2.577212724157022, 22.03771409266349, 26.51171630251724, 0.18026019999999995, 190.0, 1017, 455920, 605, 21.59537249999994
606, 3.0622862313777723, 22.010019025583375, 26.481004616309857, 0.17871849999999992, 170.0, 696, 456616, 606, 14.864301599999635
607, 6.008475338182455, 22.109751582893555, 26.68746806567107, 0.17737479999999997, 125.0, 797, 457413, 607, 16.960468799999944
608, 2.767841508022484, 21.974672278133006, 26.44278622767247, 0.17587269999999994, 125.0, 872, 458285, 608, 18.63521469999978
609, 3.1569950905768285, 21.998647493221014, 26.435212383649663, 0.17409249999999993, 515.0, 1106, 459391, 609, 23.559297800000422
610, 4.202729534090454, 21.70003797668002, 26.18540048732562, 0.1721313999999999, 320.0, 1073, 460464, 610, 22.98831969999992
611, 3.7971106286500103, 21.33484701115023, 25.680416387635226, 0.1697211999999999, 405.0, 1605, 462069, 611, 34.53986259999965
612, 4.082354726443802, 21.18764377237724, 25.54342745213954, 0.16788160000000002, 85.0, 439, 462508, 612, 9.397520800000166
613, 4.624268286124943, 21.314142934191906, 25.660527039642762, 0.1665225999999999, 515.0, 1071, 463579, 613, 23.230564699999377
614, 3.8566028324180635, 21.34055724136833, 25.67436224838783, 0.16495839999999995, 80.0, 667, 464246, 614, 14.537278900000274
615, 2.9538008968999137, 21.300405564948694, 25.598328906386644, 0.1637550999999999, 95.0, 670, 464916, 615, 14.671147000000019
616, 5.535933733894028, 21.25300028101243, 25.602456111745862, 0.16283439999999996, 50.0, 353, 465269, 616, 7.64311859999998
617, 3.7495355025460624, 21.253074535215745, 25.560659336321283, 0.16216029999999992, 55.0, 396, 465665, 617, 8.901204700000562
618, 6.183546448114541, 21.306233684983138, 25.67440327465306, 0.16109919999999994, 155.0, 783, 466448, 618, 17.370125799999187
619, 4.611751289958422, 21.302145547026477, 25.632048718661384, 0.15928119999999993, 370.0, 1237, 467685, 619, 26.888777799999843
620, 1.9460275916697718, 21.312017321940345, 25.596912831156473, 0.15756129999999993, 95.0, 674, 468359, 620, 14.70396030000029
621, 3.1836718034966545, 21.343098835391892, 25.681768197820112, 0.15597729999999993, 195.0, 1086, 469445, 621, 23.742125200000373
622, 1.9301808505312892, 21.25744865430112, 25.590676121364368, 0.15445629999999988, 70.0, 604, 470049, 622, 13.251634199999899
623, 4.237519996679702, 20.96996189530488, 25.294170365465167, 0.15306489999999998, 285.0, 942, 470991, 623, 20.589115499999934
624, 4.711588342641589, 20.90603270918824, 25.200058576672575, 0.15159789999999998, 70.0, 688, 471679, 624, 15.219214199999442
625, 4.169782629706592, 20.984328433360638, 25.26107223209686, 0.15011199999999997, 215.0, 963, 472642, 625, 20.995805000000473
626, 4.18564078935309, 20.9063516675097, 25.169940883910527, 0.1481553999999999, 495.0, 1211, 473853, 626, 27.370888800000102
627, 5.10550982396711, 20.940371193823875, 25.22076982275232, 0.14671899999999993, 35.0, 385, 474238, 627, 8.941263000000617
628, 3.920289212894176, 20.91609670068945, 25.1900272566454, 0.14515299999999992, 220.0, 1355, 475593, 628, 30.40384240000003
629, 3.473657330034308, 20.92479358236474, 25.17282221307716, 0.14303709999999994, 260.0, 996, 476589, 629, 22.134332300000096
630, 4.27840295086463, 20.953717533391885, 25.26268877388951, 0.14157729999999988, 110.0, 626, 477215, 630, 14.324598199999855
631, 3.5500054826848526, 20.93870301997705, 25.185718732002453, 0.13953969999999996, 575.0, 1638, 478853, 631, 36.36718100000053
632, 5.658125117712024, 20.988428406522505, 25.302334531566945, 0.13710879999999986, 255.0, 1063, 479916, 632, 23.905319499999678
633, 5.31750680317194, 21.142800734653946, 25.514056114322884, 0.1350630999999999, 425.0, 1210, 481126, 633, 27.052513500000714
634, 3.8479729751043523, 21.167536029315205, 25.50919461597854, 0.1333566999999999, 165.0, 686, 481812, 634, 15.411432299999433
635, 2.599522970043696, 21.1645474419227, 25.461143687321588, 0.13186179999999995, 215.0, 975, 482787, 635, 22.297990000000027
636, 5.336275156376212, 21.121219694855725, 25.443874044456944, 0.1300950999999999, 195.0, 988, 483775, 636, 22.20070990000022
637, 3.971701999442882, 21.182381316051043, 25.464647778924906, 0.12834729999999994, 230.0, 954, 484729, 637, 21.48007719999987
638, 5.997343908450628, 21.17600638757252, 25.54831250132979, 0.12687939999999995, 185.0, 677, 485406, 638, 15.395133500000156
639, 3.6833713600507116, 21.15117245266773, 25.478590087605593, 0.12554739999999995, 415.0, 803, 486209, 639, 18.401574900000014
640, 6.652777775246874, 21.18451457138521, 25.54165333150381, 0.12422709999999995, 190.0, 664, 486873, 640, 14.92908019999959
641, 5.000149580010889, 21.19276224865633, 25.482978928322886, 0.12326229999999995, 55.0, 408, 487281, 641, 9.268775400000777
642, 2.874424258145613, 21.13278122549412, 25.42041438083594, 0.12226689999999991, 120.0, 698, 487979, 642, 16.041129100000035
643, 3.929758561070813, 21.16421779537815, 25.467155828537365, 0.12066039999999992, 250.0, 1087, 489066, 643, 24.542587199999616
644, 4.658530715115816, 21.186014057469453, 25.50240714137209, 0.11917269999999996, 120.0, 566, 489632, 644, 13.0024370000001
645, 4.919456600161947, 21.565845245640027, 25.954660602900535, 0.11748069999999988, 490.0, 1314, 490946, 645, 29.905875999999807
646, 2.841853764442367, 21.558926719096604, 25.943460216485747, 0.11582739999999993, 50.0, 523, 491469, 646, 11.881829700000708
647, 2.3518766579400823, 21.66585654370925, 26.009783202526616, 0.11498949999999988, 65.0, 408, 491877, 647, 9.400986800000283
648, 4.59059024322778, 21.697856947298973, 26.136532068252563, 0.11372949999999993, 290.0, 992, 492869, 648, 22.576391600000534
649, 6.29878076097034, 21.65420506217263, 26.107285185110037, 0.11166849999999996, 250.0, 1298, 494167, 649, 30.085524799999803
650, 5.298859941709728, 21.62426897618159, 26.117747891011664, 0.11015649999999996, 60.0, 382, 494549, 650, 8.896378899999945
651, 4.41700665141835, 21.7095029215428, 26.139767838240118, 0.10885329999999994, 285.0, 1066, 495615, 651, 24.20066609999958
652, 5.5253415030389155, 21.658398731410156, 26.168196402098005, 0.10727829999999995, 335.0, 684, 496299, 652, 15.834119399999508
653, 4.424592324705745, 21.75165958290133, 26.204227109188285, 0.10561239999999994, 265.0, 1167, 497466, 653, 26.803470500000003
654, 2.863026696310374, 21.665614513535573, 26.047322374551406, 0.10386729999999991, 205.0, 772, 498238, 654, 17.80193849999978
655, 4.563480587808789, 21.746975078846265, 26.214782118923985, 0.10232559999999993, 160.0, 941, 499179, 655, 21.741456200000357
656, 3.9825142839707826, 21.72508117876555, 26.162088460420307, 0.10063934294736758, 160.0, 950, 500129, 656, 22.16664860000037
657, 4.4584386217556276, 21.616389713678892, 26.017093470136206, 0.09999999999999849, 185.0, 1023, 501152, 657, 23.974662900000112
658, 2.6902405625503314, 21.568399670249537, 25.98275683697005, 0.10000000000000074, 75.0, 665, 501817, 658, 15.884288999999626
659, 4.907160173645515, 21.688617326068982, 26.155168376273735, 0.09999999999999895, 225.0, 923, 502740, 659, 21.71393949999947
660, 6.462772747762543, 21.667113605907232, 26.12461628014881, 0.09999999999999903, 165.0, 907, 503647, 660, 21.643841500000235
661, 3.5635246674251406, 21.681761667531006, 26.09881034170746, 0.09999999999999977, 210.0, 785, 504432, 661, 18.54497910000009
662, 2.316313015910728, 21.66806702966787, 26.078304706014293, 0.10000000000000052, 70.0, 689, 505121, 662, 16.21231389999957
663, 3.310595013025239, 21.617173893245187, 26.02525287913525, 0.09999999999999852, 265.0, 1016, 506137, 663, 23.799637099999927
664, 3.511957587334164, 21.55787989882777, 25.96603102724382, 0.09999999999999949, 280.0, 827, 506964, 664, 19.542365400000563
665, 5.714367245440814, 21.709451896609462, 26.123714146052023, 0.10000000000000091, 25.0, 526, 507490, 665, 12.38743549999981
666, 6.233475796632444, 21.66520908406072, 26.217046618068178, 0.10000000000000098, 115.0, 606, 508096, 666, 14.208878399999776
667, 5.744366222149077, 21.612235519121278, 26.022350275291586, 0.10000000000000091, 75.0, 530, 508626, 667, 12.68430410000019
668, 4.496082273131452, 21.661660312329435, 26.086958700401063, 0.09999999999999848, 395.0, 1027, 509653, 668, 24.26150030000008
669, 4.047032335610102, 21.707960916650475, 26.13506088123299, 0.09999999999999931, 265.0, 857, 510510, 669, 20.393584699999337
670, 1.8362443002874225, 21.740664795797656, 26.08658705957678, 0.10000000000000082, 110.0, 453, 510963, 670, 10.905560100000002
671, 3.3790765538268412, 21.724435832103094, 26.110594499111176, 0.09999999999999877, 145.0, 960, 511923, 671, 23.019408699999985
672, 7.041036542868936, 21.80914291195514, 26.322941637897248, 0.09999999999999981, 195.0, 778, 512701, 672, 18.5484847000007
673, 5.671501093790248, 21.78985422307795, 26.249777379069293, 0.1000000000000003, 275.0, 715, 513416, 673, 17.177946800000427
674, 3.8254609174919216, 21.711007303471188, 26.12231108576274, 0.0999999999999974, 535.0, 1390, 514806, 674, 33.211366100000305
675, 6.70632652240099, 21.898364492468595, 26.330902296179925, 0.10000000000000099, 65.0, 621, 515427, 675, 15.0525047000001
676, 4.506680407099083, 21.782159506264378, 26.21229829742025, 0.09999999999999691, 395.0, 1652, 517079, 676, 39.5797149
677, 4.882380421907409, 21.669671698915007, 26.08929959597162, 0.10000000000000078, 80.0, 426, 517505, 677, 10.38292790000014
678, 4.68534766148364, 21.73262799804534, 26.212351250289075, 0.09999999999999969, 215.0, 796, 518301, 678, 21.092239199999312
679, 3.919656427007758, 21.642850650254115, 26.09647077862202, 0.10000000000000088, 125.0, 651, 518952, 679, 18.43016390000048
680, 2.0428887283604387, 21.712090124138776, 26.09664618240561, 0.10000000000000069, 225.0, 671, 519623, 680, 25.878218700000616
681, 1.8848215104756403, 21.569980707355572, 25.902945122064327, 0.1000000000000009, 70.0, 510, 520133, 681, 15.519598899999437
682, 4.4673534754131525, 21.49654658037917, 25.94659888475461, 0.10000000000000091, 15.0, 532, 520665, 682, 15.732956599999852
683, 4.716058579280146, 21.475480048449587, 25.934343156231247, 0.1000000000000004, 120.0, 703, 521368, 683, 18.157527800000025
684, 2.1504797093333416, 21.464518819869586, 25.83493021006689, 0.10000000000000075, 35.0, 409, 521777, 684, 10.59975519999989
685, 6.065088236235854, 21.50392208542935, 25.986526156580727, 0.09999999999999884, 170.0, 946, 522723, 685, 24.260452200000145
686, 3.480582312963627, 21.495034620496963, 25.91488742357419, 0.0999999999999996, 130.0, 810, 523533, 686, 21.637324600000284
687, 2.963470612787249, 21.44969838785838, 25.797936680805254, 0.10000000000000075, 140.0, 664, 524197, 687, 16.870422599999984
688, 2.6450231915395785, 21.48946436689647, 25.844219576135725, 0.09999999999999891, 195.0, 932, 525129, 688, 23.879939899999954
689, 3.3511850340836844, 21.404039635924896, 25.778845267426053, 0.09999999999999988, 225.0, 769, 525898, 689, 19.715626999999586
690, 5.7929995490677575, 21.59660213627619, 26.063417627570335, 0.10000000000000092, 115.0, 534, 526432, 690, 13.700234199999613
691, 4.307603819699387, 21.52313642976372, 25.89094847775577, 0.10000000000000099, 90.0, 623, 527055, 691, 16.068455799999356
692, 5.231342803651068, 21.52901646809807, 25.916757856810456, 0.09999999999999805, 275.0, 1145, 528200, 692, 29.39225179999994
693, 1.9478307217772317, 21.51488296212912, 25.84265433652249, 0.10000000000000067, 75.0, 361, 528561, 693, 9.297785699999622
694, 5.06999682526676, 21.579542665350125, 25.999155871170768, 0.10000000000000087, 110.0, 653, 529214, 694, 18.595574799999667
695, 5.238553870469332, 21.521545317616425, 25.92948108477734, 0.1000000000000007, 70.0, 371, 529585, 695, 11.168059300000095
696, 4.221952013457455, 21.641256576121837, 26.057252945526844, 0.0999999999999974, 580.0, 1393, 530978, 696, 40.60055310000007
697, 5.081662395167205, 21.727078814395146, 26.18969543041191, 0.09999999999999908, 255.0, 899, 531877, 697, 26.38212620000013
698, 4.347561365234501, 21.719178779452456, 26.15402784534529, 0.1000000000000009, 85.0, 510, 532387, 698, 15.07744890000049
699, 4.300866311276599, 21.59447074165271, 26.0263557141207, 0.09999999999999842, 220.0, 1042, 533429, 699, 30.593781099999433
700, 4.0399564331666395, 21.630376186225885, 26.022472551410026, 0.09999999999999896, 295.0, 921, 534350, 700, 26.743478500000492
701, 5.4786552091678695, 21.670074113953394, 26.14850841296588, 0.1000000000000002, 115.0, 727, 535077, 701, 21.118741000000227
702, 3.061096685567877, 21.614034480474466, 25.99990976933253, 0.0999999999999979, 195.0, 1196, 536273, 702, 35.26725200000055
703, 3.4882891118320454, 21.654324397073914, 26.071318681778447, 0.09999999999999826, 265.0, 1085, 537358, 703, 31.872331999999915
704, 4.260828852454512, 21.671072529857945, 26.058963699814697, 0.09999999999999963, 135.0, 805, 538163, 704, 23.78253769999992
705, 2.9894943565965812, 21.713880429439772, 26.119573139857863, 0.10000000000000003, 240.0, 749, 538912, 705, 22.270559999999932
706, 3.360075979177602, 21.660273721918404, 26.075702215022076, 0.0999999999999967, 670.0, 1801, 540713, 706, 53.10973230000036
707, 2.698957773587428, 21.697994041267723, 26.092816252134828, 0.09999999999999824, 195.0, 1089, 541802, 707, 32.36543950000032
708, 2.974485750293879, 21.62495942725692, 26.039803629697754, 0.10000000000000053, 145.0, 688, 542490, 708, 20.782516600000235
709, 2.9847541397939157, 21.684616673472497, 26.09958886952592, 0.10000000000000094, 210.0, 646, 543136, 709, 19.597586600000795
710, 4.793948173488258, 21.710857747960567, 26.176603304964082, 0.0999999999999974, 265.0, 1396, 544532, 710, 42.161263599999984
711, 5.65426652588617, 21.671480145435854, 26.097367028781875, 0.09999999999999848, 260.0, 1028, 545560, 711, 31.063666100000773
712, 4.899590579447096, 21.789387608716588, 26.2848846327045, 0.10000000000000071, 115.0, 668, 546228, 712, 20.435268799999903
713, 3.117158682304383, 21.696922023989973, 26.10704311179953, 0.09999999999999794, 400.0, 1179, 547407, 713, 36.03819180000028
714, 7.997761075954648, 21.73525439351068, 26.177309888805496, 0.10000000000000098, 20.0, 613, 548020, 714, 18.889138500000627
715, 3.515477394497261, 21.731556442279743, 26.13294089092858, 0.09999999999999964, 185.0, 803, 548823, 715, 24.770262199999706
716, 5.027392260886938, 21.71484850203137, 26.15321695321817, 0.09999999999999766, 345.0, 1284, 550107, 716, 39.90820259999964
717, 7.362781105163013, 21.70010481104755, 26.20007689847242, 0.09999999999999791, 260.0, 1192, 551299, 717, 37.713553199999296
718, 4.412934692024257, 21.68172115667321, 26.085803730293005, 0.09999999999999766, 810.0, 1285, 552584, 718, 39.88876370000071
719, 3.8129053816157823, 21.714883556113776, 26.12869618415169, 0.0999999999999973, 360.0, 1437, 554021, 719, 44.63521219999893
720, 3.513703035672086, 21.70323668888637, 26.095909548425055, 0.0999999999999971, 665.0, 1540, 555561, 720, 47.50999689999844
721, 3.6353026088693046, 21.673221611976622, 26.10693609203611, 0.09999999999999813, 560.0, 1120, 556681, 721, 34.763050499999736
722, 5.724549275485502, 21.709445079858753, 26.243791209787563, 0.10000000000000064, 55.0, 345, 557026, 722, 11.13867239999854
723, 3.99152823863551, 21.691377889278325, 26.070617833802867, 0.10000000000000053, 190.0, 688, 557714, 723, 21.375625199998467
724, 6.028992289323976, 21.758573624470042, 26.249174239656636, 0.09999999999999777, 360.0, 1239, 558953, 724, 38.1148718000004
725, 4.394707777492657, 21.773869104929513, 26.206866115421146, 0.09999999999999754, 305.0, 1332, 560285, 725, 41.08168739999928
726, 5.9873327275290835, 21.898949144658, 26.436237756671066, 0.09999999999999913, 210.0, 887, 561172, 726, 27.44714380000005
727, 2.9526705411557534, 21.996731784675696, 26.46180703368368, 0.09999999999999973, 200.0, 790, 561962, 727, 24.33507490000011
728, 3.6575161170648047, 21.905381419671276, 26.33785693859928, 0.09999999999999998, 240.0, 756, 562718, 728, 23.8103701
729, 5.048435464294739, 21.876623438760202, 26.372350654543272, 0.10000000000000091, 170.0, 649, 563367, 729, 20.178841799999645
730, 4.382893287489633, 21.87715240176633, 26.30268467759057, 0.09999999999999816, 720.0, 1112, 564479, 730, 34.38790849999896
731, 5.724862371946591, 21.892509399635205, 26.370141703840616, 0.10000000000000052, 100.0, 690, 565169, 731, 21.521213399999397
732, 3.048013045301393, 21.856949506992535, 26.26371284319776, 0.10000000000000092, 130.0, 647, 565816, 732, 20.33623499999885
733, 4.791058316813396, 21.9096526652843, 26.397519958771028, 0.09999999999999817, 235.0, 1110, 566926, 733, 35.145254699998986
734, 4.859514940010154, 21.87216424557027, 26.38327504194319, 0.09999999999999926, 290.0, 867, 567793, 734, 27.203668299998753
735, 3.750152461091286, 21.91810937327117, 26.404152273544536, 0.09999999999999853, 260.0, 1015, 568808, 735, 31.892550599999595
736, 4.290758917386013, 21.91019903487688, 26.391452299422745, 0.09999999999999809, 285.0, 1133, 569941, 736, 35.416602900000726
737, 6.137896041255893, 21.68670546738574, 26.144412969306405, 0.09999999999999745, 715.0, 1369, 571310, 737, 43.447580399999424
738, 3.561086522834205, 21.591564615829522, 25.987743341355095, 0.09999999999999747, 690.0, 1365, 572675, 738, 43.231671800000186
739, 2.180643698323093, 21.557543883867712, 25.897419411063993, 0.10000000000000006, 185.0, 745, 573420, 739, 23.645574099999067
740, 3.8436364645164134, 21.64569306849701, 26.040027117399575, 0.10000000000000088, 140.0, 651, 574071, 740, 23.69898640000065
741, 9.459611746212884, 21.72242542950075, 26.293679237365723, 0.1000000000000007, 165.0, 670, 574741, 741, 25.884851899998466
742, 3.833204457658959, 21.588880206101116, 25.976921137348363, 0.09999999999999878, 300.0, 957, 575698, 742, 27.590021899999556
743, 2.652529778426412, 21.613126494995733, 26.015344016037854, 0.09999999999999971, 205.0, 793, 576491, 743, 22.719944600001327
744, 2.8185579860238956, 21.635893663857768, 26.030372922299826, 0.10000000000000017, 50.0, 731, 577222, 744, 20.439958099999785
745, 5.273766420781612, 21.55591192699614, 26.011136357746427, 0.10000000000000071, 25.0, 378, 577600, 745, 10.728956400000243
746, 3.453625231571905, 21.5768495287214, 25.941766063983625, 0.10000000000000082, 40.0, 455, 578055, 746, 12.736949699999968
747, 2.919725845244623, 21.60724405596333, 25.98521955920804, 0.09999999999999984, 225.0, 775, 578830, 747, 22.2257099999988
748, 3.448757258930292, 21.63323264609612, 26.018403875242033, 0.09999999999999999, 225.0, 753, 579583, 748, 21.20590639999864
749, 4.504137297048585, 21.83652143070206, 26.316810090254254, 0.09999999999999848, 485.0, 1028, 580611, 749, 28.550212800000736
750, 2.8725446090317033, 22.021995168243723, 26.498181498174436, 0.09999999999999926, 215.0, 867, 581478, 750, 24.86992459999965
751, 3.7251569281895787, 21.951704324877824, 26.45802832345594, 0.099999999999998, 300.0, 1165, 582643, 751, 32.88655010000002
752, 4.82281889493472, 21.983814691380694, 26.494298015415833, 0.10000000000000021, 230.0, 726, 583369, 752, 20.686639200001082
753, 5.83214391297656, 21.959866789680458, 26.502018477505146, 0.09999999999999869, 270.0, 979, 584348, 753, 27.654753900000287
754, 5.2653703134582965, 21.967002389382344, 26.45267003653001, 0.09999999999999977, 130.0, 784, 585132, 754, 22.42465110000012
755, 5.996801348839035, 21.99678516268581, 26.553074065675126, 0.09999999999999701, 405.0, 1598, 586730, 755, 45.958631100000275
756, 4.470174936277559, 21.934607488724886, 26.422825223039787, 0.09999999999999978, 190.0, 782, 587512, 756, 22.7301652999995
757, 3.6313857831929357, 21.996717703415573, 26.445763891021166, 0.09999999999999956, 210.0, 815, 588327, 757, 23.614560500000152
758, 3.4669439732434526, 22.01805579144022, 26.46482903715493, 0.09999999999999948, 255.0, 828, 589155, 758, 23.710529900001347
759, 5.359225862171678, 21.925207978203183, 26.461775456786786, 0.09999999999999998, 135.0, 756, 589911, 759, 21.871010700000625
760, 3.183064002654028, 21.974457744818984, 26.414205107265197, 0.10000000000000035, 145.0, 709, 590620, 760, 20.74081809999916
761, 2.809499794073851, 21.937838694566075, 26.42426905812559, 0.09999999999999908, 370.0, 898, 591518, 761, 25.93381650000083
762, 6.6143841106346795, 21.961205990047045, 26.43601989973701, 0.09999999999999942, 200.0, 838, 592356, 762, 24.37167849999969
763, 3.9823788910893336, 21.946962734438337, 26.425124426307917, 0.0999999999999988, 180.0, 954, 593310, 763, 27.7050947000007
764, 3.9814182128511075, 22.021891776685674, 26.539702068866614, 0.09999999999999902, 350.0, 908, 594218, 764, 27.174501199999213
765, 2.961346137749291, 21.97824508175142, 26.44752185598485, 0.10000000000000073, 115.0, 667, 594885, 765, 20.722890499999266
766, 5.870392771316468, 21.926876772524096, 26.448898519606168, 0.09999999999999813, 165.0, 1121, 596006, 766, 32.85884729999998
767, 3.0340843927200725, 21.91799347547351, 26.361784909601273, 0.09999999999999824, 270.0, 1089, 597095, 767, 31.993447999999262
768, 2.6367715061706907, 22.0083783219258, 26.503962316446835, 0.09999999999999803, 300.0, 1152, 598247, 768, 33.77638499999921
769, 4.450712193203091, 21.957794843469177, 26.486235513948742, 0.09999999999999964, 385.0, 802, 599049, 769, 26.744288800000504
770, 7.181667580271915, 22.025493324647208, 26.597271541022714, 0.10000000000000038, 125.0, 706, 599755, 770, 25.14417930000127
771, 6.953950988305759, 21.962391701713553, 26.49646598980994, 0.09999999999999834, 640.0, 1063, 600818, 771, 36.675681700000496
772, 2.40074160003327, 21.882345329557612, 26.31005554914068, 0.10000000000000096, 165.0, 587, 601405, 772, 17.33370030000151
773, 7.377450723607821, 21.872348103029974, 26.374271387341377, 0.10000000000000046, 185.0, 696, 602101, 773, 20.59349999999904
774, 3.7386662360642493, 21.85032058046461, 26.289534224359098, 0.09999999999999797, 500.0, 1174, 603275, 774, 34.91884980000032
775, 5.559577968869413, 21.879994432719513, 26.362735502311594, 0.09999999999999884, 320.0, 946, 604221, 775, 28.32125400000041
776, 5.860026371690622, 21.974900072795027, 26.51962147450519, 0.10000000000000078, 95.0, 662, 604883, 776, 20.570751299999756
777, 3.300410739728557, 21.82736707928942, 26.24270818604643, 0.09999999999999715, 805.0, 1516, 606399, 777, 47.321116999999504
778, 5.28148805813603, 21.83721404122219, 26.304147478035297, 0.10000000000000098, 155.0, 614, 607013, 778, 19.029350399998293
779, 4.920973659401723, 21.877725984535964, 26.335297056272918, 0.10000000000000075, 40.0, 408, 607421, 779, 12.383894799999325
780, 2.9124337529251494, 21.829903936818287, 26.28855080618959, 0.10000000000000078, 145.0, 662, 608083, 780, 20.267368900000292
781, 3.2801042660927715, 21.957229208974848, 26.411580132693945, 0.09999999999999945, 220.0, 833, 608916, 781, 25.67376560000048
782, 3.360174213522646, 21.923374673502558, 26.354920320584956, 0.09999999999999906, 395.0, 901, 609817, 782, 27.661301500000263
783, 2.0911770196856967, 22.43309426034332, 26.961725494967904, 0.09999999999999977, 155.0, 785, 610602, 783, 23.986487399999532
784, 4.369703609010591, 22.65334355694607, 27.284379870040826, 0.09999999999999809, 265.0, 1135, 611737, 784, 35.11069640000096
785, 5.110649254791234, 22.638635060143848, 27.315461217927037, 0.10000000000000049, 190.0, 693, 612430, 785, 21.1428606999998
786, 3.044606901731592, 22.53895352501751, 27.102619693473034, 0.10000000000000095, 155.0, 566, 612996, 786, 17.19752030000018
787, 5.7612216317973965, 22.727634255239895, 27.36093212555502, 0.09999999999999831, 345.0, 1070, 614066, 787, 32.626043300000674
788, 4.07681013936464, 22.609727841403643, 27.21244668470541, 0.0999999999999977, 270.0, 1265, 615331, 788, 39.497817499999655
789, 4.584901196805743, 22.643949368774702, 27.257472823470923, 0.09999999999999769, 365.0, 1268, 616599, 789, 38.66818190000049
790, 3.1103630849901966, 22.724696924586496, 27.32435269841177, 0.10000000000000071, 85.0, 668, 617267, 790, 20.580890600000203
791, 2.9067698922229726, 22.664760078117745, 27.284497438680226, 0.09999999999999996, 240.0, 757, 618024, 791, 23.936982299999727
792, 5.65234834207713, 22.65662096254335, 27.301011358693074, 0.09999999999999874, 255.0, 967, 618991, 792, 31.984810699999798
793, 4.0100200948313, 22.685472966015823, 27.312815770094957, 0.10000000000000098, 30.0, 615, 619606, 793, 23.692101800001183
794, 4.155088281406387, 22.37210551987557, 26.917419977450024, 0.09999999999999777, 155.0, 1238, 620844, 794, 52.964600499999506
795, 4.65475314341937, 22.28159041476972, 26.813793435241237, 0.09999999999999837, 285.0, 1056, 621900, 795, 43.32500170000094
796, 5.117512508740162, 22.320950256811606, 26.929903045430915, 0.09999999999999913, 355.0, 888, 622788, 796, 35.60538690000067
797, 4.7261272729266475, 22.313459194698567, 26.89478925728375, 0.09999999999999724, 580.0, 1466, 624254, 797, 52.51193409999905
798, 2.964808092263272, 22.196188584518953, 26.66988824529505, 0.10000000000000014, 220.0, 733, 624987, 798, 25.87691939999968
799, 4.643577570227238, 22.295319048522433, 26.822248779019983, 0.09999999999999709, 835.0, 1543, 626530, 799, 56.77376429999822
800, 8.251264189955819, 22.350711857761095, 26.959882431533863, 0.09999999999999715, 630.0, 1515, 628045, 800, 71.95708290000039
801, 3.0573171710010865, 22.307352096668996, 26.77255276032608, 0.10000000000000056, 120.0, 685, 628730, 801, 32.52870989999974
802, 3.666884521017601, 22.302818481643477, 26.832940287404245, 0.10000000000000071, 30.0, 385, 629115, 802, 18.003020500000275
803, 3.822965492140239, 22.23306946612673, 26.74597048274415, 0.100000000000001, 105.0, 639, 629754, 803, 30.248286399999415
804, 4.902078832706118, 22.601946327286928, 27.23243823269297, 0.09999999999999794, 390.0, 1182, 630936, 804, 56.63169129999915
805, 4.590414654523191, 22.63193005006486, 27.24021564608274, 0.09999999999999706, 600.0, 1561, 632497, 805, 73.71013539999876
806, 6.1251614110483334, 22.6393803637334, 27.232805230455373, 0.0999999999999997, 415.0, 794, 633291, 806, 38.78118450000147
807, 5.956213410587415, 22.75418643122134, 27.437027372830155, 0.10000000000000052, 130.0, 690, 633981, 807, 33.7444370000012
808, 5.562657219832843, 22.74221846280936, 27.41530072654702, 0.10000000000000048, 145.0, 694, 634675, 808, 33.02133630000026
809, 4.818673569175679, 22.648773795453646, 27.34004988342423, 0.09999999999999913, 320.0, 887, 635562, 809, 41.88798010000028
810, 4.623177311298966, 22.5958372618549, 27.189440555997475, 0.09999999999999992, 200.0, 763, 636325, 810, 37.26971250000133
811, 8.421955017433442, 22.783101589648755, 27.486922657334958, 0.10000000000000098, 140.0, 616, 636941, 811, 30.46779770000103
812, 3.772740225377743, 22.678179182032103, 27.23274834438037, 0.1000000000000007, 50.0, 372, 637313, 812, 17.824322599999505
813, 5.2968467386928575, 22.667316115503287, 27.299230322597513, 0.09999999999999999, 180.0, 754, 638067, 813, 36.9544836999994
814, 5.418778402247369, 22.682594849658106, 27.31609014779997, 0.09999999999999995, 165.0, 759, 638826, 814, 39.12397080000119
815, 3.4740155630405414, 22.641356902002, 27.214534239648483, 0.10000000000000094, 95.0, 554, 639380, 815, 28.996365500001048
816, 3.5034437534437015, 22.56266894919335, 27.193376845431466, 0.09999999999999926, 335.0, 865, 640245, 816, 43.517560199999934
817, 3.7536244387022317, 22.708636100762416, 27.328917043505285, 0.09999999999999803, 455.0, 1151, 641396, 817, 58.496467900000425
818, 4.921830066213449, 22.77588507267062, 27.41150370668535, 0.10000000000000078, 170.0, 661, 642057, 818, 34.79840630000035
819, 4.342235766812516, 22.751055826612976, 27.403054636370175, 0.10000000000000091, 105.0, 533, 642590, 819, 28.114386100000047
820, 8.366090527211112, 22.773541344536675, 27.516397490811986, 0.10000000000000091, 35.0, 522, 643112, 820, 27.027201799999602
821, 2.153144711282272, 22.654645901136902, 27.200985630431052, 0.1000000000000009, 70.0, 511, 643623, 821, 26.371011400000498
822, 6.967939249078531, 22.775328606132447, 27.45639447715339, 0.09999999999999852, 300.0, 1016, 644639, 822, 53.942461900000126
823, 5.188466012679738, 22.744166019514864, 27.38115831666392, 0.09999999999999959, 100.0, 812, 645451, 823, 43.273084200000085
824, 6.203854632878303, 22.716963458251954, 27.441182623291017, 0.10000000000000099, 115.0, 625, 646076, 824, 32.81752499999857
825, 6.801500054214604, 22.726177601941018, 27.35482511161993, 0.09999999999999824, 250.0, 1091, 647167, 825, 56.70518110000012
826, 2.962177712707887, 22.735169359062553, 27.357778475746496, 0.09999999999999946, 175.0, 831, 647998, 826, 43.608670800000255
827, 7.154633774370505, 22.8021025561196, 27.497032841570878, 0.09999999999999808, 275.0, 1137, 649135, 827, 60.511814100000265
828, 6.3648532787888135, 22.71440444629093, 27.361862670931828, 0.09999999999999899, 180.0, 914, 650049, 828, 42.79946249999921
829, 4.09959056859708, 22.897045551911564, 27.567674135979804, 0.10000000000000085, 105.0, 655, 650704, 829, 30.132669599999645
830, 4.125469607681981, 22.868269100412103, 27.518492343628743, 0.10000000000000098, 50.0, 599, 651303, 830, 33.913543599999684
831, 10.427425804964745, 22.996675012915173, 27.81519620695167, 0.09999999999999905, 65.0, 905, 652208, 831, 50.09569689999989
832, 3.925499793017792, 22.862859622759256, 27.486679968047078, 0.09999999999999817, 365.0, 1109, 653317, 832, 58.99294540000119
833, 3.8237436795111996, 22.916343744582214, 27.561936123293425, 0.09999999999999798, 310.0, 1166, 654483, 833, 61.554007400000046
834, 5.6277571819056345, 23.02941637892064, 27.723351228527907, 0.09999999999999866, 305.0, 984, 655467, 834, 53.427444099999775
835, 3.886820614770815, 22.93558540738268, 27.592526317027556, 0.09999999999999709, 925.0, 1549, 657016, 835, 83.7122169000013
836, 4.00522504796321, 22.872842378894592, 27.54412789686289, 0.1000000000000007, 135.0, 377, 657393, 836, 20.488475500000277
837, 3.568147252348743, 22.836228082248443, 27.504143333856106, 0.10000000000000082, 65.0, 453, 657846, 837, 26.34993779999968
838, 3.9520232899655747, 22.991652175153913, 27.67751216498111, 0.10000000000000014, 460.0, 733, 658579, 838, 41.42684670000017
839, 3.819314052040915, 22.892134261728877, 27.550842360988607, 0.09999999999999801, 275.0, 1157, 659736, 839, 64.28712040000028
840, 4.658942961208381, 23.132874702772714, 27.924275583187438, 0.10000000000000091, 105.0, 526, 660262, 840, 29.028172000000268
841, 7.361850205359967, 23.300127784125237, 28.13219762191498, 0.09999999999999816, 285.0, 1112, 661374, 841, 59.609465499999715
842, 6.685028339497102, 23.322392372002806, 28.11448481912301, 0.09999999999999855, 430.0, 1009, 662383, 842, 54.628083999999944
843, 7.189168420690981, 23.373664949237916, 28.184269081518302, 0.09999999999999983, 240.0, 777, 663160, 843, 29.143739400000413
844, 6.362283748779761, 23.29419359379569, 28.059877260930122, 0.10000000000000035, 115.0, 708, 663868, 844, 42.29886880000049
845, 8.767204580078264, 23.43599492418981, 28.279965265002662, 0.0999999999999986, 260.0, 998, 664866, 845, 56.25803369999994
846, 3.4219626624211554, 23.20863729614633, 27.971650338942005, 0.10000000000000088, 155.0, 651, 665517, 846, 35.86261210000157
847, 3.335548104751392, 23.311030487572182, 28.01202716865013, 0.1000000000000009, 95.0, 507, 666024, 847, 28.49765700000171
848, 5.392260389010373, 23.259739634237793, 27.97422821270792, 0.10000000000000098, 30.0, 608, 666632, 848, 33.96367570000075
849, 5.730706550042389, 23.20585517832641, 27.920518789000088, 0.09999999999999999, 165.0, 753, 667385, 849, 40.76165430000037
850, 8.040634650937706, 23.318026506928707, 28.08489037676773, 0.09999999999999933, 510.0, 854, 668239, 850, 47.79107079999994
851, 5.592565097139741, 23.25909390966168, 27.946420405304877, 0.10000000000000094, 125.0, 563, 668802, 851, 28.05555259999892
852, 4.978073198924283, 23.2867170490893, 28.008675803142378, 0.0999999999999986, 195.0, 996, 669798, 852, 31.261046699999497
853, 5.636842871425512, 23.47278714467244, 28.327284801437195, 0.099999999999999, 430.0, 913, 670711, 853, 26.89145069999904
854, 4.693210503079419, 23.53181673265853, 28.337880042813858, 0.09999999999999835, 410.0, 1060, 671771, 854, 31.205189899999823
855, 7.737660682793652, 23.658097503049177, 28.558978483994466, 0.09999999999999884, 185.0, 946, 672717, 855, 27.74404239999967
856, 3.9470113824439954, 23.51128462779371, 28.25366473137578, 0.09999999999999973, 165.0, 790, 673507, 856, 23.45385989999886
857, 5.303643904696991, 23.540098340967067, 28.383509387337202, 0.10000000000000099, 130.0, 633, 674140, 857, 18.719568999998955
858, 5.083909586507737, 23.49950494643795, 28.315793291818398, 0.10000000000000042, 120.0, 701, 674841, 858, 20.611796700000923
859, 10.412305829975441, 23.683110297787888, 28.64419706116499, 0.10000000000000073, 80.0, 393, 675234, 859, 12.465644699999757
860, 5.328438805046625, 23.547676923935445, 28.404093792958438, 0.09999999999999852, 250.0, 1018, 676252, 860, 32.591083099998286
861, 4.192740201173747, 23.567955055733666, 28.3496119089306, 0.1000000000000005, 140.0, 691, 676943, 861, 22.406117300000915
862, 5.383652208495171, 23.511382005346103, 28.35236285552578, 0.09999999999999992, 265.0, 762, 677705, 862, 24.564978000000337
863, 3.9492435400777515, 23.552755987161415, 28.344011892039457, 0.09999999999999766, 195.0, 1284, 678989, 863, 43.908246100001634
864, 3.344302215382033, 23.447033888035268, 28.217658312860024, 0.0999999999999996, 125.0, 809, 679798, 864, 27.819221199999447
865, 6.230994827053495, 23.43153374458368, 28.2371824016512, 0.09999999999999654, 635.0, 1938, 681736, 865, 65.24341319999985
866, 3.9723557537285292, 23.43356281251136, 28.211007168418483, 0.09999999999999706, 350.0, 1558, 683294, 866, 53.095122900000206
867, 5.359053879569384, 23.502690972633733, 28.26097490255115, 0.0999999999999995, 195.0, 824, 684118, 867, 29.495131199999378
868, 3.7996975873004306, 23.462462672320278, 28.269644459811126, 0.10000000000000081, 180.0, 440, 684558, 868, 15.43772799999897
869, 4.2820194245296594, 23.49968345998374, 28.25641767836615, 0.10000000000000099, 110.0, 621, 685179, 869, 21.609674199999063
870, 5.594838905615834, 23.52407994250205, 28.38734631196356, 0.09999999999999883, 230.0, 948, 686127, 870, 32.46720280000045
871, 6.68260255957512, 23.481056932282215, 28.257409232382315, 0.10000000000000027, 160.0, 719, 686846, 871, 25.613869600001635
872, 4.047019290558355, 23.45739450199862, 28.209040578742904, 0.09999999999999733, 365.0, 1422, 688268, 872, 49.96344299999873
873, 4.026152967720309, 23.406909280529966, 28.11665609586382, 0.10000000000000003, 80.0, 749, 689017, 873, 26.14541100000133
874, 3.078721965632454, 23.467828318872563, 28.198530128227663, 0.09999999999999887, 245.0, 941, 689958, 874, 34.95916750000106
875, 2.3084673057021114, 23.762085120223574, 28.5306790451932, 0.10000000000000084, 30.0, 467, 690425, 875, 17.0012540000007
876, 7.070763271489374, 23.774762723527445, 28.753351994443467, 0.10000000000000088, 50.0, 497, 690922, 876, 17.384335799999462
877, 2.785737191140652, 23.709670509830598, 28.516600779051423, 0.09999999999999891, 220.0, 930, 691852, 877, 30.393627900000865
878, 5.618080724210388, 23.780130523459494, 28.654767531932105, 0.0999999999999982, 285.0, 1099, 692951, 878, 39.382392499999696
879, 5.925344379375548, 23.788614735599467, 28.635309525649912, 0.09999999999999779, 260.0, 1233, 694184, 879, 44.111124400000335
880, 4.8434295465174895, 23.746338944543492, 28.555572173812173, 0.1000000000000004, 140.0, 704, 694888, 880, 25.195967100000416
881, 6.527207998509075, 23.85615375335204, 28.73138256633983, 0.10000000000000003, 160.0, 748, 695636, 881, 27.025487999999314
882, 6.998389382483068, 23.830344118504534, 28.68800324736657, 0.09999999999999878, 225.0, 958, 696594, 882, 30.717100399999254
883, 2.615926545133088, 23.72702092896722, 28.509814487528104, 0.09999999999999999, 150.0, 754, 697348, 883, 23.58384289999958
884, 3.863333599081881, 23.74915353864232, 28.57295562429789, 0.09999999999999908, 185.0, 898, 698246, 884, 27.905257300000812
885, 6.071118056999914, 23.848136615003934, 28.69568804431577, 0.09999999999999912, 220.0, 891, 699137, 885, 28.202153399999588
886, 5.783880030341221, 23.835691763725116, 28.666435344910724, 0.09999999999999895, 175.0, 924, 700061, 886, 28.630199899998843
887, 3.450892641861738, 23.656831478074736, 28.459506108733233, 0.09999999999999812, 215.0, 1123, 701184, 887, 41.87116799999967
888, 3.6477730887911086, 23.659657180969127, 28.450469975981765, 0.09999999999999826, 285.0, 1084, 702268, 888, 45.60941930000081
889, 4.47154174937488, 23.660131188976024, 28.468977575337057, 0.10000000000000092, 135.0, 546, 702814, 889, 20.588709200001176
890, 4.5937105930370326, 23.657179979785727, 28.499300119476203, 0.09999999999999755, 290.0, 1327, 704141, 890, 47.00156059999972
891, 4.081915155042616, 23.638529252197785, 28.460569672665354, 0.10000000000000035, 125.0, 708, 704849, 891, 24.78717879999931
892, 2.2329002926469603, 23.626422349469554, 28.374986266687873, 0.09999999999999883, 285.0, 949, 705798, 892, 38.73429740000029
893, 2.3661667229623786, 23.558262724538746, 28.335042871135915, 0.10000000000000095, 80.0, 579, 706377, 893, 21.53126770000017
894, 6.2876178509129685, 23.694888775165264, 28.58561348625523, 0.10000000000000088, 110.0, 494, 706871, 894, 18.33379590000004
895, 2.74652428555895, 23.615596923828125, 28.40817786130038, 0.0999999999999982, 285.0, 1100, 707971, 895, 45.04305150000073
896, 5.078165013228525, 23.666074023997794, 28.52023133227232, 0.0999999999999983, 380.0, 1073, 709044, 896, 40.87852480000038
897, 6.347193125955474, 23.662267364139314, 28.487448587713992, 0.09999999999999823, 565.0, 1094, 710138, 897, 40.27527900000132
898, 2.6640493098908746, 23.31356884593695, 28.049898867539955, 0.10000000000000066, 90.0, 355, 710493, 898, 13.377948900000774
899, 4.94739335848296, 23.390717939011594, 28.19233873245564, 0.09999999999999795, 290.0, 1175, 711668, 899, 43.599109799999496
900, 4.605789056043152, 23.280133002416747, 28.00877197484423, 0.09999999999999964, 315.0, 802, 712470, 900, 30.147405900001104
901, 5.334490917915223, 23.361591105367623, 28.139258665197037, 0.10000000000000098, 90.0, 612, 713082, 901, 23.067127600001186
902, 4.692045170439934, 23.44348679135777, 28.212737741436154, 0.09999999999999815, 295.0, 1116, 714198, 902, 41.82180730000073
903, 4.947282947090263, 23.404055227893394, 28.174068094448316, 0.09999999999999844, 535.0, 1038, 715236, 903, 41.397393700000976
904, 4.898878563424458, 23.347311640429176, 28.047418108229515, 0.10000000000000073, 135.0, 667, 715903, 904, 26.48909570000069
905, 4.426868673922303, 23.46438024467397, 28.22447926530214, 0.09999999999999831, 390.0, 1070, 716973, 905, 39.6148833999996
906, 5.255576043364567, 23.309436598339595, 28.047304146998638, 0.10000000000000096, 125.0, 592, 717565, 906, 22.489018999998734
907, 4.985291703914602, 23.418018544626516, 28.223347248389707, 0.10000000000000057, 130.0, 684, 718249, 907, 25.89969849999943
908, 6.082534245034536, 23.32984901022065, 28.076079464157836, 0.09999999999999878, 270.0, 958, 719207, 908, 35.79384819999905
909, 7.145233181803179, 23.423884275697965, 28.269384760334972, 0.10000000000000091, 215.0, 649, 719856, 909, 24.2888583999993
910, 4.543507107027181, 23.623823975071762, 28.402428757910634, 0.10000000000000094, 80.0, 561, 720417, 910, 20.795325999999477
911, 5.110483149417809, 23.730410483224052, 28.54523095539638, 0.10000000000000042, 120.0, 700, 721117, 911, 26.770300000000134
912, 3.214426972163827, 23.653816523117246, 28.437400576300146, 0.0999999999999973, 650.0, 1437, 722554, 912, 55.170888900000136
913, 4.819638892473845, 23.671915925124598, 28.5009228515625, 0.10000000000000021, 245.0, 725, 723279, 913, 27.721266700000342
914, 5.479260757593382, 23.682772847706687, 28.538005202116366, 0.09999999999999752, 395.0, 1336, 724615, 914, 51.34230319999915
915, 4.048000879781415, 23.68502054696131, 28.4594189403033, 0.09999999999999863, 455.0, 990, 725605, 915, 37.612411500000235
916, 5.808018427072799, 23.619288937334872, 28.47900923135209, 0.10000000000000095, 110.0, 567, 726172, 916, 22.57609810000031
917, 2.870504040512946, 23.634227504977932, 28.392480798426316, 0.09999999999999937, 225.0, 847, 727019, 917, 32.24248240000088
918, 6.046444561117103, 23.70541253506331, 28.565134430870067, 0.09999999999999958, 210.0, 813, 727832, 918, 31.287811399999555
919, 3.473632769727585, 23.720849730043994, 28.541920296026735, 0.09999999999999869, 365.0, 980, 728812, 919, 36.942384399999355
920, 2.165531029117604, 23.617055951224433, 28.389239740371703, 0.10000000000000067, 15.0, 360, 729172, 920, 13.73418909999964
921, 4.171613207586368, 23.677276743699323, 28.512382324812414, 0.09999999999999881, 145.0, 951, 730123, 921, 36.90976219999902
922, 4.626869084473462, 23.714052880129547, 28.587538336122464, 0.09999999999999827, 360.0, 1083, 731206, 922, 41.745923599999514
923, 11.182706808399224, 23.81269308049628, 28.73622927023164, 0.10000000000000038, 135.0, 705, 731911, 923, 27.305337799998597
924, 6.495740610620624, 23.726602415725022, 28.607449009069246, 0.09999999999999926, 220.0, 867, 732778, 924, 33.41656240000157
925, 6.7875680513408065, 23.74791225795328, 28.546307431520336, 0.10000000000000056, 135.0, 685, 733463, 925, 26.262431099999958
926, 3.9828683716849875, 23.762555810594066, 28.53500592831484, 0.10000000000000073, 35.0, 388, 733851, 926, 15.256172000001243
927, 5.186679386736979, 23.692584585527808, 28.540209939197464, 0.09999999999999812, 265.0, 1123, 734974, 927, 43.515143499998885
928, 2.1561310200686665, 23.64678153116434, 28.401304616982806, 0.10000000000000091, 135.0, 523, 735497, 928, 20.18814939999902
929, 5.205302968795333, 23.80427556023048, 28.692398715984783, 0.10000000000000098, 55.0, 642, 736139, 929, 25.348147200000312
930, 6.452348766851979, 23.79672852322544, 28.675132090950374, 0.09999999999999837, 275.0, 1054, 737193, 930, 40.84782970000015
931, 4.780311375729623, 23.705402568996888, 28.53248751725202, 0.09999999999999991, 240.0, 764, 737957, 931, 30.176508399999875
932, 5.425176726235438, 23.662887144458388, 28.499496381104148, 0.10000000000000073, 100.0, 387, 738344, 932, 14.720903999999791
933, 4.000658198932807, 23.67810654703776, 28.534740290323892, 0.1000000000000007, 30.0, 375, 738719, 933, 14.788591799999267
934, 5.424399812283191, 23.7267988714747, 28.533043492148064, 0.09999999999999788, 480.0, 1201, 739920, 934, 57.178805499999726
935, 4.382920392402067, 23.659100769624718, 28.500408817985118, 0.09999999999999772, 345.0, 1259, 741179, 935, 47.168928799999776
936, 5.139010621816677, 23.6596751391264, 28.463022517160095, 0.10000000000000071, 160.0, 669, 741848, 936, 22.162403899999845
937, 3.5853382701797956, 23.73322014084132, 28.487655033071135, 0.10000000000000095, 85.0, 566, 742414, 937, 18.890553799999907
938, 2.978944237451477, 23.75756071406379, 28.547487070563772, 0.10000000000000027, 135.0, 719, 743133, 938, 24.083038300001135
939, 4.61420880949072, 23.649452990711396, 28.449817239871617, 0.09999999999999958, 255.0, 813, 743946, 939, 26.759204100000716
940, 2.3083008162913816, 23.67494457487076, 28.4226293311548, 0.10000000000000071, 75.0, 378, 744324, 940, 12.588815400000385
941, 3.6241239147508852, 23.570486954122988, 28.371253683899255, 0.09999999999999762, 680.0, 1299, 745623, 941, 43.206745199999204
942, 4.319954354199059, 23.716697282320716, 28.513127607080435, 0.09999999999999912, 190.0, 892, 746515, 942, 31.419302000000243
943, 6.397304897885147, 23.689402015976427, 28.59560483824698, 0.09999999999999926, 210.0, 867, 747382, 943, 32.08432189999985
944, 2.013362405112102, 23.576266447703045, 28.309014016106016, 0.10000000000000078, 30.0, 420, 747802, 944, 15.026949299999615
945, 4.735829148129619, 23.66847927875537, 28.49029487044451, 0.09999999999999844, 270.0, 1039, 748841, 945, 38.20152370000142
946, 4.679059364706048, 23.587439968530806, 28.374018017001507, 0.09999999999999981, 135.0, 778, 749619, 946, 28.64154150000104
947, 3.282147719692593, 23.753522740513827, 28.579941713317368, 0.10000000000000098, 120.0, 605, 750224, 947, 22.276100600000063
948, 5.9681000842447975, 23.983200268700628, 28.946772227625274, 0.09999999999999797, 205.0, 1171, 751395, 948, 42.84099680000145
949, 4.048854253270981, 23.977175453494738, 28.87829125685499, 0.10000000000000049, 55.0, 692, 752087, 949, 25.54023110000162
950, 4.346904692377929, 23.966743087000236, 28.881828077610166, 0.09999999999999862, 255.0, 993, 753080, 950, 36.29842910000116
951, 4.547852914349861, 23.88394498375227, 28.771060021418446, 0.09999999999999935, 140.0, 848, 753928, 951, 31.415272999998706
952, 6.310124497980583, 23.948939785936872, 28.885144399471038, 0.09999999999999891, 185.0, 932, 754860, 952, 34.21688820000054
953, 5.4371500916216515, 23.95737536625796, 28.794256583567943, 0.10000000000000091, 110.0, 649, 755509, 953, 23.963806200001272
954, 6.110790830323609, 23.984147855712145, 28.866371982853586, 0.09999999999999953, 230.0, 820, 756329, 954, 30.440524900001037
955, 6.602066242905696, 24.044352495008045, 29.063972352279556, 0.09999999999999803, 250.0, 1152, 757481, 955, 42.780697000000146
956, 5.074552282824246, 23.911445856449678, 28.745569442316956, 0.10000000000000069, 185.0, 671, 758152, 956, 25.507834000000003
957, 6.856309043587178, 23.88348590348118, 28.756047427746676, 0.10000000000000095, 80.0, 645, 758797, 957, 23.698058100000708
958, 6.28345634497612, 24.018751279000313, 29.01288635500016, 0.09999999999999863, 300.0, 992, 759789, 958, 36.909698900000876
959, 3.5816578698518695, 23.844059323677158, 28.677865926522557, 0.0999999999999991, 255.0, 893, 760682, 959, 33.14371680000113
960, 3.6569823825465377, 23.817358198895047, 28.647714115290096, 0.09999999999999756, 770.0, 1321, 762003, 960, 49.32962010000119
961, 5.74089608725626, 23.83860685924689, 28.747005358338356, 0.10000000000000071, 25.0, 384, 762387, 961, 14.147662699999273
962, 8.286523810980086, 23.71602820857243, 28.708438079794558, 0.10000000000000073, 45.0, 387, 762774, 962, 14.614823799998703
963, 7.044064664307855, 23.8413943181466, 28.78704353308899, 0.10000000000000094, 115.0, 646, 763420, 963, 24.108391899999333
964, 5.318172575954405, 23.819470119062576, 28.69396125106646, 0.09999999999999665, 480.0, 1844, 765264, 964, 68.24225970000043
965, 3.774749603161055, 23.732099822804898, 28.573026600037675, 0.09999999999999924, 185.0, 869, 766133, 965, 32.9364244999997
966, 3.0071096134020574, 23.764411141369134, 28.586291685287378, 0.09999999999999888, 185.0, 938, 767071, 966, 34.743160199997874
967, 10.278457920389675, 23.884186964335402, 28.86177265737939, 0.09999999999999852, 235.0, 1016, 768087, 967, 38.252727799997956
968, 5.1317556864763585, 23.77922279729783, 28.661929058578778, 0.10000000000000099, 125.0, 636, 768723, 968, 24.0535318000002
969, 3.363508075244667, 23.690268059663996, 28.527072802994603, 0.10000000000000095, 170.0, 645, 769368, 969, 24.275472600002104
970, 3.2390698463076335, 23.794984598075395, 28.656341533041985, 0.10000000000000063, 50.0, 678, 770046, 970, 25.316809600000852
971, 4.838357895571667, 24.669526831396574, 29.701222611524514, 0.09999999999999824, 225.0, 1089, 771135, 971, 40.99494330000016
972, 3.0689709986534726, 24.55616070496712, 29.544068218357975, 0.10000000000000078, 210.0, 662, 771797, 972, 25.107040800001414
973, 7.144014868720858, 24.697386964122103, 29.763426510112133, 0.09999999999999971, 150.0, 793, 772590, 973, 30.095323100002133
974, 4.605537694110137, 24.636464660036495, 29.682520683621547, 0.10000000000000091, 125.0, 527, 773117, 974, 19.641129400002683
975, 6.82459379020323, 24.709249652456172, 29.788561411329972, 0.09999999999999727, 290.0, 1455, 774572, 975, 55.138449000001856
976, 4.0397299418936266, 24.72320449817646, 29.710960969552623, 0.10000000000000074, 115.0, 666, 775238, 976, 25.326177099999768
977, 6.044067927775664, 24.665344955588782, 29.715994258755867, 0.099999999999998, 335.0, 1162, 776400, 977, 43.9519876000013
978, 2.086912066983214, 24.60487248382206, 29.55254408639287, 0.0999999999999994, 290.0, 842, 777242, 978, 32.14874820000114
979, 5.75757302277523, 24.720040989555216, 29.80374503610504, 0.09999999999999691, 815.0, 1657, 778899, 979, 62.76516320000155
980, 5.602475909016353, 24.62565597437196, 29.63432350535851, 0.10000000000000035, 170.0, 708, 779607, 980, 26.945997999999236
981, 4.9480301998592005, 25.04659750961676, 30.16050462304092, 0.09999999999999849, 225.0, 1025, 780632, 981, 39.81481780000104
982, 4.420524450961974, 25.272517394517266, 30.41320017123395, 0.09999999999999715, 575.0, 1519, 782151, 982, 58.51620129999719
983, 2.513691468939761, 25.180797776098075, 30.287778341377923, 0.10000000000000044, 150.0, 699, 782850, 983, 26.92483279999942
984, 4.821161571177387, 25.247971288316112, 30.41855773511958, 0.09999999999999853, 395.0, 1014, 783864, 984, 38.595639400002256
985, 5.956072978062547, 25.29422476522162, 30.470232329155287, 0.10000000000000049, 115.0, 693, 784557, 985, 26.367689300001075
986, 3.3793648869724446, 25.25025543823741, 30.36972644282322, 0.09999999999999781, 440.0, 1224, 785781, 986, 47.12618750000183
987, 7.294425332768516, 25.356360556670975, 30.652905073218584, 0.09999999999999905, 305.0, 905, 786686, 987, 34.99101740000333
988, 5.785997881002141, 25.24195136848133, 30.393102412069997, 0.09999999999999826, 230.0, 1085, 787771, 988, 44.27474380000058
989, 4.20127981549834, 25.304380865535276, 30.425915780683056, 0.09999999999999899, 300.0, 914, 788685, 989, 35.516651699999784
990, 3.998343038815151, 25.27318880486726, 30.384050995012455, 0.09999999999999787, 190.0, 1204, 789889, 990, 46.42306540000209
991, 4.114891614990595, 24.98054187664619, 30.05771519770989, 0.09999999999999842, 315.0, 1040, 790929, 991, 40.65938710000046
992, 5.875017167412136, 24.96542108602691, 30.098184076944985, 0.09999999999999806, 310.0, 1140, 792069, 992, 44.08314160000009
993, 4.161052645369349, 24.91528488699682, 29.98814048212729, 0.0999999999999982, 275.0, 1101, 793170, 993, 42.555800800000725
994, 4.610340563417004, 24.928727976959152, 29.991632425695435, 0.09999999999999967, 340.0, 798, 793968, 994, 31.22105179999926
995, 5.771247194815587, 24.965142432612556, 30.10996647007001, 0.10000000000000098, 160.0, 606, 794574, 995, 23.858249299999443
996, 4.126947835293767, 24.87848532300411, 29.928390252668386, 0.09999999999999833, 525.0, 1067, 795641, 996, 41.270127600000706
997, 3.6801363655601067, 24.875503990977716, 29.942639835345478, 0.09999999999999887, 280.0, 939, 796580, 997, 36.670684799999435
998, 3.1155667583532543, 24.965269315040718, 30.040267198484113, 0.09999999999999949, 170.0, 826, 797406, 998, 32.544912100001966
999, 3.4991374370241823, 24.957943303981246, 30.015566401073716, 0.09999999999999852, 395.0, 1017, 798423, 999, 40.03448819999903
1000, 3.2289305588169754, 24.863864414069962, 29.939813378064528, 0.10000000000000013, 205.0, 736, 799159, 1000, 29.087923899998714
1001, 4.663565386213322, 25.110288575638172, 30.225831634030147, 0.09999999999999687, 405.0, 1677, 800836, 1001, 65.99147079999966
1002, 4.543576340887108, 25.1990217871415, 30.302350068343312, 0.09999999999999881, 175.0, 950, 801786, 1002, 37.64815910000107
1003, 4.050392773810346, 25.181674227096803, 30.33291597657849, 0.10000000000000055, 140.0, 687, 802473, 1003, 27.341247000000294
1004, 4.123815439477061, 25.146809550251003, 30.24941797289699, 0.09999999999999928, 200.0, 861, 803334, 1004, 33.94471909999993
1005, 3.848915610643938, 25.22908812756697, 30.35550816853841, 0.09999999999999763, 540.0, 1293, 804627, 1005, 51.5660855999995
1006, 7.86859003857985, 25.214061545038383, 30.432241620041253, 0.09999999999999673, 460.0, 1778, 806405, 1006, 70.14724620000197
1007, 6.220153210516154, 25.13817401736756, 30.302403310108886, 0.09999999999999955, 210.0, 818, 807223, 1007, 32.96001679999972
1008, 3.325647331389404, 25.185433831081664, 30.28930797786858, 0.09999999999999794, 335.0, 1181, 808404, 1008, 46.895363600000564
1009, 6.585098235055487, 25.20588271161343, 30.376452821366332, 0.09999999999999887, 170.0, 940, 809344, 1009, 37.36181520000173
1010, 4.957987796402143, 25.207839537369924, 30.336870097535027, 0.09999999999999802, 540.0, 1153, 810497, 1010, 46.77988449999975
1011, 3.6448836013534454, 25.235913797402482, 30.38060602682904, 0.09999999999999878, 185.0, 956, 811453, 1011, 38.26753380000082
1012, 6.817455845316732, 25.29337987052803, 30.5439908842727, 0.09999999999999926, 200.0, 867, 812320, 1012, 35.096824399999605
1013, 4.757628329285191, 25.223119254692584, 30.35242207525964, 0.09999999999999969, 345.0, 797, 813117, 1013, 32.45935879999888
1014, 3.8978370328170024, 25.225498114411838, 30.346153314403026, 0.09999999999999785, 505.0, 1211, 814328, 1014, 49.198011500000575
1015, 4.1814242668686585, 25.118807782564147, 30.230610817174867, 0.10000000000000078, 85.0, 661, 814989, 1015, 26.317532900000515
1016, 6.696124897788176, 25.184760334827146, 30.36331975233419, 0.09999999999999838, 260.0, 1052, 816041, 1016, 42.75267570000142
1017, 2.198910480805024, 25.215714938439017, 30.295982027192853, 0.10000000000000055, 160.0, 686, 816727, 1017, 27.920037700001558
1018, 5.278912102444693, 25.32283141974869, 30.50337601323944, 0.09999999999999892, 390.0, 929, 817656, 1018, 37.482619800000975
1019, 4.498121141317842, 25.14641686135545, 30.260991365660136, 0.09999999999999952, 170.0, 822, 818478, 1019, 33.35455880000154
1020, 4.210081966948948, 25.222558656265107, 30.354737117006096, 0.09999999999999909, 205.0, 897, 819375, 1020, 36.50740840000071
1021, 4.677303512441037, 25.34813303451749, 30.49021747382058, 0.09999999999999826, 420.0, 1087, 820462, 1021, 44.271723400001065
1022, 3.100727584417144, 25.529376977110562, 30.700535522748346, 0.10000000000000096, 50.0, 584, 821046, 1022, 23.880117699998664
1023, 5.151866553373873, 25.57206252286295, 30.811949152667836, 0.09999999999999903, 225.0, 907, 821953, 1023, 37.290303500001755
1024, 2.4511450371716306, 25.554393932404306, 30.73150911601449, 0.09999999999999865, 295.0, 988, 822941, 1024, 40.34808419999899
1025, 6.132332380448601, 25.559987092018126, 30.811960765293666, 0.09999999999999813, 445.0, 1120, 824061, 1025, 45.68997220000165
1026, 6.184703162828968, 25.612722310152922, 30.793835786255922, 0.10000000000000066, 5.0, 352, 824413, 1026, 14.5420363000012
1027, 4.260872476002666, 25.46669326638276, 30.634166939137828, 0.09999999999999856, 235.0, 1007, 825420, 1027, 41.47961810000197
1028, 4.952578433353684, 25.56288803991459, 30.778243162643317, 0.09999999999999723, 520.0, 1473, 826893, 1028, 60.35596019999866
1029, 5.506799868019136, 25.609289197708772, 30.858779107370683, 0.10000000000000075, 45.0, 403, 827296, 1029, 16.66895740000109
1030, 9.086825679940112, 25.56844282353178, 30.823113542922, 0.09999999999999887, 210.0, 940, 828236, 1030, 38.88964599999963
1031, 6.125893778317612, 25.447562757235687, 30.604784597850443, 0.10000000000000063, 85.0, 677, 828913, 1031, 27.839812400001392
1032, 4.6534073714091875, 25.535712490323583, 30.760052775554385, 0.09999999999999752, 620.0, 1341, 830254, 1032, 54.88904810000167
1033, 6.062069693662555, 25.368683071979078, 30.575354713991462, 0.10000000000000088, 115.0, 498, 830752, 1033, 20.86726970000018
1034, 4.5285870152507135, 25.317335671811197, 30.495944562106903, 0.09999999999999735, 665.0, 1412, 832164, 1034, 58.277122399998916
1035, 4.0853562481993135, 25.31259902181689, 30.46120702457519, 0.0999999999999984, 330.0, 1047, 833211, 1035, 43.274509599999874
1036, 3.3978927501478116, 25.33641457077921, 30.46972432641324, 0.09999999999999806, 295.0, 1143, 834354, 1036, 47.491335799997614
1037, 4.066527847015935, 25.29066895145027, 30.46398528074973, 0.09999999999999831, 225.0, 1069, 835423, 1037, 44.09205010000005
1038, 5.019998035921215, 25.44143972806404, 30.678582435249062, 0.09999999999999869, 315.0, 978, 836401, 1038, 40.94668760000059
1039, 5.650444089504641, 25.30526313578107, 30.47465317274752, 0.10000000000000094, 85.0, 562, 836963, 1039, 23.504408999997395
1040, 6.248755567439823, 25.308774564921677, 30.537494253175858, 0.10000000000000078, 155.0, 662, 837625, 1040, 27.612437700001465
1041, 6.768666920442535, 25.3484475403754, 30.535095593240207, 0.09999999999999862, 265.0, 993, 838618, 1041, 41.36847560000024
1042, 6.528209264548821, 25.344929463338275, 30.54631701827644, 0.09999999999999737, 505.0, 1403, 840021, 1042, 58.90695459999915
1043, 8.525879210422259, 25.10043435444366, 30.242907575268855, 0.1000000000000002, 180.0, 727, 840748, 1043, 30.907450899998366
1044, 3.2124171505450447, 25.09452129732788, 30.148701101021985, 0.10000000000000099, 130.0, 631, 841379, 1044, 25.513196699997934
1045, 3.484336653219061, 25.160787424095247, 30.264754878364595, 0.10000000000000088, 145.0, 494, 841873, 1045, 17.901973300002282
1046, 6.359834541530541, 25.11385904098379, 30.32593280282514, 0.09999999999999892, 175.0, 928, 842801, 1046, 33.82878450000135
1047, 3.7952003652392996, 25.189369777380595, 30.2911896551809, 0.1000000000000008, 75.0, 434, 843235, 1047, 15.95664410000245
1048, 4.017296273219608, 25.102741967386276, 30.215453660310203, 0.09999999999999963, 330.0, 804, 844039, 1048, 29.415023500001553
1049, 4.419117013010919, 25.065519292651626, 30.17447669771681, 0.09999999999999715, 455.0, 1517, 845556, 1049, 55.24782349999805
1050, 5.373447819595181, 25.158097401119413, 30.29055567923046, 0.09999999999999941, 165.0, 840, 846396, 1050, 30.54296809999869
1051, 4.653830838162791, 25.108087841380726, 30.24056504683061, 0.10000000000000094, 140.0, 550, 846946, 1051, 20.621139000002586
1052, 5.704753087845645, 25.160129650554534, 30.317636305753165, 0.09999999999999895, 160.0, 922, 847868, 1052, 33.75024929999927
1053, 4.081990279536524, 25.064495770107456, 30.153871796030884, 0.09999999999999823, 500.0, 1094, 848962, 1053, 40.09011950000058
1054, 5.473186373312302, 25.080726419590224, 30.21480656249555, 0.09999999999999952, 195.0, 823, 849785, 1054, 30.019229300000006
1055, 5.934869767153331, 25.42277994675076, 30.651318716797924, 0.10000000000000045, 200.0, 698, 850483, 1055, 25.35554730000149
1056, 3.6794082413310876, 25.509096889770007, 30.683081644516463, 0.10000000000000087, 105.0, 487, 850970, 1056, 17.968374699998094
1057, 2.778066602455718, 25.504236372084844, 30.674420572916667, 0.0999999999999984, 295.0, 1050, 852020, 1057, 38.179956399999355
1058, 4.505046212114394, 25.488339302631523, 30.702818103707752, 0.0999999999999969, 410.0, 1664, 853684, 1058, 60.8034219000001
1059, 5.976526409967009, 25.499683470415647, 30.733832021537516, 0.09999999999999794, 310.0, 1183, 854867, 1059, 43.307950899998104
1060, 4.27365237601209, 25.570274392827557, 30.793002408733336, 0.10000000000000099, 145.0, 623, 855490, 1060, 23.302030700000614
1061, 5.25382101801503, 25.551041864440144, 30.754244112059773, 0.0999999999999982, 555.0, 1102, 856592, 1061, 40.577278199998545
1062, 5.002956176390515, 25.494826613567433, 30.722754841834654, 0.09999999999999787, 320.0, 1202, 857794, 1062, 44.72195259999717
1063, 5.126127662028605, 25.540721206398278, 30.764096900299712, 0.0999999999999993, 210.0, 858, 858652, 1063, 31.755255500000203
1064, 4.520141803936973, 25.55422834660803, 30.669952083126283, 0.10000000000000063, 175.0, 678, 859330, 1064, 25.214823800000886
1065, 5.6199866842593895, 25.453123094761267, 30.700518781104975, 0.09999999999999905, 215.0, 904, 860234, 1065, 33.00140349999856
1066, 8.01857370986427, 25.433521525279897, 30.708779038609684, 0.10000000000000096, 110.0, 592, 860826, 1066, 22.068691200001922
1067, 2.8939734908734573, 25.39050883916939, 30.506437805463683, 0.09999999999999767, 610.0, 1272, 862098, 1067, 47.12032609999733
1068, 5.983979638181899, 25.41418795341993, 30.588249278938683, 0.10000000000000056, 125.0, 685, 862783, 1068, 25.732316000001447
1069, 3.6311241172055184, 25.35091902761491, 30.506274330470134, 0.09999999999999908, 510.0, 899, 863682, 1069, 33.716228299999784
1070, 3.202162630165131, 25.432173310664663, 30.581140515798314, 0.09999999999999967, 155.0, 798, 864480, 1070, 29.573559399999795
1071, 6.080981114046611, 25.420104719945137, 30.6311060734932, 0.09999999999999785, 300.0, 1208, 865688, 1071, 45.49744909999936
1072, 4.177425801529195, 25.415215670377357, 30.583400863340533, 0.10000000000000046, 165.0, 696, 866384, 1072, 26.24496939999881
1073, 7.166892291099818, 25.45479687412938, 30.66495728993917, 0.10000000000000074, 115.0, 666, 867050, 1073, 25.04573270000037
1074, 7.525075975902348, 25.54539646039094, 30.807871167539084, 0.10000000000000017, 260.0, 731, 867781, 1074, 27.19993710000199
1075, 6.186257725981342, 25.46412583988535, 30.681157766984413, 0.09999999999999867, 220.0, 983, 868764, 1075, 37.045779299998685
1076, 2.889592642726954, 25.40753411710932, 30.54152649746278, 0.09999999999999774, 460.0, 1246, 870010, 1076, 46.48944820000179
1077, 5.542107856447228, 25.44969973700656, 30.627262288702674, 0.09999999999999853, 465.0, 1013, 871023, 1077, 38.00905779999812
1078, 3.7865176649205385, 25.255145831108095, 30.404095778465273, 0.10000000000000074, 105.0, 400, 871423, 1078, 15.317113599998265
1079, 6.592142880945685, 25.482195488598755, 30.71476455965223, 0.09999999999999784, 425.0, 1213, 872636, 1079, 45.79513439999937
1080, 6.772426518404948, 25.419608800486802, 30.663989233352265, 0.09999999999999741, 455.0, 1388, 874024, 1080, 52.70672970000305
1081, 5.6474047664329, 25.424301400210688, 30.649293519108674, 0.10000000000000016, 205.0, 732, 874756, 1081, 27.849936599999637
1082, 7.142709454347642, 25.488879670995836, 30.716831249497737, 0.09999999999999844, 350.0, 1039, 875795, 1082, 39.61795499999789
1083, 3.3594773261753077, 25.36132955270655, 30.467993394066305, 0.1000000000000006, 105.0, 680, 876475, 1083, 25.766272200002277
1084, 5.513209417245923, 25.513827784836515, 30.73038949718876, 0.09999999999999697, 620.0, 1618, 878093, 1084, 61.56085780000285
1085, 8.512524713283053, 25.466503530264664, 30.73685550385009, 0.10000000000000099, 140.0, 626, 878719, 1085, 23.55679919999966
1086, 4.512013547372498, 25.426334389104138, 30.585571737097414, 0.09999999999999791, 560.0, 1192, 879911, 1086, 45.192262099997606
1087, 4.777427056786285, 25.248774331127883, 30.332839106222185, 0.1000000000000009, 50.0, 517, 880428, 1087, 19.984733199999027
1088, 4.783578650411947, 25.214533725930327, 30.30054747725332, 0.10000000000000092, 85.0, 537, 880965, 1088, 21.302444000000833
1089, 4.688321693757336, 25.231314253052947, 30.358528371564955, 0.09999999999999952, 155.0, 822, 881787, 1089, 33.00502830000187
1090, 5.369349530186527, 25.263175090647632, 30.37597311801792, 0.10000000000000096, 130.0, 644, 882431, 1090, 24.512221699998918
1091, 3.4418244593154452, 25.18232673609861, 30.291732512091713, 0.09999999999999826, 210.0, 1085, 883516, 1091, 41.84039689999918
1092, 3.2706560985088347, 25.163871270751955, 30.299447857666017, 0.10000000000000099, 65.0, 625, 884141, 1092, 23.985197900001367
1093, 5.510588479876194, 25.24951586516007, 30.386776265890703, 0.09999999999999819, 275.0, 1104, 885245, 1093, 42.04530490000252
1094, 3.014268282001058, 25.111710531431584, 30.206933337174277, 0.0999999999999994, 185.0, 843, 886088, 1094, 32.61398800000097
1095, 2.170763085521986, 25.19826867682802, 30.281103728007686, 0.10000000000000088, 75.0, 652, 886740, 1095, 25.18303569999989
1096, 4.83220545800307, 25.241603101195082, 30.378661807817902, 0.1000000000000009, 120.0, 506, 887246, 1096, 19.512153799998487
1097, 6.896129407743245, 25.09040807487281, 30.24470388056038, 0.10000000000000042, 390.0, 701, 887947, 1097, 26.407958899999358
1098, 3.4394409131173673, 25.146586776106325, 30.224554178595, 0.09999999999999822, 300.0, 1095, 889042, 1098, 42.053845100002945
1099, 2.493570636143194, 25.231881599782785, 30.296529976675444, 0.10000000000000092, 55.0, 535, 889577, 1099, 20.97950860000128
1100, 4.074078152399234, 25.22478088027681, 30.348551906283248, 0.09999999999999978, 195.0, 782, 890359, 1100, 30.134224000001268
1101, 3.532385181240808, 25.136901032887124, 30.25213566606968, 0.0999999999999988, 570.0, 953, 891312, 1101, 36.678732899999886
1102, 5.735981597086115, 25.233072544539702, 30.344992629320803, 0.09999999999999964, 290.0, 803, 892115, 1102, 31.465087600001425
1103, 3.962141539693572, 25.25202759143918, 30.403315989915715, 0.09999999999999928, 300.0, 860, 892975, 1103, 33.609192600000824
1104, 8.722678212113472, 25.376924807722396, 30.622604115101513, 0.09999999999999905, 175.0, 905, 893880, 1104, 35.40563939999993
1105, 4.829432128151886, 25.24880847755, 30.433350901044562, 0.09999999999999995, 145.0, 759, 894639, 1105, 29.89018230000147
1106, 6.238993898018983, 25.189735056662414, 30.397819909797963, 0.10000000000000088, 30.0, 493, 895132, 1106, 19.518509500001528
1107, 6.841125986155624, 25.29168856781065, 30.47920777393938, 0.09999999999999708, 725.0, 1553, 896685, 1107, 60.37721369999781
1108, 4.172196495334567, 25.205632037967053, 30.247155022683405, 0.10000000000000071, 65.0, 383, 897068, 1108, 15.032579700000497
1109, 4.292599890686932, 25.1922447796981, 30.275565897321844, 0.09999999999999855, 165.0, 1011, 898079, 1109, 39.39568119999967
1110, 3.858369767901641, 25.33825716187682, 30.42775535583496, 0.10000000000000085, 95.0, 474, 898553, 1110, 18.93526809999821
1111, 6.613548530965548, 25.24034670700999, 30.431423622101487, 0.0999999999999985, 270.0, 1022, 899575, 1111, 40.2643911999985
1112, 5.612924951998626, 25.282351424273322, 30.470638616225298, 0.10000000000000078, 15.0, 425, 900000, 1112, 16.765614599997207
1113, 5.825712978742269, 25.31878941964895, 30.47889389360142, 0.10000000000000055, 320.0, 687, 900687, 1113, 26.779100700001436
1114, 5.663575537140237, 25.341315419881937, 30.533187565387497, 0.10000000000000096, 110.0, 596, 901283, 1114, 23.544059800002287
1115, 2.185073628783226, 25.24430975341797, 30.356997889200848, 0.1000000000000007, 15.0, 375, 901658, 1115, 14.534677999999985
1116, 6.404479745049924, 25.353897402900795, 30.55466541973264, 0.09999999999999805, 600.0, 1145, 902803, 1116, 45.410063600000285
1117, 4.393036088290223, 25.232671762636194, 30.37750828328557, 0.09999999999999805, 285.0, 1146, 903949, 1117, 45.422057899999345
1118, 4.653175551350255, 25.28479495742946, 30.439609246115083, 0.1000000000000009, 70.0, 515, 904464, 1118, 20.569888699999865
1119, 4.662702359849839, 25.31008932840489, 30.454706255432285, 0.09999999999999978, 190.0, 782, 905246, 1119, 30.911787999997614
1120, 2.764126342817969, 25.26109127968735, 30.368153655856926, 0.0999999999999981, 330.0, 1127, 906373, 1120, 44.6914222000014
1121, 6.390221910260152, 25.38702059984207, 30.596041256189345, 0.100000000000001, 65.0, 640, 907013, 1121, 24.85171199999968
1122, 9.031845934009956, 25.377417748173077, 30.584196716547012, 0.10000000000000071, 55.0, 384, 907397, 1122, 15.146636299999955
1123, 6.318218525715412, 25.286177976669805, 30.43268188353508, 0.09999999999999777, 195.0, 1240, 908637, 1123, 47.94454169999881
1124, 3.7709832222774775, 25.408033405650745, 30.531760980625346, 0.10000000000000088, 115.0, 495, 909132, 1124, 19.811866699998063
1125, 4.094185667898233, 25.320004227085562, 30.44447494971142, 0.10000000000000023, 185.0, 723, 909855, 1125, 28.436764300000505
1126, 5.371566052796997, 25.105408076732996, 30.23963581193597, 0.09999999999999824, 390.0, 1091, 910946, 1126, 42.95838519999961
1127, 5.115681642323871, 25.081674782164868, 30.232823367465222, 0.10000000000000092, 190.0, 647, 911593, 1127, 25.53255469999931
1128, 4.330921849005677, 25.028842831117192, 30.067720278499596, 0.10000000000000099, 180.0, 623, 912216, 1128, 24.192298499998287
1129, 6.915790041403145, 25.14913488763859, 30.29846244939641, 0.10000000000000092, 105.0, 538, 912754, 1129, 21.492813699998806
1130, 4.052276480808065, 25.107796846990134, 30.189881114906587, 0.10000000000000067, 55.0, 359, 913113, 1130, 14.210078799998882
1131, 4.934192860709681, 25.055303988002596, 30.190892208190192, 0.10000000000000069, 210.0, 672, 913785, 1131, 26.756238199999643
1132, 4.6914946259778825, 24.995078068904327, 30.077189652503957, 0.09999999999999969, 85.0, 797, 914582, 1132, 31.970346099999006
1133, 8.096610244650106, 25.14887699353289, 30.401792971212956, 0.09999999999999971, 245.0, 793, 915375, 1133, 31.25006460000077
1134, 6.299540441047735, 25.101291274228025, 30.22554359555493, 0.09999999999999878, 165.0, 958, 916333, 1134, 38.07843729999877
1135, 4.635999936483809, 25.018641088380623, 30.100923010500765, 0.09999999999999933, 200.0, 853, 917186, 1135, 33.90956730000107
1136, 5.432350745261163, 25.098335314567866, 30.176233604378293, 0.09999999999999926, 215.0, 866, 918052, 1136, 34.52418310000212
1137, 4.304859253527035, 25.019259653671668, 30.08465139653865, 0.10000000000000099, 160.0, 641, 918693, 1137, 25.243000200000097
1138, 3.5780374495563354, 25.08875196301073, 30.199038508846517, 0.09999999999999924, 155.0, 869, 919562, 1138, 34.37312549999842
1139, 5.043588455968093, 24.938107292197028, 30.04450804555518, 0.10000000000000041, 75.0, 702, 920264, 1139, 28.638274800003273
1140, 5.03955018175353, 24.69237416992438, 29.769134161311808, 0.09999999999999783, 345.0, 1218, 921482, 1140, 48.389820399999735
1141, 4.30906575375601, 24.677989592463334, 29.703849247523717, 0.10000000000000096, 110.0, 644, 922126, 1141, 25.894213599996874
1142, 4.338576996575795, 24.63779359828972, 29.672554314255954, 0.0999999999999986, 235.0, 998, 923124, 1142, 39.80671380000058
1143, 7.205231326014394, 24.810169753461782, 29.861944666003236, 0.10000000000000075, 105.0, 404, 923528, 1143, 15.993261700001312
1144, 4.939238576506895, 24.65262530337098, 29.691182801031296, 0.09999999999999891, 215.0, 930, 924458, 1144, 37.27936800000316
1145, 7.829126807304779, 24.661251351288154, 29.769617165314866, 0.10000000000000096, 55.0, 586, 925044, 1145, 23.40358760000163
1146, 7.066699290513234, 24.635421060536007, 29.6707589528332, 0.0999999999999985, 235.0, 1022, 926066, 1146, 41.27882459999819
1147, 6.087549769099969, 24.66618757959622, 29.692734353933762, 0.1000000000000007, 110.0, 670, 926736, 1147, 27.15594030000284
1148, 4.926624629589578, 24.690977510691418, 29.694341488448366, 0.09999999999999867, 290.0, 981, 927717, 1148, 39.41483230000085
1149, 4.04705424259153, 24.642429052157325, 29.67825515115474, 0.09999999999999834, 375.0, 1063, 928780, 1149, 42.89270360000228
1150, 3.5012524162878638, 24.557222564980083, 29.5299361987337, 0.09999999999999809, 385.0, 1133, 929913, 1150, 45.88660669999808
1151, 4.733200228435749, 26.237354468761023, 31.594457152645653, 0.09999999999999834, 410.0, 1063, 930976, 1151, 42.74217320000025
1152, 7.314362575568146, 26.325623483368844, 31.730674292102005, 0.09999999999999837, 645.0, 1056, 932032, 1152, 43.48811410000053
1153, 5.384585422081634, 26.432874882526885, 31.805854558944702, 0.09999999999999706, 305.0, 1560, 933592, 1153, 64.00086829999782
1154, 6.07592774065245, 26.36892566215103, 31.756655865892345, 0.09999999999999708, 595.0, 1556, 935148, 1154, 63.88674899999751
1155, 8.675399572426036, 26.478107967892207, 31.884049549149648, 0.10000000000000075, 30.0, 407, 935555, 1155, 16.841464400000405
1156, 6.296952774749923, 26.400041502851494, 31.79575013543054, 0.09999999999999826, 410.0, 1085, 936640, 1156, 45.013895399999456
1157, 4.421258720966154, 26.33727966028767, 31.68133059957395, 0.09999999999999892, 190.0, 927, 937567, 1157, 38.74759859999904
1158, 8.467472398086734, 26.367659242482176, 31.762161601017915, 0.10000000000000091, 105.0, 529, 938096, 1158, 21.54501380000147
1159, 5.82105153265299, 26.36062749483252, 31.706846644801477, 0.10000000000000006, 150.0, 744, 938840, 1159, 30.69028790000084
1160, 3.5178766999253925, 26.264581157566088, 31.58660862535287, 0.10000000000000098, 30.0, 613, 939453, 1160, 25.10898769999767
1161, 6.2762944442152975, 26.397911566162108, 31.827557971191407, 0.10000000000000099, 100.0, 625, 940078, 1161, 25.57044600000154
1162, 11.169594726300193, 26.391530383546602, 31.86208038479968, 0.1000000000000009, 110.0, 509, 940587, 1162, 21.364226400000916
1163, 7.4591126243171635, 26.56217453909702, 32.05484983178436, 0.10000000000000087, 30.0, 488, 941075, 1163, 19.902914799997234
1164, 5.525190439177763, 26.306695231802767, 31.66320604001412, 0.09999999999999788, 200.0, 1199, 942274, 1164, 49.15203230000043
1165, 5.27461495252042, 26.460412882142148, 31.81187859632201, 0.10000000000000085, 135.0, 472, 942746, 1165, 19.217898799997783
1166, 5.346200043417669, 26.38855927283692, 31.76349546737848, 0.09999999999999928, 315.0, 862, 943608, 1166, 35.89625800000067
1167, 6.163468434902218, 26.383202320053464, 31.79615067584174, 0.09999999999999751, 460.0, 1344, 944952, 1167, 55.682710599998245
1168, 6.578831013711008, 26.474887220917275, 31.94154459547419, 0.09999999999999802, 185.0, 1156, 946108, 1168, 47.723683600001095
1169, 5.562741403361777, 26.394236819363574, 31.73677579898399, 0.10000000000000098, 105.0, 614, 946722, 1169, 25.654779799999233
1170, 5.314467214537856, 26.421719559015692, 31.80544168842803, 0.09999999999999756, 400.0, 1323, 948045, 1170, 54.42305459999989
1171, 5.651814647740618, 26.432433576665375, 31.839212203863568, 0.09999999999999838, 270.0, 1053, 949098, 1171, 43.440123700002005
1172, 4.69084634328134, 26.369606643915176, 31.73536499521949, 0.09999999999999737, 175.0, 1408, 950506, 1172, 59.21016129999771
1173, 5.698049420976198, 26.421402598770573, 31.815174482238124, 0.10000000000000095, 130.0, 568, 951074, 1173, 24.042362399999547
1174, 5.387659125164084, 26.408352513005887, 31.823500277220397, 0.10000000000000073, 110.0, 667, 951741, 1174, 27.559634799999913
1175, 4.565113511546092, 26.287973483692515, 31.68991303877397, 0.10000000000000094, 105.0, 550, 952291, 1175, 23.19669419999991
1176, 5.043951453574892, 26.364279585839345, 31.735445570766093, 0.09999999999999892, 195.0, 929, 953220, 1176, 38.7034945000014
1177, 4.3523313233075385, 26.350526583337302, 31.71782849793491, 0.09999999999999826, 310.0, 1087, 954307, 1177, 45.84532479999689
1178, 5.08543122166919, 26.38966340675811, 31.803241031306403, 0.1, 225.0, 751, 955058, 1178, 31.501194899999973
1179, 4.106975677445394, 26.331305244865767, 31.684397839187483, 0.09999999999999824, 340.0, 1090, 956148, 1179, 45.41557159999866
1180, 3.5476609042907756, 26.351358353296916, 31.664601736068725, 0.10000000000000098, 110.0, 600, 956748, 1180, 25.37003509999704
1181, 5.462425254421264, 26.377516960744302, 31.780601270930116, 0.09999999999999919, 175.0, 877, 957625, 1181, 37.59693939999852
1182, 6.145444866521051, 26.39568485046857, 31.808621845723117, 0.10000000000000091, 110.0, 519, 958144, 1182, 21.54950689999896
1183, 5.654814563471338, 26.382003780862558, 31.833834745987602, 0.10000000000000095, 200.0, 575, 958719, 1183, 24.473463599999377
1184, 7.331762573590911, 26.39167162848682, 31.757607346627772, 0.10000000000000084, 145.0, 656, 959375, 1184, 27.530326899999636
1185, 3.9123531761101615, 26.448754832275913, 31.859093089388985, 0.09999999999999888, 210.0, 936, 960311, 1185, 39.28857319999952
1186, 4.382639421139565, 26.854212540017684, 32.26037125668283, 0.10000000000000066, 50.0, 354, 960665, 1186, 15.055173900000227
1187, 2.249392673908136, 26.77500538459191, 32.14419449537228, 0.10000000000000073, 105.0, 390, 961055, 1187, 16.523893199999293
1188, 3.50383453886204, 26.780092436286445, 32.234061659943706, 0.10000000000000091, 205.0, 649, 961704, 1188, 27.48038159999851
1189, 4.235995940143699, 26.913348454355404, 32.40982363366133, 0.09999999999999998, 215.0, 755, 962459, 1189, 31.74918699999762
1190, 4.139981883704662, 26.83046980794271, 32.26614028422038, 0.1000000000000007, 35.0, 375, 962834, 1190, 15.971860800000286
1191, 3.848427402201064, 26.799488543060274, 32.24238555728512, 0.0999999999999985, 440.0, 1019, 963853, 1191, 53.82391819999975
1192, 4.688580275647431, 26.925235514780294, 32.44168059823314, 0.09999999999999895, 190.0, 923, 964776, 1192, 42.37934089999908
1193, 3.856175217416708, 26.850295297376388, 32.31353151905644, 0.09999999999999754, 615.0, 1332, 966108, 1193, 56.429312799999025
1194, 5.077036400514771, 26.886488603428006, 32.4121551271528, 0.09999999999999849, 145.0, 1024, 967132, 1194, 45.34207469999819
1195, 3.8472221513005307, 26.70986237319038, 32.155866784597144, 0.09999999999999863, 225.0, 991, 968123, 1195, 41.79005790000156
1196, 4.261729068425111, 26.874492053902305, 32.370473092646925, 0.10000000000000055, 220.0, 687, 968810, 1196, 29.565569499998674
1197, 6.09202646804792, 26.963837261465386, 32.44954685946819, 0.10000000000000088, 50.0, 503, 969313, 1197, 21.4256166999985
1198, 4.535047755720769, 26.939867045401538, 32.448653762833224, 0.09999999999999876, 420.0, 963, 970276, 1198, 41.261910699999135
1199, 3.353753443275179, 27.362538562798353, 32.950136777036676, 0.10000000000000096, 105.0, 644, 970920, 1199, 27.547506099999737
1200, 6.338550229632218, 27.363089487206846, 32.93100586811095, 0.10000000000000085, 85.0, 655, 971575, 1200, 28.47532240000146
1201, 7.330205568499797, 27.33634853644357, 32.92343165529864, 0.09999999999999852, 515.0, 1017, 972592, 1201, 43.2992994999986
1202, 4.201749970445869, 27.27960835038471, 32.866607361741394, 0.10000000000000063, 70.0, 677, 973269, 1202, 28.942077899999276
1203, 3.9508164071815504, 27.39661030165493, 32.97512878184756, 0.10000000000000084, 110.0, 458, 973727, 1203, 19.599616999999853
1204, 6.9432253918154325, 27.420116033539152, 33.06228384426875, 0.09999999999999766, 490.0, 1278, 975005, 1204, 54.87506140000187
1205, 3.811628044730506, 27.3438381707582, 32.911986911862684, 0.09999999999999776, 800.0, 1243, 976248, 1205, 53.66915270000027
1206, 3.3239673033601234, 27.361814925986465, 32.911346115792064, 0.09999999999999933, 195.0, 853, 977101, 1206, 36.95764559999952
1207, 9.13725331771173, 27.360386611266456, 33.060032380059596, 0.09999999999999985, 195.0, 772, 977873, 1207, 32.98871739999959
1208, 7.28576991184417, 27.399985923189107, 32.993957762284715, 0.1000000000000008, 145.0, 660, 978533, 1208, 28.474783599998773
1209, 4.243928244675614, 27.29535825657913, 32.832865508901286, 0.10000000000000048, 95.0, 694, 979227, 1209, 30.115269999998418
1210, 6.531301577093083, 27.42428613044846, 33.023107212287535, 0.100000000000001, 145.0, 639, 979866, 1210, 27.8194173999982
1211, 4.3247757596373555, 28.921485736846925, 34.76930288314819, 0.10000000000000088, 70.0, 500, 980366, 1211, 21.758503199998813
1212, 5.660396465092496, 29.495729470534428, 35.509684553033786, 0.09999999999999792, 370.0, 1186, 981552, 1212, 51.434942500000034
1213, 5.181545908700723, 29.44657184798996, 35.43674854427189, 0.09999999999999987, 110.0, 770, 982322, 1213, 34.00756129999718
1214, 3.7786494136495077, 29.44184047942597, 35.420453081616685, 0.09999999999999777, 840.0, 1237, 983559, 1214, 53.86106949999885
1215, 5.182599432444409, 29.523257358603487, 35.53545522034051, 0.1000000000000009, 25.0, 509, 984068, 1215, 22.634475000002567
1216, 5.640634878763887, 29.450596816207284, 35.4682691139885, 0.09999999999999687, 570.0, 1678, 985746, 1216, 72.5080952999997
1217, 6.974591459828935, 29.408708672662176, 35.42769474951213, 0.0999999999999991, 230.0, 894, 986640, 1217, 38.88128219999999
1218, 4.95649760203511, 29.493504422924893, 35.4754660033481, 0.09999999999999823, 330.0, 1092, 987732, 1218, 48.00979089999964
1219, 5.3094870186556244, 29.499578685197147, 35.482880633926925, 0.10000000000000034, 135.0, 711, 988443, 1219, 31.177568500002963
1220, 6.359235242803468, 29.335125709647563, 35.37249823368943, 0.10000000000000085, 90.0, 469, 988912, 1220, 20.77863989999969
1221, 7.392788179610905, 29.466732967010593, 35.50409291624654, 0.10000000000000094, 120.0, 646, 989558, 1221, 28.217217900000833
1222, 3.8134239518504596, 29.444622678906505, 35.38536572248316, 0.09999999999999805, 565.0, 1146, 990704, 1222, 50.422870300000795
1223, 4.843189476534097, 29.56771252764853, 35.56757580963925, 0.10000000000000099, 225.0, 618, 991322, 1223, 27.348760900000343
1224, 4.788288906774515, 29.39056535158756, 35.35905506069533, 0.09999999999999948, 530.0, 828, 992150, 1224, 36.36108090000198
1225, 5.3074819014479, 29.356635803966125, 35.280422595703406, 0.1000000000000008, 70.0, 431, 992581, 1225, 19.24232039999697
1226, 4.098046264064063, 29.539786620177427, 35.55084679705667, 0.10000000000000071, 30.0, 383, 992964, 1226, 17.200034899997263
1227, 5.976619205151408, 29.47833607155152, 35.5226700499516, 0.09999999999999871, 240.0, 973, 993937, 1227, 42.67712689999826
1228, 5.586435750103984, 29.468410924899796, 35.472430916651625, 0.10000000000000088, 180.0, 652, 994589, 1228, 28.73859430000084
1229, 6.501405802795678, 29.517644767178833, 35.55101786606184, 0.09999999999999759, 425.0, 1310, 995899, 1229, 57.83718190000218
1230, 6.7604290465906605, 29.571178024646848, 35.599881093224816, 0.0999999999999983, 305.0, 1075, 996974, 1230, 47.597772900000564
1231, 8.121798311177614, 29.579996797642103, 35.60654032023314, 0.09999999999999962, 345.0, 806, 997780, 1231, 35.936051299999235
1232, 4.459888043181387, 29.426624074926988, 35.4110133517737, 0.10000000000000099, 140.0, 641, 998421, 1232, 28.556875900001614
1233, 4.718982109042187, 29.436688194926987, 35.41670549343794, 0.09999999999999797, 285.0, 1170, 999591, 1233, 52.30964699999822
