,loss,mae,mean_q,mean_eps,episode_reward,nb_episode_steps,nb_steps,episode,duration
0,0,0,0,0,390.0,952,952,0,1.8266661000000006
1, 0, 0, 0, 0, 80.0, 440, 1392, 1, 0.8639326
2, 0, 0, 0, 0, 105.0, 583, 1975, 2, 1.149682499999999
3, 0, 0, 0, 0, 75.0, 499, 2474, 3, 0.9905896999999992
4, 0, 0, 0, 0, 135.0, 620, 3094, 4, 1.2156696999999994
5, 0, 0, 0, 0, 105.0, 653, 3747, 5, 1.2900366000000005
6, 0, 0, 0, 0, 75.0, 612, 4359, 6, 1.2242727000000002
7, 0, 0, 0, 0, 425.0, 907, 5266, 7, 1.7481930000000006
8, 0, 0, 0, 0, 185.0, 697, 5963, 8, 1.318174599999999
9, 0, 0, 0, 0, 210.0, 809, 6772, 9, 1.5634537000000002
10, 0, 0, 0, 0, 95.0, 774, 7546, 10, 1.5410161000000002
11, 0, 0, 0, 0, 290.0, 841, 8387, 11, 1.6519022999999997
12, 0, 0, 0, 0, 50.0, 387, 8774, 12, 0.8489480999999977
13, 0, 0, 0, 0, 165.0, 777, 9551, 13, 1.5111474000000022
14, 0, 0, 0, 0, 155.0, 724, 10275, 14, 1.4095125999999993
15, 0, 0, 0, 0, 210.0, 913, 11188, 15, 1.7525925999999998
16, 0, 0, 0, 0, 75.0, 356, 11544, 16, 0.7028909999999975
17, 0, 0, 0, 0, 45.0, 476, 12020, 17, 0.9684998000000036
18, 0, 0, 0, 0, 75.0, 573, 12593, 18, 1.145948599999997
19, 0, 0, 0, 0, 125.0, 673, 13266, 19, 1.3431779000000006
20, 0, 0, 0, 0, 45.0, 403, 13669, 20, 0.8038144000000003
21, 0, 0, 0, 0, 155.0, 790, 14459, 21, 1.5717578999999944
22, 0, 0, 0, 0, 130.0, 554, 15013, 22, 1.1074920999999947
23, 0, 0, 0, 0, 120.0, 666, 15679, 23, 1.3230216999999982
24, 0, 0, 0, 0, 45.0, 399, 16078, 24, 0.8473673000000019
25, 0, 0, 0, 0, 85.0, 521, 16599, 25, 1.0117158999999987
26, 0, 0, 0, 0, 180.0, 725, 17324, 26, 1.4358210999999983
27, 0, 0, 0, 0, 640.0, 1352, 18676, 27, 2.6336312999999976
28, 0, 0, 0, 0, 185.0, 736, 19412, 28, 1.4471610999999953
29, 0, 0, 0, 0, 120.0, 665, 20077, 29, 1.318296200000006
30, 0, 0, 0, 0, 135.0, 774, 20851, 30, 1.5230099999999993
31, 0, 0, 0, 0, 225.0, 802, 21653, 31, 1.5986940000000018
32, 0, 0, 0, 0, 210.0, 1499, 23152, 32, 2.8734707999999998
33, 0, 0, 0, 0, 180.0, 810, 23962, 33, 1.5922197999999952
34, 0, 0, 0, 0, 80.0, 510, 24472, 34, 1.0154026000000016
35, 0, 0, 0, 0, 45.0, 391, 24863, 35, 0.7730572000000038
36, 0, 0, 0, 0, 75.0, 542, 25405, 36, 1.0987388999999936
37, 0, 0, 0, 0, 180.0, 715, 26120, 37, 1.3971285000000009
38, 0, 0, 0, 0, 65.0, 496, 26616, 38, 0.9772851000000031
39, 0, 0, 0, 0, 160.0, 962, 27578, 39, 1.932475899999993
40, 0, 0, 0, 0, 30.0, 620, 28198, 40, 1.2333247999999912
41, 0, 0, 0, 0, 215.0, 811, 29009, 41, 1.5919331000000057
42, 0, 0, 0, 0, 80.0, 626, 29635, 42, 1.2786303000000032
43, 0, 0, 0, 0, 120.0, 659, 30294, 43, 1.3132957999999917
44, 0, 0, 0, 0, 90.0, 503, 30797, 44, 1.0197205999999994
45, 0, 0, 0, 0, 105.0, 697, 31494, 45, 1.3666082000000017
46, 0, 0, 0, 0, 155.0, 797, 32291, 46, 1.5347115000000002
47, 0, 0, 0, 0, 110.0, 631, 32922, 47, 1.2685387000000077
48, 0, 0, 0, 0, 120.0, 666, 33588, 48, 1.3115904
49, 0, 0, 0, 0, 155.0, 770, 34358, 49, 1.554975099999993
50, 0, 0, 0, 0, 150.0, 866, 35224, 50, 1.7435139999999905
51, 0, 0, 0, 0, 20.0, 481, 35705, 51, 0.9382346000000013
52, 0, 0, 0, 0, 105.0, 533, 36238, 52, 1.0086545000000058
53, 0, 0, 0, 0, 775.0, 1454, 37692, 53, 3.0149093000000136
54, 0, 0, 0, 0, 90.0, 674, 38366, 54, 1.3508317000000005
55, 0, 0, 0, 0, 210.0, 882, 39248, 55, 1.8669246000000044
56, 0, 0, 0, 0, 135.0, 801, 40049, 56, 1.6428121000000004
57, 0, 0, 0, 0, 135.0, 679, 40728, 57, 1.3665871000000038
58, 0, 0, 0, 0, 125.0, 639, 41367, 58, 1.2788148000000064
59, 0, 0, 0, 0, 175.0, 704, 42071, 59, 1.4986312999999996
60, 0, 0, 0, 0, 150.0, 800, 42871, 60, 1.5724502999999999
61, 0, 0, 0, 0, 55.0, 537, 43408, 61, 1.0668196000000023
62, 0, 0, 0, 0, 210.0, 830, 44238, 62, 1.6037986000000046
63, 0, 0, 0, 0, 45.0, 363, 44601, 63, 0.6950973000000005
64, 0, 0, 0, 0, 180.0, 830, 45431, 64, 1.5834656999999908
65, 0, 0, 0, 0, 55.0, 461, 45892, 65, 0.9304276000000016
66, 0, 0, 0, 0, 110.0, 624, 46516, 66, 1.232800300000008
67, 0, 0, 0, 0, 80.0, 624, 47140, 67, 1.2280044999999973
68, 0, 0, 0, 0, 30.0, 399, 47539, 68, 0.7912148999999999
69, 0, 0, 0, 0, 105.0, 640, 48179, 69, 1.267088000000001
70, 0, 0, 0, 0, 285.0, 956, 49135, 70, 1.860969499999996
71, 0, 0, 0, 0, 90.0, 590, 49725, 71, 1.1593778000000015
72, 0, 0, 0, 0, 415.0, 851, 50576, 72, 1.675929399999987
73, 0, 0, 0, 0, 410.0, 773, 51349, 73, 1.4548749000000072
74, 0, 0, 0, 0, 210.0, 850, 52199, 74, 1.6096373999999969
75, 0, 0, 0, 0, 115.0, 659, 52858, 75, 1.3000284000000022
76, 0, 0, 0, 0, 315.0, 1000, 53858, 76, 1.9266226999999958
77, 0, 0, 0, 0, 105.0, 635, 54493, 77, 1.2428918999999894
78, 0, 0, 0, 0, 105.0, 745, 55238, 78, 1.4676101000000017
79, 0, 0, 0, 0, 210.0, 850, 56088, 79, 1.6377935000000008
80, 0, 0, 0, 0, 490.0, 1043, 57131, 80, 2.069432699999993
81, 0, 0, 0, 0, 210.0, 778, 57909, 81, 1.4969215999999932
82, 0, 0, 0, 0, 110.0, 607, 58516, 82, 1.225142500000004
83, 0, 0, 0, 0, 260.0, 944, 59460, 83, 1.8134663999999958
84, 0, 0, 0, 0, 180.0, 809, 60269, 84, 1.5865339999999861
85, 0, 0, 0, 0, 205.0, 791, 61060, 85, 1.5373206000000152
86, 0, 0, 0, 0, 180.0, 812, 61872, 86, 1.5872321999999883
87, 0, 0, 0, 0, 135.0, 787, 62659, 87, 1.4768075000000067
88, 0, 0, 0, 0, 210.0, 675, 63334, 88, 1.3123860999999977
89, 0, 0, 0, 0, 155.0, 765, 64099, 89, 1.5190873999999894
90, 0, 0, 0, 0, 50.0, 398, 64497, 90, 0.803509599999984
91, 0, 0, 0, 0, 170.0, 863, 65360, 91, 1.7049615000000244
92, 0, 0, 0, 0, 105.0, 641, 66001, 92, 1.277712699999995
93, 0, 0, 0, 0, 210.0, 852, 66853, 93, 1.673708999999974
94, 0, 0, 0, 0, 140.0, 806, 67659, 94, 1.60199590000002
95, 0, 0, 0, 0, 210.0, 799, 68458, 95, 1.5713917999999865
96, 0, 0, 0, 0, 105.0, 689, 69147, 96, 1.3560758000000135
97, 0, 0, 0, 0, 105.0, 631, 69778, 97, 1.2288480999999933
98, 0, 0, 0, 0, 120.0, 733, 70511, 98, 1.4462685999999962
99, 0, 0, 0, 0, 65.0, 377, 70888, 99, 0.7644096000000218
100, 0, 0, 0, 0, 210.0, 930, 71818, 100, 1.878678399999984
101, 0, 0, 0, 0, 135.0, 639, 72457, 101, 1.3450313999999821
102, 0, 0, 0, 0, 180.0, 875, 73332, 102, 1.7208517999999913
103, 0, 0, 0, 0, 105.0, 642, 73974, 103, 1.386788800000005
104, 0, 0, 0, 0, 460.0, 1051, 75025, 104, 2.0488539000000117
105, 0, 0, 0, 0, 135.0, 630, 75655, 105, 1.2805118999999934
106, 0, 0, 0, 0, 285.0, 1030, 76685, 106, 2.0148300000000177
107, 0, 0, 0, 0, 105.0, 414, 77099, 107, 0.817787299999992
108, 0, 0, 0, 0, 120.0, 648, 77747, 108, 1.2761429000000248
109, 0, 0, 0, 0, 155.0, 835, 78582, 109, 1.6239841000000013
110, 0, 0, 0, 0, 105.0, 643, 79225, 110, 1.2791248999999993
111, 0, 0, 0, 0, 135.0, 772, 79997, 111, 1.5441055999999946
112, 0, 0, 0, 0, 135.0, 777, 80774, 112, 1.529886800000014
113, 0, 0, 0, 0, 210.0, 783, 81557, 113, 1.5646825999999976
114, 0, 0, 0, 0, 60.0, 528, 82085, 114, 1.0537597999999946
115, 0, 0, 0, 0, 135.0, 782, 82867, 115, 1.6187888000000044
116, 0, 0, 0, 0, 210.0, 796, 83663, 116, 1.6077755000000025
117, 0, 0, 0, 0, 300.0, 1053, 84716, 117, 2.3775525000000073
118, 0, 0, 0, 0, 125.0, 764, 85480, 118, 1.5711865000000103
119, 0, 0, 0, 0, 155.0, 851, 86331, 119, 1.8047759000000099
120, 0, 0, 0, 0, 110.0, 770, 87101, 120, 1.5749001000000078
121, 0, 0, 0, 0, 500.0, 1039, 88140, 121, 2.1069717000000026
122, 0, 0, 0, 0, 50.0, 414, 88554, 122, 0.8698611999999741
123, 0, 0, 0, 0, 145.0, 799, 89353, 123, 1.6475303999999937
124, 0, 0, 0, 0, 250.0, 955, 90308, 124, 1.9616742000000045
125, 0, 0, 0, 0, 250.0, 948, 91256, 125, 1.9289584999999931
126, 0, 0, 0, 0, 80.0, 520, 91776, 126, 1.0899533999999846
127, 0, 0, 0, 0, 155.0, 796, 92572, 127, 1.6322537000000068
128, 0, 0, 0, 0, 110.0, 678, 93250, 128, 1.3933394000000021
129, 0, 0, 0, 0, 240.0, 1031, 94281, 129, 1.9080353999999886
130, 0, 0, 0, 0, 435.0, 1046, 95327, 130, 1.9681362000000036
131, 0, 0, 0, 0, 180.0, 852, 96179, 131, 1.6336050999999827
132, 0, 0, 0, 0, 105.0, 616, 96795, 132, 1.2290859000000012
133, 0, 0, 0, 0, 235.0, 944, 97739, 133, 1.843558900000005
134, 0, 0, 0, 0, 410.0, 853, 98592, 134, 1.627987499999989
135, 0, 0, 0, 0, 105.0, 655, 99247, 135, 1.319034099999982
136, 0, 0, 0, 0, 80.0, 624, 99871, 136, 1.2602444000000048
137, 91.6743618738737, 65.95552945308548, 85.23353101881288, 0.8197488999999999, 50.0, 408, 100279, 137, 2.8958346000000006
138, 37.391567123179534, 65.86408605380934, 81.79566347355745, 0.8187931000000003, 165.0, 784, 101063, 138, 6.7117542999999955
139, 31.55706525991771, 65.66435665414353, 80.72256381452576, 0.8175429999999999, 65.0, 605, 101668, 139, 5.092826099999996
140, 28.139251259949603, 65.74864514458953, 80.73219294280503, 0.8161804000000006, 135.0, 909, 102577, 140, 7.835173200000014
141, 26.608092282003568, 65.6950444758517, 80.24229033016464, 0.8146207, 120.0, 824, 103401, 141, 7.000533399999995
142, 26.09780501683553, 65.46813153076172, 79.83570039876302, 0.8128666000000005, 210.0, 1125, 104526, 142, 9.805486599999995
143, 26.848695941623166, 65.41845641101865, 79.73764693445439, 0.8112285999999997, 125.0, 695, 105221, 143, 6.001787300000018
144, 22.65463888087468, 65.37967606594688, 79.51250416493555, 0.8099874999999997, 155.0, 684, 105905, 144, 5.9971320999999875
145, 22.96423812200559, 65.5241138087023, 79.42246123448314, 0.8088354999999997, 150.0, 596, 106501, 145, 5.270094500000027
146, 30.576544912441356, 65.54770545959472, 79.79200981758736, 0.8079661000000002, 90.0, 370, 106871, 146, 3.236898599999961
147, 24.56696704165614, 65.48848440077208, 79.50663554126118, 0.806545, 270.0, 1209, 108080, 147, 10.55651899999998
148, 23.172548496344955, 65.52886445597953, 79.3727835219279, 0.8046910000000003, 170.0, 851, 108931, 148, 7.4763103999999885
149, 21.773329780248602, 65.35026583294015, 78.89148541000232, 0.8033113, 130.0, 682, 109613, 149, 6.1628006000000255
150, 22.217693525838012, 65.60881392241124, 79.31889550811998, 0.8023402000000002, 90.0, 397, 110010, 150, 3.6914355000000114
151, 25.991484573815516, 66.58209448372317, 80.65881582729754, 0.8013285999999998, 125.0, 727, 110737, 151, 6.787708699999996
152, 19.6534679742507, 66.31891000064803, 80.45200029538002, 0.8003097999999998, 105.0, 405, 111142, 152, 3.6381364000000076
153, 18.26792016863823, 66.46131006876628, 80.38693672180176, 0.7994053000000001, 110.0, 600, 111742, 153, 5.501433299999974
154, 17.018066528297606, 66.39391232672192, 80.24880713508243, 0.7982605000000002, 165.0, 672, 112414, 154, 6.03670679999999
155, 21.606632537337898, 66.3602998363995, 80.37506440940902, 0.7971957999999997, 80.0, 511, 112925, 155, 4.693036300000017
156, 13.502517230198032, 66.30779902661433, 80.19762597318555, 0.7962967, 65.0, 488, 113413, 156, 4.435251899999969
157, 15.77364536304379, 66.24119284457433, 80.04826871198208, 0.7953148000000002, 75.0, 603, 114016, 157, 5.752737400000001
158, 15.257714676497569, 66.24410494128664, 80.14147696183555, 0.7944138999999997, 30.0, 398, 114414, 158, 3.7286956000000373
159, 17.30062180019745, 66.2828627378234, 80.14055116634803, 0.7929505000000003, 230.0, 1228, 115642, 159, 11.077810399999976
160, 17.320216104474373, 66.36891295592909, 80.30194250558841, 0.7915339, 20.0, 346, 115988, 160, 3.179448700000023
161, 15.504536067114936, 66.26687544834466, 79.96193448290413, 0.790858, 85.0, 405, 116393, 161, 3.7373474999999985
162, 15.420590158793342, 66.20722937674807, 79.98406554904342, 0.7890769000000003, 510.0, 1574, 117967, 162, 14.076905900000042
163, 16.48946354662008, 66.1440050760905, 79.81520154962492, 0.7867558000000002, 485.0, 1005, 118972, 163, 9.071643900000026
164, 15.440712822808159, 66.09328212778023, 79.78649955125725, 0.7854220000000002, 115.0, 477, 119449, 164, 4.351887000000033
165, 17.724069612887803, 67.23419199664552, 81.22016166409844, 0.7840512999999999, 275.0, 1046, 120495, 165, 9.44332410000004
166, 15.186181406026046, 68.40313281076516, 82.50818038664431, 0.7827616, 35.0, 387, 120882, 166, 3.6370714999999905
167, 17.000138678786296, 68.47203540314605, 82.59950904911177, 0.7818849999999996, 105.0, 587, 121469, 167, 5.617604400000005
168, 16.389609313395027, 68.31879042214273, 82.46172825466968, 0.7808535999999998, 110.0, 559, 122028, 168, 5.212791999999979
169, 15.695658506163015, 68.44680034714257, 82.59617933490932, 0.7798141000000003, 50.0, 596, 122624, 169, 5.560223199999996
170, 14.367399342782406, 68.45984079625993, 82.71811281521391, 0.7788826, 95.0, 439, 123063, 170, 4.087064899999973
171, 14.457458514845774, 68.36315161764718, 82.41162939668658, 0.7779267999999999, 90.0, 623, 123686, 171, 5.841154899999992
172, 14.956717287671976, 68.22494795404631, 82.32041528307158, 0.7769484999999999, 80.0, 464, 124150, 172, 4.321795100000031
173, 20.920927535050854, 68.26049330024844, 82.58714780279402, 0.7759783, 110.0, 614, 124764, 173, 5.830284300000017
174, 17.197937464168053, 68.34300403740569, 82.54506900001118, 0.7748361999999996, 110.0, 655, 125419, 174, 7.121037399999977
175, 13.446638657991562, 68.17962904883534, 82.22998851001415, 0.7735465000000001, 120.0, 778, 126197, 175, 8.857223200000021
176, 15.92698108893262, 68.45067071230217, 82.57622342816951, 0.7720938999999996, 240.0, 836, 127033, 176, 9.06373050000002
177, 16.46944938206074, 68.39877849561954, 82.48684122150371, 0.7707322, 110.0, 677, 127710, 177, 6.718994800000019
178, 13.572500079324394, 68.31228635599325, 82.36510742802324, 0.7691400999999994, 440.0, 1092, 128802, 178, 10.28442709999996
179, 16.887428299611248, 68.30433452224125, 82.53435989404142, 0.7675911999999999, 105.0, 629, 129431, 179, 5.975019099999997
180, 16.24328353624052, 68.2050919462933, 82.2724791830294, 0.7663491999999995, 110.0, 751, 130182, 180, 7.0950143000000025
181, 13.804051133603027, 67.95430519405731, 81.94293782724499, 0.7648768, 240.0, 885, 131067, 181, 8.31056030000002
182, 15.324513123634665, 67.90826048825514, 81.98777381366587, 0.7637436999999998, 60.0, 374, 131441, 182, 3.545936900000015
183, 8.319601792086937, 67.70913878900635, 81.52729845453162, 0.7628788000000001, 115.0, 587, 132028, 183, 5.733786100000032
184, 11.915388861602901, 67.7719141679003, 81.78241797357165, 0.7614163000000002, 320.0, 1038, 133066, 184, 9.819379200000014
185, 11.339244245118508, 67.83200120721253, 81.73720359529378, 0.759853, 130.0, 699, 133765, 185, 7.132664500000033
186, 9.314095282074947, 67.71416857132435, 81.60071302206434, 0.7586200000000001, 200.0, 671, 134436, 186, 6.588013599999954
187, 8.21687481686473, 67.77247192382812, 81.60544633865356, 0.7576561000000004, 120.0, 400, 134836, 187, 3.799875199999974
188, 12.847703229236691, 67.68741462259568, 81.66350525556496, 0.7563304000000001, 280.0, 1073, 135909, 188, 10.44400470000005
189, 8.301904978759222, 67.69360074954437, 81.47809896710015, 0.754759, 140.0, 673, 136582, 189, 6.5022696999999425
190, 9.457982366291008, 67.61473919043254, 81.3951016114711, 0.7535386, 105.0, 683, 137265, 190, 6.758204400000068
191, 12.50565896334348, 67.65288059528058, 81.5657936576363, 0.7524090999999997, 40.0, 572, 137837, 191, 5.952816900000016
192, 11.863316839391535, 67.69758289599021, 81.63667519592398, 0.7514092, 35.0, 539, 138376, 192, 5.364850599999954
193, 11.157062143371219, 67.54939960298084, 81.4098942166283, 0.7505461000000002, 10.0, 420, 138796, 193, 4.1901973000000226
194, 10.245477987842776, 67.63481855469739, 81.48082579824488, 0.7496127999999997, 110.0, 617, 139413, 194, 6.073721500000033
195, 11.18909536557303, 67.5947743252496, 81.50413057949002, 0.7484059000000001, 125.0, 724, 140137, 195, 7.091772699999979
196, 14.17089772686254, 67.64381276300783, 81.60912678297534, 0.7466391999999993, 460.0, 1239, 141376, 196, 13.136688599999957
197, 10.87786638078881, 67.58838747975021, 81.46996558709289, 0.7449859000000002, 95.0, 598, 141974, 197, 5.8855239000000665
198, 10.709763692220053, 67.55688782912034, 81.35223570994842, 0.7435701999999992, 375.0, 975, 142949, 198, 9.805238300000042
199, 10.932768344057017, 67.5546822488719, 81.34495741219357, 0.7420402000000005, 200.0, 725, 143674, 199, 7.166016099999979
200, 14.63514349079562, 67.67861816543855, 81.5998306274414, 0.7404895, 240.0, 998, 144672, 200, 10.219777399999998
201, 15.185005531231923, 67.51873934646538, 81.40482012718512, 0.7389946000000002, 75.0, 663, 145335, 201, 6.525051899999994
202, 12.734323554400024, 67.49296256412809, 81.34162430427243, 0.7377976000000003, 180.0, 667, 146002, 202, 6.588253899999927
203, 9.538869469396529, 67.38573668919001, 81.11394619312455, 0.7365835000000001, 140.0, 682, 146684, 203, 7.017036500000017
204, 9.293159956904663, 67.52768884856125, 81.31501172237469, 0.7354998999999998, 95.0, 522, 147206, 204, 5.293767099999968
205, 11.074224209544635, 67.30069273489492, 81.0599769309715, 0.7344954999999999, 155.0, 594, 147800, 205, 5.98345089999998
206, 7.885186555908947, 67.46500071083626, 81.21390727283509, 0.7335181000000002, 45.0, 492, 148292, 206, 4.91299319999996
207, 11.181488559440691, 67.4068538224616, 81.10336901606345, 0.7324137999999998, 110.0, 735, 149027, 207, 7.338710499999934
208, 10.952021270396024, 67.33514014132682, 81.03883333559389, 0.7314364000000001, 40.0, 351, 149378, 208, 3.560195300000032
209, 13.955059476348818, 67.48537557952258, 81.3307855437402, 0.7305913, 55.0, 588, 149966, 209, 5.869957800000066
210, 11.545581158849743, 67.01836129168531, 80.80268693137002, 0.7295473000000001, 105.0, 572, 150538, 210, 5.681027900000004
211, 9.657458416955391, 66.93007535339267, 80.66022019739248, 0.7284123999999998, 165.0, 689, 151227, 211, 6.890441199999941
212, 11.543890106961092, 66.99176295137028, 80.74769034675055, 0.7274512, 55.0, 379, 151606, 212, 3.746755099999973
213, 12.561205294101153, 66.94276537619933, 80.64974550783523, 0.7266268000000004, 35.0, 537, 152143, 213, 5.434105400000021
214, 10.890684998317345, 66.9621574513547, 80.73516602559133, 0.7253442999999999, 300.0, 888, 153031, 214, 9.084584099999915
215, 10.963932688922098, 67.04541915083584, 80.88173108558132, 0.7240194999999997, 55.0, 584, 153615, 215, 5.9878040999999484
216, 10.836487360454214, 66.95214164008121, 80.62807834563289, 0.7231059999999998, 25.0, 431, 154046, 216, 4.875839300000052
217, 10.302013640938545, 67.05168780467862, 80.72211935287132, 0.7219998999999998, 160.0, 798, 154844, 217, 8.10598010000001
218, 7.4922951071909285, 67.04303395457384, 80.71509339169758, 0.7206913, 135.0, 656, 155500, 218, 6.674166899999932
219, 8.690215022079315, 66.9819713332179, 80.65208747478904, 0.7194943000000005, 170.0, 674, 156174, 219, 6.760630800000058
220, 12.451130841983193, 67.00535494758483, 80.6765380492185, 0.7185511000000001, 70.0, 374, 156548, 220, 3.804833599999938
221, 10.42749243454942, 66.88418803453888, 80.71930472350961, 0.7177294000000001, 140.0, 539, 157087, 221, 5.563003299999991
222, 9.15139954405146, 67.0097873561733, 80.7041934359897, 0.7166449000000004, 155.0, 666, 157753, 222, 6.868890700000065
223, 10.513910722317902, 66.897341315228, 80.60094633682914, 0.7155279999999998, 110.0, 575, 158328, 223, 5.8422515999999405
224, 9.346152972530675, 66.87797380281282, 80.60034246129675, 0.7144110999999997, 125.0, 666, 158994, 224, 6.800020700000005
225, 9.367622224476946, 66.87803004624007, 80.58438578518954, 0.7129800999999996, 200.0, 924, 159918, 225, 9.40526890000001
226, 8.025300575249549, 67.35979749131835, 81.09790475693836, 0.7117066, 120.0, 491, 160409, 226, 5.029238300000088
227, 8.341870255380696, 67.2934671357877, 81.02763311573536, 0.7106419, 105.0, 692, 161101, 227, 7.087450999999987
228, 8.145742684295497, 67.42245617671287, 81.13269262075073, 0.7094080000000001, 110.0, 679, 161780, 228, 6.952038600000037
229, 9.1570266050203, 67.32781313898774, 81.10095210693581, 0.7078042, 550.0, 1103, 162883, 229, 11.247873400000003
230, 7.5441479159177405, 67.28822741988142, 81.05521167100534, 0.7063552, 55.0, 507, 163390, 230, 5.218128200000024
231, 9.418807149985257, 67.31664848888622, 81.12383620318245, 0.7052869000000002, 130.0, 680, 164070, 231, 6.942510699999957
232, 11.026835260814742, 67.30740870090953, 81.08275762636062, 0.7040593, 90.0, 684, 164754, 232, 7.020146899999986
233, 12.472610623932871, 67.38499584054588, 81.26612494045631, 0.7029648999999999, 65.0, 532, 165286, 233, 5.462145899999996
234, 9.025215796472283, 67.27650440498391, 81.06117504599172, 0.7019631999999999, 150.0, 581, 165867, 234, 6.058761300000015
235, 10.955325538379759, 67.424140698982, 81.28453101796552, 0.7007868999999999, 90.0, 726, 166593, 235, 7.613279199999965
236, 8.765544848059708, 67.39556161412654, 81.23120040413718, 0.6995611000000002, 120.0, 636, 167229, 236, 6.782138400000008
237, 8.332295650191979, 67.3924569420833, 81.13819255607929, 0.6980563000000007, 260.0, 1036, 168265, 237, 10.701839000000064
238, 8.39854275033471, 67.27637822665409, 80.99756315850233, 0.6963777999999997, 125.0, 829, 169094, 238, 8.65544239999997
239, 9.305137866623129, 67.30484542127773, 81.13791263791501, 0.6948676000000001, 125.0, 849, 169943, 239, 8.939871799999992
240, 5.889323249187347, 67.97071292626596, 81.79054541483413, 0.6936102999999999, 105.0, 548, 170491, 240, 5.801441400000044
241, 6.81396474137561, 68.06946965574308, 81.90542574875228, 0.6926454999999999, 105.0, 524, 171015, 241, 5.426279499999964
242, 8.973548932125171, 68.2512630780538, 82.23626678466798, 0.6916338999999999, 180.0, 600, 171615, 242, 6.280589500000019
243, 8.671527280470059, 68.09421140135302, 82.04159933563729, 0.6907059999999998, 35.0, 431, 172046, 243, 4.508812499999976
244, 8.855442369576139, 68.18793869899547, 82.10437150915556, 0.6899283999999999, 90.0, 433, 172479, 244, 4.562554599999999
245, 6.8880386570564855, 68.0750195174852, 81.95394912568649, 0.6887205999999999, 70.0, 909, 173388, 245, 9.718856499999902
246, 9.689765710102852, 68.0830360201735, 82.0240210720043, 0.6875442999999999, 45.0, 398, 173786, 246, 4.269308300000034
247, 10.033982918404117, 68.08865189316249, 82.17896125340226, 0.6868225, 85.0, 404, 174190, 247, 4.405656500000077
248, 8.464400262673303, 68.05178100913271, 81.96655307429852, 0.6859135000000002, 85.0, 606, 174796, 248, 6.461069800000018
249, 8.819898738502607, 68.22037213552889, 82.18430500777167, 0.6848622999999997, 90.0, 562, 175358, 249, 6.063968100000011
250, 6.615571711791481, 68.12041183901242, 81.9488254206271, 0.6836211999999998, 450.0, 817, 176175, 250, 8.790481
251, 8.216828994942407, 68.07552254577043, 82.01748649801361, 0.6821460999999996, 245.0, 822, 176997, 251, 8.766160500000069
252, 9.81980389012929, 67.99656024914007, 81.91085696024007, 0.6808599999999998, 120.0, 607, 177604, 252, 6.585693900000024
253, 19.129428431850215, 68.24897242815067, 82.56853895920973, 0.6799626999999998, 65.0, 390, 177994, 253, 4.345867500000054
254, 7.370045357108117, 67.98458086395263, 81.8091398010254, 0.6791616999999998, 125.0, 500, 178494, 254, 5.410407899999996
255, 9.80926100229583, 68.04694142757174, 81.89535042383822, 0.6781023999999999, 155.0, 677, 179171, 255, 7.360490400000003
256, 8.838736015453014, 68.09530914325883, 81.94783925348693, 0.6767793999999999, 160.0, 793, 179964, 256, 8.604983199999992
257, 8.39194334574265, 67.97713092766186, 81.92606794904954, 0.6756112, 65.0, 505, 180469, 257, 5.468603499999972
258, 10.202650971678334, 68.0039568899682, 81.91544971383256, 0.6745348000000003, 155.0, 691, 181160, 258, 7.457785100000024
259, 7.347177269606056, 67.80750636980801, 81.56093311678029, 0.6734466999999997, 180.0, 518, 181678, 259, 5.619845000000055
260, 10.03481082222556, 68.01948603398382, 81.9367146752424, 0.6725026, 135.0, 531, 182209, 260, 5.8386906999999155
261, 7.875018180580304, 67.86648015086408, 81.68521478946711, 0.6716098, 95.0, 461, 182670, 261, 5.138211200000001
262, 7.216441721610326, 67.95336228259661, 81.82598214485732, 0.6701356000000002, 435.0, 1177, 183847, 262, 12.713193199999978
263, 8.914209878835521, 68.02506588681445, 81.96377274673848, 0.6684723999999999, 120.0, 671, 184518, 263, 7.313574100000096
264, 8.399163432942734, 67.93035318463016, 81.793812202944, 0.6672664000000001, 210.0, 669, 185187, 264, 7.422663100000136
265, 7.645551795625985, 67.82785685226663, 81.65459760693767, 0.6658021000000002, 350.0, 958, 186145, 265, 10.583567800000083
266, 6.723104168677036, 67.80221546314381, 81.57557634895231, 0.6645753999999998, 75.0, 405, 186550, 266, 4.471105800000032
267, 7.80817981458999, 67.88639900276253, 81.71975199381511, 0.6637113999999998, 70.0, 555, 187105, 267, 6.235408799999959
268, 6.288021942730215, 67.81482334781593, 81.58865047022552, 0.6627592, 60.0, 503, 187608, 268, 5.743936000000076
269, 6.32277691663652, 67.94672295428823, 81.80085246530787, 0.6617062000000001, 115.0, 667, 188275, 269, 7.5087418000000525
270, 9.124650782745526, 68.00693427805012, 82.0243536757733, 0.6606082000000002, 40.0, 553, 188828, 270, 6.1409748999999465
271, 7.734150423196131, 67.90272054118002, 81.73424786890676, 0.6596614, 60.0, 499, 189327, 271, 5.548228000000108
272, 6.370599865231935, 67.86278235621569, 81.61096871771464, 0.6586219, 430.0, 656, 189983, 272, 7.2780548999999155
273, 7.710776596555389, 69.43734559513386, 83.60929074370652, 0.6573097000000002, 230.0, 802, 190785, 273, 8.777395800000022
274, 9.180231579321122, 69.4311677959944, 83.58771786939134, 0.65602, 195.0, 631, 191416, 274, 7.0241662000000815
275, 5.271449426390196, 69.29688979314527, 83.37185382395283, 0.6550687000000002, 20.0, 426, 191842, 275, 4.759704399999919
276, 9.510223526881894, 69.52835136019569, 83.77233484115959, 0.6537267999999994, 180.0, 1065, 192907, 276, 11.833839299999909
277, 9.627939313117947, 69.48269623347691, 83.63440671648299, 0.6522643000000001, 55.0, 560, 193467, 277, 6.29004000000009
278, 6.661883703854651, 69.48081711759785, 83.65197466872026, 0.6512076999999997, 125.0, 614, 194081, 278, 6.853146100000004
279, 8.251758739987821, 69.50344611796157, 83.62041415535444, 0.6502752999999999, 20.0, 422, 194503, 279, 4.713040699999965
280, 7.142096624367408, 69.47149000265588, 83.55749469271167, 0.6492808000000004, 150.0, 683, 195186, 280, 7.651644900000065
281, 7.089655370843188, 69.39581719514365, 83.52647109343627, 0.6482808999999998, 35.0, 428, 195614, 281, 4.79706340000007
282, 8.54467890692274, 69.30375917429524, 83.45617357372915, 0.6475636, 75.0, 369, 195983, 282, 4.148073199999999
283, 7.022080545319564, 69.48626912219832, 83.53229346890278, 0.6468057999999999, 45.0, 473, 196456, 283, 5.297365600000148
284, 10.923124529389243, 69.47772210225476, 83.72674940373751, 0.6453351999999993, 210.0, 1161, 197617, 284, 12.89848239999992
285, 8.087496941198003, 69.34707494958654, 83.44445632340071, 0.6439438, 105.0, 385, 198002, 285, 4.344836799999939
286, 7.373878094320204, 69.37146343156404, 83.52509668387619, 0.6431382999999999, 70.0, 510, 198512, 286, 5.815475600000127
287, 8.621319809620795, 69.3321481290071, 83.46638813848081, 0.6418513000000003, 120.0, 920, 199432, 287, 10.505946799999947
288, 8.551928265058265, 69.4133283264783, 83.5430812316687, 0.6404941, 90.0, 588, 200020, 288, 6.6927160000000185
289, 8.081874865851447, 69.09228727842938, 83.18937596011924, 0.6387823000000008, 190.0, 1314, 201334, 289, 14.796533000000181
290, 4.983763262396223, 69.09823032088009, 83.0622204745119, 0.6371397999999998, 40.0, 511, 201845, 290, 5.798409499999934
291, 5.9912715186180865, 69.1272516655538, 83.13291017412267, 0.6360651999999999, 130.0, 683, 202528, 291, 7.764304999999922
292, 6.287730777138235, 69.08653176184929, 83.13754089279931, 0.6350868999999999, 80.0, 404, 202932, 292, 4.634485300000051
293, 6.967588627806771, 69.10428590480137, 83.16536174520809, 0.6337611999999998, 370.0, 1069, 204001, 293, 12.153746500000125
294, 12.968252853521145, 69.16866404288469, 83.40454849177488, 0.6321718000000002, 155.0, 697, 204698, 294, 8.080861299999924
295, 8.057385106832001, 69.06746163510665, 83.14661813358833, 0.6309118000000002, 180.0, 703, 205401, 295, 8.109882700000071
296, 7.949981035880166, 69.23421668099526, 83.36976207606199, 0.6297112000000002, 135.0, 631, 206032, 296, 7.354495400000133
297, 6.937217570569204, 69.16085361646569, 83.23411323879075, 0.6286257999999997, 30.0, 575, 206607, 297, 6.864273199999843
298, 10.842503816079992, 69.16450518382383, 83.29350580081248, 0.6276862000000001, 30.0, 469, 207076, 298, 5.7405251000000135
299, 7.819584863352928, 68.96250822225194, 82.95780380151834, 0.6265576000000002, 155.0, 785, 207861, 299, 9.256781000000046
300, 6.359233601225747, 69.03367555092392, 83.05201218844441, 0.6251950000000003, 210.0, 729, 208590, 300, 8.481389099999888
301, 5.794176746144334, 69.03288726490068, 83.02650486483118, 0.6241051000000003, 60.0, 482, 209072, 301, 5.667909899999813
302, 7.8327833360317785, 69.03556212179095, 83.1063623913563, 0.6226983999999994, 355.0, 1081, 210153, 302, 14.1164718
303, 6.682431205421312, 68.81572844692853, 82.7541360150155, 0.6210802000000004, 340.0, 717, 210870, 303, 9.21278889999985
304, 6.531626625494524, 68.87830568642696, 82.93533521945932, 0.6199497999999998, 180.0, 539, 211409, 304, 6.655700799999977
305, 7.692053031388134, 68.9054986449787, 82.92130784765135, 0.6189264999999998, 85.0, 598, 212007, 305, 7.359063900000137
306, 6.085872907081299, 68.87369401920476, 82.83984463783881, 0.617932, 50.0, 507, 212514, 306, 5.906913999999915
307, 9.070713849153568, 68.74970688337322, 82.75312383792412, 0.6169510000000002, 100.0, 583, 213097, 307, 7.137282200000072
308, 5.571505918208655, 68.80188331108589, 82.79124082094663, 0.6160797999999998, 75.0, 385, 213482, 308, 4.631455199999891
309, 5.575332028424971, 68.83910369873047, 82.73708535825777, 0.6150834999999999, 200.0, 722, 214204, 309, 8.660460600000079
310, 7.748867183923721, 68.95221930304878, 82.98370762008557, 0.6138082000000001, 180.0, 695, 214899, 310, 8.917853799999875
311, 7.48787730449824, 68.89695914014638, 82.92509806241921, 0.6126823, 95.0, 556, 215455, 311, 6.797250000000076
312, 8.080534313129379, 68.83377179766035, 82.87657875114388, 0.6115383999999998, 125.0, 715, 216170, 312, 8.344868900000165
313, 7.956976588728816, 68.88488234290782, 82.89865284803918, 0.6101982999999999, 210.0, 774, 216944, 313, 9.464663599999994
314, 6.297447808764198, 68.82225886524974, 82.83271141852532, 0.6088581999999997, 265.0, 715, 217659, 314, 8.987856100000045
315, 7.077415995108775, 68.75579605102538, 82.79339650472005, 0.6078637, 65.0, 390, 218049, 315, 4.710532600000079
316, 5.506087404981164, 68.9423698844832, 82.90336032409047, 0.6070708000000002, 60.0, 491, 218540, 316, 6.18850939999993
317, 6.459217110140757, 68.73422301111142, 82.68405627416185, 0.6061932999999998, 120.0, 484, 219024, 317, 6.436267199999975
318, 5.910931565406814, 68.80109521083475, 82.781378533821, 0.605422, 50.0, 373, 219397, 318, 4.4760868000000755
319, 11.129573507768912, 68.70916226844648, 82.78088957398802, 0.6043492, 290.0, 819, 220216, 319, 9.877059800000097
320, 7.780845721992047, 67.91918711655187, 81.73867314618676, 0.6030082, 110.0, 671, 220887, 320, 8.28805340000008
321, 6.326872437815123, 68.06442736372163, 81.92776960863846, 0.6019776999999997, 120.0, 474, 221361, 321, 5.823401800000056
322, 6.784036268258379, 68.05010500408355, 81.90826665787469, 0.6010975000000001, 125.0, 504, 221865, 322, 6.047206299999971
323, 7.522788926215596, 67.94432026496936, 81.79703357886855, 0.6002289999999999, 110.0, 461, 222326, 323, 5.878679099999999
324, 9.090274138141291, 67.99482820900738, 81.87108104056799, 0.5990787999999998, 110.0, 817, 223143, 324, 10.465853499999866
325, 7.303009149592246, 67.91647303744655, 81.68568769684228, 0.5979916, 15.0, 391, 223534, 325, 4.90024470000003
326, 6.0443263041929605, 68.00308780252499, 81.825555272346, 0.5971465, 100.0, 548, 224082, 326, 6.655364299999974
327, 6.177969197285028, 68.00666410187144, 81.77362314860027, 0.5959243000000001, 135.0, 810, 224892, 327, 9.7873368999999
328, 9.076694825416133, 67.86307092372805, 81.66082162085152, 0.5948505999999999, 45.0, 383, 225275, 328, 4.739257200000111
329, 8.24483711992457, 68.03881433601968, 81.97689455521892, 0.5938642, 125.0, 713, 225988, 329, 8.801226999999926
330, 7.054041190887924, 67.9214331956125, 81.77929043044324, 0.5923647999999997, 310.0, 953, 226941, 330, 11.584997199999862
331, 8.007216499858005, 67.83227872335783, 81.62735065337151, 0.5911723, 60.0, 372, 227313, 331, 4.566968800000041
332, 6.291461924675341, 67.84179523879406, 81.59489555919872, 0.5901031000000002, 240.0, 816, 228129, 332, 10.140436500000078
333, 6.836314519241936, 67.92715534320376, 81.74965281434868, 0.5883715000000004, 255.0, 1108, 229237, 333, 13.8822889999999
334, 7.713247656775198, 67.87904865132522, 81.72871442247265, 0.5868037000000002, 90.0, 634, 229871, 334, 7.721713800000089
335, 8.815870287042422, 67.6486461721662, 81.52608256584229, 0.5855653, 200.0, 742, 230613, 335, 9.126108199999862
336, 8.499732520974716, 67.51799640695842, 81.2763574289721, 0.5840460999999998, 210.0, 946, 231559, 336, 12.54861619999997
337, 4.722237337767028, 67.54213315213497, 81.20643511210402, 0.5827348, 50.0, 511, 232070, 337, 6.33215180000002
338, 8.533760521964282, 67.60501164843322, 81.40311785412442, 0.5817097, 185.0, 628, 232698, 338, 8.458372800000006
339, 9.191530688905125, 67.68338529982434, 81.44935792149406, 0.5808537999999998, 35.0, 323, 233021, 339, 4.046520899999905
340, 7.383241351005557, 67.5717466324778, 81.33035705523363, 0.5799249999999999, 165.0, 709, 233730, 340, 8.907745099999829
341, 8.397972008300519, 67.64505029521169, 81.46675374938013, 0.5788827999999999, 35.0, 449, 234179, 341, 5.5328269999999975
342, 6.613596769182522, 67.68879402275992, 81.50588387804464, 0.578062, 125.0, 463, 234642, 342, 5.94057029999999
343, 7.8242872003810335, 67.59138566365792, 81.3424083226775, 0.5770125999999999, 155.0, 703, 235345, 343, 8.722531900000149
344, 9.622842947917409, 67.64413275388208, 81.4442241102162, 0.5759254, 75.0, 505, 235850, 344, 6.884021000000075
345, 6.66588657791134, 67.53447582297129, 81.2071196972274, 0.5750109999999999, 60.0, 511, 236361, 345, 6.818142699999953
346, 6.207330604901119, 67.64272477953496, 81.39285207142288, 0.5739336999999998, 180.0, 686, 237047, 346, 8.340124500000002
347, 6.854802650187099, 67.622599548206, 81.35734074241236, 0.5722902999999996, 335.0, 1140, 238187, 347, 14.01304610000011
348, 9.947816762317151, 67.58164859785805, 81.44504224770183, 0.5707765, 105.0, 542, 238729, 348, 6.784274099999948
349, 5.685154857479931, 67.46159717414386, 81.15837061370223, 0.5696748999999997, 185.0, 682, 239411, 349, 8.3896072
350, 8.939730606887533, 67.48542332766678, 81.28408812223789, 0.568513, 150.0, 609, 240020, 350, 7.626554700000042
351, 6.1213260031704895, 67.11516961225661, 80.74647803628706, 0.5670189999999997, 395.0, 1051, 241071, 351, 13.071726900000158
352, 6.160039859775483, 67.11044079637902, 80.70652358888641, 0.5655015999999998, 125.0, 635, 241706, 352, 8.006838099999868
353, 7.775221025725023, 67.13121969473836, 80.78859002582888, 0.5643415, 200.0, 654, 242360, 353, 8.149675299999899
354, 6.618862573475597, 67.14889147254637, 80.79924425307803, 0.5628789999999998, 465.0, 971, 243331, 354, 11.995420700000068
355, 5.699217332773898, 67.09706042604144, 80.69224232467869, 0.5611833999999997, 180.0, 913, 244244, 355, 12.284988600000133
356, 7.526638088604177, 67.07310681122382, 80.79585767962655, 0.5597199999999998, 40.0, 713, 244957, 356, 9.450667100000146
357, 5.171919871647694, 67.14055623650894, 80.71930637414586, 0.5584536999999997, 165.0, 694, 245651, 357, 9.019923299999846
358, 7.246606264076635, 67.17206855814186, 80.87926712640042, 0.5571468999999998, 140.0, 758, 246409, 358, 9.320016499999838
359, 6.548695451311065, 67.1468383823847, 80.77480384571574, 0.5558724999999999, 130.0, 658, 247067, 359, 8.152665800000023
360, 8.263443204683908, 67.183869426965, 80.92641940244228, 0.5543703999999998, 240.0, 1011, 248078, 360, 12.038506999999981
361, 7.983410689209584, 67.06657889321886, 80.69015401526343, 0.5530339000000001, 75.0, 474, 248552, 361, 5.653459800000064
362, 7.943631450255553, 67.3452123745171, 80.98379264326994, 0.5521582, 135.0, 499, 249051, 362, 5.995860499999935
363, 5.655963405966759, 67.1587835170296, 80.77487092663628, 0.5512969, 80.0, 458, 249509, 363, 5.510510900000099
364, 4.365415690080175, 66.98160288725902, 80.5576784077359, 0.5505507999999999, 35.0, 371, 249880, 364, 4.526133100000152
365, 5.48597012103643, 66.41448671126328, 79.88060885034915, 0.5496490000000002, 95.0, 631, 250511, 365, 8.109038800000008
366, 8.48617957003491, 66.26196414049168, 79.79959756115598, 0.5485536999999998, 210.0, 586, 251097, 366, 7.509645800000044
367, 5.79105505407662, 66.14457879624925, 79.5315302771491, 0.5476266999999999, 65.0, 444, 251541, 367, 5.710779400000092
368, 6.478392954435498, 65.99216663214388, 79.4030712008061, 0.5467105000000001, 90.0, 574, 252115, 368, 6.93106929999999
369, 6.726498727320399, 66.13195708600905, 79.55921459443158, 0.5454936999999999, 235.0, 778, 252893, 369, 9.527413900000056
370, 7.8513351079890725, 66.0581910176446, 79.48290647662749, 0.5440563999999999, 140.0, 819, 253712, 370, 9.837839600000052
371, 6.057382381071627, 66.11347442440491, 79.63207056857418, 0.5428774, 110.0, 491, 254203, 371, 5.943916100000024
372, 9.654487096973993, 66.22849768481208, 79.78342428855525, 0.541972, 105.0, 515, 254718, 372, 6.112191800000119
373, 6.762930113760676, 66.21333061640881, 79.68486289125374, 0.5405824000000002, 480.0, 1029, 255747, 373, 12.40002299999992
374, 5.735153628105602, 65.99262285100455, 79.39317793066812, 0.5393313999999998, 50.0, 361, 256108, 374, 4.398615300000074
375, 5.9640175214142195, 66.0963588871368, 79.52325207203673, 0.5384151999999999, 210.0, 657, 256765, 375, 8.021451600000091
376, 6.127018912611027, 66.13411265981524, 79.53613292115872, 0.5369392, 280.0, 983, 257748, 376, 12.17967079999994
377, 10.231369947464692, 66.0997142791748, 79.75087728954497, 0.5356764999999999, 65.0, 420, 258168, 377, 5.241031600000042
378, 6.009324355059612, 66.01957020974642, 79.41947675974892, 0.5347197999999999, 55.0, 643, 258811, 378, 7.931252299999869
379, 6.982826202006956, 66.0737943858983, 79.51895818651613, 0.5331177999999996, 315.0, 1137, 259948, 379, 13.996703699999898
380, 6.463172226984993, 65.4857531598506, 78.78666612464963, 0.5315049999999998, 135.0, 655, 260603, 380, 8.154501799999935
381, 6.237277739444134, 65.3618390752662, 78.63685959762668, 0.5303359, 155.0, 644, 261247, 381, 7.976843400000007
382, 8.019813454868485, 65.36907940258229, 78.71690325763427, 0.5286196000000001, 375.0, 1263, 262510, 382, 15.592898800000057
383, 9.446592121346233, 65.4534660379092, 78.78582448760669, 0.5267917000000001, 390.0, 768, 263278, 383, 9.54551239999978
384, 8.729068344593047, 65.32457685343425, 78.62070294189454, 0.5257630000000001, 35.0, 375, 263653, 384, 4.751289600000064
385, 9.216939684568695, 65.48950694762554, 78.83219238865533, 0.5248143999999999, 150.0, 679, 264332, 385, 8.46361079999997
386, 7.110387802150281, 65.43986653735459, 78.70154685806072, 0.5231818, 425.0, 1135, 265467, 386, 14.087804399999868
387, 6.861695517990606, 65.52182598655105, 78.90391689327592, 0.5216526999999999, 105.0, 564, 266031, 387, 7.070144600000049
388, 8.00888060458074, 65.46984446160147, 78.78285074679651, 0.5203747, 135.0, 856, 266887, 388, 11.267773399999896
389, 10.123939837235428, 65.404235590115, 78.75982849150047, 0.5186556999999997, 240.0, 1054, 267941, 389, 14.18949399999974
390, 7.437366445642726, 65.40309467367645, 78.64584235209536, 0.5170465000000002, 185.0, 734, 268675, 390, 9.928293399999802
391, 7.15807965146327, 65.34659298794672, 78.68456859554007, 0.5158900000000001, 35.0, 551, 269226, 391, 7.475458100000196
392, 6.379738786205144, 65.37701810426974, 78.64894754782632, 0.5148369999999999, 135.0, 619, 269845, 392, 8.424282800000128
393, 6.185327383351547, 65.41302310095892, 78.71312878926595, 0.5137939, 65.0, 540, 270385, 393, 7.37817079999968
394, 7.322441157009734, 65.35087222190359, 78.7351580864221, 0.5129497000000001, 45.0, 398, 270783, 394, 5.456266700000015
395, 5.023885471666301, 65.26977602358218, 78.50722279866537, 0.5119839999999998, 165.0, 675, 271458, 395, 9.3182611000002
396, 7.257924926310162, 65.33820012604191, 78.63814978033986, 0.5105493999999998, 240.0, 919, 272377, 396, 12.634839199999988
397, 7.497894623026649, 65.2532923440905, 78.49767335161611, 0.5091156999999998, 180.0, 674, 273051, 397, 9.257466600000043
398, 5.895246198853931, 65.29170223770329, 78.513574473688, 0.5077764999999997, 150.0, 814, 273865, 398, 11.250064800000018
399, 4.854124876525667, 65.38744049072265, 78.6604819615682, 0.5067199000000001, 20.0, 360, 274225, 399, 4.970756900000197
400, 8.12917191827848, 65.50176206909784, 78.95439604957505, 0.5058505000000001, 55.0, 606, 274831, 400, 8.396269000000302
401, 6.732475902908926, 65.37458189784088, 78.59728414288499, 0.5048812, 20.0, 471, 275302, 401, 6.648706199999651
402, 7.251703484264249, 65.36150945443117, 78.70308017619432, 0.5036859999999999, 295.0, 857, 276159, 402, 12.07461420000027
403, 8.309051218056082, 65.36507245757122, 78.74854806671567, 0.5022684999999998, 115.0, 718, 276877, 403, 9.992559600000277
404, 6.800290409888806, 65.42451918389627, 78.72063232271418, 0.5005270000000002, 420.0, 1217, 278094, 404, 16.7067705999998
405, 7.381471898828082, 65.31262925971396, 78.64791389969402, 0.49862800000000007, 185.0, 893, 278987, 405, 12.367112299999917
406, 8.733167580008693, 65.25406922800013, 78.55138982895592, 0.49725100000000005, 130.0, 637, 279624, 406, 8.890728299999864
407, 6.6324212195172265, 65.44253607841821, 78.73241889674799, 0.4961359000000002, 80.0, 602, 280226, 407, 8.49148299999979
408, 5.217174817973601, 65.56679835194402, 78.90623990161774, 0.4952854, 55.0, 343, 280569, 408, 4.934193399999913
409, 7.772914966257425, 65.53251687822029, 78.92729396492754, 0.4943997999999999, 130.0, 641, 281210, 409, 8.881234699999823
410, 8.823632502222239, 65.36344500869068, 78.68576559949277, 0.49321990000000016, 160.0, 670, 281880, 410, 9.401333799999975
411, 7.242086427964373, 65.48578734038979, 78.81864829583468, 0.49203100000000016, 110.0, 651, 282531, 411, 9.147867099999985
412, 9.310277932909484, 65.49111614401217, 78.87341328304952, 0.49085289999999976, 145.0, 658, 283189, 412, 9.323021000000153
413, 6.470789481703164, 65.59974809556682, 78.92965452132687, 0.4898980000000001, 35.0, 403, 283592, 413, 5.7284223000001475
414, 5.765172403205578, 65.37771745882291, 78.62983820199383, 0.4887991000000001, 205.0, 818, 284410, 414, 11.528666000000158
415, 6.135115364520608, 65.51849739876903, 78.78597510421037, 0.4876605999999999, 105.0, 447, 284857, 415, 6.509208200000103
416, 5.849711781345917, 65.39232413839892, 78.65037567296999, 0.48656439999999984, 215.0, 771, 285628, 416, 10.976351899999827
417, 4.932035581433568, 65.5099505884894, 78.8968071937561, 0.4854528999999999, 80.0, 464, 286092, 417, 6.604870900000151
418, 9.024874836740125, 65.43039983449175, 78.81860009282406, 0.48408039999999974, 240.0, 1061, 287153, 418, 15.03559610000002
419, 8.429331393176337, 65.3918934676792, 78.71227663789554, 0.48233979999999993, 315.0, 873, 288026, 419, 12.426348099999814
420, 5.356989478496195, 65.38557089885683, 78.62021520483584, 0.48096459999999974, 95.0, 655, 288681, 420, 9.241822400000274
421, 5.607299131041731, 65.37005898548149, 78.62332297765721, 0.4791439000000002, 380.0, 1368, 290049, 421, 19.75917619999973
422, 5.399054008220236, 64.74126611466542, 77.87719978678561, 0.477496, 90.0, 463, 290512, 422, 6.607255500000065
423, 4.788668424430045, 64.74809972884808, 77.89742181656209, 0.47665630000000003, 105.0, 470, 290982, 423, 6.725591500000064
424, 8.351527496302872, 64.65374737438302, 77.83802486857178, 0.4757860000000001, 45.0, 497, 291479, 424, 7.20394239999996
425, 7.178735887238909, 64.78671641858577, 77.94047062686892, 0.47461329999999996, 120.0, 806, 292285, 425, 11.628724500000317
426, 4.605076888212063, 64.62431808774262, 77.71606129762472, 0.4735701999999999, 10.0, 353, 292638, 426, 5.371750999999676
427, 5.8205444288454355, 64.73992399482196, 77.87931911354093, 0.47202219999999995, 470.0, 1367, 294005, 427, 19.74398149999979
428, 6.539657256462995, 64.81883235258215, 78.0010499123966, 0.4704093999999999, 80.0, 425, 294430, 428, 6.286481300000105
429, 9.096689700227474, 64.82400559393514, 78.1253954791871, 0.46946080000000007, 140.0, 629, 295059, 429, 9.123244899999918
430, 6.1588810418761755, 64.7525350414732, 77.86615755093173, 0.4681791999999999, 185.0, 795, 295854, 430, 11.529297000000042
431, 6.118940763097878, 64.82332650820415, 77.99320435523987, 0.4671180999999999, 105.0, 384, 296238, 431, 5.610879900000327
432, 7.356973354846171, 64.79211382530714, 77.97905685355605, 0.46597869999999986, 185.0, 882, 297120, 432, 12.915571900000032
433, 8.754796033288848, 64.87256424276679, 78.15137155206354, 0.4643856999999998, 220.0, 888, 298008, 433, 12.895914500000345
434, 6.840920212454424, 64.88238838789705, 78.0820214277256, 0.4628349999999998, 195.0, 835, 298843, 434, 12.310956299999816
435, 7.6595625856361105, 64.84906475730146, 78.04554423757403, 0.46172620000000003, 65.0, 397, 299240, 435, 5.708360699999957
436, 7.0450020497461185, 64.76064808431785, 77.90365115079013, 0.4605868, 110.0, 869, 300109, 436, 12.881042200000138
437, 5.506017675231162, 64.3328172700447, 77.38067344197056, 0.4593942999999998, 135.0, 456, 300565, 437, 6.892276399999901
438, 6.431828756204153, 64.49915621508013, 77.61102138230153, 0.4582477000000001, 215.0, 818, 301383, 438, 12.309662900000149
439, 6.404933991593234, 64.444228249307, 77.58345019891395, 0.4569319000000001, 45.0, 644, 302027, 439, 9.495402800000193
440, 7.029466034469734, 64.43148807750708, 77.4943525513434, 0.4557573999999998, 135.0, 661, 302688, 440, 9.721165800000108
441, 9.393379308810804, 64.59031046808293, 77.84261581961033, 0.45475570000000004, 85.0, 452, 303140, 441, 6.7210691000000224
442, 7.42833942674439, 64.2010761716149, 77.21384180675854, 0.4540321, 50.0, 352, 303492, 442, 5.373365300000387
443, 5.728766275371115, 64.41027889251708, 77.48295551300049, 0.45317529999999984, 150.0, 600, 304092, 443, 9.004006799999843
444, 4.775175019901676, 64.38099986314774, 77.3965682066404, 0.45188649999999997, 155.0, 832, 304924, 444, 12.54875009999978
445, 5.465416224981387, 64.32175793985682, 77.31548037992061, 0.45045189999999996, 215.0, 762, 305686, 445, 11.409570700000131
446, 6.530047126474433, 64.40240141007094, 77.49441786415072, 0.44928189999999996, 45.0, 538, 306224, 446, 8.057753200000207
447, 6.262850554482254, 64.45831866314892, 77.53095319498554, 0.44828830000000003, 110.0, 566, 306790, 447, 8.422404399999778
448, 6.141240351032793, 64.28030055680006, 77.4169488204153, 0.44731719999999997, 60.0, 513, 307303, 448, 7.6540006999998695
449, 10.25299034791964, 64.32903841984125, 77.44133191049835, 0.4465638999999998, 45.0, 324, 307627, 449, 4.887353900000107
450, 7.824039034048716, 64.48546111618263, 77.57140077231587, 0.4456513000000001, 330.0, 690, 308317, 450, 10.286944500000118
451, 6.529607526446539, 64.34919812374079, 77.4036982010822, 0.4445451999999999, 100.0, 539, 308856, 451, 8.147963099999743
452, 8.413570191450475, 64.43118625480687, 77.59159985152225, 0.4434813999999999, 215.0, 643, 309499, 452, 9.734319099999993
453, 7.139258831308689, 64.42779627740383, 77.58592901229858, 0.44175069999999994, 335.0, 1280, 310779, 453, 18.99518560000024
454, 5.922741597307392, 64.38497890391872, 77.49044167194623, 0.4401297999999999, 145.0, 521, 311300, 454, 7.886598999999933
455, 7.533904997886031, 64.6332503323076, 77.80719308695872, 0.43906059999999986, 110.0, 667, 311967, 455, 10.165605300000152
456, 9.296198177553878, 64.51509666442871, 77.65339965098288, 0.43788970000000005, 190.0, 634, 312601, 456, 9.707595099999708
457, 7.235588942353121, 64.48828397077672, 77.61640550809749, 0.43633989999999984, 430.0, 1088, 313689, 457, 16.294742499999757
458, 7.639848821020126, 64.50045494384766, 77.68894300537109, 0.4347981999999998, 125.0, 625, 314314, 458, 9.471846899999946
459, 4.350198111788579, 64.47448712767138, 77.51222193600684, 0.43384780000000006, 80.0, 431, 314745, 459, 6.673635600000125
460, 6.559902369134254, 64.4934379229815, 77.61454422102929, 0.4325518000000001, 210.0, 1009, 315754, 460, 15.359278899999936
461, 5.713226091671498, 64.38419815109856, 77.46215776252167, 0.4310514999999999, 135.0, 658, 316412, 461, 9.984623100000135
462, 4.502123570242493, 64.40896521892745, 77.51058116401593, 0.43011010000000005, 75.0, 388, 316800, 462, 5.9873993000001065
463, 7.370800554784327, 64.52436276873806, 77.66283827687538, 0.42934149999999993, 125.0, 466, 317266, 463, 7.172772399999758
464, 9.554011167210387, 64.41367324318473, 77.6073600889191, 0.4284648999999999, 65.0, 508, 317774, 464, 7.787191200000052
465, 6.790895975388513, 64.45547695726451, 77.55175433772625, 0.4270987000000001, 220.0, 1010, 318784, 465, 15.513598699999875
466, 5.333047750614981, 64.3654103228154, 77.4567023240883, 0.42560020000000004, 80.0, 655, 319439, 466, 10.127259800000047
467, 6.588194714566785, 64.26336785104064, 77.3269858424439, 0.4238064999999999, 375.0, 1338, 320777, 467, 20.512274100000013
468, 7.950205345398824, 64.00483794834302, 77.09343645600933, 0.4221468999999999, 105.0, 506, 321283, 468, 7.839709899999889
469, 4.719304084869957, 63.94637774978944, 76.9092911686374, 0.42110919999999996, 170.0, 647, 321930, 469, 10.02219279999963
470, 8.326289788656627, 64.20923507336488, 77.35222197070564, 0.42017769999999993, 125.0, 388, 322318, 470, 6.0611675000000105
471, 6.655429064044877, 64.15210304058418, 77.17422502507608, 0.41914809999999975, 215.0, 756, 323074, 471, 11.743231599999945
472, 6.993356224831114, 64.15076354006503, 77.19619512896166, 0.41783319999999974, 140.0, 705, 323779, 472, 11.071951900000386
473, 10.467477017885138, 64.19523348479436, 77.26404637303845, 0.4167811, 35.0, 464, 324243, 473, 7.517464899999595
474, 7.444047688185668, 64.0995409949487, 77.14775242524989, 0.4155067, 325.0, 952, 325195, 474, 15.218094899999869
475, 6.431645955315478, 64.11001901848371, 77.13650835291276, 0.41379849999999974, 135.0, 946, 326141, 475, 14.73968670000022
476, 4.652412863057337, 64.12363321666096, 77.1221545697864, 0.41214519999999977, 485.0, 891, 327032, 476, 14.046048900000187
477, 8.602725858707085, 64.05101614715542, 77.14332565153488, 0.41054140000000006, 140.0, 891, 327923, 477, 13.927036900000076
478, 4.937938380187208, 64.04046388105913, 76.98702216408469, 0.40924449999999996, 75.0, 550, 328473, 478, 8.604192400000102
479, 6.072824788198137, 64.12058508226846, 77.15719225890655, 0.4076722, 410.0, 1197, 329670, 479, 18.756936400000086
480, 8.077189595257906, 64.15362102979377, 77.21356729656382, 0.4062375999999999, 65.0, 397, 330067, 480, 6.3992238000000725
481, 8.231520240879938, 63.907061354798486, 76.9291458641065, 0.40534299999999995, 60.0, 597, 330664, 481, 9.42069870000023
482, 6.550283152016864, 63.86695827192562, 76.8123224464951, 0.40424050000000006, 60.0, 628, 331292, 482, 9.955259599999863
483, 8.195903067009898, 64.01425665712205, 77.05908255531384, 0.40311189999999997, 135.0, 626, 331918, 483, 9.906456000000162
484, 5.665135571584456, 63.89927017856652, 76.74110691983935, 0.4021651, 20.0, 426, 332344, 484, 6.84262549999994
485, 7.0157260889866775, 63.93329624849207, 76.91317630543428, 0.40139919999999996, 125.0, 425, 332769, 485, 6.789091499999813
486, 7.102091087894296, 64.06499136092272, 77.0682145058112, 0.4004784999999999, 170.0, 598, 333367, 486, 9.578498400000171
487, 5.289750263894477, 63.83584664817748, 76.74988440536872, 0.3993868, 105.0, 615, 333982, 487, 9.896199499999966
488, 8.404166994131735, 63.82096296221898, 76.88918556610408, 0.39819339999999975, 150.0, 711, 334693, 488, 11.329851099999814
489, 6.388528984514918, 63.98431985439052, 76.99404712709422, 0.3972357999999999, 80.0, 353, 335046, 489, 5.653442499999983
490, 7.055246204545123, 63.953363196996456, 77.03010527799776, 0.396523, 45.0, 439, 335485, 490, 7.051550799999859
491, 6.442864676367264, 63.95098313312141, 76.94113053302375, 0.39524589999999993, 255.0, 980, 336465, 491, 15.819836499999838
492, 9.8077309383482, 63.855326490374736, 76.98506978059709, 0.3937393, 135.0, 694, 337159, 492, 11.184814599999754
493, 5.398891529055103, 63.908567534401946, 76.84898025925095, 0.39248199999999994, 130.0, 703, 337862, 493, 11.323586599999999
494, 6.440741595719686, 63.91675716335491, 76.91642340043555, 0.3914776, 55.0, 413, 338275, 494, 6.769746999999825
495, 5.910476891360557, 63.88409171053934, 76.83720759220094, 0.3905109999999999, 120.0, 661, 338936, 495, 10.792343300000084
496, 6.615499526422167, 63.77068835982949, 76.70918653758298, 0.38907730000000007, 215.0, 932, 339868, 496, 15.157114399999955
497, 8.960536560063721, 63.61279440894634, 76.56822378689527, 0.3874852, 215.0, 837, 340705, 497, 13.474552099999983
498, 4.84227709272936, 63.441305939985085, 76.29528532728636, 0.3862539999999999, 150.0, 531, 341236, 498, 8.647406600000068
499, 8.052701979539764, 63.33318832827286, 76.23425273626623, 0.3854565999999999, 45.0, 355, 341591, 499, 5.80581519999987
500, 4.454234851645711, 63.31155252974966, 76.09059283007745, 0.38447469999999995, 150.0, 736, 342327, 500, 12.044358499999817
501, 6.527883747603535, 63.52136625413438, 76.40109171438257, 0.38274219999999987, 545.0, 1189, 343516, 501, 19.467164799999864
502, 6.760320191295003, 63.42196223963445, 76.33382987017607, 0.3813139, 65.0, 398, 343914, 502, 6.53827339999998
503, 4.591027951839979, 63.61478348067861, 76.48692088697169, 0.38048139999999997, 40.0, 527, 344441, 503, 8.658534500000314
504, 7.827328259972009, 63.52426218264031, 76.51372025229715, 0.37953190000000003, 80.0, 528, 344969, 504, 8.732934899999691
505, 7.322428318884875, 63.52337330018458, 76.34996894870638, 0.3786552999999999, 65.0, 446, 345415, 505, 7.329098399999566
506, 5.764969306658296, 63.5186166120723, 76.41284713337129, 0.3774123999999998, 240.0, 935, 346350, 506, 15.442927699999927
507, 8.423289525556564, 63.397414807128904, 76.36165274658204, 0.37600839999999996, 95.0, 625, 346975, 507, 10.376271699999961
508, 5.79501216918969, 63.451546730482875, 76.24512713723931, 0.3749014, 120.0, 605, 347580, 508, 9.998802699999942
509, 7.004654682168211, 63.50174420094976, 76.40512675480514, 0.373429, 320.0, 1031, 348611, 509, 16.93571120000024
510, 5.225078001828631, 63.61524024169491, 76.46236115578411, 0.37199080000000007, 105.0, 567, 349178, 510, 9.378446600000188
511, 6.863385370852803, 63.403466640783, 76.28081053731835, 0.3710493999999999, 105.0, 479, 349657, 511, 7.986607800000002
512, 6.15251917783256, 64.1382774051103, 77.17413845091286, 0.3694357, 320.0, 1314, 350971, 512, 21.919276600000103
513, 8.838158341293985, 64.6332673711225, 77.78830014378572, 0.36781749999999996, 45.0, 484, 351455, 513, 8.104172699999708
514, 6.976848919443981, 64.51501598857767, 77.61503210787781, 0.36621369999999986, 365.0, 1298, 352753, 514, 21.456447200000184
515, 11.244742864918766, 64.7726211455486, 78.078041889477, 0.36467380000000005, 55.0, 413, 353166, 515, 6.754121099999793
516, 8.008203006496927, 64.58310573632119, 77.69989011502379, 0.36335259999999986, 345.0, 1055, 354221, 516, 17.90053429999989
517, 7.124688384287498, 64.4798904947874, 77.59362133410798, 0.3615462999999998, 350.0, 952, 355173, 517, 16.08124769999995
518, 7.581166134339647, 64.61858976199485, 77.7735795206982, 0.3597616000000002, 360.0, 1031, 356204, 518, 17.250564899999972
519, 7.13299089358029, 64.56459848305093, 77.66668455550794, 0.3580174, 270.0, 907, 357111, 519, 15.33625660000007
520, 4.840766886955215, 64.60145574660528, 77.66473747616722, 0.3567285999999999, 85.0, 525, 357636, 520, 8.767279900000176
521, 7.5208354331753915, 64.46774455773149, 77.57605406793061, 0.3554218, 355.0, 927, 358563, 521, 15.68160110000008
522, 8.037248768140726, 64.52065358935907, 77.64998987827886, 0.35379459999999996, 245.0, 881, 359444, 522, 14.785886199999823
523, 6.007156597316265, 64.21294707489014, 77.19619528198243, 0.35210169999999985, 205.0, 1000, 360444, 523, 16.769386899999972
524, 6.0710539481762495, 64.01078331080292, 76.96484243001791, 0.34985440000000007, 740.0, 1497, 361941, 524, 25.043959000000086
525, 9.993496100887779, 63.99737978638368, 77.05954713006979, 0.3481804, 50.0, 363, 362304, 525, 6.181220999999823
526, 5.099115764736233, 63.979092091725285, 76.88602491106306, 0.34725519999999993, 85.0, 665, 362969, 526, 11.262486699999954
527, 6.10741818998078, 64.04791276984744, 77.03301200160274, 0.3458791000000001, 170.0, 864, 363833, 527, 14.500638699999854
528, 8.218676131585001, 63.893435064134, 76.89215785039535, 0.34450659999999994, 105.0, 661, 364494, 528, 11.103051099999902
529, 7.481604002221206, 63.99300002497296, 76.98313082096189, 0.34329249999999994, 155.0, 688, 365182, 529, 11.651150099999995
530, 6.59613267232252, 63.91510012702518, 76.9112260621057, 0.3416212, 370.0, 1169, 366351, 530, 19.65392750000001
531, 12.050166123539288, 64.01910478898907, 77.23955827778437, 0.340228, 70.0, 379, 366730, 531, 6.410056199999872
532, 5.454150016004172, 64.03909087472816, 76.98143003673786, 0.3390777999999999, 290.0, 899, 367629, 532, 15.111653299999944
533, 8.368815298883185, 64.04522718702044, 77.11243898418093, 0.3374875, 155.0, 868, 368497, 533, 14.644039899999825
534, 5.591429002383321, 63.96958613444849, 76.95602155862396, 0.3362697999999999, 55.0, 485, 368982, 534, 8.1795903000002
535, 5.226762365536256, 64.03186405528676, 76.97742804324989, 0.3350907999999999, 225.0, 825, 369807, 535, 14.0199262000001
536, 6.443934600337958, 64.24533731705102, 77.33242090469751, 0.3334707999999999, 440.0, 975, 370782, 536, 16.451344799999788
537, 6.952304808980357, 64.23612523004336, 77.35174459511097, 0.3317302000000001, 155.0, 959, 371741, 537, 16.136297900000045
538, 7.55522511721824, 64.22507431328933, 77.19672237681324, 0.3303612999999999, 110.0, 562, 372303, 538, 9.515814200000023
539, 6.305735745758529, 64.2205238235281, 77.33614079714825, 0.32921379999999995, 200.0, 713, 373016, 539, 12.098433900000146
540, 7.532268124445044, 64.26662034012696, 77.31359726052867, 0.3274813000000001, 305.0, 1212, 374228, 540, 20.423151999999845
541, 5.576970439492086, 64.13421331926787, 77.09848118754266, 0.3257416, 135.0, 721, 374949, 541, 12.165577499999927
542, 6.086826874252452, 64.33477714347103, 77.41188241524125, 0.3241602999999999, 330.0, 1036, 375985, 542, 17.535710800000288
543, 7.498050300179855, 64.19922886841687, 77.30374782643419, 0.3227203, 25.0, 564, 376549, 543, 9.547758799999883
544, 6.738783425819583, 64.17548123491488, 77.15389332344861, 0.3216592, 130.0, 615, 377164, 544, 10.635310300000128
545, 6.316099392988735, 64.14175650484842, 77.1260752119031, 0.32038389999999994, 80.0, 802, 377966, 545, 13.567443299999923
546, 6.314998374604538, 64.20894270323294, 77.22984517603919, 0.318691, 350.0, 1079, 379045, 546, 18.252797999999984
547, 6.264273807315723, 64.08324294712233, 77.09522768103558, 0.3166848999999998, 260.0, 1150, 380195, 547, 19.57726559999992
548, 7.6693247818041845, 64.15702783874193, 77.21320454862105, 0.3153060999999999, 65.0, 382, 380577, 548, 6.508638500000416
549, 4.778346891843432, 63.95444900069494, 76.88095748078278, 0.3145284999999999, 35.0, 482, 381059, 549, 8.179179799999929
550, 5.4105546614878754, 64.14591462749587, 77.10628586006642, 0.3137356, 75.0, 399, 381458, 550, 6.824441799999931
551, 6.1452647046796205, 64.04629415205156, 77.01453810724719, 0.3127501, 110.0, 696, 382154, 551, 11.805086700000174
552, 5.876958391095132, 64.0932416202619, 77.08369071727975, 0.3117988, 20.0, 361, 382515, 552, 6.1952502999997705
553, 9.054655367177869, 63.98619244747235, 77.02995045005437, 0.31076919999999997, 130.0, 783, 383298, 553, 13.32217400000036
554, 6.390845642540906, 63.98107485384554, 76.88615087560706, 0.30973149999999994, 50.0, 370, 383668, 554, 6.424050900000111
555, 6.139328646334498, 64.09029826868048, 77.07405158296943, 0.30836799999999975, 350.0, 1145, 384813, 555, 19.608367799999996
556, 4.9466252367063, 64.16991986361417, 77.15748908303, 0.30684249999999985, 135.0, 550, 385363, 556, 9.40026719999969
557, 6.633987366762318, 64.13747840422751, 77.19068289167895, 0.3055239999999998, 180.0, 915, 386278, 557, 15.647988199999872
558, 7.475694249237593, 64.02138148728508, 77.05239693586057, 0.3038824, 430.0, 909, 387187, 558, 15.503120299999864
559, 9.43853766643084, 64.00465911963047, 77.05596073835324, 0.3023622999999999, 170.0, 780, 387967, 559, 13.464089699999931
560, 7.460247240656707, 64.09391830809173, 77.08898776627123, 0.3010203999999999, 190.0, 711, 388678, 560, 12.22009160000016
561, 8.207618000822523, 63.994149071496146, 76.94147792148473, 0.29964519999999994, 190.0, 817, 389495, 561, 14.03353670000024
562, 4.672564188551216, 64.01239621824277, 76.948489779115, 0.29850399999999994, 120.0, 451, 389946, 562, 7.862942299999759
563, 5.545060054795988, 62.76123451721701, 75.4181859220967, 0.2974519, 150.0, 718, 390664, 563, 12.35102629999983
564, 6.551157655820221, 62.629102866170896, 75.32348101940117, 0.29590029999999984, 325.0, 1006, 391670, 564, 17.47150069999998
565, 5.894133476737265, 62.70064636394039, 75.4565791762441, 0.29440719999999987, 125.0, 653, 392323, 565, 11.364808799999992
566, 4.345091815558927, 62.582739216940745, 75.18034169333322, 0.2933155, 55.0, 560, 392883, 566, 9.717493099999956
567, 6.728602728999124, 62.56513220688392, 75.27953489073391, 0.2919762999999999, 150.0, 928, 393811, 567, 16.159644800000024
568, 6.7766709500508595, 62.49415331489281, 75.12957780949408, 0.2903859999999999, 380.0, 839, 394650, 568, 14.668261100000109
569, 5.404976270387693, 62.61916319921674, 75.3247064033163, 0.2891934999999999, 110.0, 486, 395136, 569, 8.489902799999982
570, 5.454078532891289, 62.493113174565, 75.139457487546, 0.28821339999999995, 105.0, 603, 395739, 570, 10.444038799999817
571, 7.961353198430565, 62.629682641280326, 75.37345731695683, 0.28710639999999993, 140.0, 627, 396366, 571, 10.885979199999838
572, 6.801883000944709, 62.5413424434333, 75.19278802542851, 0.2857068999999999, 245.0, 928, 397294, 572, 16.25056140000015
573, 5.495539718736616, 62.57463535461057, 75.19965775846137, 0.2841273999999999, 265.0, 827, 398121, 573, 14.55244599999969
574, 4.605477461479988, 62.67477734752537, 75.34895632242419, 0.28251010000000004, 365.0, 970, 399091, 574, 17.039878999999928
575, 5.54629115242643, 62.41926227798254, 75.03873100072876, 0.28031589999999984, 475.0, 1468, 400559, 575, 25.821826200000032
576, 9.943529284823821, 62.25817860913239, 74.97815752253989, 0.27842140000000004, 45.0, 637, 401196, 576, 11.314498099999582
577, 5.957588547863494, 62.09164172124997, 74.66631124071209, 0.27689139999999995, 440.0, 1063, 402259, 577, 18.753809699999692
578, 4.452378719378584, 62.1419886933348, 74.64951240368926, 0.27537129999999993, 90.0, 626, 402885, 578, 11.227452500000254
579, 5.577821417039534, 62.086402072092596, 74.6755608185324, 0.27432280000000003, 115.0, 539, 403424, 579, 9.649842199999512
580, 5.77259284897348, 62.199365075178974, 74.77922754963552, 0.27338049999999997, 155.0, 508, 403932, 580, 9.282381299999543
581, 4.199212374165654, 62.16847419271282, 74.72804134967281, 0.27218889999999996, 95.0, 816, 404748, 581, 14.588677200000348
582, 4.994031425657464, 62.01846621360308, 74.52856026166751, 0.2708713, 175.0, 648, 405396, 582, 11.68407180000031
583, 7.446177957695618, 62.14681120227994, 74.86707208876004, 0.26992719999999987, 75.0, 401, 405797, 583, 7.174955399999817
584, 5.0678094655042285, 62.17760654348782, 74.77003460359246, 0.2686456, 330.0, 1023, 406820, 584, 18.337002599999323
585, 4.422294861820067, 62.31216728843456, 74.92583194049685, 0.26731269999999996, 90.0, 458, 407278, 585, 8.314980900000592
586, 6.886386996421417, 62.124082430792974, 74.71189262293562, 0.2664028, 30.0, 553, 407831, 586, 9.90942780000023
587, 8.631915840946492, 62.22082925342378, 74.9052684093657, 0.26496009999999987, 245.0, 1050, 408881, 587, 18.796020199999475
588, 5.695576139585766, 62.057910261746635, 74.61538910340212, 0.26356599999999997, 110.0, 499, 409380, 588, 9.059630499999912
589, 6.113877082052075, 62.15127926823506, 74.74860203229007, 0.26196129999999984, 400.0, 1284, 410664, 589, 23.190911499999856
590, 5.541890067468449, 62.16227450526378, 74.74867554589562, 0.26033679999999987, 80.0, 521, 411185, 590, 9.412502600000153
591, 6.519234282523394, 62.18082459189675, 74.82412511652166, 0.2594718999999999, 45.0, 440, 411625, 591, 8.131741999999576
592, 4.502503082528323, 62.31113375089171, 74.87720864223516, 0.25821099999999997, 215.0, 961, 412586, 592, 17.42534270000033
593, 7.6060760812252814, 62.331751574151234, 74.97934086045366, 0.25681240000000005, 105.0, 593, 413179, 593, 10.746484000000237
594, 5.883789628245342, 62.208064458360234, 74.80618064805886, 0.2556333999999999, 120.0, 717, 413896, 594, 13.112799900000027
595, 5.380338987178472, 62.25515404666763, 74.81421806151609, 0.25439049999999996, 155.0, 664, 414560, 595, 12.12217579999924
596, 6.034894503156344, 62.29329358736674, 74.9673304133945, 0.25314489999999995, 185.0, 720, 415280, 596, 13.146183300000303
597, 9.108384260310633, 62.2170517903211, 74.94662127156896, 0.2516967999999999, 280.0, 889, 416169, 597, 16.291307500000585
598, 4.402341333109788, 62.26775938265035, 74.83927455525868, 0.2501757999999999, 285.0, 801, 416970, 598, 14.744778499999484
599, 7.972681765355586, 62.24784880667897, 74.85564773400775, 0.24850359999999996, 335.0, 1057, 418027, 599, 19.577740700000504
600, 8.579544648727264, 62.30761404489399, 75.07296850267042, 0.24681159999999996, 150.0, 823, 418850, 600, 15.302712099999553
601, 5.059482581649856, 62.19312840467059, 74.76005292782348, 0.2455875999999999, 90.0, 537, 419387, 601, 9.964977599999656
602, 6.5472795093775815, 61.96504488114124, 74.49378218098259, 0.24405579999999988, 345.0, 1165, 420552, 602, 21.65587939999932
603, 5.5813211554014925, 61.58470589083084, 74.02710740804294, 0.24243939999999997, 155.0, 631, 421183, 603, 11.81812379999974
604, 6.279889532026074, 61.87177925413219, 74.43430972241502, 0.24096609999999996, 320.0, 1006, 422189, 604, 18.535727299999962
605, 4.192661767027208, 61.753215432978, 74.23494677640954, 0.23953149999999993, 105.0, 588, 422777, 605, 11.003220100000362
606, 6.328966317435679, 61.74818422244145, 74.29027585494212, 0.2384407, 110.0, 624, 423401, 606, 11.71124730000065
607, 5.693037824456348, 61.70205298677803, 74.1886438627951, 0.23684859999999988, 210.0, 1145, 424546, 607, 21.351398800000425
608, 7.133406493200524, 61.8036505028753, 74.37115702865147, 0.2349090999999999, 405.0, 1010, 425556, 608, 18.974213800000143
609, 5.346458225957746, 61.89936462650454, 74.42559377158561, 0.23355729999999994, 45.0, 492, 426048, 609, 9.35096429999976
610, 6.657817616467634, 61.7544563293457, 74.2182035588036, 0.23256999999999994, 15.0, 605, 426653, 610, 11.43281400000069
611, 6.503641334379951, 61.75183413087714, 74.22274801373655, 0.23140719999999995, 135.0, 687, 427340, 611, 13.049429399999099
612, 7.703278545564958, 61.85704603729698, 74.38092938988609, 0.23017869999999999, 125.0, 678, 428018, 612, 12.905940599999667
613, 5.45795542887382, 61.777094373395364, 74.29919979956843, 0.2284524999999999, 415.0, 1240, 429258, 613, 23.364291399999274
614, 5.083343180056611, 61.76357832573478, 74.27589959652356, 0.22673979999999988, 135.0, 663, 429921, 614, 12.642417000000023
615, 4.568504554725119, 60.73533264977591, 72.99159108843122, 0.22488309999999992, 560.0, 1400, 431321, 615, 26.774247299999843
616, 8.024136539499526, 60.61713694987324, 72.95987513913947, 0.22266729999999998, 165.0, 1062, 432383, 616, 20.29650330000004
617, 6.7200312709368495, 60.769805833517786, 73.08271190919072, 0.2211138999999999, 170.0, 664, 433047, 617, 12.78036990000055
618, 5.818737811386098, 60.75679797762421, 73.04707184669432, 0.21952539999999993, 265.0, 1101, 434148, 618, 21.014358800000082
619, 5.463220528517387, 60.607993678796134, 72.83644282213966, 0.21757509999999994, 180.0, 1066, 435214, 619, 20.53185730000041
620, 3.662564870262089, 60.702239392205826, 72.97525751109362, 0.21623679999999992, 45.0, 421, 435635, 620, 8.119705600000088
621, 4.873515673615122, 60.63383407080734, 72.89386382305649, 0.21505329999999986, 160.0, 894, 436529, 621, 17.28012889999991
622, 7.171759709323707, 60.59451528738814, 72.91866427415992, 0.21363309999999994, 90.0, 684, 437213, 622, 13.34339810000074
623, 5.883635310798275, 60.67373762624791, 72.99488480835919, 0.21244419999999992, 125.0, 637, 437850, 623, 12.507207800000288
624, 8.657857035203119, 60.486332863507045, 72.81272827658125, 0.21143979999999996, 85.0, 479, 438329, 624, 9.449720700000398
625, 3.923083423805318, 60.74739485470508, 73.00714656842854, 0.21048129999999993, 110.0, 586, 438915, 625, 11.449437000000216
626, 7.892749107440884, 60.51930192167999, 72.86506892523482, 0.2095155999999999, 95.0, 487, 439402, 626, 9.568102399999589
627, 5.462275081034396, 60.60037919928064, 72.83782730779419, 0.20836719999999995, 185.0, 789, 440191, 627, 15.353258899999673
628, 7.610192999789566, 60.09853717491886, 72.32640690506597, 0.20691999999999997, 155.0, 819, 441010, 628, 15.9281332999999
629, 4.404970232242477, 60.28972100628617, 72.49245266343095, 0.20581479999999994, 50.0, 409, 441419, 629, 8.0358954000003
630, 4.839633044111364, 60.16091805793987, 72.30427191015679, 0.20462139999999995, 400.0, 917, 442336, 630, 17.996284300000298
631, 8.623917766188809, 60.268397269992654, 72.55127437253246, 0.20320749999999996, 215.0, 654, 442990, 631, 12.768862899999476
632, 6.12905743624853, 60.01921336298403, 72.16038797129755, 0.20210139999999993, 80.0, 575, 443565, 632, 11.296245200000158
633, 5.163860287838781, 60.25223101698202, 72.45590063763149, 0.20122930000000003, 65.0, 394, 443959, 633, 7.820409999999356
634, 5.070985572372639, 59.990130796964586, 72.07222536602757, 0.20045529999999998, 65.0, 466, 444425, 634, 9.189167499999712
635, 7.972930501490387, 60.16617395201726, 72.3980277673522, 0.19943289999999989, 115.0, 670, 445095, 635, 13.28492869999991
636, 5.340920004150982, 60.187528024039665, 72.35111960234025, 0.19825299999999996, 80.0, 641, 445736, 636, 12.993954499999745
637, 9.688723006010521, 60.16200196626368, 72.48980796500427, 0.19721619999999995, 115.0, 511, 446247, 637, 10.25914080000075
638, 5.805016480878105, 60.16249758184879, 72.31600651200846, 0.19565199999999985, 305.0, 1227, 447474, 638, 24.251700300000266
639, 4.557984344860898, 60.149485298877714, 72.29943421529278, 0.19390959999999993, 190.0, 709, 448183, 639, 14.074249600000257
640, 5.8637423894686185, 60.22889729682973, 72.45528341129126, 0.1923201999999999, 255.0, 1057, 449240, 640, 21.036622100000386
641, 3.992298002428367, 60.08901782636883, 72.21099166870117, 0.19083339999999996, 105.0, 595, 449835, 641, 11.942372199999227
642, 6.833307233559234, 59.49123873029436, 71.57766863141741, 0.18966789999999994, 130.0, 700, 450535, 642, 14.073839300000145
643, 6.361299384791309, 59.26300061054719, 71.28448274808052, 0.1884762999999999, 120.0, 624, 451159, 643, 12.496367300000202
644, 8.522321751875904, 59.219409248394996, 71.31006914321298, 0.18743499999999993, 35.0, 533, 451692, 644, 10.762945999999829
645, 6.990083944016489, 59.16547463252627, 71.135232880691, 0.18630279999999994, 210.0, 725, 452417, 645, 14.506332799999655
646, 5.015341143038288, 59.20777637313747, 71.15468741362949, 0.1849347999999999, 85.0, 795, 453212, 646, 15.95556250000027
647, 5.179386891213506, 59.28282560124571, 71.25099849314824, 0.18377469999999993, 120.0, 494, 453706, 647, 9.98043989999951
648, 6.889057105709972, 59.25389376000821, 71.31145558372441, 0.18248319999999996, 215.0, 941, 454647, 648, 18.9019016000002
649, 4.5469850235569105, 59.31235267647444, 71.29976677247419, 0.18080739999999998, 270.0, 921, 455568, 649, 18.515514800000346
650, 7.868898831435031, 59.41292810711302, 71.44739065940605, 0.1791873999999999, 225.0, 879, 456447, 650, 17.84194260000004
651, 6.51059679361907, 59.185615296797316, 71.28369327891957, 0.17800029999999992, 40.0, 440, 456887, 651, 8.898649699999623
652, 7.973125964978348, 59.366180134624855, 71.45585244412301, 0.17685819999999997, 250.0, 829, 457716, 652, 16.872061600000052
653, 4.444747659738188, 59.244636436561485, 71.19230591414811, 0.17541909999999997, 100.0, 770, 458486, 653, 15.667255700000169
654, 4.62408465771618, 59.265548066464724, 71.2117963627189, 0.1738243, 490.0, 1002, 459488, 654, 20.255066700000498
655, 6.663458183202014, 59.2148553213947, 71.18964762627324, 0.1721403999999999, 250.0, 869, 460357, 655, 17.72116140000071
656, 6.990295086358444, 59.15755235653113, 71.17728831980489, 0.17044929999999994, 200.0, 1010, 461367, 656, 20.609358599999723
657, 6.356369507338466, 59.066477236254464, 71.01642522154184, 0.16849629999999996, 325.0, 1160, 462527, 657, 23.845861099999638
658, 11.856006363674384, 59.263920855895215, 71.35517479583176, 0.16681959999999996, 115.0, 703, 463230, 658, 14.566487699999925
659, 5.518270949870609, 59.050332475251366, 71.00724430718898, 0.16515909999999995, 285.0, 1142, 464372, 659, 23.464804999999615
660, 4.174352547429896, 59.054892232917645, 70.9598392051164, 0.16360299999999986, 65.0, 587, 464959, 660, 12.129448100000445
661, 7.850935992736348, 59.07996471309478, 71.133449605894, 0.1626076, 60.0, 519, 465478, 661, 10.8532208000006
662, 5.4415296717194135, 59.23748483447608, 71.21674304113598, 0.16169139999999993, 65.0, 499, 465977, 662, 10.336767699999655
663, 6.192142492327362, 59.17311797080896, 71.16631746292114, 0.16011909999999993, 460.0, 1248, 467225, 663, 25.779610599999614
664, 6.200251540594649, 59.074092092657544, 71.07587893651709, 0.15833799999999992, 40.0, 731, 467956, 664, 15.335308300000179
665, 6.69837409890615, 59.08190403278057, 71.04712395301232, 0.15709509999999993, 165.0, 650, 468606, 665, 13.727299199999834
666, 6.445841400959768, 59.033107327743316, 70.98936968686651, 0.15567939999999997, 190.0, 923, 469529, 666, 19.342137399999956
667, 6.054968445564314, 58.66148101657178, 70.55392887118876, 0.15383799999999986, 420.0, 1123, 470652, 667, 23.76000110000041
668, 4.92811373175879, 58.20867413636983, 69.92819123632847, 0.15219189999999988, 300.0, 706, 471358, 668, 14.918242300000202
669, 7.000932531216957, 58.31796257402644, 70.17744708354246, 0.1507509999999999, 175.0, 895, 472253, 669, 19.00817520000055
670, 4.255893383499073, 58.162973341734514, 69.86852188732313, 0.14961429999999992, 45.0, 368, 472621, 670, 7.738513899999816
671, 6.5569369153075066, 58.35112379646079, 70.20321605419751, 0.14851179999999994, 460.0, 857, 473478, 671, 18.242756200000258
672, 5.422067522045669, 58.22493716773637, 70.03246456111243, 0.1469556999999999, 240.0, 872, 474350, 672, 18.38106760000028
673, 4.367395322379612, 58.264712129320415, 70.05086240768432, 0.1454148999999999, 120.0, 840, 475190, 673, 17.685173400000167
674, 5.351535661601872, 58.285236145398635, 70.06140861748167, 0.1439344, 190.0, 805, 475995, 674, 16.88277460000063
675, 8.612073406625491, 58.48632055753237, 70.3768953286208, 0.14265549999999996, 80.0, 616, 476611, 675, 12.990986499999963
676, 4.337565849749839, 58.206516193145276, 69.99333661309149, 0.14106249999999995, 430.0, 1154, 477765, 676, 24.558354300000246
677, 5.878117487887922, 58.12119470183382, 69.90630355183261, 0.13941279999999992, 90.0, 679, 478444, 677, 14.531637499999306
678, 4.895156619052092, 58.24766274134318, 70.06116174379984, 0.13772169999999992, 645.0, 1200, 479644, 678, 25.73537469999974
679, 5.008342398295688, 58.770415970448695, 70.61987469348122, 0.13568049999999987, 385.0, 1068, 480712, 679, 22.78445340000053
680, 4.596460076353522, 59.049210015135834, 70.96337872705917, 0.13372299999999993, 240.0, 1107, 481819, 680, 23.492008999999598
681, 6.7180964312571625, 58.95811712330785, 70.92790639213634, 0.13157829999999995, 425.0, 1276, 483095, 681, 25.88425460000053
682, 6.321030343179336, 59.030125086820576, 70.96124718662053, 0.12957669999999996, 375.0, 948, 484043, 682, 18.239330999999765
683, 4.653871382621151, 59.03067877734149, 70.90986156463623, 0.12775149999999993, 300.0, 1080, 485123, 683, 20.73387989999992
684, 9.379678711508612, 58.877192379751996, 70.92851307603897, 0.12646539999999992, 30.0, 349, 485472, 684, 6.910666000000674
685, 3.2997683277374388, 59.10279593011053, 70.98309017767619, 0.12574719999999995, 40.0, 449, 485921, 685, 8.65691919999972
686, 5.918803717110917, 59.0422543337771, 70.98420340185007, 0.12436569999999994, 345.0, 1086, 487007, 686, 20.989804199999526
687, 7.195809648513342, 58.949626583041564, 70.97466708674575, 0.12291309999999994, 35.0, 528, 487535, 687, 10.193307800000184
688, 7.159201016618401, 59.04452174854209, 71.00529610841534, 0.12120219999999997, 295.0, 1373, 488908, 688, 26.529935300000034
689, 6.998988767876022, 58.966300736350576, 70.95596886996566, 0.11957499999999993, 120.0, 435, 489343, 689, 8.387154699999883
690, 5.553738704082549, 59.07537864704979, 71.02875429158422, 0.11883879999999997, 105.0, 383, 489726, 690, 7.475793800000247
691, 6.404800665241826, 58.76642215332361, 70.66435980442887, 0.11782719999999992, 175.0, 741, 490467, 691, 14.267042699999365
692, 5.3187345242586686, 58.76913572986674, 70.62348827417345, 0.1167255999999999, 120.0, 483, 490950, 692, 9.414891099999295
693, 4.4382672084041825, 58.636778411469926, 70.3962187989388, 0.11594349999999991, 30.0, 386, 491336, 693, 7.477758899999571
694, 6.514390136142807, 58.71731459600686, 70.64258030885776, 0.11498769999999996, 155.0, 676, 492012, 694, 13.252399799999694
695, 6.681425060765501, 58.78919778153495, 70.66732776561172, 0.11348559999999992, 215.0, 993, 493005, 695, 19.540850200000023
696, 6.583329010088246, 58.70915652577093, 70.60222708929398, 0.11125899999999991, 680.0, 1481, 494486, 696, 28.765911499999675
697, 5.122347797737072, 58.718989744098906, 70.52827279502098, 0.1091412999999999, 295.0, 872, 495358, 697, 17.85927240000001
698, 6.942505743276624, 58.848901791752134, 70.78733832387246, 0.1072809999999999, 210.0, 1195, 496553, 698, 24.337979700000687
699, 6.999957212425914, 58.80905851102343, 70.76643196554745, 0.10528749999999994, 340.0, 1020, 497573, 699, 19.639353999999912
700, 4.279713981424536, 58.68142365072375, 70.50069090941243, 0.10388799999999991, 85.0, 535, 498108, 700, 10.507843899999898
701, 10.05551568637616, 58.47473017751994, 70.33299470443046, 0.10310319999999991, 15.0, 337, 498445, 701, 6.567092399999638
702, 7.555420358599252, 58.82095155039743, 70.75632763142107, 0.10243179999999992, 75.0, 409, 498854, 702, 8.058151700000053
703, 5.638558509396323, 58.60950715007994, 70.45250822490472, 0.1011753999999999, 175.0, 987, 499841, 703, 19.283477900000435
704, 6.427915810545286, 58.86735331886693, 70.763437431737, 0.10004016842105364, 95.0, 570, 500411, 704, 11.072570299999825
705, 6.2659615313401025, 59.01774624168549, 71.03220055886491, 0.10000000000000094, 10.0, 551, 500962, 705, 10.768580899999506
706, 6.362815469503403, 58.86018174524465, 70.75615673170564, 0.10000000000000067, 60.0, 362, 501324, 706, 7.104776500000298
707, 4.254928983989413, 59.11039366545501, 71.0232966740926, 0.1000000000000008, 45.0, 432, 501756, 707, 8.527502999999342
708, 4.500691022123651, 59.087985340226325, 70.95664818495109, 0.09999999999999958, 185.0, 813, 502569, 708, 16.0640841000004
709, 4.851759828786602, 59.04571774100674, 70.99103956776656, 0.10000000000000085, 155.0, 654, 503223, 709, 13.485083300000042
710, 6.208296314730261, 59.04172884530394, 71.00082530557674, 0.10000000000000056, 180.0, 685, 503908, 710, 13.828340099999878
711, 5.423156980340178, 58.97786541171493, 70.89819013489962, 0.10000000000000098, 115.0, 614, 504522, 711, 12.249110700000529
712, 5.696723599624046, 58.99434579016201, 70.92029379736172, 0.09999999999999772, 305.0, 1257, 505779, 712, 24.969972100000632
713, 5.523712313175201, 58.83712043572421, 70.73969373181092, 0.09999999999999858, 235.0, 1005, 506784, 713, 20.092343400000573
714, 5.884765368183246, 59.04889624246252, 70.98502220541744, 0.0999999999999999, 35.0, 767, 507551, 714, 15.369600199999695
715, 6.124483701882412, 59.01544881676258, 70.96425450377302, 0.0999999999999999, 215.0, 766, 508317, 715, 15.333756499999254
716, 8.231665458999105, 59.03046641983352, 70.97592396169276, 0.09999999999999805, 290.0, 1144, 509461, 716, 22.991397300000244
717, 6.072825017696167, 58.30620895226104, 70.10200271007801, 0.09999999999999805, 315.0, 1147, 510608, 717, 23.14266740000039
718, 3.32372550097975, 57.76573150373613, 69.40502348622367, 0.10000000000000075, 50.0, 409, 511017, 718, 8.294437200000175
719, 4.958949813790565, 57.68840847711493, 69.34653316971159, 0.10000000000000056, 130.0, 685, 511702, 719, 13.851304099999652
720, 3.806047923500056, 57.702700805664065, 69.35089665151013, 0.09999999999999874, 215.0, 965, 512667, 720, 19.479384400000527
721, 6.355374359315442, 57.73134670169672, 69.49914460248112, 0.1000000000000008, 20.0, 434, 513101, 721, 8.717295100000229
722, 8.817101160803357, 57.82795389123865, 69.64519081734322, 0.09999999999999894, 180.0, 925, 514026, 722, 18.7809914999998
723, 4.800500448524337, 57.764407963004444, 69.4878443120408, 0.09999999999999921, 245.0, 873, 514899, 723, 17.541837800000394
724, 4.523286542207518, 57.64727293939755, 69.27366147722516, 0.10000000000000099, 270.0, 637, 515536, 724, 12.975087699999676
725, 6.2640835882061054, 57.8047745068868, 69.51291547351413, 0.10000000000000067, 90.0, 360, 515896, 725, 7.461144400000194
726, 4.980433241065673, 57.6349332076868, 69.25978010501004, 0.09999999999999926, 150.0, 867, 516763, 726, 17.610241399999722
727, 4.831682933164322, 57.59750896546899, 69.22307102854658, 0.0999999999999978, 405.0, 1230, 517993, 727, 25.121699599999374
728, 6.631807184235129, 57.53213955107189, 69.18554119533962, 0.09999999999999884, 345.0, 945, 518938, 728, 19.28357749999941
729, 5.780959769207919, 57.594570881611595, 69.21342430159572, 0.09999999999999934, 215.0, 851, 519789, 729, 17.42390239999986
730, 5.764882894903224, 57.41335764222569, 69.02859772154059, 0.09999999999999999, 185.0, 753, 520542, 730, 15.391878600000382
731, 5.387762015120658, 57.18741932462134, 68.77662563903968, 0.09999999999999803, 380.0, 1151, 521693, 731, 24.508946699999797
732, 4.432824664929295, 57.293966939655675, 68.87673554323874, 0.09999999999999826, 420.0, 1086, 522779, 732, 22.48651179999979
733, 8.412125378136839, 57.321721043818755, 68.91530551550524, 0.09999999999999856, 205.0, 1007, 523786, 733, 20.67847570000049
734, 3.4393098419352386, 57.003157221672616, 68.51567548214238, 0.1000000000000009, 15.0, 518, 524304, 734, 10.737933899999916
735, 4.811156920715565, 57.14076817748234, 68.69376678343544, 0.10000000000000099, 45.0, 619, 524923, 735, 12.808944999999767
736, 3.669060796306232, 57.2349110440269, 68.79402732849121, 0.10000000000000073, 60.0, 386, 525309, 736, 7.978986600000098
737, 5.6038056622907435, 57.385467272752905, 68.96385038944713, 0.10000000000000063, 50.0, 342, 525651, 737, 7.2316233999999895
738, 4.4212698592615824, 57.11716211939151, 68.6398807420321, 0.10000000000000088, 185.0, 652, 526303, 738, 13.518975199999659
739, 3.522135136500458, 57.209339434383836, 68.75392154389364, 0.10000000000000059, 45.0, 326, 526629, 739, 6.754499300000134
740, 6.5223474278312015, 57.23581770253299, 68.83119164076932, 0.09999999999999959, 135.0, 812, 527441, 740, 17.082229499999812
741, 6.673043704760467, 57.235971463342224, 68.85287638203079, 0.09999999999999833, 275.0, 1065, 528506, 741, 22.085749699999724
742, 4.357948202675986, 57.19232067243953, 68.77989550470149, 0.10000000000000099, 170.0, 618, 529124, 742, 12.828745400000116
743, 5.934675827077853, 57.23717034932387, 68.84717761955388, 0.10000000000000098, 75.0, 602, 529726, 743, 12.599788600000466
744, 7.2678111588612575, 56.88818563312424, 68.40005527434539, 0.10000000000000062, 70.0, 679, 530405, 744, 14.167281500000172
745, 5.624633685789174, 56.63322200775146, 68.06486608717177, 0.10000000000000026, 140.0, 720, 531125, 745, 15.06073379999998
746, 8.169100743756399, 56.58780654022313, 68.04873799530316, 0.100000000000001, 40.0, 638, 531763, 746, 13.502696399999877
747, 4.724209754424902, 56.506505448112534, 67.92941090889302, 0.09999999999999952, 215.0, 821, 532584, 747, 17.33348920000026
748, 5.859664333925846, 56.66273456666528, 68.16875568084185, 0.10000000000000095, 200.0, 574, 533158, 748, 12.173273899999913
749, 5.9494206674852625, 56.50857958600605, 67.97046485920593, 0.099999999999998, 540.0, 1161, 534319, 749, 24.396031299999777
750, 4.262813527785828, 56.567645528343284, 67.97478966230757, 0.10000000000000032, 155.0, 712, 535031, 750, 14.888792200000353
751, 5.653719699340509, 56.579121112823486, 68.0629068063506, 0.0999999999999981, 325.0, 1128, 536159, 751, 23.74192419999963
752, 5.468578218349388, 56.44129421836451, 67.78809461378513, 0.10000000000000091, 105.0, 532, 536691, 752, 11.362870200000543
753, 5.924064284880281, 56.51660169898291, 67.99230855692691, 0.09999999999999815, 395.0, 1118, 537809, 753, 23.77151860000049
754, 6.983322279437614, 56.59607063652239, 68.09221314658433, 0.09999999999999729, 480.0, 1446, 539255, 754, 30.54696310000054
755, 4.688668477819282, 56.52326811767404, 67.92667634727945, 0.1000000000000004, 125.0, 703, 539958, 755, 14.668838700000379
756, 5.44831833045584, 56.10165969940395, 67.43912685695793, 0.099999999999998, 610.0, 1164, 541122, 756, 24.33791460000066
757, 4.541183748175619, 56.00630147339868, 67.36820850997675, 0.10000000000000087, 85.0, 488, 541610, 757, 10.554546700000174
758, 5.859048493993756, 56.140454515600645, 67.51436750423274, 0.09999999999999794, 330.0, 1183, 542793, 758, 25.271948599999632
759, 4.872206894131665, 56.085614568179416, 67.4284741667128, 0.09999999999999873, 140.0, 970, 543763, 759, 20.758271400000012
760, 5.067602307863005, 56.06141893320673, 67.36147562662761, 0.10000000000000077, 115.0, 663, 544426, 760, 14.236791599999378
761, 6.813391480481986, 56.11642268997907, 67.5616000992536, 0.10000000000000067, 50.0, 363, 544789, 761, 7.968436899999688
762, 4.292842907203273, 56.079316666088616, 67.3892837637757, 0.09999999999999828, 145.0, 1077, 545866, 762, 23.32042300000012
763, 3.869815086584334, 56.031582389331085, 67.32224030092539, 0.10000000000000005, 270.0, 747, 546613, 763, 16.011804600000687
764, 5.342787450393555, 56.04638939342279, 67.39424359661409, 0.10000000000000046, 195.0, 696, 547309, 764, 14.945257399999718
765, 3.9238697042217456, 56.08590487591234, 67.41687592349378, 0.0999999999999986, 405.0, 996, 548305, 765, 21.38362059999963
766, 7.967343616660903, 56.2374397502226, 67.6342897751752, 0.1000000000000006, 210.0, 680, 548985, 766, 14.838889800000288
767, 5.435409284890332, 56.035887053672305, 67.37733629409303, 0.1, 225.0, 752, 549737, 767, 16.179329900000084
768, 5.0569408429766955, 56.17097444634688, 67.48457795795642, 0.09999999999999881, 225.0, 950, 550687, 768, 20.781913199999508
769, 7.386192571596395, 56.24113703864528, 67.6559796204438, 0.09999999999999876, 270.0, 962, 551649, 769, 20.97063629999957
770, 8.085154853783946, 56.22011910358458, 67.64029314463374, 0.09999999999999759, 440.0, 1310, 552959, 770, 28.227037099999507
771, 3.8801475606897737, 56.08480859926234, 67.29701725225799, 0.10000000000000071, 35.0, 382, 553341, 771, 8.292314400000578
772, 5.1804529539728446, 56.07329463396653, 67.42903181424543, 0.1000000000000009, 55.0, 509, 553850, 772, 11.261276700000053
773, 5.6984353579869405, 56.232551979710756, 67.63441791288137, 0.10000000000000045, 105.0, 697, 554547, 773, 15.292495300000155
774, 5.853936994993699, 56.14350976141994, 67.48962471526202, 0.09999999999999865, 165.0, 987, 555534, 774, 21.45406020000064
775, 7.346824385060663, 56.30601119995117, 67.76849878791957, 0.10000000000000024, 95.0, 722, 556256, 775, 16.031890199999907
776, 6.3123348811667865, 56.20751587413994, 67.60278631683089, 0.10000000000000041, 80.0, 702, 556958, 776, 15.447371500000372
777, 4.382868884230677, 56.15395536524479, 67.52578964011398, 0.09999999999999847, 260.0, 1031, 557989, 777, 22.58698699999968
778, 5.498927644338695, 56.12968537958968, 67.48289001107615, 0.10000000000000096, 25.0, 598, 558587, 778, 13.181643400000212
779, 6.133146854802337, 56.13143804218202, 67.50030742295615, 0.09999999999999871, 270.0, 971, 559558, 779, 21.41921749999983
780, 4.573464007142687, 56.09489213149913, 67.40976218898801, 0.10000000000000056, 125.0, 685, 560243, 780, 15.254081199999746
781, 6.055728477545627, 56.14306684382859, 67.56186428299445, 0.09999999999999827, 280.0, 1081, 561324, 781, 23.972319900000002
782, 5.9371849937498755, 55.97548341302662, 67.31139806071792, 0.100000000000001, 155.0, 638, 561962, 782, 14.160050600000432
783, 6.127813712536952, 55.99467523434741, 67.3102961567162, 0.09999999999999915, 280.0, 885, 562847, 783, 19.603941999999734
784, 3.9509162700813234, 55.90838480942122, 67.14756911183132, 0.10000000000000085, 120.0, 655, 563502, 784, 14.555019899999934
785, 7.393091583310246, 56.05254996998483, 67.45786380845546, 0.0999999999999978, 375.0, 1227, 564729, 785, 26.98355619999984
786, 3.3592152607734085, 56.025295188083895, 67.32025018632955, 0.10000000000000094, 45.0, 549, 565278, 786, 12.27843539999958
787, 5.765093832665607, 55.92973705200612, 67.21802243003802, 0.09999999999999919, 105.0, 879, 566157, 787, 19.533110899999883
788, 4.006066461778604, 56.07320238553561, 67.36588017390325, 0.1000000000000009, 80.0, 650, 566807, 788, 14.565299500000037
789, 5.130130479641731, 55.873789789242736, 67.16247289458667, 0.10000000000000087, 85.0, 489, 567296, 789, 10.909744699999465
790, 4.986294474025241, 56.08518886878842, 67.43832820204437, 0.10000000000000098, 105.0, 610, 567906, 790, 13.572972799999661
791, 7.1567393928857115, 55.93999560867868, 67.25416322452266, 0.10000000000000084, 115.0, 656, 568562, 791, 14.662545999999566
792, 6.530649885691683, 56.0118218970111, 67.32886862066474, 0.09999999999999992, 445.0, 762, 569324, 792, 16.997046699999373
793, 6.527624888878862, 55.978498253122346, 67.30772986493261, 0.09999999999999779, 335.0, 1233, 570557, 793, 27.4025515000003
794, 6.716562644214857, 55.64764108930315, 66.88675028483073, 0.0999999999999984, 400.0, 1050, 571607, 794, 23.506256300000132
795, 6.75951681359509, 55.648271252774094, 66.90798976186437, 0.0999999999999988, 315.0, 954, 572561, 795, 21.429447900000014
796, 6.317157744684718, 55.72807832856868, 67.00151767348035, 0.09999999999999883, 310.0, 947, 573508, 796, 21.41784490000009
797, 6.119336289390335, 55.69820180277186, 66.97090355805524, 0.09999999999999852, 305.0, 1016, 574524, 797, 22.85504039999978
798, 6.155427282367387, 55.817586192299714, 67.1046715801099, 0.09999999999999908, 315.0, 899, 575423, 798, 20.151883700000326
799, 7.41039973218664, 55.689942092346634, 67.01933032660176, 0.10000000000000094, 85.0, 556, 575979, 799, 12.583066899999721
800, 5.219531533344513, 55.65495012825496, 66.90275703617401, 0.09999999999999869, 400.0, 978, 576957, 800, 22.015523699999903
801, 5.409178251151925, 55.70102682041581, 66.93181896930378, 0.0999999999999997, 240.0, 794, 577751, 801, 18.226956299999983
802, 7.163551679325764, 55.798480307767136, 67.13634773439189, 0.10000000000000095, 70.0, 578, 578329, 802, 13.314778300000398
803, 7.006740925806996, 55.68498366105266, 66.96411688201674, 0.09999999999999791, 660.0, 1191, 579520, 803, 26.811791099999937
804, 6.572514656985603, 55.79264728012563, 67.05081699984557, 0.09999999999999878, 190.0, 958, 580478, 804, 21.903460799999266
805, 4.851141117936011, 56.16242599487305, 67.50362876996603, 0.0999999999999985, 475.0, 1022, 581500, 805, 23.36249990000033
806, 5.2473987943107225, 56.17632266915162, 67.52534190217173, 0.09999999999999949, 215.0, 826, 582326, 806, 18.884097800000745
807, 7.2290448661148545, 56.24416752338409, 67.65503318309784, 0.09999999999999966, 205.0, 800, 583126, 807, 18.569034699999975
808, 6.494285883715409, 56.20649724002683, 67.60003436276756, 0.09999999999999788, 320.0, 1201, 584327, 808, 27.361885899999834
809, 3.402177443446597, 56.02085836252935, 67.31252058414992, 0.10000000000000066, 75.0, 351, 584678, 809, 8.067383300000074
810, 5.962602788871247, 56.10435210183199, 67.41539305609626, 0.09999999999999737, 520.0, 1406, 586084, 810, 32.14429089999976
811, 6.294213639961562, 56.151419648786835, 67.50414718186357, 0.09999999999999708, 420.0, 1555, 587639, 811, 35.72965790000035
812, 6.503030333318748, 56.16446236769358, 67.51842237512271, 0.10000000000000071, 60.0, 384, 588023, 812, 8.873416099999304
813, 5.21302413228774, 56.27905322368237, 67.7103456281042, 0.09999999999999964, 110.0, 803, 588826, 813, 18.636207499999728
814, 5.230716387678406, 56.080172933893415, 67.37767593684845, 0.09999999999999876, 180.0, 963, 589789, 814, 22.3090502999994
815, 4.7158241213030925, 55.48093855173491, 66.70740485052998, 0.09999999999999845, 255.0, 1034, 590823, 815, 23.874396799999886
816, 5.667456502984818, 55.260991167789676, 66.46510828664992, 0.09999999999999895, 100.0, 923, 591746, 816, 21.558976300000722
817, 5.815888056871972, 55.35867222280063, 66.55169504854335, 0.10000000000000067, 110.0, 673, 592419, 817, 15.37920800000029
818, 7.293723433374455, 55.24907299966523, 66.49422263521137, 0.1000000000000008, 195.0, 660, 593079, 818, 15.384527700000035
819, 5.607544180598015, 55.256725487342244, 66.43690001658904, 0.10000000000000096, 125.0, 585, 593664, 819, 13.653774299999895
820, 6.365576182929114, 55.251653388164925, 66.4586962995858, 0.10000000000000073, 105.0, 667, 594331, 820, 15.60480269999971
821, 4.28745850934757, 55.29438995601624, 66.48791475671483, 0.10000000000000099, 65.0, 635, 594966, 821, 14.82815489999939
822, 6.412733826865542, 55.41264062570342, 66.66250215016359, 0.0999999999999981, 270.0, 1128, 596094, 822, 26.30700700000034
823, 4.877687543147692, 55.13073451430709, 66.25020137245272, 0.10000000000000092, 125.0, 648, 596742, 823, 15.304561499999181
824, 4.598607234363138, 55.227593509646226, 66.33499495791693, 0.10000000000000056, 185.0, 685, 597427, 824, 16.01769769999919
825, 6.611880765248731, 55.36891184755714, 66.57252851288294, 0.09999999999999919, 245.0, 877, 598304, 825, 20.688310300000012
826, 6.857803043528441, 55.309685061916035, 66.5363470940716, 0.10000000000000096, 110.0, 643, 598947, 826, 15.332519499999762
827, 5.572215676322899, 55.45742756938058, 66.65762099596283, 0.09999999999999869, 195.0, 979, 599926, 827, 23.087252699999226
828, 7.095050770891087, 55.106116689251934, 66.26072026359782, 0.09999999999999865, 295.0, 989, 600915, 828, 23.256070200000977
829, 3.4963584706187247, 54.78750457763672, 65.80332557678223, 0.10000000000000082, 65.0, 450, 601365, 829, 10.640817900000911
830, 5.768625776394575, 54.97469751053497, 66.07082014003721, 0.09999999999999791, 715.0, 1190, 602555, 830, 28.051187899998695
831, 4.10509995180679, 54.92196146016085, 65.98199586891951, 0.10000000000000075, 90.0, 403, 602958, 831, 9.580283100000088
832, 7.130600542410628, 55.121453015215984, 66.23835569109235, 0.10000000000000071, 20.0, 385, 603343, 832, 9.246107799999663
833, 7.500478450353183, 55.03937709747799, 66.23773234533886, 0.09999999999999704, 455.0, 1575, 604918, 833, 37.2953209999996
834, 5.542550524333855, 54.79452301619889, 65.85779181146002, 0.10000000000000071, 50.0, 385, 605303, 834, 9.252500200000213
835, 4.830380632528174, 54.99815189660485, 66.06764382390834, 0.09999999999999831, 285.0, 1072, 606375, 835, 25.549320099999022
836, 6.291625349312766, 54.9317723679067, 66.10981108727958, 0.10000000000000041, 125.0, 702, 607077, 836, 16.83397429999968
837, 6.918828155783573, 54.82324760880213, 65.91488187639546, 0.09999999999999876, 330.0, 964, 608041, 837, 22.938694000000396
838, 5.434202065584303, 54.983060891600864, 66.11720885353527, 0.10000000000000046, 45.0, 696, 608737, 838, 16.577661600000283
839, 4.4427454308420415, 55.04541683673859, 66.1298274564743, 0.09999999999999966, 135.0, 800, 609537, 839, 19.37996099999873
840, 5.945470906073594, 54.968058593715284, 66.05142921039811, 0.09999999999999919, 30.0, 879, 610416, 840, 21.06676730000072
841, 5.064237368886605, 54.63981507058423, 65.67900128548871, 0.09999999999999855, 225.0, 1009, 611425, 841, 24.316300100001172
842, 4.259568276816036, 54.68096601480558, 65.73710288511919, 0.09999999999999853, 205.0, 1013, 612438, 842, 24.56164699999863
843, 5.584855954734446, 54.591621007907946, 65.6172650579332, 0.09999999999999941, 140.0, 839, 613277, 843, 20.276308299999073
844, 4.4022545545694935, 54.56228580438384, 65.59078295691292, 0.09999999999999841, 225.0, 1046, 614323, 844, 25.208277100000487
845, 5.7611779954698354, 54.623017951117625, 65.670031314426, 0.0999999999999975, 425.0, 1350, 615673, 845, 32.45279179999852
846, 5.954944949284446, 54.70151368834132, 65.68317203841907, 0.10000000000000077, 40.0, 417, 616090, 846, 9.987167999999656
847, 6.778715931352169, 54.588136208751216, 65.6586350637769, 0.10000000000000071, 105.0, 378, 616468, 847, 9.17127520000031
848, 6.476888910721404, 54.74849827318307, 65.80133062960154, 0.10000000000000075, 300.0, 664, 617132, 848, 16.277509100000316
849, 5.902777767216458, 54.59746179468492, 65.6205547691794, 0.09999999999999935, 115.0, 850, 617982, 849, 20.654911999999968
850, 5.334317609040013, 54.729669101486714, 65.80532914307588, 0.09999999999999906, 115.0, 902, 618884, 850, 22.025089700000535
851, 5.660492968503733, 54.562061205561854, 65.58307656708712, 0.09999999999999963, 225.0, 805, 619689, 851, 19.649687499999345
852, 6.665416444410699, 54.10082180953307, 65.10463547834648, 0.09999999999999891, 185.0, 931, 620620, 852, 22.628702099998918
853, 5.861032684214991, 53.985640049678864, 64.92167580913136, 0.10000000000000057, 130.0, 683, 621303, 853, 16.55600030000096
854, 4.738633302064576, 53.89362045240551, 64.7119473925756, 0.09999999999999876, 210.0, 963, 622266, 854, 23.492814299999736
855, 6.491099476266826, 53.92143911956459, 64.89390381091812, 0.09999999999999815, 340.0, 1116, 623382, 855, 27.54419609999968
856, 5.728806790504577, 53.93398688619981, 64.8525326134378, 0.10000000000000071, 150.0, 669, 624051, 856, 16.438003799999933
857, 5.704125474131744, 53.91993699983786, 64.85693453723238, 0.10000000000000085, 185.0, 655, 624706, 857, 15.985067400000844
858, 4.511249625200244, 53.78590355938, 64.62637545957737, 0.099999999999998, 335.0, 1161, 625867, 858, 28.245114899998953
859, 4.815100498871499, 53.745794945219124, 64.59164653337334, 0.09999999999999773, 290.0, 1255, 627122, 859, 30.772847199999887
860, 4.641963972934786, 53.75783607450988, 64.61035045054501, 0.10000000000000028, 110.0, 717, 627839, 860, 17.8027306999993
861, 6.822322384422195, 53.967009088675965, 64.93861077689185, 0.09999999999999959, 225.0, 812, 628651, 861, 20.159723500000837
862, 6.149729867864933, 53.85213577179682, 64.73573353177025, 0.09999999999999856, 285.0, 1008, 629659, 862, 24.974079400000846
863, 4.678445229356683, 53.50910828958346, 64.2543527317798, 0.10000000000000099, 115.0, 635, 630294, 863, 15.79198770000039
864, 4.257689416855446, 53.30364109291005, 64.0506244453489, 0.09999999999999798, 280.0, 1167, 631461, 864, 28.83841290000055
865, 3.4174157158109066, 53.33751222117517, 64.05065243636768, 0.09999999999999898, 255.0, 917, 632378, 865, 22.839652700000443
866, 9.171431577402466, 53.422566986083986, 64.32945723983477, 0.09999999999999835, 355.0, 1060, 633438, 866, 26.431805800000802
867, 7.098363249029417, 53.32076726419846, 64.14204853907482, 0.09999999999999817, 625.0, 1109, 634547, 867, 27.559527499999604
868, 3.8944037861636964, 53.25786772713637, 63.95045892145478, 0.10000000000000098, 100.0, 599, 635146, 868, 14.991124199999831
869, 3.883750478852129, 53.24202104219691, 63.952560098010196, 0.10000000000000098, 70.0, 607, 635753, 869, 15.296478100000968
870, 4.966901224350953, 53.36244307076244, 64.11444840706129, 0.09999999999999856, 470.0, 1006, 636759, 870, 25.437767999999778
871, 6.841974497111184, 53.214416617159394, 63.954943295754354, 0.09999999999999742, 320.0, 1381, 638140, 871, 34.88238529999944
872, 8.66483823469441, 53.386955176080974, 64.30694719723293, 0.10000000000000069, 175.0, 672, 638812, 872, 16.935938099999476
873, 4.523712502257163, 53.266355972931166, 63.98411807533072, 0.10000000000000096, 85.0, 595, 639407, 873, 14.734636799999862
874, 3.99318441366538, 53.49036980218697, 64.18995013332095, 0.10000000000000066, 30.0, 351, 639758, 874, 9.006585700000869
875, 7.167650078816117, 53.3864974105914, 64.22419766045606, 0.09999999999999874, 170.0, 965, 640723, 875, 24.34242540000014
876, 6.883950325235584, 53.29927046381713, 64.08263422969011, 0.09999999999999702, 600.0, 1585, 642308, 876, 39.83588769999915
877, 4.535777463793983, 53.160892406031635, 63.86489602379973, 0.10000000000000091, 80.0, 521, 642829, 877, 13.272007699999449
878, 5.077726036258365, 53.38138918005902, 64.13266408505648, 0.10000000000000095, 105.0, 575, 643404, 878, 14.781876900000498
879, 6.34739194139922, 53.255596753046405, 64.07051893133415, 0.09999999999999913, 170.0, 889, 644293, 879, 22.95006470000044
880, 4.325166959724503, 53.38952376314266, 64.11272895645476, 0.09999999999999859, 285.0, 1002, 645295, 880, 25.410542499999792
881, 3.701861522487692, 53.30826000522923, 64.02721947334908, 0.10000000000000069, 75.0, 370, 645665, 881, 9.504143699999986
882, 8.892672810920685, 53.355512627571684, 64.18831977217009, 0.10000000000000071, 110.0, 669, 646334, 882, 16.90862350000134
883, 6.475607381553435, 53.359421757401016, 64.17274056497168, 0.0999999999999987, 190.0, 976, 647310, 883, 24.875872000000527
884, 3.6799905551990992, 53.169105914836756, 63.844402653510585, 0.10000000000000078, 55.0, 426, 647736, 884, 11.119360000000597
885, 5.131004152214452, 53.372176006341434, 64.13353596306368, 0.0999999999999982, 215.0, 1099, 648835, 885, 28.220889300000636
886, 4.456986075519089, 53.29323094288142, 64.01303380985487, 0.09999999999999826, 125.0, 1087, 649922, 886, 27.840786099999605
887, 4.00019416809082, 53.08046904343825, 63.77038854941344, 0.10000000000000073, 90.0, 390, 650312, 887, 10.064062900000863
888, 4.760014805465173, 53.193051250862986, 63.91354416578244, 0.09999999999999823, 275.0, 1092, 651404, 888, 28.030779799999436
889, 3.8235522059675975, 53.03969187169642, 63.72727824035502, 0.0999999999999993, 130.0, 858, 652262, 889, 22.033149599999888
890, 5.658029992900821, 53.16689795520002, 63.94716130203444, 0.09999999999999738, 390.0, 1398, 653660, 890, 36.24265170000035
891, 5.8104039600536, 53.17552605244651, 63.93999955191541, 0.09999999999999752, 225.0, 1340, 655000, 891, 34.5231277999992
892, 5.48959891998615, 53.14207803775103, 63.938101274539264, 0.10000000000000073, 30.0, 390, 655390, 892, 10.30584269999963
893, 5.679724476169568, 53.09444692076706, 63.83483315677178, 0.09999999999999759, 680.0, 1312, 656702, 893, 33.90311669999937
894, 4.003040921740518, 53.054678656838156, 63.70334706348408, 0.10000000000000059, 140.0, 682, 657384, 894, 17.851665399999547
895, 4.517905348227509, 53.136377509227124, 63.800283407059354, 0.0999999999999994, 215.0, 841, 658225, 895, 22.074544299999616
896, 3.68732999070957, 53.09940526643152, 63.80603036991817, 0.1000000000000009, 50.0, 514, 658739, 896, 13.270891300000585
897, 7.877281618339044, 53.27604705037197, 64.12218485752277, 0.1000000000000009, 105.0, 513, 659252, 897, 13.479214099999808
898, 5.247398493921056, 52.99588998481178, 63.68845902495162, 0.09999999999999866, 415.0, 986, 660238, 898, 26.44551649999994
899, 5.147091765016188, 52.56161657369362, 63.18921956753004, 0.09999999999999742, 380.0, 1378, 661616, 899, 36.06604060000063
900, 5.106182674800649, 52.61064052207797, 63.23214780022116, 0.1000000000000009, 95.0, 510, 662126, 900, 13.333250699999553
901, 5.167123715462666, 52.51557245097571, 63.10720085520712, 0.09999999999999845, 290.0, 1033, 663159, 901, 27.157457399998748
902, 7.208855063752798, 52.653752991425556, 63.348416246059074, 0.10000000000000091, 40.0, 521, 663680, 902, 13.64559139999983
903, 4.4597666906593725, 52.49205882881261, 63.05503341095357, 0.09999999999999973, 150.0, 790, 664470, 903, 20.70484209999995
904, 6.8253271974096394, 52.72793675982763, 63.38709573897104, 0.10000000000000049, 120.0, 693, 665163, 904, 19.465275099999417
905, 5.775491417906893, 52.5901538309889, 63.245477586560284, 0.099999999999999, 255.0, 913, 666076, 905, 24.477341100000558
906, 4.813691537787802, 52.56061014357205, 63.15644427831884, 0.10000000000000078, 85.0, 661, 666737, 906, 17.799599499998294
907, 6.764867364148204, 52.42341036393502, 63.057261781829396, 0.10000000000000099, 85.0, 627, 667364, 907, 16.843740000000253
908, 5.939654759533277, 52.62386544159835, 63.296518639840535, 0.09999999999999802, 130.0, 1154, 668518, 908, 30.578749100001005
909, 3.5330495026087085, 52.479735190580314, 63.03857359113914, 0.10000000000000073, 75.0, 389, 668907, 909, 10.252186699999584
910, 4.285854603905955, 52.60264263129441, 63.25952403696053, 0.09999999999999962, 235.0, 807, 669714, 910, 21.63968550000027
911, 5.4008046806511745, 52.48597310735034, 63.092657386482536, 0.09999999999999779, 320.0, 1232, 670946, 911, 32.67685969999911
912, 4.817767261387923, 52.253034475017394, 62.81728984237811, 0.10000000000000085, 170.0, 654, 671600, 912, 17.482301999998526
913, 4.756486553318367, 52.21803431085413, 62.75726909690092, 0.09999999999999826, 85.0, 1087, 672687, 913, 28.779343500000323
914, 6.653260399841208, 52.28767476646434, 62.86854721918256, 0.10000000000000042, 165.0, 701, 673388, 914, 18.651479899999686
915, 8.187141612444199, 52.31012370077412, 62.962256463725915, 0.10000000000000032, 140.0, 712, 674100, 915, 19.17352480000045
916, 6.9690646554396185, 52.46226892349271, 63.111295494344596, 0.09999999999999823, 385.0, 1094, 675194, 916, 28.962122900000395
917, 6.796636017392125, 52.29357301834417, 62.920933199600434, 0.100000000000001, 115.0, 639, 675833, 917, 17.012229199999638
918, 4.5598953001781615, 52.51379600940163, 63.11728112089469, 0.09999999999999888, 225.0, 937, 676770, 918, 25.157425300001705
919, 10.634636134823662, 52.572152780189676, 63.407459030257776, 0.10000000000000028, 155.0, 717, 677487, 919, 19.221011600000566
920, 4.955731751797376, 52.23303385605047, 62.77115479457525, 0.0999999999999996, 145.0, 810, 678297, 920, 22.050841800000853
921, 6.751752622812895, 52.40818136839327, 62.98835366508647, 0.10000000000000085, 25.0, 654, 678951, 921, 17.775349899999128
922, 3.688051188139268, 52.321956455560375, 62.81658559728552, 0.10000000000000075, 35.0, 405, 679356, 922, 11.128415000001041
923, 3.8806083299830854, 52.27176229811032, 62.81836539731586, 0.10000000000000082, 75.0, 451, 679807, 923, 12.226642300000094
924, 7.732675911435086, 52.60842721410258, 63.26304999615916, 0.10000000000000098, 115.0, 642, 680449, 924, 17.267124500000136
925, 4.823996296609348, 52.60636340104452, 63.229753526823, 0.09999999999999816, 230.0, 1113, 681562, 925, 30.138854299999366
926, 7.193289517630369, 52.662127167139296, 63.32335812495305, 0.10000000000000073, 35.0, 390, 681952, 926, 10.53854069999943
927, 5.3461853936843, 52.87596173658439, 63.56944647353873, 0.10000000000000078, 75.0, 423, 682375, 927, 11.562748500000453
928, 6.069674254358251, 52.731687221834285, 63.43701463981394, 0.09999999999999745, 295.0, 1366, 683741, 928, 37.0292057000006
929, 5.109906033348438, 52.79062590120141, 63.440790209707735, 0.09999999999999898, 340.0, 916, 684657, 929, 24.706255400000373
930, 4.730305733348869, 52.714453959902855, 63.34779005098422, 0.09999999999999788, 400.0, 1198, 685855, 930, 32.34014509999906
931, 5.7913205658014, 52.82102720554058, 63.471379359563194, 0.10000000000000099, 160.0, 624, 686479, 931, 16.86916890000066
932, 6.732365163075146, 52.72027093247176, 63.42284428704645, 0.09999999999999921, 70.0, 873, 687352, 932, 23.89430650000031
933, 5.198682687116851, 52.787509720900964, 63.39726655236606, 0.09999999999999892, 190.0, 928, 688280, 933, 25.68060449999939
934, 7.33661482067268, 52.54855180398012, 63.22021889169306, 0.1000000000000009, 120.0, 507, 688787, 934, 14.084434899999906
935, 6.234405456829091, 52.66027754318743, 63.3016160889412, 0.09999999999999777, 280.0, 1237, 690024, 935, 33.90336080000088
936, 5.175424131268323, 52.35840817377457, 62.903994599933434, 0.09999999999999913, 285.0, 889, 690913, 936, 24.449306000000433
937, 7.065787238758686, 52.34384159338834, 62.98979975021118, 0.09999999999999812, 335.0, 1126, 692039, 937, 31.282811900000524
938, 4.518319020362057, 52.225949153193724, 62.7738058459121, 0.09999999999999784, 490.0, 1215, 693254, 938, 33.26822009999887
939, 6.050237768975109, 52.47028017265852, 63.093765143461006, 0.09999999999999928, 205.0, 860, 694114, 939, 23.79512849999992
940, 4.55536873777056, 52.35063364831476, 62.9088058555061, 0.09999999999999899, 230.0, 915, 695029, 940, 25.155035100000532
941, 3.7445186118385716, 52.391676158872755, 62.919288377067964, 0.10000000000000096, 90.0, 591, 695620, 941, 16.452993799999604
942, 6.266754704003104, 52.34686763205366, 62.94337125483878, 0.10000000000000088, 75.0, 499, 696119, 942, 13.978095200000098
943, 5.5184457906122715, 52.210011056491304, 62.806793312637176, 0.09999999999999705, 525.0, 1568, 697687, 943, 43.48946249999972
944, 7.600102758629183, 52.297422581705554, 62.938797301259534, 0.09999999999999892, 230.0, 928, 698615, 944, 25.82928130000073
945, 5.610267520884699, 52.456992146782476, 63.07046086704634, 0.10000000000000007, 145.0, 742, 699357, 945, 20.718357800000376
946, 3.6098451540723953, 52.398288567256564, 62.93216762373505, 0.09999999999999974, 150.0, 789, 700146, 946, 22.10213460000159
947, 6.332248886988598, 52.31947735960379, 62.848609703591784, 0.0999999999999997, 105.0, 795, 700941, 947, 22.423945200000162
948, 5.246107669639911, 52.263212022738216, 62.81195279807527, 0.09999999999999916, 375.0, 884, 701825, 948, 24.689841000001252
949, 5.929340742603051, 52.26024927294817, 62.8351576481766, 0.10000000000000044, 120.0, 699, 702524, 949, 19.657157499999812
950, 4.480177469985022, 52.21341157613811, 62.70361759005734, 0.099999999999999, 60.0, 911, 703435, 950, 25.448626299999887
951, 5.297434759007254, 52.195677175682995, 62.7601446043328, 0.10000000000000088, 185.0, 651, 704086, 951, 18.338466100000005
952, 3.869799719307462, 52.2532485094716, 62.75691348352347, 0.09999999999999978, 160.0, 783, 704869, 952, 22.033444400000008
953, 6.306688992642261, 52.360736887362314, 62.96164746503527, 0.10000000000000095, 40.0, 566, 705435, 953, 16.25211769999987
954, 6.500209554894864, 52.4272610674088, 63.0530297310679, 0.09999999999999916, 160.0, 883, 706318, 954, 24.658460300001025
955, 5.610719190144831, 52.133399547974754, 62.664002324905866, 0.10000000000000088, 120.0, 652, 706970, 955, 18.308950599999662
956, 4.638138675494729, 52.12836489098094, 62.648877758846105, 0.10000000000000092, 25.0, 535, 707505, 956, 15.089419900001303
957, 4.598985299533781, 52.324819789213294, 62.88761633143705, 0.1000000000000006, 130.0, 680, 708185, 957, 19.1962481999999
958, 6.55612954522487, 52.39679136960315, 63.00162589801515, 0.09999999999999883, 330.0, 948, 709133, 958, 26.59322720000091
959, 6.227542037034736, 52.345416520062614, 62.946935119628904, 0.09999999999999935, 195.0, 850, 709983, 959, 24.123037499999555
960, 6.041685977802863, 51.172835796598406, 61.49377650684781, 0.09999999999999856, 280.0, 1008, 710991, 960, 28.678271199998562
961, 3.5273221631744085, 51.2572000283015, 61.541689866938405, 0.10000000000000088, 35.0, 493, 711484, 961, 13.998170499999105
962, 5.211755586194926, 51.2252129442865, 61.58623641030083, 0.10000000000000028, 125.0, 716, 712200, 962, 20.307933999998568
963, 3.705410059703433, 51.178646715531436, 61.50001831528563, 0.10000000000000096, 75.0, 644, 712844, 963, 18.298318799999834
964, 6.074730841154905, 51.414071938426225, 61.82370743899001, 0.10000000000000087, 35.0, 485, 713329, 964, 13.921818099999655
965, 5.14868116043968, 51.31406094115457, 61.669039625003016, 0.0999999999999996, 190.0, 810, 714139, 965, 23.37584659999993
966, 4.4171344093599565, 51.3295833181238, 61.68959120226253, 0.09999999999999949, 215.0, 826, 714965, 966, 23.72126990000106
967, 3.9455345375940514, 51.37557637397433, 61.7169413919467, 0.10000000000000091, 80.0, 527, 715492, 967, 15.056271100000231
968, 5.986739295493555, 51.15940664742739, 61.4907801096676, 0.10000000000000085, 95.0, 655, 716147, 968, 18.644258199999967
969, 4.889017627602387, 51.2272102904177, 61.57150261701938, 0.10000000000000071, 195.0, 668, 716815, 969, 19.104790699999285
970, 3.8341542275153313, 51.246766373762355, 61.54503713869581, 0.10000000000000077, 55.0, 663, 717478, 970, 18.899499700000888
971, 4.53619262351676, 51.25109633467738, 61.57832671311688, 0.10000000000000012, 190.0, 737, 718215, 971, 21.585011099999974
972, 5.190831650439182, 51.14190953873109, 61.47509013954963, 0.10000000000000063, 110.0, 677, 718892, 972, 19.59947060000013
973, 4.988645341891272, 51.42930802698089, 61.800870017204225, 0.10000000000000099, 35.0, 619, 719511, 973, 17.757983299999978
974, 5.267845987969515, 51.09810837845974, 61.461010224778015, 0.10000000000000099, 165.0, 637, 720148, 974, 18.30766240000048
975, 8.358920775449185, 51.02696588033301, 61.41690220552332, 0.09999999999999797, 390.0, 1173, 721321, 975, 33.69511340000099
976, 8.188818149436182, 51.10080347247031, 61.424669651792144, 0.10000000000000073, 60.0, 667, 721988, 976, 19.27769309999894
977, 5.331191343214849, 51.11643952908723, 61.46376635199008, 0.10000000000000013, 150.0, 736, 722724, 977, 21.361186399999497
978, 5.7234119114408735, 51.099367115655085, 61.447550749724435, 0.09999999999999919, 165.0, 878, 723602, 978, 25.286869999999908
979, 6.774891990328796, 51.126646798492935, 61.481718125147644, 0.09999999999999741, 435.0, 1389, 724991, 979, 40.101900300000125
980, 5.326880937243033, 51.02700387007035, 61.31969578461077, 0.10000000000000099, 70.0, 636, 725627, 980, 18.687050999998974
981, 5.237030207162554, 51.04536565767302, 61.36533849489439, 0.09999999999999731, 520.0, 1430, 727057, 981, 41.45219089999955
982, 7.235451899527157, 51.135762818682, 61.473991735410316, 0.09999999999999803, 395.0, 1151, 728208, 982, 33.31414750000113
983, 3.9284703602495883, 50.97153965271625, 61.21831912404483, 0.09999999999999873, 375.0, 970, 729178, 983, 28.171458700000585
984, 6.669159288518131, 51.01788220405579, 61.37650628089905, 0.10000000000000085, 45.0, 480, 729658, 984, 14.091711099999884
985, 4.452971044548909, 51.040050551944866, 61.318390194931936, 0.09999999999999996, 225.0, 757, 730415, 985, 22.127257899999677
986, 4.731553854084894, 50.93776460553779, 61.157576482804096, 0.0999999999999987, 430.0, 976, 731391, 986, 28.642848000001322
987, 6.414611262079994, 51.1264049483031, 61.49502411123664, 0.0999999999999987, 215.0, 974, 732365, 987, 28.626579499999934
988, 6.966399025634743, 51.01080537715909, 61.31889594165846, 0.09999999999999813, 535.0, 1119, 733484, 988, 32.83989289999954
989, 5.513988957101665, 50.99822405673946, 61.36343609674459, 0.10000000000000078, 125.0, 662, 734146, 989, 19.611855600000126
990, 4.102065450178002, 51.17812422586437, 61.47801275673152, 0.0999999999999988, 200.0, 954, 735100, 990, 28.408329400001094
991, 5.188879135904071, 51.01243249583833, 61.30416614847972, 0.09999999999999891, 230.0, 931, 736031, 991, 27.289009500000247
992, 5.071319614335791, 51.00379099650128, 61.33168266172284, 0.09999999999999765, 610.0, 1291, 737322, 992, 38.03929209999842
993, 5.894539317796257, 51.0175862639031, 61.368489592155996, 0.09999999999999802, 185.0, 1153, 738475, 993, 33.95665969999936
994, 7.602639593072792, 51.14388787568505, 61.54114884659171, 0.10000000000000085, 30.0, 469, 738944, 994, 14.047700799999802
995, 5.721990638782591, 50.95404524993117, 61.262317497713205, 0.09999999999999869, 185.0, 979, 739923, 995, 29.034498499999245
996, 4.39869285544612, 50.36992851234752, 60.50895196023072, 0.10000000000000064, 150.0, 676, 740599, 996, 20.008368099999643
997, 5.41042239421534, 50.04478626885083, 60.15364334014247, 0.10000000000000078, 155.0, 662, 741261, 997, 19.679595999999947
998, 3.9052453608843534, 50.22955776131066, 60.27770949686241, 0.10000000000000077, 50.0, 411, 741672, 998, 12.200204300001133
999, 7.860730831313133, 50.221727264404294, 60.458604357910154, 0.10000000000000099, 75.0, 625, 742297, 999, 18.718870299999253
1000, 6.7056513837850575, 50.21759870896147, 60.38180677001663, 0.0999999999999994, 170.0, 842, 743139, 1000, 25.21398760000011
1001, 6.268931438975657, 50.20414814551671, 60.355423124631244, 0.09999999999999877, 115.0, 960, 744099, 1001, 28.637559700000565
1002, 3.1473770063393607, 50.102992679761805, 60.22721802373851, 0.10000000000000059, 25.0, 322, 744421, 1002, 9.65525340000022
1003, 7.886553656205025, 50.23954567854849, 60.45949420711387, 0.09999999999999758, 345.0, 1315, 745736, 1003, 39.265290400000595
1004, 7.054974665102794, 50.27278245976403, 60.48251843112549, 0.10000000000000087, 90.0, 491, 746227, 1004, 14.70363130000078
1005, 4.502625280163868, 50.192147285707534, 60.29093034332502, 0.09999999999999962, 185.0, 806, 747033, 1005, 24.419847399998616
1006, 4.342569542774396, 50.23075422144059, 60.39416943040005, 0.09999999999999984, 175.0, 774, 747807, 1006, 23.45224000000053
1007, 5.5889342160564714, 50.02335082556228, 60.17028062291606, 0.10000000000000098, 150.0, 642, 748449, 1007, 19.555925200000274
1008, 4.954231229516133, 50.125719957449455, 60.242850610283305, 0.0999999999999983, 425.0, 1073, 749522, 1008, 32.18218689999958
1009, 5.284486355520642, 50.118595025352704, 60.28443522814456, 0.09999999999999981, 150.0, 779, 750301, 1009, 23.47959339999943
1010, 5.500610459484605, 50.176437799674105, 60.315219787962405, 0.09999999999999858, 305.0, 1004, 751305, 1010, 30.59421090000069
1011, 5.755634609089458, 50.163295200288694, 60.319419590173965, 0.09999999999999906, 175.0, 902, 752207, 1011, 27.317894499999966
1012, 7.372734855638728, 50.292751588518655, 60.51535934115213, 0.09999999999999856, 400.0, 1008, 753215, 1012, 30.227820400001292
1013, 7.13259081882788, 50.29194580510998, 60.45234820859652, 0.10000000000000038, 140.0, 705, 753920, 1013, 21.406510300001173
1014, 5.494609655336124, 50.35890687485456, 60.544017393426245, 0.09999999999999719, 645.0, 1494, 755414, 1014, 45.493046499999764
1015, 4.329118841473597, 50.18140787676156, 60.27395295522299, 0.10000000000000075, 130.0, 664, 756078, 1015, 20.18097949999901
1016, 5.71190023622913, 50.18610716656427, 60.35165048304184, 0.09999999999999729, 550.0, 1448, 757526, 1016, 43.93806450000011
1017, 5.828871008623966, 50.26729347658244, 60.4376439027042, 0.0999999999999982, 305.0, 1102, 758628, 1017, 33.52898239999922
1018, 5.1831432288750205, 50.10551848234954, 60.19095059775521, 0.10000000000000087, 95.0, 486, 759114, 1018, 14.974240499999723
1019, 5.173835340041954, 50.18803120759817, 60.28677555230948, 0.09999999999999842, 340.0, 1040, 760154, 1019, 31.781454800000574
1020, 5.759091817848156, 50.00815919279321, 60.13291533300482, 0.10000000000000088, 200.0, 652, 760806, 1020, 19.88575089999904
1021, 7.179221793673093, 50.10861426331943, 60.3097559305062, 0.10000000000000074, 140.0, 665, 761471, 1021, 20.22398130000147
1022, 8.823673489557372, 50.012321924280236, 60.16048084965458, 0.10000000000000066, 125.0, 675, 762146, 1022, 20.811290699999518
1023, 7.000605939830198, 49.94597509686615, 60.02687557306876, 0.10000000000000099, 160.0, 618, 762764, 1023, 18.9076129999994
1024, 7.194072260759972, 50.167512363743135, 60.312189108358844, 0.09999999999999894, 240.0, 925, 763689, 1024, 28.465020699999513
1025, 5.400597571835903, 50.13009190702153, 60.296227346637295, 0.10000000000000071, 140.0, 668, 764357, 1025, 20.695070800000394
1026, 4.716901224202618, 49.983370034947434, 60.03376127860608, 0.10000000000000045, 60.0, 698, 765055, 1026, 21.45790350000061
1027, 8.127798468509262, 50.35550757789225, 60.652956918093544, 0.10000000000000088, 15.0, 493, 765548, 1027, 15.110367799999949
1028, 3.8056862858949967, 50.06694027162948, 60.181970722270464, 0.10000000000000099, 140.0, 636, 766184, 1028, 19.59434759999931
1029, 5.776616483182431, 50.06145038293258, 60.17589218037044, 0.09999999999999842, 340.0, 1041, 767225, 1029, 31.971917000000758
1030, 4.151804498461226, 50.06892951549409, 60.128671691124765, 0.0999999999999978, 405.0, 1229, 768454, 1030, 38.031737299999804
1031, 5.2871899694543, 49.99194563085383, 60.07592639923096, 0.10000000000000081, 75.0, 440, 768894, 1031, 13.603273799999442
1032, 7.099541211685666, 50.2599430462908, 60.48723173390611, 0.09999999999999878, 160.0, 957, 769851, 1032, 29.39777949999916
1033, 4.597823870019056, 50.18504193850926, 60.30782191668238, 0.09999999999999909, 195.0, 896, 770747, 1033, 27.711488299999473
1034, 10.861411205893567, 50.43499271142856, 60.70531525571122, 0.10000000000000066, 40.0, 351, 771098, 1034, 11.18266340000082
1035, 7.356266918973573, 50.30697775363393, 60.51043470427146, 0.09999999999999906, 215.0, 901, 771999, 1035, 28.09304660000089
1036, 4.8115875598969104, 50.12434591418589, 60.21136377260076, 0.09999999999999787, 195.0, 1203, 773202, 1036, 37.11180720000084
1037, 3.7150026752811964, 50.36686223228865, 60.53081657177391, 0.09999999999999933, 265.0, 854, 774056, 1037, 26.50488729999961
1038, 5.483322497447738, 50.197803311945535, 60.32501897787499, 0.10000000000000073, 55.0, 391, 774447, 1038, 13.69504760000018
1039, 4.206805332234017, 50.22173198453567, 60.351252026972105, 0.09999999999999908, 155.0, 898, 775345, 1039, 35.6196261999994
1040, 6.33256324236034, 50.38922495630329, 60.637515981888335, 0.09999999999999803, 535.0, 1149, 776494, 1040, 40.60649190000004
1041, 5.193255742740743, 50.28002781935141, 60.38847468380637, 0.10000000000000078, 75.0, 426, 776920, 1041, 13.253843000000415
1042, 5.655692248006595, 50.195509504595265, 60.3398717074641, 0.09999999999999788, 480.0, 1198, 778118, 1042, 37.7557039000003
1043, 5.466962215183008, 50.26013679331784, 60.38529757331399, 0.09999999999999819, 390.0, 1105, 779223, 1043, 34.68407479999951
1044, 4.1203267234994705, 50.34169241893722, 60.49004899833097, 0.0999999999999986, 270.0, 996, 780219, 1044, 32.54839600000014
1045, 7.683003834286548, 50.63625898566498, 60.91834316514943, 0.1000000000000009, 40.0, 511, 780730, 1045, 16.146562600000834
1046, 5.778508841121798, 50.48103377646076, 60.69126812667125, 0.10000000000000099, 150.0, 634, 781364, 1046, 20.016453100000945
1047, 4.4948119845279715, 50.66725975705176, 60.857443548969385, 0.09999999999999983, 265.0, 776, 782140, 1047, 24.630079399999886
1048, 7.97046247558079, 50.5074527231471, 60.72558213424111, 0.10000000000000073, 85.0, 667, 782807, 1048, 21.183743699999468
1049, 6.503035270150525, 50.666546185362996, 60.92697120957045, 0.10000000000000035, 105.0, 709, 783516, 1049, 22.441321699998298
1050, 5.534781480973193, 50.66266753169016, 60.90616091653025, 0.10000000000000087, 70.0, 482, 783998, 1050, 15.973900799999683
1051, 6.302670141161426, 50.56230843898571, 60.770799019728024, 0.09999999999999656, 1000.0, 1907, 785905, 1051, 60.318849900000714
1052, 6.679662003370535, 50.71979824446405, 60.98842324627941, 0.10000000000000099, 140.0, 622, 786527, 1052, 19.914064300000973
1053, 5.884637726133182, 50.62371198326743, 60.908460156828845, 0.09999999999999945, 240.0, 833, 787360, 1053, 26.361435599999822
1054, 10.141898748775324, 50.7749721072969, 61.02042146410261, 0.10000000000000078, 70.0, 420, 787780, 1054, 13.295943900000566
1055, 6.946886472874406, 50.68939061368798, 60.91551364269373, 0.09999999999999867, 460.0, 982, 788762, 1055, 31.715012299999216
1056, 4.572939437088767, 50.533252105940974, 60.72097003976682, 0.10000000000000071, 85.0, 669, 789431, 1056, 21.439916299999823
1057, 5.787157273936819, 50.401405555614524, 60.57032792464547, 0.09999999999999948, 120.0, 828, 790259, 1057, 26.61949679999998
1058, 5.094140673384947, 50.316013100567986, 60.406603027792535, 0.1000000000000006, 175.0, 680, 790939, 1058, 21.590904799999407
1059, 7.79902076408451, 50.19647230140466, 60.373472025365004, 0.10000000000000087, 215.0, 486, 791425, 1059, 15.472754099999293
1060, 5.7426859367441665, 50.312940974753545, 60.49253642260198, 0.09999999999999828, 320.0, 1077, 792502, 1060, 34.6140106999992
1061, 7.422482921079749, 50.17618478102491, 60.36721349359707, 0.09999999999999844, 275.0, 1038, 793540, 1061, 34.448835600000166
1062, 7.02479137291371, 50.12891796273245, 60.24036194946098, 0.100000000000001, 225.0, 639, 794179, 1062, 20.785375499999645
1063, 3.888225088208006, 50.18783981787977, 60.274660826939616, 0.10000000000000074, 5.0, 394, 794573, 1063, 12.768905699998868
1064, 9.354651642808548, 50.27860822237455, 60.579622861422024, 0.10000000000000059, 20.0, 325, 794898, 1064, 10.784528399999544
1065, 6.448781662208586, 50.17133737879824, 60.259968350494475, 0.09999999999999845, 175.0, 1033, 795931, 1065, 33.57843829999911
1066, 3.5617271546770604, 50.136052290934586, 60.21801182785195, 0.10000000000000085, 130.0, 473, 796404, 1066, 15.182296499999211
1067, 5.41396298427675, 50.20037119265312, 60.330500055531985, 0.09999999999999971, 205.0, 793, 797197, 1067, 25.525941500000044
1068, 5.543486317258273, 50.25445547693574, 60.426352254871624, 0.09999999999999888, 215.0, 938, 798135, 1068, 30.207352499999615
1069, 5.22150294716526, 50.24487419872591, 60.397285859396746, 0.09999999999999794, 265.0, 1179, 799314, 1069, 38.09405659999902
1070, 5.804436952882752, 50.02208259206731, 60.133753034803604, 0.09999999999999921, 205.0, 873, 800187, 1070, 28.663651700000628
1071, 5.1059415128607535, 49.21431612573577, 59.14023639541704, 0.09999999999999677, 1095.0, 1751, 801938, 1071, 56.40789270000096
1072, 7.676547085998966, 49.09470795354853, 59.06349687212146, 0.09999999999999873, 210.0, 969, 802907, 1072, 31.516141699999935
1073, 6.669869809727885, 49.18198668153283, 59.137065651328236, 0.1000000000000002, 135.0, 727, 803634, 1073, 23.822220599999127
1074, 3.949614765379065, 49.24964134992953, 59.13916255471235, 0.10000000000000071, 105.0, 668, 804302, 1074, 21.766748399999415
1075, 6.730521927195147, 49.125886302348995, 59.09225233724295, 0.10000000000000087, 50.0, 484, 804786, 1075, 15.708560899998702
1076, 8.778233472228974, 49.201027322053115, 59.17288388815169, 0.09999999999999905, 130.0, 903, 805689, 1076, 29.445723599999837
1077, 3.8562282816562887, 49.070074766185506, 58.90624333456595, 0.10000000000000091, 80.0, 649, 806338, 1077, 21.311957500000062
1078, 6.164625628191588, 49.292084887776774, 59.2426439163866, 0.0999999999999987, 190.0, 974, 807312, 1078, 31.948355900000024
1079, 4.860273125449522, 49.15954014009956, 59.055282346794016, 0.09999999999999884, 240.0, 946, 808258, 1079, 31.01940090000062
1080, 5.3336623681626, 49.0999971693468, 59.004925918257726, 0.09999999999999792, 255.0, 1187, 809445, 1080, 39.059981499998685
1081, 5.934665124336484, 48.83253939985933, 58.66674785756, 0.10000000000000075, 80.0, 403, 809848, 1081, 13.153319799999736
1082, 5.792239790939986, 49.27068181770348, 59.27182307587148, 0.100000000000001, 65.0, 638, 810486, 1082, 20.990025799999785
1083, 5.652519832437838, 49.248746429024955, 59.14716885328906, 0.09999999999999798, 300.0, 1167, 811653, 1083, 38.883326000001034
1084, 7.994021206176633, 49.50426853818846, 59.64388851579187, 0.09999999999999959, 260.0, 812, 812465, 1084, 27.065645599999698
1085, 4.870874993864772, 49.32655864085966, 59.25590556212894, 0.09999999999999809, 215.0, 1133, 813598, 1085, 37.391414100000475
1086, 4.6229515793122165, 49.20624099754254, 59.10213981366122, 0.10000000000000071, 90.0, 669, 814267, 1086, 22.417734000000564
1087, 4.886670214730009, 49.32009785189052, 59.25534846183206, 0.09999999999999842, 250.0, 1042, 815309, 1087, 34.43749050000042
1088, 4.912884070564456, 49.34733048766775, 59.34961930109857, 0.09999999999999984, 90.0, 774, 816083, 1088, 25.733766499999547
1089, 3.4593068111518566, 49.26196116750891, 59.22901270606301, 0.10000000000000066, 50.0, 352, 816435, 1089, 11.793940899999143
1090, 5.0019432981084515, 49.230858481728234, 59.17204508366999, 0.09999999999999859, 370.0, 1001, 817436, 1090, 33.60145209999973
1091, 4.880615255740569, 49.3085676655309, 59.23577291167861, 0.09999999999999692, 475.0, 1647, 819083, 1091, 54.74580629999946
1092, 5.463146840694151, 49.46973553582582, 59.47646374689531, 0.10000000000000012, 300.0, 738, 819821, 1092, 24.67362680000042
1093, 7.44358181164902, 48.776318233081085, 58.66670002413249, 0.10000000000000012, 195.0, 737, 820558, 1093, 24.74788939999962
1094, 7.266324631010936, 48.66292860597286, 58.514979733513826, 0.10000000000000048, 100.0, 694, 821252, 1094, 23.099438699999155
1095, 6.174283164345993, 48.7385161057958, 58.55541244602803, 0.0999999999999997, 310.0, 795, 822047, 1095, 26.90371849999974
1096, 7.6300938195590655, 48.69310097907906, 58.5017310683407, 0.10000000000000092, 170.0, 536, 822583, 1096, 17.874311400000806
1097, 4.675361915278173, 48.69137541322224, 58.52664202885045, 0.10000000000000019, 110.0, 729, 823312, 1097, 24.90511829999923
1098, 5.260788316015705, 48.851257090433116, 58.68045822850614, 0.10000000000000071, 135.0, 669, 823981, 1098, 22.372537300001568
1099, 5.197951445863268, 48.65137573109213, 58.48171955515876, 0.10000000000000084, 100.0, 459, 824440, 1099, 15.566280899998674
1100, 5.6701588128512, 48.5614227817938, 58.40000289983407, 0.09999999999999896, 195.0, 919, 825359, 1100, 30.758465299999443
1101, 5.163157018273248, 48.701592034252634, 58.5355873822903, 0.09999999999999903, 205.0, 907, 826266, 1101, 30.5552631999999
1102, 5.844216636657284, 48.688603413838386, 58.52131558039795, 0.09999999999999948, 140.0, 829, 827095, 1102, 28.35225410000021
1103, 6.276588540402647, 48.717577767301385, 58.53581794150151, 0.10000000000000066, 175.0, 674, 827769, 1103, 22.627547300000515
1104, 3.8305566317091384, 48.689119854192626, 58.50376444849475, 0.10000000000000046, 125.0, 696, 828465, 1104, 23.396791600000142
1105, 6.057277901142132, 48.60030872615304, 58.42748694532499, 0.1000000000000009, 115.0, 508, 828973, 1105, 17.338401499999236
1106, 5.723484920388688, 48.713130794587684, 58.50874724674746, 0.10000000000000016, 115.0, 732, 829705, 1106, 24.74340890000167
1107, 6.514122798357337, 48.37602838210901, 58.13422484209533, 0.09999999999999876, 370.0, 962, 830667, 1107, 32.8633037999989
1108, 4.705347118691597, 48.427933189133256, 58.18363267963268, 0.10000000000000099, 155.0, 619, 831286, 1108, 20.847027300000263
1109, 6.553550082583166, 48.104664388692605, 57.80762886714772, 0.09999999999999798, 430.0, 1166, 832452, 1109, 39.053387199999634
1110, 8.43482173083182, 48.22329182925379, 57.971625410921526, 0.10000000000000096, 145.0, 587, 833039, 1110, 20.03967459999876
1111, 6.327043953813224, 48.29586833662776, 58.03141905083714, 0.09999999999999776, 170.0, 1245, 834284, 1111, 43.34290680000049
1112, 4.061446054768417, 48.180853927208304, 57.88857409133445, 0.10000000000000087, 105.0, 491, 834775, 1112, 16.920591500000228
1113, 5.9706962743547205, 48.270040772824416, 58.04527335810879, 0.09999999999999785, 360.0, 1207, 835982, 1113, 41.291918999999325
1114, 4.25568387283738, 48.09973389013374, 57.76395843909449, 0.09999999999999867, 180.0, 983, 836965, 1114, 33.58410100000037
1115, 7.085052310350803, 48.28415976892604, 58.06996946523685, 0.0999999999999996, 180.0, 808, 837773, 1115, 28.142902999999933
1116, 6.652990631835527, 48.27170098613331, 58.027510915284275, 0.10000000000000057, 135.0, 683, 838456, 1116, 23.43550900000082
1117, 4.644642393687773, 48.22072051008777, 57.92555035924065, 0.09999999999999938, 205.0, 845, 839301, 1117, 29.06175499999881
1118, 4.56087554109386, 48.179700970107035, 57.88453612378226, 0.10000000000000081, 195.0, 659, 839960, 1118, 22.593390199999703
1119, 5.758597642841129, 48.32506586905862, 58.138091264896794, 0.10000000000000091, 165.0, 521, 840481, 1119, 17.80795229999967
1120, 4.809935770311408, 48.30070709172314, 58.01823872799812, 0.10000000000000092, 60.0, 543, 841024, 1120, 18.9371314
1121, 6.068424710473935, 48.29268408307773, 58.056533771051754, 0.09999999999999828, 230.0, 1079, 842103, 1121, 37.196810299999925
1122, 4.04141752861942, 48.084087381708805, 57.74068065504954, 0.10000000000000073, 30.0, 386, 842489, 1122, 13.410230699999374
1123, 6.017243251706343, 48.30886317534768, 58.082386837104444, 0.09999999999999985, 80.0, 772, 843261, 1123, 26.535418299999947
1124, 8.511916413279296, 48.35403292519705, 58.18079855876603, 0.09999999999999959, 185.0, 812, 844073, 1124, 27.83865490000062
1125, 4.285751260633956, 48.21301000915989, 57.899306454144714, 0.09999999999999835, 275.0, 1058, 845131, 1125, 36.84667239999908
1126, 4.776272604763508, 48.40444303659292, 58.184006588275615, 0.1000000000000009, 90.0, 650, 845781, 1126, 22.637699499999144
1127, 6.942539583682471, 48.40665999023252, 58.17599732741962, 0.10000000000000081, 415.0, 659, 846440, 1127, 23.02867630000037
1128, 5.4127704426087435, 48.240945324897766, 57.978031158447266, 0.09999999999999966, 155.0, 800, 847240, 1128, 27.59121210000012
1129, 5.1257648540763405, 48.44710766799807, 58.2283293205922, 0.1000000000000009, 110.0, 508, 847748, 1129, 17.791641899999377
1130, 4.726060516063949, 48.32811300892182, 58.070054947552954, 0.10000000000000092, 110.0, 537, 848285, 1130, 18.946357600001647
1131, 4.834520340254947, 48.12036718681677, 57.823856860488206, 0.1000000000000007, 170.0, 670, 848955, 1131, 23.260462199999893
1132, 5.319952067444904, 48.313817355402456, 58.06864070643333, 0.10000000000000071, 20.0, 383, 849338, 1132, 13.321045000000595
1133, 4.41139589041162, 48.22305944199378, 57.93390803238051, 0.10000000000000066, 120.0, 674, 850012, 1133, 23.523173400000815
1134, 5.829483670170078, 47.90481510834445, 57.55533167861067, 0.09999999999999952, 220.0, 823, 850835, 1134, 28.768041299999823
1135, 7.491128237319715, 47.76345877213912, 57.455998767505996, 0.1000000000000008, 175.0, 660, 851495, 1135, 23.274305300001288
1136, 6.275561165735957, 47.860131922330964, 57.469630708344624, 0.10000000000000099, 50.0, 627, 852122, 1136, 21.838660500001424
1137, 7.404402186294948, 47.79126956373405, 57.4807863531066, 0.0999999999999978, 580.0, 1226, 853348, 1137, 42.5597429999998
1138, 6.581428955142077, 47.91586359945836, 57.62417618771817, 0.10000000000000081, 175.0, 658, 854006, 1138, 23.159596399998918
1139, 5.213888368939036, 47.76028347494614, 57.35928858464687, 0.09999999999999969, 145.0, 796, 854802, 1139, 28.096361800000523
1140, 4.579390015682349, 47.78808126009427, 57.48836637056791, 0.1000000000000009, 110.0, 650, 855452, 1140, 22.87798400000065
1141, 5.550787910782621, 47.86971227930344, 57.56612682109357, 0.09999999999999955, 155.0, 818, 856270, 1141, 28.92709410000134
1142, 4.280656977992015, 47.74723496199015, 57.353556542100776, 0.10000000000000078, 110.0, 661, 856931, 1142, 23.42062630000146
1143, 5.121892219786447, 47.723452029784035, 57.34761067840951, 0.10000000000000088, 120.0, 652, 857583, 1143, 23.297568500000125
1144, 3.479125682580269, 47.65985288458356, 57.24117687462413, 0.10000000000000066, 70.0, 354, 857937, 1144, 12.480104799999026
1145, 3.8712969550522427, 47.89062850146699, 57.53387558565112, 0.09999999999999849, 345.0, 1023, 858960, 1145, 36.51675710000018
1146, 5.365073149359745, 47.772617472773014, 57.426014289303104, 0.10000000000000064, 30.0, 345, 859305, 1146, 12.342846100000315
1147, 5.946650845286049, 47.980825702994714, 57.686274605947965, 0.09999999999999928, 190.0, 862, 860167, 1147, 30.65185520000159
1148, 3.990777362206532, 48.634887894950126, 58.38468870516376, 0.10000000000000037, 105.0, 707, 860874, 1148, 24.97717089999969
1149, 4.926433369323805, 48.88455689948653, 58.76070743058298, 0.10000000000000092, 100.0, 539, 861413, 1149, 19.22605779999867
1150, 7.125560618695475, 48.753389740624435, 58.6408136705508, 0.09999999999999787, 565.0, 1203, 862616, 1150, 42.75374219999867
1151, 5.70281816513478, 48.843464438522915, 58.726413894202636, 0.09999999999999792, 320.0, 1185, 863801, 1151, 42.67538349999995
1152, 5.024138670446277, 48.74890826001948, 58.565528732767625, 0.09999999999999712, 540.0, 1533, 865334, 1152, 54.45443599999999
1153, 7.661008032158879, 49.04286014147041, 58.992443046885086, 0.10000000000000098, 70.0, 605, 865939, 1153, 21.501692200001344
1154, 6.010614937776403, 48.85362350561057, 58.67036066237529, 0.10000000000000099, 60.0, 628, 866567, 1154, 22.50724470000023
1155, 3.839754086606742, 48.826113428815404, 58.63405499712427, 0.100000000000001, 120.0, 638, 867205, 1155, 23.007903600000645
1156, 4.115211401051328, 48.88670991072014, 58.68224055731474, 0.10000000000000092, 55.0, 536, 867741, 1156, 27.823582899998655
1157, 6.57728381695286, 48.82417042304344, 58.705152175992815, 0.10000000000000059, 160.0, 682, 868423, 1157, 24.437287200000355
1158, 8.56465335668543, 48.78011925156052, 58.656469013239885, 0.09999999999999792, 310.0, 1184, 869607, 1158, 42.459607299999334
1159, 6.56489080859468, 48.58784299705461, 58.44270008488705, 0.10000000000000057, 120.0, 684, 870291, 1159, 24.525345000000016
1160, 4.592647678637877, 48.30447896718979, 58.01609169244766, 0.100000000000001, 90.0, 640, 870931, 1160, 23.033108999999968
1161, 5.923320861468801, 48.091450695939635, 57.79759234419916, 0.09999999999999855, 400.0, 1011, 871942, 1161, 36.469135800000004
1162, 8.38668219078417, 48.18081054904244, 57.95365382324565, 0.1000000000000004, 100.0, 704, 872646, 1162, 25.40597770000204
1163, 5.089059777518429, 48.25146011069969, 57.95422245207287, 0.10000000000000071, 105.0, 378, 873024, 1163, 13.580906700000924
1164, 5.7080256492518435, 48.07774972172913, 57.77764175985461, 0.09999999999999876, 195.0, 963, 873987, 1164, 35.19982660000096
1165, 8.307045438298996, 48.08210777794243, 57.842219245246746, 0.10000000000000042, 150.0, 701, 874688, 1165, 25.10681990000012
1166, 9.632189024273139, 48.21629769624169, 58.035788630015816, 0.1000000000000007, 120.0, 670, 875358, 1166, 24.09243609999976
1167, 3.5905703754886016, 48.2810675716249, 57.954624103479645, 0.10000000000000099, 175.0, 631, 875989, 1167, 22.610099599998648
1168, 8.326163994002371, 48.206885842982494, 57.99044563311579, 0.0999999999999994, 160.0, 842, 876831, 1168, 30.610420600001817
1169, 7.087089270382402, 48.19778426250391, 57.96979477534297, 0.0999999999999971, 490.0, 1537, 878368, 1169, 55.691421399998944
1170, 4.63864451377884, 48.147266751019416, 57.81866475354019, 0.0999999999999996, 130.0, 809, 879177, 1170, 29.61098209999909
1171, 6.04066124763499, 47.83971440893972, 57.53547601292276, 0.09999999999999797, 270.0, 1170, 880347, 1171, 42.75484309999956
1172, 5.351421961657714, 47.126011444590596, 56.61301844683303, 0.09999999999999751, 410.0, 1346, 881693, 1172, 49.23132779999651
1173, 7.287198108806853, 47.04781035149898, 56.57019970117026, 0.09999999999999837, 260.0, 1057, 882750, 1173, 38.68440120000014
1174, 7.047489387686401, 47.10849683303242, 56.64875217703886, 0.09999999999999765, 385.0, 1290, 884040, 1174, 47.196323699998175
1175, 4.395572863102836, 47.08400136723238, 56.54857956381405, 0.1000000000000006, 145.0, 680, 884720, 1175, 24.79290140000012
1176, 9.435394135698814, 47.207864747573964, 56.75039561835605, 0.09999999999999873, 205.0, 969, 885689, 1176, 35.85547570000199
1177, 6.209508021665251, 47.175208062240756, 56.716421433506376, 0.10000000000000062, 155.0, 679, 886368, 1177, 25.138207500000135
1178, 5.354907531080948, 47.15682031646852, 56.683719919573875, 0.09999999999999863, 185.0, 992, 887360, 1178, 36.56227850000141
1179, 4.890216236981376, 47.05896161170019, 56.543010474821365, 0.09999999999999834, 165.0, 1063, 888423, 1179, 39.347818799997185
1180, 5.366627664482298, 46.90312612023892, 56.34149969642156, 0.10000000000000067, 55.0, 363, 888786, 1180, 13.996363499998552
1181, 5.090040062116023, 47.09632383296058, 56.626984283540494, 0.09999999999999867, 200.0, 982, 889768, 1181, 36.32160350000049
1182, 5.048988754906121, 46.91684968625346, 56.356395786808385, 0.09999999999999863, 260.0, 992, 890760, 1182, 36.52115050000066
1183, 7.935048298858036, 47.14980208316696, 56.76155514137767, 0.09999999999999931, 30.0, 856, 891616, 1183, 31.512343200000032
1184, 8.522539466482687, 46.84571339450987, 56.371221175975045, 0.10000000000000035, 125.0, 708, 892324, 1184, 26.469717899999523
1185, 7.95224594080146, 46.8310687096343, 56.327480984841884, 0.09999999999999883, 225.0, 947, 893271, 1185, 35.02709760000289
1186, 6.820714605691213, 46.932349900293616, 56.425046587789524, 0.09999999999999731, 325.0, 1432, 894703, 1186, 52.72536659999969
1187, 4.237547916554776, 46.71480617948768, 56.07692191566947, 0.09999999999999866, 205.0, 986, 895689, 1187, 36.740464400001656
1188, 7.0547062577689035, 46.778653218049705, 56.24265023076522, 0.09999999999999858, 240.0, 1003, 896692, 1188, 37.176607100002
1189, 7.619517461466445, 46.866370772017916, 56.34691914084817, 0.09999999999999795, 565.0, 1176, 897868, 1189, 43.5621515999992
1190, 3.7367462121665618, 46.88722503269026, 56.278410239297834, 0.10000000000000078, 75.0, 427, 898295, 1190, 15.79625759999908
1191, 3.9730056758468644, 46.73043467719027, 56.06416750851312, 0.1000000000000005, 230.0, 691, 898986, 1191, 25.95746020000297
1192, 6.086089962632247, 46.81014484389689, 56.262895354591464, 0.10000000000000023, 150.0, 723, 899709, 1192, 27.32008059999862
1193, 6.09142751361139, 46.38572760258219, 55.70905492639029, 0.10000000000000088, 200.0, 651, 900360, 1193, 24.587309799997456
1194, 4.341942019095771, 45.92967589274269, 55.114994206611385, 0.10000000000000063, 115.0, 678, 901038, 1194, 25.554967500000203
1195, 4.403807663572087, 45.79204070820322, 55.03146934333808, 0.09999999999999826, 270.0, 1087, 902125, 1195, 41.857821900001
1196, 7.894086515775534, 45.81851251197584, 55.15068252158888, 0.09999999999999971, 155.0, 792, 902917, 1196, 29.996267499998794
1197, 4.803858138516569, 45.68797253005056, 54.82374442235493, 0.10000000000000096, 105.0, 643, 903560, 1197, 24.05983660000129
1198, 5.371770488402723, 45.776713720384485, 55.00631977031511, 0.09999999999999698, 400.0, 1609, 905169, 1198, 60.456334599999536
1199, 6.809049690336537, 45.86133078124625, 55.18491610427576, 0.10000000000000088, 120.0, 652, 905821, 1199, 24.594992499998625
1200, 6.6199775414049995, 45.974943453548875, 55.23131677709474, 0.10000000000000088, 105.0, 652, 906473, 1200, 24.77519029999894
1201, 5.522512180042332, 45.912334224452145, 55.18485492727031, 0.10000000000000013, 270.0, 736, 907209, 1201, 27.742270700000518
1202, 7.427937136379892, 45.92743391129113, 55.185712752913744, 0.09999999999999815, 185.0, 1118, 908327, 1202, 42.340828899999906
1203, 4.911036913561926, 45.87065425494702, 55.12343390767076, 0.0999999999999985, 330.0, 1019, 909346, 1203, 38.640046299999085
1204, 6.976901460496872, 45.817651906779396, 55.10963064401261, 0.10000000000000073, 35.0, 386, 909732, 1204, 14.887473300001147
1205, 5.779213465925754, 46.04857268508192, 55.35088779788991, 0.09999999999999991, 100.0, 764, 910496, 1205, 29.211630500001775
1206, 5.724256048888662, 46.36957986964736, 55.73501263662826, 0.10000000000000053, 205.0, 688, 911184, 1206, 26.213436900001398
1207, 5.282041372866303, 46.21896863098882, 55.56425585723729, 0.09999999999999948, 170.0, 828, 912012, 1207, 31.714780000002065
1208, 4.617904043228212, 46.15927598369655, 55.44025160661384, 0.09999999999999831, 355.0, 1072, 913084, 1208, 41.10890339999969
1209, 4.133276840857631, 46.2191874765829, 55.524552920378625, 0.09999999999999838, 285.0, 1053, 914137, 1209, 40.109836800002086
1210, 4.923026308875679, 46.40351381750533, 55.768513581721145, 0.09999999999999948, 230.0, 829, 914966, 1210, 31.85783359999914
1211, 6.762861805736209, 46.40197767283582, 55.8023024382095, 0.09999999999999916, 185.0, 884, 915850, 1211, 33.96383170000263
1212, 6.0178231635148185, 46.27190471137011, 55.60822957091861, 0.0999999999999968, 720.0, 1728, 917578, 1212, 66.73819129999902
1213, 5.928752074748169, 46.385338856623726, 55.74855477469308, 0.10000000000000092, 165.0, 546, 918124, 1213, 20.988859600001888
1214, 5.925186083314486, 46.40444752773808, 55.72757198604365, 0.09999999999999848, 270.0, 1029, 919153, 1214, 39.48645389999729
1215, 4.2305141052367325, 46.02871928155528, 55.28467960663658, 0.09999999999999813, 295.0, 1122, 920275, 1215, 43.304873499997484
1216, 5.1011173655394435, 45.34170173613493, 54.4660746992127, 0.09999999999999873, 525.0, 968, 921243, 1216, 37.272373900003004
1217, 6.726349093671237, 45.51842237352491, 54.79093831068986, 0.10000000000000095, 65.0, 572, 921815, 1217, 22.090110000001005
1218, 6.303847336816631, 45.4232613955385, 54.565135762570726, 0.10000000000000091, 80.0, 533, 922348, 1218, 20.488259699999617
1219, 7.104538001606856, 45.48854870540805, 54.70414784629602, 0.09999999999999684, 490.0, 1699, 924047, 1219, 65.41689889999907
1220, 5.8592249159198655, 45.383565679728555, 54.57609793436613, 0.09999999999999816, 330.0, 1112, 925159, 1220, 43.39686139999685
1221, 6.968089329691148, 45.47214169154351, 54.652961871757014, 0.099999999999998, 390.0, 1165, 926324, 1221, 45.11277120000159
1222, 3.8008304087211715, 45.4170629057433, 54.53946170172728, 0.09999999999999978, 60.0, 782, 927106, 1222, 30.688093000000663
1223, 4.981648338449455, 45.33098800619581, 54.44899078553936, 0.09999999999999802, 300.0, 1156, 928262, 1223, 45.196712600001774
1224, 6.676730989384442, 45.36005656296826, 54.548331812220475, 0.10000000000000057, 140.0, 683, 928945, 1224, 26.56505079999988
1225, 4.6471984083939315, 45.340930072526284, 54.44365116779069, 0.10000000000000074, 50.0, 665, 929610, 1225, 25.65066619999925
1226, 7.686012024965231, 45.56615314119538, 54.80694660181166, 0.1000000000000006, 185.0, 681, 930291, 1226, 26.6384982999989
1227, 4.328005031131037, 45.88370103601085, 55.13071282515611, 0.09999999999999795, 280.0, 1177, 931468, 1227, 46.97413130000132
1228, 7.509183035098572, 45.977016686025586, 55.32265344769275, 0.09999999999999841, 240.0, 1046, 932514, 1228, 40.848437799999374
1229, 9.161995249185576, 45.90738450118123, 55.276664953889856, 0.09999999999999871, 130.0, 971, 933485, 1229, 38.13637969999763
1230, 4.123158792420767, 46.0561896136593, 55.33901473491806, 0.10000000000000067, 65.0, 361, 933846, 1230, 14.416274600000179
1231, 6.608278419321575, 45.97527340480259, 55.24300447832636, 0.10000000000000085, 95.0, 476, 934322, 1231, 18.609067199999117
1232, 5.944544531579766, 45.98119466116002, 55.2411381002745, 0.10000000000000059, 95.0, 682, 935004, 1232, 26.87729390000095
1233, 4.342603095736302, 45.95533975413148, 55.23528992558869, 0.10000000000000034, 150.0, 710, 935714, 1233, 28.24586139999883
1234, 6.928758932748726, 46.02159022608547, 55.29770969724542, 0.09999999999999937, 255.0, 846, 936560, 1234, 33.409460099999706
1235, 7.447161357627725, 46.02756601585532, 55.33257510491137, 0.09999999999999755, 340.0, 1325, 937885, 1235, 52.30759360000229
1236, 8.681794124519705, 46.23326729050833, 55.50652318024755, 0.10000000000000074, 20.0, 398, 938283, 1236, 15.897252599999774
1237, 7.0544115477403, 45.86660317993164, 55.089351888020836, 0.1000000000000007, 25.0, 375, 938658, 1237, 14.718615400001
1238, 4.052059871815864, 45.98386206827153, 55.204665436241335, 0.09999999999999917, 240.0, 881, 939539, 1238, 34.675688600000285
1239, 4.934946539614032, 46.01634078536406, 55.2349334689104, 0.10000000000000094, 140.0, 551, 940090, 1239, 22.276059499999974
1240, 6.190658451423465, 46.749533629769765, 56.17358994757992, 0.10000000000000098, 80.0, 609, 940699, 1240, 24.1917446999978
1241, 5.38441784774705, 46.70138392390975, 56.131440449909995, 0.09999999999999755, 495.0, 1328, 942027, 1241, 52.588246100000106
1242, 6.869368453277992, 46.84117395254282, 56.30293180025541, 0.1000000000000009, 60.0, 650, 942677, 1242, 25.801612600000226
1243, 5.130062727211597, 46.634292902689076, 56.00364318247356, 0.09999999999999823, 495.0, 1093, 943770, 1243, 43.922270999999455
1244, 5.333176500810438, 46.67060477063123, 56.02773221711942, 0.09999999999999795, 385.0, 1177, 944947, 1244, 47.38281300000017
1245, 8.815915583232462, 46.61787643985472, 56.09245749948106, 0.10000000000000077, 55.0, 414, 945361, 1245, 16.498507399999653
1246, 5.281502564565011, 46.66877896005657, 56.049262769028154, 0.09999999999999762, 640.0, 1302, 946663, 1246, 51.98227349999797
1247, 4.764195599455814, 46.56822475839834, 55.97570667892206, 0.10000000000000087, 130.0, 488, 947151, 1247, 19.53303700000106
1248, 4.342055688714321, 46.7485356640638, 56.157857051926555, 0.09999999999999887, 300.0, 939, 948090, 1248, 37.55795849999777
1249, 4.192196079653732, 46.67857588411913, 56.04351120650001, 0.10000000000000084, 60.0, 466, 948556, 1249, 18.690054700000474
1250, 7.9857783688490205, 46.72579268235427, 56.24861033512996, 0.1000000000000009, 75.0, 650, 949206, 1250, 26.321886800000357
1251, 6.4190562942451095, 46.638725768922185, 56.03258754458465, 0.09999999999999996, 395.0, 758, 949964, 1251, 30.431565700000647
1252, 5.885362480673763, 46.38887851044451, 55.71379304247677, 0.10000000000000091, 115.0, 529, 950493, 1252, 21.33208409999861
1253, 9.251960670416898, 46.60106634763208, 56.12259491646644, 0.09999999999999855, 305.0, 1010, 951503, 1253, 40.41655449999962
1254, 5.218050408644428, 46.47703841923226, 55.82454272250599, 0.09999999999999949, 140.0, 827, 952330, 1254, 33.60626929999853
1255, 6.475419532093737, 46.42115354386587, 55.80330700041756, 0.09999999999999772, 485.0, 1260, 953590, 1255, 50.730365399998846
1256, 6.413400550070963, 46.45296815033191, 55.84080431631892, 0.10000000000000082, 85.0, 657, 954247, 1256, 26.743640500000765
1257, 9.863139046882006, 46.41220411412856, 55.87744925442864, 0.1000000000000006, 90.0, 680, 954927, 1257, 27.460797300002014
1258, 4.369956837140095, 46.42021374408314, 55.73754664735107, 0.09999999999999803, 260.0, 1151, 956078, 1258, 46.5475340999983
1259, 3.4844351845629076, 46.54138346840354, 55.87060565387502, 0.1000000000000006, 85.0, 680, 956758, 1259, 27.575756800000818
1260, 6.166065626302223, 46.38416794885563, 55.740209989909886, 0.09999999999999883, 285.0, 948, 957706, 1260, 38.58913519999987
1261, 7.122980737861158, 46.52041062631699, 55.957697869182994, 0.09999999999999806, 645.0, 1141, 958847, 1261, 46.31454880000092
1262, 5.98714964427054, 46.58823291460673, 56.01542755762736, 0.09999999999999877, 140.0, 960, 959807, 1262, 38.84869510000135
1263, 6.804111749692948, 46.483555534174, 55.89220173043108, 0.10000000000000055, 140.0, 687, 960494, 1263, 27.958783900001436
1264, 4.758890165290693, 46.42172494039048, 55.847812067853276, 0.10000000000000056, 130.0, 685, 961179, 1264, 28.21650899999804
1265, 5.525025740334621, 46.496343724177436, 55.83313878572904, 0.1000000000000009, 130.0, 650, 961829, 1265, 26.377133199999662
1266, 8.430948097707683, 46.51465318328197, 56.04063903462875, 0.09999999999999871, 445.0, 971, 962800, 1266, 39.752617800000735
1267, 7.292780826874224, 46.45690950300941, 55.845856758047496, 0.09999999999999713, 675.0, 1522, 964322, 1267, 62.199743600001966
1268, 6.290293045045501, 46.603330827428096, 56.01677913877285, 0.09999999999999712, 795.0, 1533, 965855, 1268, 62.761823699998786
1269, 5.247880070078179, 46.499433294307664, 55.87004393944875, 0.09999999999999797, 230.0, 1171, 967026, 1269, 47.977339400000346
1270, 4.910648968948367, 46.59256179407362, 55.973840421271284, 0.10000000000000098, 65.0, 607, 967633, 1270, 24.81579630000124
1271, 5.443931203424221, 46.55194724854969, 55.867202059427896, 0.10000000000000078, 30.0, 420, 968053, 1271, 17.458458599998266
1272, 5.3863021443127, 46.388975846903406, 55.72820818650858, 0.10000000000000091, 155.0, 526, 968579, 1272, 21.6759392999993
1273, 7.298998190210479, 46.45670230975669, 55.85490978928347, 0.1000000000000002, 155.0, 727, 969306, 1273, 30.11724470000263
1274, 5.605062593778014, 46.66960396986166, 56.06314940644058, 0.0999999999999985, 245.0, 1021, 970327, 1274, 42.02537200000006
1275, 6.4649001600640315, 47.032408279556414, 56.51878409858222, 0.09999999999999817, 300.0, 1110, 971437, 1275, 45.68123429999832
1276, 7.530730605125427, 47.06009521484375, 56.607434955788726, 0.09999999999999909, 190.0, 895, 972332, 1276, 37.3923063000002
1277, 4.23232592524399, 47.13039860849003, 56.6332307844175, 0.10000000000000014, 125.0, 733, 973065, 1277, 31.17140980000113
1278, 4.875964736336306, 46.91545432234464, 56.35841924850255, 0.10000000000000096, 120.0, 584, 973649, 1278, 24.108305499998096
1279, 8.45222700760401, 46.84897444487023, 56.30240783950469, 0.10000000000000096, 160.0, 589, 974238, 1279, 24.17124370000238
1280, 8.838415071257721, 47.06276377985033, 56.66966297262806, 0.09999999999999885, 135.0, 944, 975182, 1280, 39.35740110000188
1281, 4.408204108196658, 46.90561992589517, 56.30430050334253, 0.09999999999999878, 330.0, 958, 976140, 1281, 40.407920400000876
1282, 7.657533504939996, 47.004081743680516, 56.4974633202186, 0.1000000000000009, 125.0, 650, 976790, 1282, 27.07942280000134
1283, 4.784819324008491, 46.955098415689, 56.38065557708581, 0.09999999999999877, 180.0, 959, 977749, 1283, 40.2124212000017
1284, 6.709177577568518, 46.99690426112888, 56.47846465477576, 0.09999999999999731, 510.0, 1430, 979179, 1284, 60.17867469999692
1285, 7.858340939461745, 46.979860838396654, 56.5200585424586, 0.09999999999999883, 435.0, 949, 980128, 1285, 41.01835349999965
1286, 7.307287526113549, 47.13525411817763, 56.68752759078453, 0.09999999999999841, 510.0, 1044, 981172, 1286, 43.84171979999883
1287, 4.333598239225368, 47.16202032023609, 56.61425005609002, 0.09999999999999906, 385.0, 901, 982073, 1287, 38.005550799996854
1288, 6.739416897986339, 47.237617657136965, 56.78084405363546, 0.09999999999999881, 140.0, 951, 983024, 1288, 40.037297099999705
1289, 5.720035036360179, 47.03980131407042, 56.48057188429274, 0.10000000000000062, 40.0, 333, 983357, 1289, 14.254004000002169
1290, 7.141206422665983, 47.16155969106478, 56.75198645607578, 0.09999999999999905, 180.0, 903, 984260, 1290, 37.70606690000204
1291, 5.238293137445548, 47.219198208410766, 56.71600015880992, 0.09999999999999892, 150.0, 927, 985187, 1291, 38.982185100001516
1292, 4.353060973742628, 47.061820949247014, 56.54085875044616, 0.09999999999999917, 280.0, 881, 986068, 1292, 37.365911799999594
1293, 6.349260953177956, 47.21693831438794, 56.72902240054145, 0.0999999999999988, 245.0, 955, 987023, 1293, 40.19962080000187
1294, 5.23661862544056, 47.09558024841067, 56.57776687702698, 0.09999999999999996, 115.0, 757, 987780, 1294, 32.00015390000044
1295, 5.201116328203459, 47.175683194258085, 56.6518493812541, 0.09999999999999992, 105.0, 762, 988542, 1295, 32.31799869999668
1296, 5.1844850017850685, 47.00114452179068, 56.453424158131504, 0.10000000000000092, 30.0, 542, 989084, 1296, 23.244804599999043
1297, 5.717224481841277, 47.120806269060104, 56.66180675127353, 0.09999999999999931, 155.0, 855, 989939, 1297, 36.13369430000239
1298, 5.24552884369488, 46.87582089498601, 56.366747531842826, 0.0999999999999997, 245.0, 794, 990733, 1298, 33.67889220000143
1299, 6.38620780030853, 46.81318232197089, 56.243935732233446, 0.09999999999999791, 620.0, 1192, 991925, 1299, 52.02996339999663
1300, 3.4301162436469768, 46.62855463562563, 55.989457266671316, 0.10000000000000094, 25.0, 553, 992478, 1300, 23.58216850000099
1301, 6.643190313498179, 46.85868120320638, 56.29828106689453, 0.1000000000000007, 80.0, 375, 992853, 1301, 16.11738289999994
1302, 5.911204244710447, 46.65829891382262, 56.07037750140641, 0.09999999999999847, 205.0, 1032, 993885, 1302, 43.852737300003355
1303, 7.598363316763219, 46.80402173725426, 56.3060966687845, 0.0999999999999981, 575.0, 1128, 995013, 1303, 48.47722749999957
1304, 7.666052814976678, 46.87561645643326, 56.330350669196825, 0.09999999999999812, 225.0, 1126, 996139, 1304, 48.46044339999935
1305, 7.042282521841319, 46.84380015497622, 56.32162781425144, 0.09999999999999803, 335.0, 1150, 997289, 1305, 49.331875500000024
1306, 5.681484330438459, 46.82971612325882, 56.25730385680805, 0.09999999999999837, 195.0, 1054, 998343, 1306, 46.01511059999757
1307, 6.191086108053632, 46.84931505559685, 56.306879889777996, 0.10000000000000042, 125.0, 701, 999044, 1307, 30.744485399998666
1308, 5.815865749459591, 46.868789571504664, 56.336753654682674, 0.09999999999999887, 200.0, 941, 999985, 1308, 43.54516270000022
