,loss,mae,mean_q,mean_eps,episode_reward,nb_episode_steps,nb_steps,episode,duration
0,0,0,0,0,185.0,1012,1012,0,2.3956795
1, 0, 0, 0, 0, 50.0, 526, 1538, 1, 1.1532285000000009
2, 0, 0, 0, 0, 120.0, 696, 2234, 2, 1.5085653999999984
3, 0, 0, 0, 0, 180.0, 628, 2862, 3, 1.756132100000002
4, 0, 0, 0, 0, 60.0, 392, 3254, 4, 1.0263181999999986
5, 0, 0, 0, 0, 30.0, 568, 3822, 5, 1.530273300000001
6, 0, 0, 0, 0, 35.0, 386, 4208, 6, 0.9810873999999998
7, 0, 0, 0, 0, 135.0, 747, 4955, 7, 2.0877768000000003
8, 0, 0, 0, 0, 180.0, 1000, 5955, 8, 2.311000700000001
9, 0, 0, 0, 0, 445.0, 1368, 7323, 9, 3.1069156000000007
10, 0, 0, 0, 0, 385.0, 936, 8259, 10, 2.1916092999999996
11, 0, 0, 0, 0, 120.0, 463, 8722, 11, 1.0539326999999972
12, 0, 0, 0, 0, 255.0, 877, 9599, 12, 2.114339600000001
13, 0, 0, 0, 0, 230.0, 808, 10407, 13, 1.8550090999999966
14, 0, 0, 0, 0, 180.0, 630, 11037, 14, 1.521581900000001
15, 0, 0, 0, 0, 155.0, 615, 11652, 15, 1.517205699999998
16, 0, 0, 0, 0, 80.0, 398, 12050, 16, 0.904123300000002
17, 0, 0, 0, 0, 155.0, 734, 12784, 17, 1.669189000000003
18, 0, 0, 0, 0, 165.0, 689, 13473, 18, 1.6398981999999975
19, 0, 0, 0, 0, 315.0, 1135, 14608, 19, 2.5725662999999983
20, 0, 0, 0, 0, 90.0, 688, 15296, 20, 1.562691000000001
21, 0, 0, 0, 0, 135.0, 649, 15945, 21, 1.5028853000000026
22, 0, 0, 0, 0, 155.0, 683, 16628, 22, 1.5865460999999996
23, 0, 0, 0, 0, 520.0, 1641, 18269, 23, 3.5418795000000003
24, 0, 0, 0, 0, 110.0, 615, 18884, 24, 1.374952300000004
25, 0, 0, 0, 0, 335.0, 751, 19635, 25, 1.6518774999999977
26, 0, 0, 0, 0, 110.0, 690, 20325, 26, 1.5545891000000012
27, 0, 0, 0, 0, 210.0, 628, 20953, 27, 1.4112977999999998
28, 0, 0, 0, 0, 135.0, 664, 21617, 28, 1.495705799999996
29, 0, 0, 0, 0, 180.0, 723, 22340, 29, 1.607999399999997
30, 0, 0, 0, 0, 110.0, 745, 23085, 30, 1.626969299999999
31, 0, 0, 0, 0, 135.0, 620, 23705, 31, 1.4057688999999982
32, 0, 0, 0, 0, 470.0, 1441, 25146, 32, 3.027203
33, 0, 0, 0, 0, 65.0, 360, 25506, 33, 0.8466542999999973
34, 0, 0, 0, 0, 210.0, 787, 26293, 34, 1.9666204999999906
35, 0, 0, 0, 0, 205.0, 902, 27195, 35, 2.2509828000000027
36, 0, 0, 0, 0, 15.0, 506, 27701, 36, 1.2234379000000075
37, 0, 0, 0, 0, 140.0, 785, 28486, 37, 1.9881823999999995
38, 0, 0, 0, 0, 75.0, 515, 29001, 38, 1.2340696000000122
39, 0, 0, 0, 0, 210.0, 861, 29862, 39, 2.0802943999999997
40, 0, 0, 0, 0, 240.0, 1504, 31366, 40, 3.4703640999999976
41, 0, 0, 0, 0, 65.0, 618, 31984, 41, 1.6948697999999922
42, 0, 0, 0, 0, 125.0, 550, 32534, 42, 1.3567779000000115
43, 0, 0, 0, 0, 135.0, 620, 33154, 43, 1.3282903000000061
44, 0, 0, 0, 0, 185.0, 787, 33941, 44, 1.624807599999997
45, 0, 0, 0, 0, 105.0, 604, 34545, 45, 1.2601179999999914
46, 0, 0, 0, 0, 20.0, 407, 34952, 46, 1.041745000000006
47, 0, 0, 0, 0, 170.0, 928, 35880, 47, 2.0708926000000076
48, 0, 0, 0, 0, 180.0, 813, 36693, 48, 1.7086148000000065
49, 0, 0, 0, 0, 15.0, 494, 37187, 49, 1.053221899999997
50, 0, 0, 0, 0, 100.0, 555, 37742, 50, 1.1873867999999987
51, 0, 0, 0, 0, 30.0, 410, 38152, 51, 0.9011278000000118
52, 0, 0, 0, 0, 335.0, 722, 38874, 52, 1.5150827000000078
53, 0, 0, 0, 0, 180.0, 803, 39677, 53, 1.732713700000005
54, 0, 0, 0, 0, 80.0, 578, 40255, 54, 1.4120510000000053
55, 0, 0, 0, 0, 95.0, 792, 41047, 55, 1.6714812000000023
56, 0, 0, 0, 0, 340.0, 1076, 42123, 56, 2.2756689999999935
57, 0, 0, 0, 0, 180.0, 1085, 43208, 57, 2.2564497000000046
58, 0, 0, 0, 0, 30.0, 344, 43552, 58, 0.7657525000000049
59, 0, 0, 0, 0, 105.0, 455, 44007, 59, 0.9777150000000034
60, 0, 0, 0, 0, 210.0, 834, 44841, 60, 1.7292587000000026
61, 0, 0, 0, 0, 180.0, 785, 45626, 61, 1.6605110999999937
62, 0, 0, 0, 0, 135.0, 798, 46424, 62, 1.6891753000000023
63, 0, 0, 0, 0, 80.0, 506, 46930, 63, 1.0780979999999971
64, 0, 0, 0, 0, 210.0, 781, 47711, 64, 1.6368200000000002
65, 0, 0, 0, 0, 210.0, 691, 48402, 65, 1.473210899999998
66, 0, 0, 0, 0, 195.0, 934, 49336, 66, 1.9689910000000026
67, 0, 0, 0, 0, 595.0, 1163, 50499, 67, 2.3778542999999956
68, 0, 0, 0, 0, 80.0, 637, 51136, 68, 1.3623953000000029
69, 0, 0, 0, 0, 140.0, 847, 51983, 69, 1.7935257000000036
70, 0, 0, 0, 0, 125.0, 685, 52668, 70, 1.5451355000000149
71, 0, 0, 0, 0, 390.0, 811, 53479, 71, 1.6729594999999904
72, 0, 0, 0, 0, 215.0, 913, 54392, 72, 1.940706399999982
73, 0, 0, 0, 0, 155.0, 716, 55108, 73, 1.5536620000000028
74, 0, 0, 0, 0, 120.0, 623, 55731, 74, 1.3789951999999914
75, 0, 0, 0, 0, 260.0, 968, 56699, 75, 2.0467998000000023
76, 0, 0, 0, 0, 210.0, 978, 57677, 76, 2.096582500000011
77, 0, 0, 0, 0, 215.0, 969, 58646, 77, 2.0594118999999864
78, 0, 0, 0, 0, 420.0, 855, 59501, 78, 1.8274769999999876
79, 0, 0, 0, 0, 180.0, 721, 60222, 79, 1.495402299999995
80, 0, 0, 0, 0, 135.0, 749, 60971, 80, 1.578572500000007
81, 0, 0, 0, 0, 150.0, 648, 61619, 81, 1.4704289000000017
82, 0, 0, 0, 0, 105.0, 645, 62264, 82, 1.375155800000016
83, 0, 0, 0, 0, 120.0, 726, 62990, 83, 1.518611099999987
84, 0, 0, 0, 0, 135.0, 819, 63809, 84, 1.7257847000000197
85, 0, 0, 0, 0, 210.0, 854, 64663, 85, 1.7807638999999824
86, 0, 0, 0, 0, 180.0, 830, 65493, 86, 1.7879140000000007
87, 0, 0, 0, 0, 190.0, 728, 66221, 87, 1.5297798
88, 0, 0, 0, 0, 460.0, 1003, 67224, 88, 2.093554299999994
89, 0, 0, 0, 0, 215.0, 813, 68037, 89, 1.8428953000000092
90, 0, 0, 0, 0, 375.0, 852, 68889, 90, 1.9028851999999858
91, 0, 0, 0, 0, 135.0, 675, 69564, 91, 1.446514900000011
92, 0, 0, 0, 0, 30.0, 457, 70021, 92, 0.9772680000000094
93, 0, 0, 0, 0, 440.0, 930, 70951, 93, 1.9740664999999922
94, 0, 0, 0, 0, 30.0, 359, 71310, 94, 0.8021839999999827
95, 0, 0, 0, 0, 305.0, 720, 72030, 95, 1.5404838999999981
96, 0, 0, 0, 0, 240.0, 967, 72997, 96, 1.9717547000000195
97, 0, 0, 0, 0, 75.0, 522, 73519, 97, 1.115398099999993
98, 0, 0, 0, 0, 210.0, 1041, 74560, 98, 2.2400904999999796
99, 0, 0, 0, 0, 80.0, 356, 74916, 99, 0.7761792999999955
100, 0, 0, 0, 0, 180.0, 795, 75711, 100, 1.679536799999994
101, 0, 0, 0, 0, 235.0, 945, 76656, 101, 2.111108800000011
102, 0, 0, 0, 0, 110.0, 732, 77388, 102, 1.601075800000018
103, 0, 0, 0, 0, 80.0, 569, 77957, 103, 1.2992522999999778
104, 0, 0, 0, 0, 125.0, 458, 78415, 104, 1.0769322000000159
105, 0, 0, 0, 0, 385.0, 807, 79222, 105, 1.8246546999999964
106, 0, 0, 0, 0, 150.0, 696, 79918, 106, 1.433633900000018
107, 0, 0, 0, 0, 80.0, 578, 80496, 107, 1.1935434999999757
108, 0, 0, 0, 0, 20.0, 416, 80912, 108, 0.8586508999999864
109, 0, 0, 0, 0, 135.0, 664, 81576, 109, 1.3502124999999978
110, 0, 0, 0, 0, 210.0, 761, 82337, 110, 1.6319969999999842
111, 0, 0, 0, 0, 155.0, 798, 83135, 111, 1.647198799999984
112, 0, 0, 0, 0, 315.0, 839, 83974, 112, 1.7820238000000188
113, 0, 0, 0, 0, 320.0, 1020, 84994, 113, 2.169590499999998
114, 0, 0, 0, 0, 265.0, 961, 85955, 114, 1.9946428000000083
115, 0, 0, 0, 0, 335.0, 768, 86723, 115, 1.5815363000000104
116, 0, 0, 0, 0, 210.0, 853, 87576, 116, 1.8243440999999905
117, 0, 0, 0, 0, 105.0, 615, 88191, 117, 1.2653370000000166
118, 0, 0, 0, 0, 80.0, 519, 88710, 118, 1.105244099999993
119, 0, 0, 0, 0, 80.0, 398, 89108, 119, 0.8398530000000051
120, 0, 0, 0, 0, 210.0, 1417, 90525, 120, 2.806738899999999
121, 0, 0, 0, 0, 75.0, 405, 90930, 121, 0.8635406000000216
122, 0, 0, 0, 0, 210.0, 819, 91749, 122, 1.6816927000000135
123, 0, 0, 0, 0, 90.0, 601, 92350, 123, 1.2752266999999904
124, 0, 0, 0, 0, 35.0, 401, 92751, 124, 0.8590337999999917
125, 0, 0, 0, 0, 30.0, 685, 93436, 125, 1.396310700000015
126, 0, 0, 0, 0, 110.0, 570, 94006, 126, 1.154342200000002
127, 0, 0, 0, 0, 120.0, 719, 94725, 127, 1.421120899999977
128, 0, 0, 0, 0, 80.0, 636, 95361, 128, 1.2850171000000046
129, 0, 0, 0, 0, 135.0, 682, 96043, 129, 1.4104424999999878
130, 0, 0, 0, 0, 295.0, 952, 96995, 130, 1.9728806999999904
131, 0, 0, 0, 0, 110.0, 666, 97661, 131, 1.381156400000009
132, 0, 0, 0, 0, 210.0, 1220, 98881, 132, 2.4144694999999956
133, 0, 0, 0, 0, 80.0, 545, 99426, 133, 1.1256940999999756
134, 43.295220349561724, 40.987146489760455, 52.451505263221456, 0.8198307999999996, 110.0, 762, 100188, 134, 3.2406019000000015
135, 19.916855872723094, 40.91145629771272, 50.70678728784037, 0.8190469000000004, 135.0, 684, 100872, 135, 6.1043746
136, 17.72203627693966, 40.93569353153754, 50.196075575060604, 0.8178490000000005, 135.0, 647, 101519, 136, 5.8484083999999825
137, 12.107709682708958, 40.85783338716446, 49.743502172286824, 0.8167608999999999, 90.0, 562, 102081, 137, 5.0860389000000055
138, 17.865997277843746, 40.91422202170696, 49.96970934877011, 0.8157862, 105.0, 521, 102602, 138, 4.735825500000004
139, 14.993529635277865, 40.81651170677114, 49.73750100536881, 0.8148357999999999, 135.0, 535, 103137, 139, 4.677478000000008
140, 18.27567721899608, 40.89346753926646, 49.857842718871154, 0.8139934, 50.0, 401, 103538, 140, 3.65670190000003
141, 13.691672886018273, 40.8756421370472, 49.63569133401775, 0.8130070000000001, 165.0, 695, 104233, 141, 6.306641899999988
142, 15.860655945587158, 40.86567466430664, 49.63350630493164, 0.811819, 105.0, 625, 104858, 142, 5.704655099999968
143, 14.823530814669153, 40.89516927243711, 49.578414636331274, 0.8106571000000002, 110.0, 666, 105524, 143, 5.958862199999999
144, 14.70366190632331, 40.915208513886284, 49.538306162366126, 0.8095699000000004, 90.0, 542, 106066, 144, 5.185431999999992
145, 18.900916405228582, 40.91098070504984, 49.6969295953323, 0.8087248, 105.0, 397, 106463, 145, 3.921544499999982
146, 10.27556784261014, 40.856772713214, 49.30575541424927, 0.8075134000000006, 190.0, 949, 107412, 146, 9.291103399999997
147, 12.27782577816744, 40.92776376475459, 49.43479169762653, 0.8059347999999997, 180.0, 805, 108217, 147, 7.48457940000003
148, 11.306751843373846, 40.874173403157045, 49.37287543906394, 0.8046316000000001, 50.0, 643, 108860, 148, 5.7595870000000104
149, 14.566265715292408, 40.92423112785776, 49.503617948153206, 0.8029836999999995, 330.0, 1188, 110048, 149, 10.845426599999996
150, 10.540319202290188, 40.89589892622894, 49.49234193461449, 0.8015463999999995, 45.0, 409, 110457, 150, 3.7939347000000225
151, 8.57001457259377, 40.901742170988435, 49.44651611841763, 0.8000820999999994, 210.0, 1218, 111675, 151, 11.162507799999958
152, 9.37369978107555, 40.988991589097736, 49.70415216398331, 0.798517, 80.0, 521, 112196, 152, 4.829747800000007
153, 8.088166589173587, 40.87104302257425, 49.4332683804669, 0.7969815999999994, 380.0, 1185, 113381, 153, 10.907219999999995
154, 7.044733454729354, 40.892099219632435, 49.410934556875404, 0.7950934, 245.0, 913, 114294, 154, 8.465551600000026
155, 8.728790630323765, 40.89310342837603, 49.33223296434451, 0.7937101, 210.0, 624, 114918, 155, 5.831113400000049
156, 7.042230877437089, 40.839936929000054, 49.41703462098774, 0.7924645000000002, 125.0, 760, 115678, 156, 7.0282349000000295
157, 11.957322214043165, 40.9377438827727, 49.565928229754775, 0.7913278000000002, 155.0, 503, 116181, 157, 4.757403600000032
158, 9.854359180204176, 40.866097855465604, 49.40155408583656, 0.7902459999999998, 125.0, 699, 116880, 158, 6.807402400000001
159, 12.517393378711684, 41.009559539728286, 49.7553710437758, 0.7892047000000001, 75.0, 458, 117338, 159, 4.428051900000014
160, 6.371536767677498, 40.822997592850356, 49.26701744017273, 0.7880212000000006, 150.0, 857, 118195, 160, 8.332878599999958
161, 12.315933341387087, 40.95171140741419, 49.63999428320183, 0.7865694999999999, 135.0, 756, 118951, 161, 7.194703000000004
162, 5.494658116032095, 40.83421979417988, 49.16713167078355, 0.7852006000000002, 225.0, 765, 119716, 162, 7.256910500000004
163, 8.314180802278802, 40.97388981094518, 49.53880256089447, 0.7832079999999998, 215.0, 1449, 121165, 163, 13.675704399999972
164, 5.787618629314037, 40.90479323536612, 49.36241518144965, 0.7812550000000003, 65.0, 721, 121886, 164, 7.5150888999999665
165, 7.009010539995278, 40.92349740760416, 49.49998123243866, 0.7800562000000001, 80.0, 611, 122497, 165, 7.511401400000011
166, 9.087412821766515, 40.921325089627466, 49.54356512799359, 0.7788358, 165.0, 745, 123242, 166, 8.501085199999977
167, 7.7425426708013525, 40.95476148704782, 49.46571747838603, 0.7774056999999995, 150.0, 844, 124086, 167, 8.287660699999947
168, 7.08238469353472, 40.91797895689268, 49.42338972068243, 0.7759135, 210.0, 814, 124900, 168, 7.970661000000007
169, 8.87237483002164, 40.91317310792351, 49.53951837719139, 0.7747695999999996, 90.0, 457, 125357, 169, 4.270330899999976
170, 9.022261448189282, 40.89772430763167, 49.44411174407522, 0.7739182, 80.0, 489, 125846, 170, 5.494648699999971
171, 5.728694459695495, 40.93259241339866, 49.39547488609057, 0.7730776000000004, 45.0, 445, 126291, 171, 4.3663589999999886
172, 4.644577356316577, 40.89730373689498, 49.26450639922044, 0.7722855999999998, 75.0, 435, 126726, 172, 4.50451929999997
173, 8.695974856841184, 40.91838573866802, 49.46663043495375, 0.7713010000000001, 105.0, 659, 127385, 173, 6.497364199999993
174, 5.31924701791579, 40.943635017353394, 49.376191764349876, 0.7695531999999998, 560.0, 1283, 128668, 174, 12.585376699999983
175, 4.73043801469408, 40.95250700081989, 49.3783475122634, 0.7678332999999997, 110.0, 628, 129296, 175, 6.208164599999975
176, 8.057143826022187, 40.73769568209826, 49.21027395240499, 0.7664004999999996, 205.0, 964, 130260, 176, 9.434810299999981
177, 8.675294921373773, 40.22804669041158, 48.678328131165955, 0.7651809999999998, 60.0, 391, 130651, 177, 3.8669324999999617
178, 8.285058594784559, 40.18711224768524, 48.45119552311343, 0.7643728000000001, 35.0, 507, 131158, 178, 5.040888499999937
179, 6.814921615683303, 40.21922285007666, 48.53289172670237, 0.7632991000000001, 130.0, 686, 131844, 179, 6.736569199999963
180, 5.406335657861616, 40.1624361872673, 48.33169499465397, 0.7622784999999997, 75.0, 448, 132292, 180, 4.5100197000000435
181, 9.233878684877515, 40.14728190282008, 48.50559647033265, 0.7612317999999999, 80.0, 715, 133007, 181, 6.984545600000047
182, 8.476090544945095, 40.17308850732363, 48.45696274228079, 0.7598440000000003, 160.0, 827, 133834, 182, 8.351552799999922
183, 9.50401506060967, 40.203722263532946, 48.53923944863622, 0.7585588000000001, 135.0, 601, 134435, 183, 6.187233500000048
184, 6.869447547000843, 40.1766053210248, 48.41645380795657, 0.7571989000000006, 245.0, 910, 135345, 184, 9.8004459
185, 8.127916616818869, 40.22007939376992, 48.50917839550317, 0.7555284999999997, 410.0, 946, 136291, 185, 10.989986000000044
186, 9.165615343486174, 40.08019454195229, 48.35807953514881, 0.7543522000000001, 95.0, 361, 136652, 186, 3.7591121000000385
187, 6.772137559902407, 40.24348725622072, 48.42326446297546, 0.753328, 100.0, 777, 137429, 187, 7.902904700000022
188, 7.901534164184315, 40.19746935533614, 48.453623003946376, 0.7519824999999998, 105.0, 718, 138147, 188, 7.1239428999999745
189, 7.666908627306974, 40.18102641017349, 48.40544001702909, 0.7505587, 175.0, 864, 139011, 189, 8.432445200000075
190, 6.654031704222889, 40.18974137840221, 48.38663722906502, 0.7490979999999997, 180.0, 759, 139770, 190, 7.712479999999914
191, 6.896724461538581, 40.30834759971648, 48.616439826643784, 0.7479450999999999, 80.0, 522, 140292, 191, 5.137038400000051
192, 7.797089000671496, 40.30069720678982, 48.56148825908104, 0.7469884000000001, 30.0, 541, 140833, 192, 5.4776663999999755
193, 8.006796877280298, 40.30602148888816, 48.60193975878433, 0.7459903, 55.0, 568, 141401, 193, 5.750254000000041
194, 6.302850921098173, 40.27298482053692, 48.59810793727203, 0.7449220000000003, 105.0, 619, 142020, 194, 6.340890400000035
195, 5.01306664811741, 40.300550905726126, 48.53295167218532, 0.7435314999999992, 185.0, 926, 142946, 195, 9.317224699999997
196, 6.692845384354022, 40.31484566873579, 48.638781853576205, 0.7422157000000001, 35.0, 536, 143482, 196, 5.564802600000007
197, 9.519082313787726, 40.3415793922889, 48.86207420933692, 0.7412751999999999, 110.0, 509, 143991, 197, 5.1291393999999855
198, 7.650934951085794, 40.233473911620024, 48.54827609815096, 0.7402014999999998, 80.0, 684, 144675, 198, 7.062989300000027
199, 6.942465771627523, 40.34284694482249, 48.6460726002671, 0.7386975999999998, 470.0, 987, 145662, 199, 10.118649799999957
200, 6.4401584732292285, 40.272062104655156, 48.579955881728935, 0.7370947000000001, 215.0, 794, 146456, 200, 7.950209900000004
201, 7.8656471862955, 40.28790324683328, 48.56902206569042, 0.7359166, 110.0, 515, 146971, 201, 5.314210799999955
202, 7.915132854083728, 40.37466428953436, 48.735876536690064, 0.7350517, 35.0, 446, 147417, 202, 4.623944599999959
203, 4.6368318388356435, 40.27383880132361, 48.5182056909875, 0.7339392999999999, 185.0, 790, 148207, 203, 8.12037250000003
204, 5.833977338872189, 40.252647172420396, 48.50827708229742, 0.7326396999999997, 80.0, 654, 148861, 204, 6.9367803000000094
205, 6.224667685471963, 40.26452409144131, 48.492785967770395, 0.7314732999999999, 150.0, 642, 149503, 205, 6.596632899999918
206, 7.710469316286237, 40.31652555258378, 48.66379840477653, 0.7305642999999999, 45.0, 368, 149871, 206, 3.866040099999964
207, 3.7134222853349588, 40.0655758946695, 48.24131773029334, 0.7296831999999996, 140.0, 611, 150482, 207, 6.299118900000053
208, 3.7309899923457706, 40.036958742469075, 48.26243081518387, 0.72874, 65.0, 437, 150919, 208, 4.589006500000096
209, 6.6035953957953994, 40.10254878689714, 48.37608095972899, 0.7277338000000002, 155.0, 681, 151600, 209, 7.108324400000015
210, 7.126319669726966, 40.093580703612496, 48.415992011962494, 0.7265620000000003, 110.0, 621, 152221, 210, 6.885101600000098
211, 4.614681080007402, 40.03692824662395, 48.29021688561371, 0.725437, 155.0, 629, 152850, 211, 6.515787799999998
212, 6.1746563423278085, 40.05206180330958, 48.304429317460695, 0.7241175999999995, 185.0, 837, 153687, 212, 8.736762099999964
213, 6.054718530784924, 40.040789052199784, 48.276196239051124, 0.722719, 160.0, 717, 154404, 213, 7.559331400000019
214, 7.108135427233087, 40.07583860816567, 48.38646144394965, 0.7214553999999996, 150.0, 687, 155091, 214, 7.154775299999983
215, 6.379471930130473, 40.123073813000566, 48.44178419772934, 0.7201216000000001, 125.0, 795, 155886, 215, 8.528261100000009
216, 4.789888607053319, 40.05958604210724, 48.257701140801004, 0.7187643999999997, 185.0, 713, 156599, 216, 7.586890000000039
217, 4.754086194072096, 40.05178619566418, 48.261836261976335, 0.7175178999999998, 120.0, 672, 157271, 217, 7.1586628999999675
218, 3.289584949814667, 40.06233517921577, 48.266242230948755, 0.7163821, 120.0, 590, 157861, 218, 6.197513599999979
219, 5.611051446483659, 40.15479293448387, 48.38915874503252, 0.7152283000000003, 125.0, 692, 158553, 219, 7.240950800000064
220, 10.084315684139, 40.189517517835995, 48.641258901955155, 0.7142373999999998, 55.0, 409, 158962, 220, 4.388745999999969
221, 6.37647200254731, 40.27917284645568, 48.570614894166916, 0.7127559999999992, 380.0, 1237, 160199, 221, 12.787582199999974
222, 5.35872842056404, 40.79701790925387, 49.12817818948601, 0.7104933999999998, 215.0, 1277, 161476, 222, 13.475279600000022
223, 5.412769015791804, 40.873410933147106, 49.27791962143063, 0.7087635999999997, 120.0, 645, 162121, 223, 6.994800699999928
224, 4.543926506098919, 40.72071415502535, 49.02382007096711, 0.7077934, 110.0, 433, 162554, 224, 4.68871450000006
225, 4.564331128147202, 40.844708280518724, 49.28630327174147, 0.7068268000000003, 105.0, 641, 163195, 225, 6.842778599999974
226, 4.7242310537291425, 40.80260383742196, 49.15079075949533, 0.7057459, 180.0, 560, 163755, 226, 6.060975800000051
227, 5.622828161362939, 40.784409503547515, 49.21803097822228, 0.7045362999999998, 135.0, 784, 164539, 227, 8.42565460000003
228, 7.944751225613259, 40.83673439615021, 49.29930756911348, 0.7033645, 80.0, 518, 165057, 228, 5.570605499999942
229, 4.778213224383687, 40.801796297020495, 49.154633084848236, 0.7020540999999998, 195.0, 938, 165995, 229, 9.965574399999923
230, 3.4151506233097884, 40.7221812826072, 49.07680819657048, 0.7008445000000001, 25.0, 406, 166401, 230, 4.4463029999999435
231, 5.752054971326786, 40.81827724911034, 49.294668156114646, 0.6997762000000004, 135.0, 781, 167182, 231, 8.414571499999965
232, 8.488946598547477, 40.880241714289156, 49.411988133559994, 0.6987088000000001, 105.0, 405, 167587, 232, 4.41587770000001
233, 5.113420771900564, 40.70508570472399, 49.054449493686356, 0.6976531, 180.0, 768, 168355, 233, 8.268712900000082
234, 5.6691621757318, 40.779585216254105, 49.19038239654277, 0.6962319999999996, 290.0, 811, 169166, 234, 8.876826400000027
235, 9.592052924550813, 40.963125047354865, 49.48623905576509, 0.6948495999999997, 150.0, 725, 169891, 235, 7.890942600000017
236, 6.934389674287919, 41.278080245464466, 49.8315315986274, 0.6935472999999999, 135.0, 722, 170613, 236, 7.8057198999999855
237, 6.662104219675064, 41.25258998616536, 49.8115712890625, 0.69256, 50.0, 375, 170988, 237, 4.087157100000013
238, 4.134761069242065, 41.28884208344843, 49.73488859098113, 0.6915448000000002, 120.0, 753, 171741, 238, 8.233795299999997
239, 4.162379583090912, 41.3288971364393, 49.81973589538897, 0.6903567999999997, 105.0, 567, 172308, 239, 6.183809099999962
240, 5.563492221244867, 41.38647402887759, 49.847709807796754, 0.6893497, 100.0, 552, 172860, 240, 6.137041899999986
241, 7.126601967359343, 41.36412853171147, 49.97418111334625, 0.6883120000000001, 110.0, 601, 173461, 241, 6.303321299999993
242, 3.0725300557533717, 41.35826493628014, 49.79304509228825, 0.6869899000000003, 210.0, 868, 174329, 242, 9.517611299999999
243, 6.581709148500349, 41.421534024752106, 50.007918911380365, 0.6855652000000002, 155.0, 715, 175044, 243, 7.858472600000027
244, 9.697686676523405, 41.49561544330772, 50.26317473847471, 0.6844708000000004, 30.0, 501, 175545, 244, 5.55513760000008
245, 3.1995238890519015, 41.284762202082455, 49.66757329992346, 0.6836869, 50.0, 370, 175915, 245, 4.045808700000066
246, 4.071090257000309, 41.38696412347798, 49.883069281834906, 0.6829696, 60.0, 427, 176342, 246, 4.593773199999987
247, 5.375905880064682, 41.39035776735262, 49.95795052652141, 0.6821136999999998, 110.0, 524, 176866, 247, 5.734656100000052
248, 7.675063274304072, 41.36301380191837, 49.88044533257012, 0.6811425999999999, 155.0, 555, 177421, 248, 6.150001900000007
249, 5.38525873842538, 41.40438109694628, 49.91055098531764, 0.6801832000000002, 65.0, 511, 177932, 249, 5.714660299999878
250, 3.691453484059079, 41.30051829318497, 49.75383090693231, 0.6794163999999999, 30.0, 341, 178273, 250, 3.692513599999984
251, 6.544473528731972, 41.43731198136095, 50.07154202419634, 0.6785938000000001, 105.0, 573, 178846, 251, 6.46322669999995
252, 3.1685110129492013, 41.39810662366906, 49.830657112355134, 0.6777252999999998, 105.0, 392, 179238, 252, 4.368682100000115
253, 3.086359845676734, 41.44763503740738, 49.93800659348854, 0.6765606999999996, 415.0, 902, 180140, 253, 9.865720499999952
254, 7.043577314116234, 41.54169337694035, 50.11468676633613, 0.6751296999999998, 120.0, 688, 180828, 254, 7.704550700000027
255, 6.140741693898352, 41.54715532337854, 50.11910031476152, 0.6729408999999994, 515.0, 1744, 182572, 255, 19.73745400000007
256, 5.761778133160317, 41.59440678678161, 50.18515345181713, 0.6707511999999997, 90.0, 689, 183261, 256, 8.015337300000056
257, 3.3580197565595253, 41.53657748408763, 50.044956601712926, 0.6694956999999998, 85.0, 706, 183967, 257, 7.930302900000015
258, 4.536285818912272, 41.54622860110748, 50.06311457943202, 0.6675390999999997, 665.0, 1468, 185435, 258, 17.024564499999997
259, 4.979025716124627, 41.56373522941608, 50.06225356675146, 0.6658569999999999, 60.0, 401, 185836, 259, 4.72955990000014
260, 4.6901214321155145, 41.6046261212912, 50.1590708077672, 0.6648984999999998, 120.0, 664, 186500, 260, 7.658793800000012
261, 4.17921022612671, 41.51307842302026, 50.01921196457762, 0.6637212999999997, 110.0, 644, 187144, 261, 7.246294899999839
262, 4.511047548228285, 41.544282384035064, 50.137299630700085, 0.6625512999999998, 100.0, 656, 187800, 262, 8.477705499999956
263, 5.206606163637133, 41.560154321177905, 50.11504358645306, 0.6608737000000002, 340.0, 1208, 189008, 263, 13.83485010000004
264, 3.938976805175573, 41.553628368859485, 50.087680351858154, 0.6591807999999999, 165.0, 673, 189681, 264, 8.098462899999959
265, 3.914703184618152, 41.71861599160613, 50.285850765036166, 0.6580746999999997, 75.0, 556, 190237, 265, 6.236844099999871
266, 3.9878836120032286, 42.04471393480693, 50.655670250931834, 0.6570486999999999, 110.0, 584, 190821, 266, 6.9158941000000596
267, 5.458919005828317, 42.12513850493865, 50.80002866008065, 0.6558894999999999, 190.0, 704, 191525, 267, 8.021024500000067
268, 5.523804132663554, 42.096627751213106, 50.77458584262239, 0.6547933000000001, 115.0, 514, 192039, 268, 5.881175500000154
269, 6.707892727069557, 42.09387699508667, 50.82464664077759, 0.6534306999999999, 190.0, 1000, 193039, 269, 11.384927500000003
270, 5.049228703875221, 42.01339042558801, 50.625663500153614, 0.6518098000000002, 160.0, 801, 193840, 270, 9.636264499999925
271, 7.343527743106626, 42.15005508484132, 50.89389141241071, 0.6504166000000001, 155.0, 747, 194587, 271, 9.363341900000023
272, 6.597330706099332, 42.06391389491194, 50.70540982406243, 0.6492664000000002, 90.0, 531, 195118, 272, 6.692929499999991
273, 3.8046895310617566, 42.06773322459017, 50.63890971065907, 0.6479874999999998, 205.0, 890, 196008, 273, 10.984155600000122
274, 4.543773248411861, 42.07427056256463, 50.738001490574256, 0.6467274999999998, 35.0, 510, 196518, 274, 6.3319830000000366
275, 3.653889747544595, 42.0569910262521, 50.68174076859893, 0.6456078999999997, 150.0, 734, 197252, 275, 9.116245100000015
276, 4.544362584186112, 42.043227194569596, 50.68764521592965, 0.6442137999999996, 160.0, 815, 198067, 276, 9.887943899999982
277, 3.5756747286023978, 42.09143630772421, 50.72951727044092, 0.6428889999999998, 210.0, 657, 198724, 277, 7.982833300000038
278, 7.565831957415816, 42.07537090975935, 50.78693272922579, 0.6416460999999999, 255.0, 724, 199448, 278, 9.058239000000185
279, 3.824973881314948, 42.17416813688458, 50.8328223678301, 0.6404221, 210.0, 636, 200084, 279, 7.735346899999968
280, 5.148826902274226, 42.680540116106876, 51.43719951442031, 0.6393007000000002, 110.0, 610, 200694, 280, 7.597064299999829
281, 3.1942056779573846, 42.5976611250764, 51.24083020803812, 0.6382369, 45.0, 572, 201266, 281, 7.147372799999857
282, 4.714473508993193, 42.625038101559596, 51.37869519657559, 0.6368148999999994, 320.0, 1008, 202274, 282, 13.070563900000025
283, 4.140441273036413, 42.6167212843895, 51.33985490202904, 0.6353317000000003, 120.0, 640, 202914, 283, 8.01963139999998
284, 5.451537566551796, 42.64426926128681, 51.40070571429913, 0.6332932000000002, 210.0, 1625, 204539, 284, 20.399359300000015
285, 4.083170978364511, 42.65009813423617, 51.396880636842745, 0.6308596000000002, 405.0, 1079, 205618, 285, 13.440685200000189
286, 5.0794686121663135, 42.652938297008745, 51.40892755269474, 0.6286743999999995, 610.0, 1349, 206967, 286, 16.800434400000086
287, 3.7556301618078645, 42.67488971863164, 51.40582023240526, 0.6267196000000002, 205.0, 823, 207790, 287, 10.341472500000009
288, 4.23525432751763, 42.71258885789626, 51.49236592207805, 0.6256153, 110.0, 404, 208194, 288, 5.177774900000031
289, 3.5828777834218233, 42.677183242554364, 51.396261605810615, 0.6245748999999997, 285.0, 752, 208946, 289, 9.736919800000123
290, 5.336284465237124, 42.72186483194119, 51.53585982472266, 0.6231807999999999, 290.0, 797, 209743, 290, 10.613461700000016
291, 3.8826222814067646, 42.90069948832194, 51.63433606889513, 0.6219775, 50.0, 540, 210283, 291, 8.291490600000088
292, 6.451707266567502, 43.16140760937182, 52.067858425187474, 0.6201792999999995, 240.0, 1458, 211741, 292, 20.22024230000011
293, 2.8147858844027605, 43.15042360988232, 51.94481674684297, 0.6182785000000002, 155.0, 654, 212395, 293, 9.32570439999995
294, 5.718968125401585, 43.18438661826769, 52.08622499447544, 0.6171300999999999, 135.0, 622, 213017, 294, 8.142859700000145
295, 4.2208178031270975, 43.213876310629765, 52.07309759298369, 0.6158439999999998, 160.0, 807, 213824, 295, 10.769109300000082
296, 7.990042607245576, 43.23113465063351, 52.22108082591053, 0.6145938999999996, 10.0, 582, 214406, 296, 7.552867699999979
297, 4.766453684223343, 43.13876154985912, 51.9531859509466, 0.6132546999999999, 300.0, 906, 215312, 297, 11.888498700000127
298, 4.3571691796431935, 43.18904457092285, 52.032956790924075, 0.6118992999999998, 85.0, 600, 215912, 298, 7.967771099999936
299, 7.074740453787116, 43.185155819414, 52.10083137152021, 0.6109399, 110.0, 466, 216378, 299, 7.231262800000195
300, 5.447659428747281, 43.24317618728127, 52.09201350797065, 0.6095521000000002, 370.0, 1076, 217454, 300, 14.043713099999877
301, 4.919357862589876, 43.18297096424308, 52.043649144784474, 0.6076647999999999, 275.0, 1021, 218475, 301, 13.434731600000077
302, 6.8725268577717324, 43.25032950519176, 52.15830844707703, 0.6061050999999996, 110.0, 712, 219187, 302, 9.452426900000091
303, 5.428058094032209, 43.2492834592735, 52.112506515005045, 0.6049954, 110.0, 521, 219708, 303, 6.832275299999992
304, 3.1055190119515643, 43.259169638252565, 52.075322422131684, 0.6039658, 130.0, 623, 220331, 304, 8.334431399999858
305, 3.036981354487109, 43.28159052842147, 52.123199816350336, 0.6023755000000006, 335.0, 1144, 221475, 305, 15.150170200000048
306, 4.134943614174976, 43.27202649040018, 52.121222650048566, 0.6005043999999996, 210.0, 935, 222410, 306, 12.511467000000039
307, 6.687880113994728, 43.34028281990273, 52.314805607700784, 0.5990751999999998, 120.0, 653, 223063, 307, 8.820295299999998
308, 4.567325877966808, 43.30319295839194, 52.18629857029305, 0.5976288999999998, 320.0, 954, 224017, 308, 12.602018900000076
309, 5.612865321997266, 43.27422681221595, 52.14974865913391, 0.5958342999999999, 325.0, 1040, 225057, 309, 13.788880300000073
310, 5.334595043355634, 43.31315208103346, 52.16496832711356, 0.5941738000000002, 195.0, 805, 225862, 310, 10.774016800000027
311, 5.3505107261226605, 43.271813873916145, 52.119914653358954, 0.5929660000000001, 135.0, 537, 226399, 311, 7.351719099999855
312, 5.846482704041534, 43.26203982795825, 52.178553759196156, 0.5917302999999999, 415.0, 836, 227235, 312, 11.198025800000096
313, 3.0813336156895668, 43.249434680360736, 51.99250466086648, 0.5902354000000002, 185.0, 825, 228060, 313, 10.990083200000072
314, 5.838691565237275, 43.2655061918504, 52.17630330215047, 0.5887162000000002, 210.0, 863, 228923, 314, 11.558531700000003
315, 4.741691948327803, 43.374211946645175, 52.2440134034121, 0.5873410000000003, 190.0, 665, 229588, 315, 9.050138800000013
316, 4.1461560429737965, 43.324097414853995, 52.15757893597033, 0.5863221999999999, 75.0, 467, 230055, 316, 6.503073399999948
317, 4.039935314276795, 43.24296363780136, 52.07428635191084, 0.5849487999999999, 235.0, 1059, 231114, 317, 14.626958400000149
318, 4.29305441805713, 43.261189631806545, 52.15486908896256, 0.5836294, 45.0, 407, 231521, 318, 5.552996200000052
319, 5.822484399502476, 43.27839608681508, 52.17092310465299, 0.5827015, 155.0, 624, 232145, 319, 8.75145550000002
320, 4.982619316195978, 43.2599560672797, 52.13280282992761, 0.5812128999999998, 225.0, 1030, 233175, 320, 14.089101600000049
321, 8.69004649464564, 43.351295495908666, 52.30184299642015, 0.5798692, 30.0, 463, 233638, 321, 6.399186699999973
322, 4.84148883733046, 43.2482913479157, 52.080665592809446, 0.5786776000000002, 215.0, 861, 234499, 322, 11.737232999999833
323, 4.020351586087297, 43.20416471030977, 51.99731300274531, 0.5773843000000001, 50.0, 576, 235075, 323, 7.956017799999927
324, 2.880876448508111, 43.2986715461322, 52.16942462462815, 0.5763790000000001, 80.0, 541, 235616, 324, 7.405567500000188
325, 4.843738025223667, 43.25297381661155, 52.078758769565155, 0.5755357000000001, 20.0, 396, 236012, 325, 5.395120800000086
326, 2.840114153861808, 43.2276679723259, 52.04577338523314, 0.5746186000000001, 110.0, 623, 236635, 326, 8.708415000000059
327, 5.13684005912008, 43.29968998349946, 52.20961494445801, 0.5735359, 95.0, 580, 237215, 327, 8.0942778000001
328, 2.574945811515726, 43.245733217205235, 52.02880057898324, 0.5723100999999998, 35.0, 782, 237997, 328, 10.675482899999906
329, 5.709658688668049, 43.32619204451607, 52.24799532306984, 0.5708043999999999, 200.0, 891, 238888, 329, 12.416917399999875
330, 3.7240853081923615, 43.27839358189796, 52.12023792868616, 0.5693463999999999, 100.0, 729, 239617, 330, 10.202249100000017
331, 2.281869602638141, 42.786577966742385, 51.4753313231052, 0.5679684999999998, 110.0, 802, 240419, 331, 11.24456269999996
332, 4.558590800898621, 42.37777516928064, 51.022600573804006, 0.5668731999999999, 95.0, 415, 240834, 332, 5.911945900000092
333, 3.90575599976075, 42.42941153762687, 51.06853337844892, 0.5658678999999999, 140.0, 702, 241536, 333, 9.779091899999912
334, 6.809750651853762, 42.51807849781517, 51.27430024747296, 0.5645998, 95.0, 707, 242243, 334, 9.807754500000101
335, 4.660981720568916, 42.39651057253409, 51.07652685203418, 0.5631958, 265.0, 853, 243096, 335, 11.86838560000001
336, 5.285382783016585, 42.528197247049086, 51.24398422729024, 0.5617243, 195.0, 782, 243878, 336, 11.997599300000047
337, 4.400224844163114, 42.36461448143993, 50.99746732475344, 0.5606937999999999, 45.0, 363, 244241, 337, 5.518827399999964
338, 3.7332225727832524, 42.40098892380653, 51.06853539947461, 0.5597973999999997, 135.0, 633, 244874, 338, 9.300320600000077
339, 7.130307738101759, 42.49233516722686, 51.30874077848686, 0.5586472, 115.0, 645, 245519, 339, 9.278115399999933
340, 4.59075957607319, 42.449844338656604, 51.13445271134942, 0.5571172000000001, 335.0, 1055, 246574, 340, 15.312187399999857
341, 5.935557117451626, 42.44621914968441, 51.21102302611186, 0.5554800999999998, 190.0, 764, 247338, 341, 11.174403900000016
342, 6.674314743847164, 42.48953765070336, 51.2450532383389, 0.5539501, 225.0, 936, 248274, 342, 13.22678719999999
343, 4.2546788333947285, 42.44094051163772, 51.100187657893386, 0.5524812999999998, 160.0, 696, 248970, 343, 9.971608199999991
344, 5.579283707394389, 42.44783658934344, 51.16488178610214, 0.5514895, 65.0, 406, 249376, 344, 5.778539799999862
345, 5.573342798025804, 42.57573098988332, 51.32493090999628, 0.5503123, 190.0, 902, 250278, 345, 13.04648700000007
346, 4.300024695527869, 42.84321348453925, 51.53826258434513, 0.5490577, 75.0, 492, 250770, 346, 7.151684899999964
347, 5.615053934884626, 42.82663441857626, 51.63895944284838, 0.5476474, 470.0, 1075, 251845, 347, 15.075834299999997
348, 4.148267380849913, 42.83436168256656, 51.52111951694932, 0.5462155000000002, 35.0, 516, 252361, 348, 7.409249400000135
349, 4.596046083981568, 42.841568527305796, 51.59948219459138, 0.5449348000000002, 180.0, 907, 253268, 349, 13.810660899999903
350, 3.687733129835985, 42.84609904695064, 51.5731057055453, 0.5434417, 80.0, 752, 254020, 350, 11.521055100000012
351, 3.554490461289508, 42.83593117216098, 51.53551616908619, 0.5421925, 110.0, 636, 254656, 351, 9.345911500000057
352, 8.750977200571842, 42.927602416359335, 51.83587521671699, 0.5412295, 45.0, 434, 255090, 352, 6.398628499999859
353, 2.903754843297855, 42.82409782705381, 51.547443679691284, 0.5402583999999999, 95.0, 645, 255735, 353, 9.396656699999994
354, 7.217454932804809, 42.84773831886015, 51.68009738881451, 0.5392558000000001, 30.0, 469, 256204, 354, 6.9148762999998326
355, 3.965298913406467, 42.79934513752906, 51.55125036615859, 0.5383090000000001, 75.0, 583, 256787, 355, 8.396824000000379
356, 3.658090605699415, 42.828670349930576, 51.55490781141529, 0.5371056999999998, 175.0, 754, 257541, 356, 11.114673500000208
357, 3.654993264683582, 42.89138544956452, 51.64058297725734, 0.5356962999999997, 270.0, 812, 258353, 357, 11.691457000000355
358, 4.857485250577371, 42.82181842589186, 51.572659193350866, 0.5342940999999998, 145.0, 746, 259099, 358, 10.801748299999872
359, 5.221596284950248, 42.78573431254019, 51.55424345330466, 0.5328900999999999, 115.0, 814, 259913, 359, 11.980171199999859
360, 3.018574714237813, 42.7714593069894, 51.46877844226337, 0.5316975999999999, 65.0, 511, 260424, 360, 7.437891900000068
361, 4.222004880746235, 42.792668014368594, 51.50541366960309, 0.5306283999999999, 340.0, 677, 261101, 361, 10.002737799999977
362, 3.745887251344965, 42.7487464012331, 51.44866393194049, 0.5293882, 155.0, 701, 261802, 362, 10.395435299999917
363, 5.5729871745357356, 42.73606247634031, 51.501884541886575, 0.5279562999999999, 250.0, 890, 262692, 363, 13.186210600000322
364, 4.261230168589788, 42.674145587655, 51.37823293375414, 0.5266908999999997, 160.0, 516, 263208, 364, 7.596261700000014
365, 4.60857993051015, 42.78681509700043, 51.52985415237629, 0.5251393, 290.0, 1208, 264416, 365, 17.709222999999838
366, 4.453264385569656, 42.763598705517225, 51.514337578786154, 0.5233059999999998, 75.0, 829, 265245, 366, 12.490381499999785
367, 4.16364190223146, 42.81953909767233, 51.56872740032871, 0.5215626999999996, 385.0, 1108, 266353, 367, 17.012279800000215
368, 7.256575455409276, 42.776039123535156, 51.57494185565693, 0.5196781000000001, 440.0, 986, 267339, 368, 15.387513000000126
369, 6.387737694991887, 42.79873792532399, 51.591180685475386, 0.5179761999999999, 510.0, 905, 268244, 369, 13.670435499999712
370, 5.031249895691872, 42.80495100506281, 51.520660361597095, 0.5166307000000001, 75.0, 590, 268834, 370, 9.061696900000243
371, 3.695828091468644, 42.73471682301159, 51.396189467164085, 0.515548, 120.0, 613, 269447, 371, 9.341653699999824
372, 3.595518060230157, 43.10288353863884, 51.85615259507123, 0.5142313000000002, 230.0, 850, 270297, 372, 13.275323000000299
373, 5.717899927805712, 43.659630877065055, 52.601866471336265, 0.5125456000000002, 315.0, 1023, 271320, 373, 15.99352480000016
374, 4.076539028929907, 43.630556891636296, 52.531353497373466, 0.5109733, 140.0, 724, 272044, 374, 10.97604339999998
375, 3.752026237712966, 43.68567343817817, 52.59053372418439, 0.5097142000000001, 110.0, 675, 272719, 375, 10.673104400000284
376, 2.9818048798619303, 43.62188664141839, 52.459615143910966, 0.5082994, 170.0, 897, 273616, 376, 13.857169099999737
377, 4.825811913493507, 43.56026818509587, 52.43909456629953, 0.5071915, 35.0, 334, 273950, 377, 5.120297700000265
378, 4.429374440824488, 43.63510603645859, 52.53433889633647, 0.505747, 355.0, 1271, 275221, 378, 19.247700899999927
379, 5.392338623368613, 43.675236973317766, 52.61994320217524, 0.5038407999999999, 475.0, 847, 276068, 379, 13.075719699999809
380, 4.442471216660178, 43.748488587437414, 52.68088627177708, 0.5022639999999998, 285.0, 905, 276973, 380, 13.71161979999988
381, 5.824318859332461, 43.7729578095723, 52.772661216859895, 0.5010067, 85.0, 492, 277465, 381, 7.549287800000002
382, 3.8040417086014515, 43.70528985251577, 52.59543419593329, 0.49983759999999994, 155.0, 807, 278272, 382, 13.551430999999866
383, 4.715278138534939, 43.68083963925538, 52.61984049889349, 0.49849750000000004, 110.0, 682, 278954, 383, 11.64529930000026
384, 5.643334612697581, 43.692153143149696, 52.64016036652192, 0.497269, 145.0, 683, 279637, 384, 11.166499099999783
385, 3.420606504134137, 43.75558708794683, 52.6372379001096, 0.4960288000000002, 185.0, 695, 280332, 385, 10.90065530000038
386, 4.195651996102463, 43.71431695036666, 52.63907348601862, 0.49495960000000006, 85.0, 493, 280825, 386, 7.647627199999988
387, 3.764867028361137, 43.69302135334599, 52.564801724684656, 0.49366359999999987, 210.0, 947, 281772, 387, 15.029093699999976
388, 3.642128143710644, 43.679881551078786, 52.557923045414185, 0.4921569999999999, 175.0, 727, 282499, 388, 11.361796299999696
389, 6.626824646665737, 43.77255696785159, 52.83344073993404, 0.4909122999999997, 125.0, 656, 283155, 389, 10.154734199999893
390, 3.984498037060477, 43.72634960870323, 52.59368388457868, 0.4897494999999999, 105.0, 636, 283791, 390, 9.967047399999956
391, 3.623329199867967, 43.710017966332835, 52.57760562183701, 0.48840669999999986, 345.0, 856, 284647, 391, 13.569607400000223
392, 6.273105717251792, 43.80844392397904, 52.757258337702325, 0.4871602, 90.0, 529, 285176, 392, 8.328525700000228
393, 6.969986858018901, 43.76812935174915, 52.79230842410676, 0.48611080000000007, 175.0, 637, 285813, 393, 10.050655300000017
394, 5.552346045039106, 43.7589209544086, 52.71641657800133, 0.48450700000000024, 380.0, 1145, 286958, 394, 18.260991099999956
395, 5.613459204041371, 43.86878551858844, 52.87896159923438, 0.4830012999999999, 100.0, 528, 287486, 395, 8.512945100000252
396, 4.246960316736674, 43.729096346021656, 52.60365312888723, 0.48174040000000007, 245.0, 873, 288359, 396, 13.63577179999993
397, 5.488957060667319, 43.7315711076641, 52.67316953005805, 0.48003759999999984, 280.0, 1019, 289378, 397, 16.33107680000012
398, 8.214632453831289, 43.79026988937921, 52.81416869634696, 0.47866510000000007, 120.0, 506, 289884, 398, 8.189149199999974
399, 4.828560468686862, 44.05726020268765, 53.04348834462634, 0.47754100000000005, 120.0, 743, 290627, 399, 11.96619980000014
400, 6.258341127655888, 44.19555728142533, 53.20377560156442, 0.47607400000000005, 225.0, 887, 291514, 400, 14.18317419999994
401, 4.793374924052918, 44.176557972403984, 53.17670484187485, 0.47432889999999983, 290.0, 1052, 292566, 401, 16.634678800000074
402, 5.76835452456667, 44.21260700803815, 53.215043530319676, 0.4730257, 50.0, 396, 292962, 402, 6.588364100000035
403, 3.1717542130710945, 44.10535954169507, 53.019332677013466, 0.47219229999999995, 125.0, 530, 293492, 403, 8.70490589999963
404, 3.797315475165844, 44.12719125366211, 53.092794410705565, 0.47126529999999983, 90.0, 500, 293992, 404, 8.040153500000088
405, 3.7543118659939085, 44.13310595921108, 53.11627695295546, 0.47013489999999997, 215.0, 756, 294748, 405, 12.185670699999719
406, 4.225736110586371, 44.23910225912034, 53.23286543128347, 0.46894509999999995, 45.0, 566, 295314, 406, 9.110992800000076
407, 2.7136714991723747, 44.13233183682495, 53.09322448866304, 0.4678291000000001, 120.0, 674, 295988, 407, 10.93483200000037
408, 5.799242793345167, 44.171024078407434, 53.20963461575574, 0.46650520000000023, 155.0, 797, 296785, 408, 12.780508599999848
409, 4.300615838149391, 44.072634242436294, 52.974052806041065, 0.46526860000000003, 155.0, 577, 297362, 409, 9.985921299999973
410, 3.0820029760306737, 44.15422983589412, 53.10618942788562, 0.4641768999999997, 110.0, 636, 297998, 410, 10.625448499999948
411, 7.3767982886504315, 44.14507265899141, 53.21194410162457, 0.4630735, 65.0, 590, 298588, 411, 9.526003899999978
412, 4.385082468438845, 44.10866881448985, 53.08915042464351, 0.46171089999999987, 215.0, 924, 299512, 412, 14.952975899999728
413, 4.997972155188861, 44.05316359114973, 53.02513031632933, 0.4602223, 125.0, 730, 300242, 413, 11.999671399999897
414, 4.549106966672212, 43.88058862020803, 52.82328079204956, 0.4588299999999998, 230.0, 817, 301059, 414, 13.3389545
415, 2.3273001965089115, 43.85343704980893, 52.70987051118988, 0.457732, 70.0, 403, 301462, 415, 6.667055800000071
416, 2.960259288846259, 43.7918680578589, 52.655627725608795, 0.45691750000000003, 20.0, 502, 301964, 416, 8.335202000000208
417, 5.7476210646921455, 43.80563196805444, 52.80987320323982, 0.45610210000000007, 15.0, 404, 302368, 417, 6.632801400000062
418, 3.1289527688194743, 43.86556730122146, 52.76336814208352, 0.4553911, 30.0, 386, 302754, 418, 6.311854099999891
419, 3.8861043646580655, 43.873700229718295, 52.80989175588211, 0.45420309999999997, 250.0, 934, 303688, 419, 15.631061399999908
420, 3.0399660371243953, 43.827802369088836, 52.665636392073196, 0.45276849999999996, 90.0, 660, 304348, 420, 10.950312400000257
421, 4.21114924072718, 43.90491097126532, 52.87794860349883, 0.45158589999999976, 140.0, 654, 305002, 421, 10.772957200000292
422, 4.119385015185888, 43.84490540650514, 52.801971435546875, 0.45059770000000005, 20.0, 444, 305446, 422, 7.413700399999925
423, 2.9669511707064373, 43.74100451753171, 52.60657447515967, 0.44957800000000014, 145.0, 689, 306135, 423, 11.551100600000154
424, 2.415600482561016, 43.947026267570536, 52.88246254270353, 0.4484368000000001, 135.0, 579, 306714, 424, 9.585216399999808
425, 5.478047637030818, 43.928476053969305, 52.851717554536975, 0.4474368999999999, 50.0, 532, 307246, 425, 8.873465600000145
426, 4.584731335911064, 43.88224543727396, 52.84255239900074, 0.44601129999999983, 620.0, 1052, 308298, 426, 19.030322699999942
427, 7.411287512923505, 43.89450565894045, 52.91007799439294, 0.4445272, 30.0, 597, 308895, 427, 10.441357700000026
428, 3.389022915416266, 43.959047475137, 52.86710854995349, 0.44355430000000007, 105.0, 484, 309379, 428, 8.683406000000105
429, 3.743630509753879, 43.84642506880726, 52.7226209626781, 0.44249320000000003, 110.0, 695, 310074, 429, 11.52133619999995
430, 5.166198886280642, 43.77766791365093, 52.83143523446937, 0.44150680000000003, 30.0, 401, 310475, 430, 6.682277599999907
431, 5.925677308373716, 43.8947688611203, 52.84613281092873, 0.4403592999999998, 140.0, 874, 311349, 431, 14.544830000000275
432, 4.362519097890733, 43.83741268752615, 52.71622843656409, 0.43872399999999984, 225.0, 943, 312292, 432, 15.832661200000075
433, 6.287689068286345, 43.87385153310179, 52.856294226922586, 0.4374090999999999, 65.0, 518, 312810, 433, 8.648069599999872
434, 4.541910615173295, 43.82406467147695, 52.753924086187986, 0.4360077999999999, 270.0, 1039, 313849, 434, 17.21806430000015
435, 4.044052830191649, 43.78520389054015, 52.68267981253673, 0.43439680000000014, 200.0, 751, 314600, 435, 13.022148699999889
436, 4.82409494404525, 43.78470467906411, 52.67034559794333, 0.43274350000000006, 245.0, 1086, 315686, 436, 18.20106220000025
437, 5.51013748155267, 43.79471048975426, 52.71234583637273, 0.4311738999999999, 145.0, 658, 316344, 437, 10.935495000000174
438, 3.5531280567879833, 43.86749203929585, 52.71841253206875, 0.42976720000000007, 330.0, 905, 317249, 438, 17.124058100000184
439, 4.431140639980035, 43.83283988538995, 52.80383912435018, 0.4280562999999999, 225.0, 996, 318245, 439, 19.003093000000263
440, 5.111388007896045, 43.83441680592776, 52.79069429343369, 0.4264632999999998, 110.0, 774, 319019, 440, 14.83471150000014
441, 5.143173694555063, 43.7953495001941, 52.68864022485958, 0.42504219999999987, 260.0, 805, 319824, 441, 16.546554200000173
442, 3.9494232675093772, 43.731859261455064, 52.585887298040966, 0.4238119, 110.0, 562, 320386, 442, 10.55401619999975
443, 3.7588736920872616, 43.45376283345771, 52.27405012059637, 0.4227507999999999, 95.0, 617, 321003, 443, 12.510935599999812
444, 7.3088337499497715, 43.57424577162915, 52.46396184545964, 0.42186160000000006, 55.0, 371, 321374, 444, 7.198569899999711
445, 2.994910341331806, 43.583360193769714, 52.38499684236488, 0.4209102999999999, 185.0, 686, 322060, 445, 12.988692900000387
446, 3.463906572208513, 43.52514133353158, 52.4038442955752, 0.4192650999999999, 700.0, 1142, 323202, 446, 22.624616199999764
447, 2.4929636375184554, 43.54895391882178, 52.3556572963517, 0.4177854999999998, 80.0, 502, 323704, 447, 9.31181689999994
448, 5.2767848231020995, 43.520595576386945, 52.40031373281562, 0.41640399999999983, 300.0, 1033, 324737, 448, 18.3991888999999
449, 5.61010517396647, 43.569812454294826, 52.43637782047919, 0.41489560000000003, 95.0, 643, 325380, 449, 11.740608399999928
450, 2.5312789997981704, 43.48208448104276, 52.27029039805172, 0.4137273999999999, 130.0, 655, 326035, 450, 12.400149399999918
451, 3.6724945108095803, 43.53620981875761, 52.40886855419771, 0.41255469999999994, 185.0, 648, 326683, 451, 13.220174799999768
452, 3.6219399953254294, 43.500817210063175, 52.35382590448813, 0.41072499999999995, 685.0, 1385, 328068, 452, 25.43229919999976
453, 5.392538753002882, 43.568080768585205, 52.45407647768656, 0.4083984999999999, 295.0, 1200, 329268, 453, 22.20009519999985
454, 4.29442309744839, 43.47558112536321, 52.31428991539629, 0.40647519999999976, 350.0, 937, 330205, 454, 17.670639400000255
455, 5.032273508709415, 43.496894806854485, 52.40216275148614, 0.40516749999999985, 30.0, 516, 330721, 455, 9.95579889999999
456, 4.8596483609003895, 43.4761884366549, 52.384434431027145, 0.4038255999999998, 380.0, 975, 331696, 456, 18.416659100000288
457, 2.729046316131869, 43.48635282122682, 52.263298740078774, 0.4024467999999998, 150.0, 557, 332253, 457, 11.03537389999974
458, 3.7239725386596616, 43.481963045108394, 52.30723791537078, 0.4013659, 150.0, 644, 332897, 458, 12.20243500000015
459, 2.6003150210437793, 43.5177734311289, 52.302374113078905, 0.40035519999999986, 55.0, 479, 333376, 459, 9.523376999999982
460, 6.061994083967488, 43.540606300387765, 52.479845730604325, 0.39911050000000015, 265.0, 904, 334280, 460, 16.793875099999696
461, 4.238204275933022, 43.486485482248426, 52.3135904905838, 0.3974266000000001, 265.0, 967, 335247, 461, 17.68479679999973
462, 4.162845652516965, 43.51920624236603, 52.35381224534133, 0.3956553999999998, 355.0, 1001, 336248, 462, 18.242950199999996
463, 3.5870202611456263, 43.51613272632342, 52.32888014798338, 0.39388599999999985, 210.0, 965, 337213, 463, 18.72146759999987
464, 4.64756754757082, 43.57397505518291, 52.4637035455995, 0.39233979999999996, 275.0, 753, 337966, 464, 13.519442199999958
465, 4.940120687867124, 43.54127212448969, 52.441616265823875, 0.3909340000000001, 140.0, 809, 338775, 465, 15.196182200000294
466, 3.909123958787922, 43.56476648788006, 52.4066809428764, 0.38912860000000005, 265.0, 1197, 339972, 466, 23.565641900000173
467, 6.506333843113563, 43.5580887689772, 52.49084483268146, 0.3874366, 170.0, 683, 340655, 467, 13.613439399999606
468, 2.6473151618834607, 43.417883750962915, 52.19793483189174, 0.3860974, 205.0, 805, 341460, 468, 16.823811000000205
469, 6.250271165830977, 43.469644712921756, 52.3779728115005, 0.3847024000000001, 175.0, 745, 342205, 469, 15.736941699999988
470, 4.493624446446735, 43.43969481120738, 52.235039861319294, 0.3833353, 390.0, 774, 342979, 470, 14.323122100000091
471, 3.0961847207642723, 43.425864356616145, 52.18559468321639, 0.38229399999999997, 65.0, 383, 343362, 471, 7.450299000000086
472, 5.178273372596616, 43.47291808054237, 52.37753983071019, 0.38142819999999994, 100.0, 579, 343941, 472, 10.935521899999912
473, 3.4172167389847705, 43.42588108983533, 52.27369400550579, 0.3803068, 65.0, 667, 344608, 473, 13.088690599999609
474, 6.527200809037788, 43.51816161918088, 52.41486557286409, 0.3787731999999998, 275.0, 1037, 345645, 474, 18.935749700000088
475, 4.5577560736410385, 43.42643989292921, 52.2585459177473, 0.37743309999999997, 105.0, 452, 346097, 475, 7.9577962999997
476, 5.715833325068213, 43.53078447463196, 52.39695604136914, 0.37640349999999984, 180.0, 692, 346789, 476, 12.39191770000025
477, 2.8166980825840158, 43.490423378369485, 52.30458822768912, 0.37540000000000007, 65.0, 423, 347212, 477, 7.495580899999823
478, 2.901419577999085, 43.36997426633034, 52.141390254871595, 0.3744513999999999, 125.0, 631, 347843, 478, 11.222749999999905
479, 2.698702977705248, 43.520114104280765, 52.322093829912006, 0.3734469999999999, 45.0, 485, 348328, 479, 8.619431900000109
480, 2.7876292057409735, 43.42754338125507, 52.22503483937886, 0.3725596, 120.0, 501, 348829, 480, 9.168804900000396
481, 4.957694821212717, 43.486328775848826, 52.32710747620882, 0.3715389999999999, 215.0, 633, 349462, 481, 11.410357600000225
482, 5.449070317502093, 43.15134659463478, 51.98291208187993, 0.3701241999999998, 310.0, 939, 350401, 482, 16.872447500000362
483, 3.6110210885951353, 42.665843442189605, 51.348920196815484, 0.3684034000000001, 290.0, 973, 351374, 483, 17.531727500000216
484, 5.056042287643511, 42.83759745944936, 51.54385491900225, 0.36701829999999996, 50.0, 566, 351940, 484, 10.06239830000004
485, 4.314152894683617, 42.77751033936915, 51.43969363054352, 0.3661075, 135.0, 446, 352386, 485, 8.518383099999937
486, 7.546649184581396, 42.80357143184444, 51.642880551449885, 0.3651066999999999, 140.0, 666, 353052, 486, 12.169251099999656
487, 7.697196289153863, 42.94333615640956, 51.76951517019998, 0.3641644, 30.0, 381, 353433, 487, 7.259023099999922
488, 4.244225611822945, 42.78879020472935, 51.42376436505999, 0.3630339999999999, 130.0, 875, 354308, 488, 18.89721679999957
489, 2.9282839341239417, 42.67391137680389, 51.32707325345438, 0.3618783999999999, 110.0, 409, 354717, 489, 8.379159399999935
490, 3.044778788496903, 42.751949671919014, 51.43233675761737, 0.36102609999999985, 85.0, 538, 355255, 490, 10.366779400000269
491, 3.8131876734789425, 42.850093456337866, 51.53610887032572, 0.35990019999999995, 170.0, 713, 355968, 491, 13.75170849999995
492, 3.8571049004563918, 42.799213562011715, 51.5114991584191, 0.35867349999999987, 165.0, 650, 356618, 492, 12.88915709999992
493, 4.950205998567609, 42.726972118938136, 51.396497854802284, 0.35713900000000004, 230.0, 1055, 357673, 493, 26.337218699999994
494, 4.337489764118837, 42.782071937492475, 51.49167962619062, 0.3554884, 135.0, 779, 358452, 494, 18.584632500000225
495, 2.795692401603411, 42.797489240874874, 51.46780517690048, 0.35405109999999995, 145.0, 818, 359270, 495, 18.64423859999988
496, 4.0536610060547655, 43.11922821869721, 51.91008539715329, 0.35198289999999993, 515.0, 1480, 360750, 496, 37.4879818000004
497, 5.666578468084335, 43.41696572875976, 52.28330541556222, 0.34986340000000005, 140.0, 875, 361625, 497, 22.140966500000104
498, 6.106649446541287, 43.495321430068415, 52.43719242049987, 0.3483289, 185.0, 830, 362455, 498, 19.783403200000066
499, 4.625936506350559, 43.48156275824895, 52.313502117439555, 0.3462210999999999, 520.0, 1512, 363967, 499, 45.668456100000185
500, 6.872611851392392, 43.41074196212068, 52.32247108566071, 0.3444093999999999, 50.0, 501, 364468, 500, 14.19962919999989
501, 4.525121328246898, 43.412874063580496, 52.23305311524661, 0.3429712000000001, 375.0, 1097, 365565, 501, 33.57722039999999
502, 3.356673739196585, 43.50547966716958, 52.36840041455605, 0.3413583999999999, 50.0, 695, 366260, 502, 20.883021599999665
503, 5.808368060871517, 43.49021283177987, 52.35463649731902, 0.340156, 165.0, 641, 366901, 503, 18.668671200000063
504, 4.030536737452453, 43.44924215027331, 52.23229871371377, 0.33911649999999977, 75.0, 514, 367415, 504, 15.719195199999831
505, 5.562506814756154, 43.37992945076532, 52.2047084398682, 0.3380086, 80.0, 717, 368132, 505, 22.451385500000015
506, 5.14986840898979, 43.485796839179855, 52.36089999359984, 0.3366225999999998, 85.0, 823, 368955, 506, 26.612253799999962
507, 3.9834250949132137, 43.415043602162356, 52.185376220519004, 0.3352852000000001, 155.0, 663, 369618, 507, 20.248568899999555
508, 6.641968953609466, 43.54754840087891, 52.35826164754232, 0.33435099999999995, 55.0, 375, 369993, 508, 12.014110000000073
509, 7.031174708882008, 43.681409338983826, 52.63533832399788, 0.33330519999999997, 95.0, 787, 370780, 509, 24.039385299999594
510, 4.139407513304167, 43.66994780636905, 52.5364337944222, 0.33155560000000006, 350.0, 1157, 371937, 510, 35.17880000000059
511, 4.476406872500862, 43.6350430894172, 52.46026506825882, 0.33004449999999985, 25.0, 522, 372459, 511, 16.390907399999378
512, 7.197878115372703, 43.66532641229318, 52.5957242000993, 0.3287188000000001, 180.0, 951, 373410, 512, 29.972868099999687
513, 3.0191024390197247, 43.72378395294475, 52.54402228382146, 0.32689989999999985, 375.0, 1070, 374480, 513, 34.21192069999961
514, 3.4308849114526825, 43.66478893440518, 52.46931886724413, 0.32510259999999985, 415.0, 927, 375407, 514, 28.004841599999963
515, 4.454275935685093, 43.71818745353005, 52.588926605744795, 0.32347629999999994, 510.0, 880, 376287, 515, 26.165646399999787
516, 3.211814078629704, 43.69903843485347, 52.53879453479949, 0.322138, 175.0, 607, 376894, 516, 18.774549200000365
517, 3.918309787474222, 43.70515168543814, 52.587796830861585, 0.32063590000000003, 235.0, 1062, 377956, 517, 33.06232809999983
518, 3.5915522859710403, 43.891933164025986, 52.859096812386795, 0.31925889999999996, 90.0, 468, 378424, 518, 14.013820300000589
519, 3.835146732452184, 43.74155568214385, 52.61994122331431, 0.3181905999999999, 70.0, 719, 379143, 519, 22.59907479999947
520, 4.916093888120299, 43.745191051299315, 52.64421707750803, 0.31694589999999995, 195.0, 664, 379807, 520, 20.56027559999984
521, 4.355584111601601, 43.69530280738139, 52.557811408305064, 0.3157426, 135.0, 673, 380480, 521, 20.50454119999995
522, 3.5460569118661, 43.64011686909406, 52.44990989376355, 0.3143583999999999, 230.0, 865, 381345, 522, 27.15066999999999
523, 3.416938821678393, 43.59277688956994, 52.43082120456322, 0.3126141999999998, 285.0, 1073, 382418, 523, 33.12229560000014
524, 5.846127765210746, 43.68397682769389, 52.6272572867478, 0.3109375, 190.0, 790, 383208, 524, 25.957828900000095
525, 4.800417359669026, 43.64238094344852, 52.55423884504423, 0.30931210000000003, 300.0, 1016, 384224, 525, 33.3464428999996
526, 4.16423750019767, 43.63919249120748, 52.46661262392248, 0.3078252999999999, 110.0, 636, 384860, 526, 21.92511259999992
527, 3.335148924740202, 43.751172487731104, 52.61954042460719, 0.3067911999999998, 105.0, 513, 385373, 527, 17.180795899999794
528, 5.616115821358196, 43.71634177772366, 52.618337296466436, 0.3054474999999998, 325.0, 980, 386353, 528, 32.55321300000014
529, 2.913800542945602, 43.64143559976589, 52.4324002295184, 0.3039786999999999, 125.0, 652, 387005, 529, 21.582859699999972
530, 6.2225562201767435, 43.738344350675256, 52.63417666830668, 0.3026538999999999, 140.0, 820, 387825, 530, 27.242181000000528
531, 3.81015966553241, 43.70144356489182, 52.543468683958054, 0.3013398999999999, 150.0, 640, 388465, 531, 21.98657809999986
532, 5.277408906185552, 43.62247387366959, 52.54016169294526, 0.30005289999999996, 110.0, 790, 389255, 532, 26.969295499999134
533, 2.681975816650639, 43.615543726127285, 52.43333934018022, 0.29841849999999986, 225.0, 1026, 390281, 533, 35.877891200000704
534, 4.334686104620929, 43.48225018544951, 52.328165592435894, 0.29688579999999987, 170.0, 677, 390958, 534, 20.673544700000093
535, 3.743161214878869, 43.41603518860997, 52.163836275460916, 0.2956950999999999, 95.0, 646, 391604, 535, 19.70996650000052
536, 7.883546700784228, 43.51173837416441, 52.43239618536681, 0.29477079999999994, 30.0, 381, 391985, 536, 12.149168400000235
537, 3.8570553293292837, 43.42062684288321, 52.218433013442876, 0.29384740000000004, 135.0, 645, 392630, 537, 19.66703830000006
538, 5.502578801529843, 43.479395893793395, 52.33469142684017, 0.2922958, 235.0, 1079, 393709, 538, 30.291572899999665
539, 5.500882913806577, 43.55058090632748, 52.38872305151798, 0.2906101, 145.0, 794, 394503, 539, 17.003723199999513
540, 7.202360257299769, 43.47615604632029, 52.299103285658916, 0.28937619999999986, 45.0, 577, 395080, 540, 23.57170479999968
541, 4.287093183567078, 43.546609728207144, 52.43820255260749, 0.28812609999999994, 200.0, 812, 395892, 541, 32.28566360000059
542, 6.653550306773101, 43.46322547115226, 52.29293623899338, 0.28663749999999993, 420.0, 842, 396734, 542, 33.7271953999998
543, 6.539294640354526, 43.50418919324875, 52.404444061792816, 0.2851308999999999, 90.0, 832, 397566, 543, 31.059464500000104
544, 4.004092435438209, 43.447391744040274, 52.24275566366309, 0.2835019, 175.0, 978, 398544, 544, 34.37791620000007
545, 3.6298397631471992, 43.496289962377304, 52.33112286298703, 0.2820952, 175.0, 585, 399129, 545, 21.97187600000052
546, 4.3283895463574416, 43.46517806829408, 52.311975684276845, 0.28094949999999996, 160.0, 688, 399817, 546, 25.31849349999993
547, 5.299665595814296, 43.2722841849123, 52.06812070408684, 0.2798676999999999, 120.0, 514, 400331, 547, 18.76272920000065
548, 4.592085770550159, 43.14515492173492, 51.914328854809256, 0.2784169000000001, 355.0, 1098, 401429, 548, 39.859804699999586
549, 3.8788148623714087, 43.20092684750928, 51.96174221611464, 0.2762595999999998, 145.0, 1299, 402728, 549, 46.43212390000008
550, 3.0270136807627264, 43.16314128430909, 51.85539025215715, 0.2745810999999999, 35.0, 566, 403294, 550, 19.33602719999999
551, 4.4999454347205985, 43.21939620587972, 52.0121797144363, 0.272998, 470.0, 1193, 404487, 551, 41.662305699999706
552, 4.280983222634971, 43.23243536960703, 51.95218687080587, 0.27155259999999987, 80.0, 413, 404900, 552, 14.454844500000036
553, 4.922047221214245, 43.257672766104186, 52.06229359133588, 0.270577, 180.0, 671, 405571, 553, 24.597589099999823
554, 3.185595930381031, 43.26442988735445, 52.06487418467274, 0.2693188, 105.0, 727, 406298, 554, 25.863810200000444
555, 8.22325800321041, 43.23659983048072, 52.13809719452491, 0.2681029, 85.0, 624, 406922, 555, 22.464094199999636
556, 3.0136650057401853, 43.28661109548565, 52.03817091866275, 0.26670069999999996, 340.0, 934, 407856, 556, 34.707950600000004
557, 4.1606038831585215, 43.15546193812181, 51.90026309131332, 0.26525619999999994, 75.0, 671, 408527, 557, 18.373655600000347
558, 4.330247105747986, 43.182087628859385, 51.94637808915655, 0.2635785999999999, 295.0, 1193, 409720, 558, 39.875628900000265
559, 7.590390530564747, 43.8551491868907, 52.81258636233451, 0.2618784999999999, 180.0, 696, 410416, 559, 22.581853499999852
560, 3.861815496922174, 44.042529166220774, 52.956901205040865, 0.2602378, 230.0, 1127, 411543, 560, 35.74422620000041
561, 3.7332071695822338, 44.06493138149001, 53.02643711583938, 0.2583405999999999, 325.0, 981, 412524, 561, 33.7096046000006
562, 4.231203150019735, 44.00506931767803, 52.89050174856784, 0.25702749999999996, 95.0, 478, 413002, 562, 15.848646899999949
563, 4.263602766296978, 43.98538093150313, 52.86008401593998, 0.25602040000000004, 160.0, 641, 413643, 563, 22.484112399999503
564, 2.898725589410383, 44.01494784452477, 52.86442815041055, 0.2550024999999999, 50.0, 490, 414133, 564, 16.133819600000606
565, 7.0647496826089045, 44.030711535111216, 53.029071125342675, 0.2539126, 150.0, 721, 414854, 565, 24.836294499999894
566, 3.10408981047409, 44.00958407979975, 52.908432357100295, 0.25272459999999985, 40.0, 599, 415453, 566, 20.332840699999906
567, 4.340828129958432, 44.04835119427375, 52.96873074657512, 0.2517084999999999, 120.0, 530, 415983, 567, 19.601261699999668
568, 5.05467354319413, 44.02369728324583, 52.966412795217416, 0.2506500999999998, 155.0, 646, 416629, 568, 23.81726389999949
569, 2.860539858007715, 44.0655811430916, 52.972113121880426, 0.24950169999999997, 140.0, 630, 417259, 569, 23.104811199999858
570, 5.985291567007619, 43.89950784572885, 52.84005046876009, 0.24849909999999992, 100.0, 484, 417743, 570, 18.053433800000676
571, 7.56918657879184, 44.07025245723868, 53.147586753673124, 0.24746499999999994, 125.0, 665, 418408, 571, 23.905712300000232
572, 4.0542510525189455, 44.09495742199112, 53.02209725759826, 0.24610959999999996, 120.0, 841, 419249, 572, 31.953619699999763
573, 6.990786368200868, 44.091617590151955, 53.14980072708604, 0.24477310000000002, 160.0, 644, 419893, 573, 24.779565900000307
574, 3.066104209176236, 44.12198077827875, 53.019475615097704, 0.24360669999999987, 145.0, 652, 420545, 574, 25.331751200000326
575, 3.306303716128191, 44.250759732896, 53.229170647220336, 0.24246099999999993, 205.0, 621, 421166, 575, 23.654275699999744
576, 4.105492912176857, 44.1651319223111, 53.11432405547604, 0.24106419999999998, 515.0, 931, 422097, 576, 27.22729249999975
577, 5.957291284785808, 44.16000018886239, 53.153622466629805, 0.23929119999999995, 395.0, 1039, 423136, 577, 29.06123260000004
578, 4.772574901014657, 44.15343722311559, 53.15252429301253, 0.23776389999999997, 200.0, 658, 423794, 578, 16.294074999999793
579, 3.4879206402771428, 44.16074713696255, 53.10040293918567, 0.23589009999999988, 455.0, 1424, 425218, 579, 31.057888899999853
580, 4.198361427094673, 44.116446565265306, 53.02680533356462, 0.23402169999999994, 120.0, 652, 425870, 580, 15.80244490000041
581, 2.9462312384869676, 44.20042271030192, 53.10878382410322, 0.23272929999999997, 135.0, 784, 426654, 581, 16.78273050000007
582, 5.084932055833176, 44.13228890841855, 53.12893607374349, 0.2307916000000001, 340.0, 1369, 428023, 582, 29.96613400000024
583, 2.6845413663836775, 44.13095245639266, 53.05441154938578, 0.22906539999999997, 110.0, 549, 428572, 583, 12.23877309999989
584, 3.4523126891601548, 44.20506592204319, 53.15342435849524, 0.22789720000000008, 200.0, 749, 429321, 584, 16.229048900000635
585, 4.036705213858688, 44.12727590122983, 53.05360926894128, 0.2262745, 200.0, 1054, 430375, 585, 22.682604000000538
586, 3.950110774656588, 44.026500499609746, 52.96260536800731, 0.22485069999999988, 70.0, 528, 430903, 586, 11.109331499999826
587, 4.184087240222294, 44.1398856118115, 53.09305322335367, 0.22307589999999985, 405.0, 1444, 432347, 587, 30.651459100000466
588, 3.795791119518803, 44.050238493012216, 52.97518910878595, 0.2208168999999999, 400.0, 1066, 433413, 588, 24.637628399999812
589, 3.4326105491773595, 44.12491686922833, 53.05685393694535, 0.2189305, 350.0, 1030, 434443, 589, 26.581702700000278
590, 5.614254533549949, 44.162082700262445, 53.112729265096604, 0.21666160000000004, 345.0, 1491, 435934, 590, 37.16306919999988
591, 5.456608022681767, 44.151035503163556, 53.13247018689465, 0.21450699999999998, 340.0, 903, 436837, 591, 22.710528800000247
592, 3.893942884275696, 44.093173738411274, 53.00892703773921, 0.21314169999999996, 85.0, 614, 437451, 592, 17.66639859999941
593, 4.719833457627879, 44.18895664302984, 53.20061404144709, 0.21219849999999998, 40.0, 434, 437885, 593, 14.710243799999262
594, 3.877449225657547, 44.07680069991733, 53.012407148367146, 0.2112300999999999, 125.0, 642, 438527, 594, 19.236766800000623
595, 7.015777232687097, 44.133311823242636, 53.13202564438803, 0.20967039999999992, 505.0, 1091, 439618, 595, 31.807757200000196
596, 4.154231358371341, 44.643764383826046, 53.68765991659032, 0.2081061999999999, 275.0, 647, 440265, 596, 17.99814889999925
597, 4.077133362648843, 45.51493567539739, 54.75559091394177, 0.20678320000000003, 210.0, 823, 441088, 597, 23.315099999999802
598, 4.661832748566984, 45.578293883465946, 54.858223688303106, 0.20543319999999995, 135.0, 677, 441765, 598, 18.9891475000004
599, 6.522873847960823, 45.78207426396694, 55.14353248412932, 0.204112, 80.0, 791, 442556, 599, 22.56198789999962
600, 8.653726979444201, 45.699044043707744, 55.11263685696863, 0.20279799999999995, 145.0, 669, 443225, 600, 18.877926500000285
601, 3.0298811476354652, 45.53750314142892, 54.74149400053226, 0.2012616999999999, 455.0, 1038, 444263, 601, 29.44821089999914
602, 4.714240741036747, 45.63596103091403, 54.880326325587426, 0.1996191999999999, 165.0, 787, 445050, 602, 21.93067130000054
603, 6.67266877501109, 45.66741246190564, 55.004944144684956, 0.1981017999999999, 215.0, 899, 445949, 603, 26.687083699999675
604, 4.525128026941188, 45.61860436723218, 54.839241802020375, 0.1962549999999999, 280.0, 1153, 447102, 604, 34.47219150000001
605, 5.548582147739527, 45.6737668086491, 54.9832975788143, 0.19457019999999986, 175.0, 719, 447821, 605, 21.545067000000017
606, 6.058544619242207, 45.69582296445874, 54.9964757915395, 0.19304649999999995, 410.0, 974, 448795, 606, 32.65756229999988
607, 6.070918284662259, 45.730121602767554, 54.98841810960036, 0.19181889999999985, 45.0, 390, 449185, 607, 12.52912970000034
608, 6.7090020022959695, 45.6864949188551, 54.982788141684644, 0.1910368, 70.0, 479, 449664, 608, 15.343570099999852
609, 6.445262601832936, 45.97152422207258, 55.29577618140679, 0.18977409999999992, 420.0, 924, 450588, 609, 29.469475699999748
610, 4.037039226565796, 46.11379237052722, 55.42838276960911, 0.18838089999999993, 120.0, 624, 451212, 610, 17.45556850000048
611, 5.441515011871739, 46.27109670269397, 55.679314694663354, 0.18735489999999996, 20.0, 516, 451728, 611, 14.549246900000071
612, 4.958489704107785, 46.14704942703247, 55.50098559130793, 0.1865592999999999, 105.0, 368, 452096, 612, 11.547896500000206
613, 3.9863515252543387, 46.08069380287812, 55.447776580525336, 0.18574659999999993, 65.0, 535, 452631, 613, 15.639029599999958
614, 4.019180250181034, 46.155377843738655, 55.49157273452894, 0.18485829999999998, 60.0, 452, 453083, 614, 13.642588699999578
615, 3.6249153811961, 46.12128195740593, 55.43444341650729, 0.1838673999999999, 180.0, 649, 453732, 615, 21.56882570000016
616, 5.793373187909542, 46.10634953711762, 55.48339741762315, 0.18232389999999993, 480.0, 1066, 454798, 616, 32.483845400000064
617, 5.765797953049256, 46.142717604808745, 55.56323989319047, 0.1805391999999999, 165.0, 917, 455715, 617, 34.69042190000073
618, 4.82172005940136, 46.199856187810944, 55.58548718732388, 0.1788093999999999, 450.0, 1005, 456720, 618, 31.36612249999962
619, 2.8742740496993067, 46.11333848024026, 55.4105222261869, 0.17755389999999988, 60.0, 390, 457110, 619, 11.777269199999864
620, 4.42017394610314, 46.02584933068758, 55.32619776644159, 0.17683479999999996, 55.0, 409, 457519, 620, 12.916686100000334
621, 7.475209453749279, 46.252618241963795, 55.70848929004752, 0.17584299999999994, 65.0, 693, 458212, 621, 22.129465299999538
622, 4.1891065601692645, 46.27335166931152, 55.66934652106706, 0.1748322999999999, 155.0, 430, 458642, 622, 13.210924500000147
623, 7.250827181747409, 46.18935062102877, 55.611890048635715, 0.17409699999999997, 80.0, 387, 459029, 623, 11.928511000000071
624, 4.214692496798104, 46.25835160267206, 55.59070555957747, 0.17316549999999992, 185.0, 648, 459677, 624, 20.708415799999784
625, 4.750166739461376, 45.777383601756654, 55.068524103804776, 0.17152299999999998, 295.0, 1177, 460854, 625, 39.505507100000614
626, 5.597598347092362, 45.763566044622976, 55.05162786161949, 0.17002629999999994, 20.0, 486, 461340, 626, 15.796255700000074
627, 6.6696080426638895, 45.84101692721841, 55.22878980782716, 0.16870779999999994, 210.0, 979, 462319, 627, 35.328771500000585
628, 4.00293353057905, 45.74689235761472, 54.98064983679627, 0.16736409999999996, 65.0, 514, 462833, 628, 18.45850309999969
629, 4.913518760100994, 45.76557313901008, 55.03029729533352, 0.16566579999999992, 395.0, 1373, 464206, 629, 53.02239009999994
630, 2.938328299178043, 45.70626215284937, 54.997472188294275, 0.1639612, 95.0, 521, 464727, 630, 17.558791200000087
631, 2.5894966213761466, 45.88130775741909, 55.129926018092945, 0.16316109999999992, 105.0, 368, 465095, 631, 12.169741799999429
632, 5.0647538711146645, 45.798256355203605, 55.101995505056074, 0.16199289999999994, 145.0, 930, 466025, 632, 30.323562999999922
633, 4.757146242450731, 45.85965901403246, 55.14662365280193, 0.16049169999999993, 65.0, 738, 466763, 633, 23.173899399999755
634, 6.216427430874704, 45.871103811166925, 55.252281530811445, 0.1589436999999999, 255.0, 982, 467745, 634, 36.58649919999971
635, 7.3330101019977905, 45.92481268848162, 55.283474438919306, 0.15719139999999995, 315.0, 965, 468710, 635, 35.7034294999994
636, 4.761369228083032, 45.85459758721146, 55.1601212881749, 0.15522129999999992, 265.0, 1224, 469934, 636, 46.55075260000012
637, 4.017464588549506, 45.249806235108196, 54.350175996369956, 0.15355089999999993, 165.0, 632, 470566, 637, 22.645854500000496
638, 4.272607485284994, 45.21267207202007, 54.389635992650256, 0.15205239999999995, 475.0, 1033, 471599, 638, 37.386871300000166
639, 4.156964681370213, 45.25543051539711, 54.41721237238256, 0.15013539999999997, 180.0, 1097, 472696, 639, 41.58319990000018
640, 3.8770856882317957, 45.179468663346256, 54.34939761716593, 0.14792589999999994, 515.0, 1358, 474054, 640, 49.13600530000076
641, 7.757028592605364, 45.338400148528386, 54.658391174126265, 0.1461258999999999, 160.0, 642, 474696, 641, 19.43043619999935
642, 2.722733534936577, 45.27813448537045, 54.42482197933689, 0.14523399999999992, 25.0, 349, 475045, 642, 11.069495700000516
643, 4.493926228268799, 45.19201648523989, 54.324826179812305, 0.14391639999999997, 550.0, 1115, 476160, 643, 36.724727599999824
644, 4.799662274316509, 45.30101482916015, 54.471972820751986, 0.14165649999999994, 395.0, 1396, 477556, 644, 44.55862840000009
645, 2.611502252466662, 45.20306184258259, 54.31260973075186, 0.14001669999999997, 25.0, 426, 477982, 645, 14.310935900000004
646, 6.958001841749273, 45.43232824248292, 54.70644862209556, 0.13878909999999994, 255.0, 938, 478920, 646, 35.6353509999999
647, 4.643810527012596, 45.28394363691222, 54.4855065363758, 0.1369908999999999, 260.0, 1060, 479980, 647, 39.38276709999991
648, 4.720484433551854, 45.68115835315539, 54.95519890578678, 0.1350810999999999, 365.0, 1062, 481042, 648, 39.47249379999994
649, 4.6651875387739254, 45.718504707358164, 54.99490086916845, 0.1338094, 30.0, 351, 481393, 649, 13.38538570000037
650, 6.2323895071812885, 45.667608843351665, 54.96643588082832, 0.13246749999999993, 310.0, 1140, 482533, 650, 40.88075240000035
651, 5.496306138699597, 45.66180430497273, 54.93035094006227, 0.1309869999999999, 105.0, 505, 483038, 651, 18.659492599999794
652, 3.618856472043407, 45.70974872917529, 54.94628719304571, 0.12971709999999992, 175.0, 906, 483944, 652, 34.14851640000052
653, 4.307992320274107, 45.71800166022848, 54.9813044982549, 0.12738069999999996, 515.0, 1690, 485634, 653, 59.33435510000072
654, 4.312268425315871, 45.69057958408938, 54.94480948529001, 0.12543489999999988, 55.0, 472, 486106, 654, 15.384983400000237
655, 2.9542156292609576, 45.660558745617, 54.860654372868574, 0.12455289999999994, 45.0, 508, 486614, 655, 18.625708999999915
656, 4.54336524936809, 45.64979294969015, 54.930360077959136, 0.12334059999999993, 115.0, 839, 487453, 656, 31.050384000000122
657, 5.2037161819569695, 45.759795936378275, 55.028725584562835, 0.12208599999999992, 130.0, 555, 488008, 657, 20.555980699999964
658, 4.447460733284891, 45.691019335767436, 54.97788989260962, 0.12071439999999994, 175.0, 969, 488977, 658, 40.25252610000007
659, 7.940201988912205, 45.73228572024186, 55.094506937253406, 0.11850039999999991, 650.0, 1491, 490468, 659, 57.18914109999969
660, 4.246471083583783, 45.456205963223354, 54.641064581573445, 0.11653839999999996, 175.0, 689, 491157, 660, 26.040822400000252
661, 6.000772019971204, 45.37899700416651, 54.633800469734815, 0.11535939999999989, 25.0, 621, 491778, 661, 22.220130900000186
662, 8.084120483894106, 45.54697938398881, 54.8584478352713, 0.11419659999999993, 110.0, 671, 492449, 662, 28.418867800000044
663, 7.511110248547312, 45.54820929432367, 54.7862117369593, 0.11321289999999988, 110.0, 422, 492871, 663, 15.569972899999811
664, 4.069088776591572, 45.45374750906754, 54.621263023506174, 0.11225079999999994, 90.0, 647, 493518, 664, 24.135605100000248
665, 6.246805203419169, 45.630120319297454, 54.93714597243671, 0.1113201999999999, 105.0, 387, 493905, 665, 14.385568800000328
666, 6.0011904171835155, 45.52035839129717, 54.8196708524329, 0.11012949999999992, 365.0, 936, 494841, 666, 37.4889964999993
667, 3.006365947345983, 45.457022581289166, 54.630425654952745, 0.10869579999999993, 100.0, 657, 495498, 667, 25.247835499998473
668, 3.5387059602513147, 45.4426689967056, 54.62255275078834, 0.10722429999999994, 175.0, 978, 496476, 668, 38.52300810000088
669, 4.596896545283053, 45.44060165624219, 54.67269705041881, 0.1055286999999999, 400.0, 906, 497382, 669, 36.34345899999971
670, 6.7414573027647755, 45.477891797560424, 54.74301525666752, 0.1038717999999999, 190.0, 935, 498317, 670, 37.80891300000076
671, 5.923954385574217, 45.50536095912971, 54.79042011870924, 0.10203399999999994, 180.0, 1107, 499424, 671, 44.99743860000126
672, 5.004665336427097, 45.490465022613485, 54.72726824473434, 0.1004036663967604, 190.0, 741, 500165, 672, 22.30562259999897
673, 5.832544371568956, 45.347419687622754, 54.54666465460921, 0.09999999999999909, 155.0, 895, 501060, 673, 29.82562440000038
674, 6.231398298084563, 45.353003002876456, 54.595587337848755, 0.09999999999999681, 570.0, 1720, 502780, 674, 78.773733
675, 7.661160602358175, 45.40305189311211, 54.672116040008994, 0.10000000000000075, 70.0, 406, 503186, 675, 17.146381499998824
676, 6.521644946772265, 45.35848200795801, 54.612478559971976, 0.09999999999999933, 305.0, 854, 504040, 676, 29.7195628999998
677, 6.583497079353126, 45.362205142450634, 54.63746150301073, 0.09999999999999884, 120.0, 946, 504986, 677, 34.33954850000009
678, 3.1212684256666776, 45.3925163898613, 54.520754264309666, 0.09999999999999896, 230.0, 921, 505907, 678, 32.68867760000103
679, 6.7709681744068195, 45.40608469794252, 54.708899619850435, 0.09999999999999933, 415.0, 853, 506760, 679, 28.878103900000497
680, 5.847029945937691, 45.33940326787864, 54.520456046815134, 0.10000000000000099, 110.0, 628, 507388, 680, 22.599438600000212
681, 4.9149146232614545, 45.34783802950446, 54.51256872370919, 0.1000000000000007, 55.0, 374, 507762, 681, 13.222842899998795
682, 5.156872758055525, 45.327523654227086, 54.52430724280804, 0.0999999999999989, 200.0, 934, 508696, 682, 32.59299730000021
683, 6.936254823410168, 45.41584749943905, 54.673034558408254, 0.10000000000000071, 30.0, 383, 509079, 683, 13.455086100000699
684, 5.4984880710775785, 45.39552549757399, 54.62568702354088, 0.10000000000000094, 75.0, 555, 509634, 684, 19.542806800000108
685, 4.349842007398112, 45.29696443038988, 54.43383393391212, 0.09999999999999874, 230.0, 967, 510601, 685, 33.218894999999975
686, 6.014502530736821, 45.38280992721444, 54.57828076917734, 0.09999999999999831, 240.0, 1072, 511673, 686, 36.213989399999264
687, 4.201921354087306, 45.36416866141306, 54.53927555352869, 0.10000000000000034, 135.0, 710, 512383, 687, 24.890710599998783
688, 5.777777704643314, 45.36451095640952, 54.564310090698605, 0.0999999999999985, 270.0, 1019, 513402, 688, 34.63562069999898
689, 4.917306655297032, 45.54963610760577, 54.794416927981686, 0.10000000000000071, 50.0, 385, 513787, 689, 12.960584799999197
690, 5.66397643171824, 45.47445814475035, 54.688567442282654, 0.0999999999999987, 120.0, 975, 514762, 690, 33.4656116999995
691, 3.8660499140665943, 45.39905574424135, 54.60571007055739, 0.10000000000000088, 135.0, 652, 515414, 691, 21.565182600001208
692, 3.5768458353823913, 45.430047096564756, 54.570628606785114, 0.10000000000000057, 155.0, 684, 516098, 692, 23.517544199999975
693, 4.792764463122803, 45.4247469099965, 54.57597372227808, 0.10000000000000092, 90.0, 541, 516639, 693, 18.266165900000487
694, 5.9450137024585565, 45.44094987145322, 54.679623098407035, 0.09999999999999934, 305.0, 851, 517490, 694, 28.56320229999983
695, 4.275405866173053, 45.418073609273044, 54.63623227653386, 0.09999999999999869, 185.0, 977, 518467, 695, 32.87047220000022
696, 4.664550248556626, 45.4108610172943, 54.62265968322754, 0.09999999999999874, 345.0, 966, 519433, 696, 32.88236810000126
697, 2.9967792378550646, 45.464054140646105, 54.61547559139021, 0.10000000000000064, 35.0, 347, 519780, 697, 11.702754300000379
698, 7.015182424740341, 45.31247014379354, 54.53270758637703, 0.10000000000000094, 140.0, 646, 520426, 698, 21.89045239999905
699, 5.202175455200798, 45.103274470083285, 54.27264431255866, 0.09999999999999809, 355.0, 1132, 521558, 699, 38.81067559999974
700, 3.8506750807923784, 44.98552405516691, 54.09015199693583, 0.09999999999999949, 305.0, 826, 522384, 700, 32.585374899999806
701, 2.9102289820262444, 45.13249183288073, 54.19607775599847, 0.09999999999999933, 215.0, 853, 523237, 701, 30.19873390000066
702, 6.775842904140752, 45.0630821061913, 54.2446722205653, 0.10000000000000096, 105.0, 643, 523880, 702, 17.490885699999126
703, 7.016573960174164, 45.16339590342622, 54.39097152779636, 0.0999999999999992, 300.0, 876, 524756, 703, 24.05897460000051
704, 5.91676178385998, 45.07498086529014, 54.25932853015853, 0.10000000000000092, 120.0, 648, 525404, 704, 17.223252899999352
705, 5.559536171161084, 45.083555090871975, 54.23500689318774, 0.09999999999999802, 315.0, 1153, 526557, 705, 35.536757199999556
706, 4.926600786870707, 45.16699317204866, 54.30499730350302, 0.09999999999999816, 375.0, 1112, 527669, 706, 31.08022329999949
707, 5.739377973752247, 45.22668449298756, 54.406033406386506, 0.10000000000000096, 85.0, 592, 528261, 707, 16.284926700000142
708, 3.0759043365485907, 45.17081330173699, 54.271756756213286, 0.10000000000000095, 200.0, 645, 528906, 708, 17.405349299999216
709, 4.964751279257106, 45.096016996710965, 54.22579971855209, 0.10000000000000064, 100.0, 676, 529582, 709, 18.03353479999896
710, 2.9624480562868403, 45.102961595124526, 54.19470593060004, 0.09999999999999888, 310.0, 938, 530520, 710, 24.901689099999203
711, 7.863391455396153, 45.32327950983359, 54.610667595040184, 0.10000000000000096, 110.0, 643, 531163, 711, 17.396956399999908
712, 4.977915599600089, 45.106813333472424, 54.199864144227945, 0.09999999999999977, 210.0, 784, 531947, 712, 21.478224399999817
713, 5.456730135700159, 45.197708191230284, 54.34805955942611, 0.10000000000000057, 105.0, 684, 532631, 713, 18.386459999999715
714, 5.121156784703507, 45.222243434442184, 54.383788721733, 0.09999999999999962, 150.0, 806, 533437, 714, 22.47304869999971
715, 5.214654954502508, 45.227734225343525, 54.384193844693975, 0.09999999999999865, 595.0, 989, 534426, 715, 28.430768199999875
716, 5.879404392482836, 45.263992863601274, 54.46513955313006, 0.09999999999999827, 465.0, 1081, 535507, 716, 29.409810999999536
717, 4.273741348369701, 45.30778390801127, 54.47154319112861, 0.10000000000000087, 5.0, 481, 535988, 717, 13.495565900000656
718, 6.277724077984914, 45.20824402557961, 54.43393534102838, 0.0999999999999989, 615.0, 934, 536922, 718, 29.689453000000867
719, 5.992649527194464, 45.28592494781755, 54.48107661186514, 0.09999999999999713, 495.0, 1523, 538445, 719, 71.03110430000015
720, 6.117288403765677, 45.35031365300273, 54.550452709198, 0.10000000000000019, 110.0, 728, 539173, 720, 29.729170099999465
721, 5.325046466527885, 45.30563705999732, 54.491334425535236, 0.10000000000000091, 55.0, 522, 539695, 721, 19.17016329999933
722, 6.910978937745959, 45.02288280204696, 54.19116652755848, 0.10000000000000052, 185.0, 689, 540384, 722, 24.80791130000034
723, 5.241619208614741, 44.747815425055364, 53.78123754092625, 0.10000000000000094, 80.0, 560, 540944, 723, 19.68759499999942
724, 5.1714573775377, 44.802799923632364, 53.87845008081441, 0.09999999999999788, 280.0, 1201, 542145, 724, 41.08157080000092
725, 5.682041090656928, 44.71260410605125, 53.79802967120914, 0.09999999999999777, 285.0, 1236, 543381, 725, 42.750049899999794
726, 5.491133330448144, 44.82750741348786, 53.92964357648577, 0.10000000000000013, 120.0, 735, 544116, 726, 25.898840100000598
727, 4.000154150409117, 44.781293231346275, 53.86469133895715, 0.10000000000000067, 155.0, 673, 544789, 727, 23.24585009999828
728, 6.353124822381624, 44.77853848213373, 53.90709628615269, 0.10000000000000063, 80.0, 344, 545133, 728, 11.9051786
729, 6.954389269001926, 44.66969841404965, 53.736777667523754, 0.10000000000000067, 75.0, 361, 545494, 729, 12.737609799998609
730, 5.675976868347416, 44.83635039574179, 53.930475521179964, 0.09999999999999845, 190.0, 1033, 546527, 730, 36.27111789999981
731, 6.951330352266994, 44.81686362481385, 53.90419949328377, 0.09999999999999867, 295.0, 981, 547508, 731, 35.098202400000446
732, 5.847696411908125, 44.93825518849768, 54.06114752484381, 0.10000000000000081, 80.0, 659, 548167, 732, 25.793427700000393
733, 8.649314020942782, 44.779966605078315, 53.908166398707124, 0.09999999999999983, 230.0, 776, 548943, 733, 29.097597599999062
734, 3.9116357828165036, 44.782228240047594, 53.80829789839595, 0.10000000000000075, 100.0, 664, 549607, 734, 24.998041299999386
735, 4.784318809670079, 44.77911937339063, 53.859254780670256, 0.0999999999999984, 245.0, 1049, 550656, 735, 46.99032690000058
736, 5.784221673751989, 44.64456464308203, 53.71254225046154, 0.09999999999999895, 265.0, 922, 551578, 736, 35.61983800000053
737, 3.9454534415131923, 44.67692458037358, 53.689776368353776, 0.09999999999999977, 215.0, 785, 552363, 737, 29.344257999999172
738, 8.950780938951105, 44.778748262339626, 53.91590724155821, 0.10000000000000095, 60.0, 580, 552943, 738, 21.112461099999564
739, 5.005038949962734, 44.71748689754989, 53.74847270167151, 0.10000000000000095, 220.0, 645, 553588, 739, 23.884502500000963
740, 4.4722670673429405, 44.71257249857203, 53.72844107379162, 0.09999999999999833, 300.0, 1066, 554654, 740, 39.25091319999956
741, 2.9412050925383246, 44.76410143758972, 53.775419274339164, 0.09999999999999769, 380.0, 1268, 555922, 741, 47.03066999999828
742, 4.931823186671642, 44.715371124579775, 53.79344120659792, 0.10000000000000073, 30.0, 391, 556313, 742, 13.903883099999803
743, 4.206212872424475, 44.69580642824419, 53.75760229309993, 0.10000000000000012, 110.0, 737, 557050, 743, 26.82920759999979
744, 7.601432020316657, 44.68549303267892, 53.91559466743989, 0.10000000000000069, 70.0, 367, 557417, 744, 15.601177000000462
745, 5.976218559406401, 44.6747227779796, 53.730156954775964, 0.10000000000000099, 190.0, 627, 558044, 745, 19.175932799998918
746, 4.236025395553287, 44.84207748164975, 53.928224293778584, 0.10000000000000098, 50.0, 615, 558659, 746, 20.402371299998777
747, 6.285843172897246, 44.73210662860612, 53.84738242905472, 0.09999999999999959, 445.0, 811, 559470, 747, 32.72758090000025
748, 4.824601013248212, 44.68114582549003, 53.695000479154494, 0.10000000000000098, 125.0, 642, 560112, 748, 23.65143209999951
749, 4.720329353976956, 44.14676850650018, 53.09874150757978, 0.09999999999999876, 235.0, 962, 561074, 749, 35.6443978999996
750, 5.516704488202643, 44.176877546616744, 53.1726416357069, 0.0999999999999989, 170.0, 934, 562008, 750, 35.69107720000102
751, 4.542740130475227, 44.23422282117478, 53.14297179201816, 0.09999999999999795, 275.0, 1175, 563183, 751, 44.4112284999992
752, 3.825304658812045, 44.21523005998314, 53.12282870402887, 0.09999999999999969, 160.0, 796, 563979, 752, 29.81290009999975
753, 4.389884806116967, 44.17947971530077, 53.06811213687183, 0.09999999999999866, 355.0, 984, 564963, 753, 38.12030539999978
754, 6.110571382782567, 44.136506967209094, 53.15746922708636, 0.10000000000000074, 75.0, 398, 565361, 754, 15.585192299999107
755, 3.366202248825917, 44.211275026326724, 53.089624877759675, 0.10000000000000027, 170.0, 718, 566079, 755, 29.50806300000113
756, 4.071408716741926, 44.13165843560829, 53.065712235729144, 0.10000000000000096, 80.0, 644, 566723, 756, 26.913015799998902
757, 4.832154519466666, 44.22000727266879, 53.15965017026609, 0.09999999999999817, 255.0, 1110, 567833, 757, 43.53360409999914
758, 4.99997930414453, 44.24589063072739, 53.21409612276307, 0.10000000000000067, 75.0, 357, 568190, 758, 13.591856800001551
759, 4.231975050013102, 44.12685622769501, 53.06662030444719, 0.0999999999999988, 345.0, 955, 569145, 759, 35.103078500000265
760, 5.191758683234815, 44.37251138197385, 53.356493674740406, 0.09999999999999831, 420.0, 1071, 570216, 760, 40.32561069999974
761, 4.957292527004491, 44.688769144980135, 53.76683037939291, 0.0999999999999975, 360.0, 1351, 571567, 761, 43.03087289999894
762, 6.4275456268545765, 44.888510196645996, 53.95708594059269, 0.10000000000000069, 140.0, 671, 572238, 762, 19.678580800000418
763, 3.8778492569524263, 44.79687721388681, 53.84406349772499, 0.10000000000000069, 100.0, 672, 572910, 763, 19.572996599999897
764, 4.536286035329104, 44.78493573930528, 53.84592953999837, 0.09999999999999906, 145.0, 900, 573810, 764, 28.29678249999961
765, 9.453212153884776, 44.85376524741361, 54.045936555053395, 0.09999999999999981, 170.0, 778, 574588, 765, 23.603137800000695
766, 4.413767716629304, 44.85643024569789, 53.91031592471334, 0.09999999999999899, 295.0, 914, 575502, 766, 27.547703800000818
767, 6.01881797207957, 44.81895890399163, 53.89556264145456, 0.09999999999999937, 225.0, 847, 576349, 767, 26.053097199999684
768, 4.4975304662153635, 44.77764917570969, 53.811037971233496, 0.09999999999999923, 230.0, 870, 577219, 768, 26.111132300000463
769, 6.7931948805976115, 44.8037486606174, 53.902665908520035, 0.09999999999999888, 375.0, 936, 578155, 769, 27.522226099999898
770, 2.6826416109369635, 44.64343583747132, 53.6662278175354, 0.10000000000000096, 115.0, 584, 578739, 770, 17.48667899999964
771, 5.7160380722546, 44.80966173791457, 53.87566976583968, 0.09999999999999981, 165.0, 779, 579518, 771, 23.175077699999747
772, 8.316135047147498, 45.050017410891186, 54.32129374542394, 0.09999999999999871, 200.0, 971, 580489, 772, 34.65125970000008
773, 5.3515969262748015, 45.20754053339612, 54.3554989443589, 0.0999999999999983, 245.0, 1074, 581563, 773, 35.29024070000014
774, 2.836834576530288, 45.21245412344884, 54.34100351815272, 0.10000000000000088, 80.0, 495, 582058, 774, 14.826847399999679
775, 4.8414607595162025, 45.22510472007671, 54.39013612432667, 0.10000000000000078, 240.0, 661, 582719, 775, 20.01367819999905
776, 3.0568941263628258, 45.216918705645654, 54.32330408146244, 0.10000000000000071, 50.0, 382, 583101, 776, 11.374005299998316
777, 4.144824427961809, 45.15364350529255, 54.27118173602406, 0.10000000000000098, 125.0, 603, 583704, 777, 17.49694819999968
778, 4.640800119411746, 45.17964792251587, 54.33771700393863, 0.10000000000000084, 120.0, 656, 584360, 778, 17.64208030000009
779, 4.352985633867923, 45.08133111044625, 54.168869369126554, 0.10000000000000098, 120.0, 642, 585002, 779, 17.237199600000167
780, 5.294045124168151, 45.24669375077958, 54.373405789289144, 0.10000000000000057, 5.0, 321, 585323, 780, 9.121616399999766
781, 4.711759568709738, 45.158614886731264, 54.31470180215723, 0.09999999999999994, 355.0, 761, 586084, 781, 21.129785099999935
782, 6.774804652377664, 45.18273738872014, 54.38152123044077, 0.10000000000000045, 110.0, 698, 586782, 782, 18.578160099999877
783, 6.160177533505657, 45.17855388595598, 54.32329922908005, 0.09999999999999898, 110.0, 917, 587699, 783, 27.043489599998793
784, 5.73718697989722, 45.22668085851651, 54.399817597199956, 0.10000000000000091, 100.0, 519, 588218, 784, 15.036610699999073
785, 4.323192239787608, 45.1912730541508, 54.319681705164264, 0.09999999999999878, 400.0, 958, 589176, 785, 26.785660800000187
786, 5.066873303611708, 45.15265030233867, 54.31573062861731, 0.1000000000000006, 40.0, 327, 589503, 786, 9.083079500000167
787, 4.3387655333036514, 45.267580377773974, 54.483655453979814, 0.10000000000000071, 30.0, 381, 589884, 787, 10.472544799999014
788, 5.944598641511117, 45.988882701822526, 55.33112578291353, 0.09999999999999842, 565.0, 1042, 590926, 788, 28.735569499998746
789, 5.719687143257659, 46.08284891638786, 55.42703057246603, 0.09999999999999772, 290.0, 1256, 592182, 789, 34.295019799999864
790, 5.187682636127327, 45.98383280898585, 55.30043991551255, 0.0999999999999995, 240.0, 825, 593007, 790, 22.526266299999406
791, 4.167608554375932, 45.925786214517366, 55.1944461376109, 0.10000000000000095, 45.0, 564, 593571, 791, 15.447137200000725
792, 7.253939522595775, 46.02076017340658, 55.51909240340318, 0.10000000000000081, 45.0, 439, 594010, 792, 12.181533099999797
793, 6.605991901368895, 46.04157951288734, 55.37731827047213, 0.09999999999999742, 380.0, 1382, 595392, 793, 41.348716099999365
794, 5.577496469035297, 46.03343730523214, 55.32954419688272, 0.09999999999999847, 315.0, 1031, 596423, 794, 30.884529699998893
795, 3.213358546938934, 46.09731880530204, 55.377445381989894, 0.10000000000000071, 50.0, 379, 596802, 795, 11.449349000000439
796, 5.202501016255054, 45.99307843932399, 55.32737437442497, 0.09999999999999927, 195.0, 864, 597666, 796, 25.813802299999224
797, 5.2685970913350975, 46.07470354067734, 55.37950149236941, 0.09999999999999831, 185.0, 1071, 598737, 797, 32.854119999999966
798, 5.013694735265877, 46.05392271248346, 55.37518295010059, 0.0999999999999989, 245.0, 933, 599670, 798, 27.903607700000066
799, 5.712456194195063, 45.84926162269045, 55.1558212730955, 0.09999999999999792, 320.0, 1185, 600855, 799, 36.308309300000474
800, 8.297484978625219, 45.87240819016548, 55.256399264400955, 0.10000000000000069, 80.0, 365, 601220, 800, 11.042301600000428
801, 4.084838424629621, 45.86256759711221, 55.10486295746594, 0.10000000000000082, 65.0, 451, 601671, 801, 13.71320410000044
802, 3.0288761101359007, 45.78306414935054, 54.99186554344333, 0.09999999999999869, 260.0, 980, 602651, 802, 30.22393799999918
803, 3.9190436725778452, 45.75478870724294, 55.01161750556799, 0.10000000000000063, 170.0, 677, 603328, 803, 20.596004700000776
804, 3.1669900066317944, 45.67975032346861, 54.909329208130416, 0.10000000000000052, 35.0, 689, 604017, 804, 21.303625500000635
805, 3.225160716914795, 45.756845133965, 54.96484747515038, 0.10000000000000078, 30.0, 426, 604443, 805, 13.49631920000138
806, 4.967146379674829, 45.725584333735945, 54.993474330127434, 0.099999999999999, 375.0, 911, 605354, 806, 27.742811599999186
807, 4.942801397633553, 45.76518583374023, 55.03468350219727, 0.10000000000000099, 105.0, 625, 605979, 807, 19.39079219999985
808, 6.318518240392362, 45.89265685274185, 55.19593587007793, 0.099999999999998, 270.0, 1163, 607142, 808, 35.88349409999864
809, 4.553196242461482, 45.77083774403343, 55.03843718695196, 0.099999999999999, 470.0, 911, 608053, 809, 27.889909500001522
810, 5.772696243062425, 45.8452500124831, 55.103380145107636, 0.09999999999999852, 315.0, 1017, 609070, 810, 30.870069100001274
811, 5.566004335834987, 45.7452883039202, 55.04257299544963, 0.10000000000000081, 75.0, 658, 609728, 811, 20.359353399999236
812, 4.054138830369887, 45.382271144904344, 54.55735906432657, 0.09999999999999956, 140.0, 816, 610544, 812, 25.352842000000237
813, 4.545785375951956, 45.09080668392345, 54.208791100265636, 0.09999999999999797, 455.0, 1170, 611714, 813, 36.27993120000065
814, 4.150663330634325, 45.25729382286125, 54.41084137174524, 0.10000000000000024, 140.0, 721, 612435, 814, 22.428638999999748
815, 6.982387277867702, 45.12538446987559, 54.311002844800385, 0.0999999999999978, 265.0, 1227, 613662, 815, 38.08796389999952
816, 4.197131167107373, 45.15189008732113, 54.252254892314426, 0.09999999999999866, 285.0, 986, 614648, 816, 31.239188499999727
817, 5.507545634936675, 45.136866102973336, 54.314286262868976, 0.09999999999999816, 380.0, 1112, 615760, 817, 34.761345700000675
818, 6.552260122232861, 45.22142573067243, 54.40689712719883, 0.09999999999999774, 790.0, 1249, 617009, 818, 38.967547500000364
819, 8.189750528343174, 45.22273362412744, 54.433197887576355, 0.10000000000000073, 25.0, 392, 617401, 819, 12.326161099999808
820, 6.736735974786206, 45.11149425399236, 54.291764035681176, 0.10000000000000091, 55.0, 533, 617934, 820, 17.037532199999987
821, 4.690691193163395, 45.05233219909668, 54.13242481994629, 0.10000000000000088, 125.0, 500, 618434, 821, 15.57572699999946
822, 4.561130114037852, 45.20826964030602, 54.36278727735371, 0.0999999999999996, 190.0, 809, 619243, 822, 25.368931599999996
823, 3.9410354947281436, 45.20558844869451, 54.32489267985026, 0.10000000000000095, 145.0, 645, 619888, 823, 20.328246899998703
824, 8.750149241071076, 45.035791308325045, 54.27115994339469, 0.0999999999999997, 215.0, 795, 620683, 824, 25.004097900000488
825, 5.772301473531733, 45.03905523176024, 54.23935114843606, 0.1000000000000009, 100.0, 507, 621190, 825, 15.986869899999874
826, 6.50402265184442, 44.92527000643464, 54.024699908422555, 0.09999999999999779, 785.0, 1235, 622425, 826, 39.297334599999886
827, 6.141555289647383, 45.01026352041322, 54.144768094371315, 0.09999999999999958, 275.0, 813, 623238, 827, 25.913945700000113
828, 3.1768787575206106, 44.98410959318867, 54.03465411168697, 0.10000000000000071, 90.0, 381, 623619, 828, 12.03548839999894
829, 4.877900805032644, 44.9292574486482, 54.0214695812335, 0.09999999999999855, 295.0, 1009, 624628, 829, 32.21268129999953
830, 3.8163365435648697, 45.012442485520126, 54.0915702929996, 0.09999999999999817, 305.0, 1108, 625736, 830, 35.23165970000082
831, 5.790338062665292, 44.93152350834438, 54.025678296770366, 0.10000000000000042, 75.0, 700, 626436, 831, 22.47882579999896
832, 3.5936017841529035, 44.93294123074734, 53.9967346091719, 0.09999999999999803, 415.0, 1148, 627584, 832, 43.93488789999901
833, 2.747189220991039, 44.95345104184738, 53.98953450375095, 0.10000000000000064, 45.0, 349, 627933, 833, 11.602372800000012
834, 4.562386517946456, 45.000681280698075, 54.135864750840184, 0.099999999999999, 260.0, 913, 628846, 834, 27.181777699999657
835, 4.268748527302098, 45.04550247551695, 54.10697584286964, 0.10000000000000099, 165.0, 637, 629483, 835, 18.780223800000385
836, 3.1980685964825963, 44.86041694416118, 53.899224227618916, 0.1000000000000007, 40.0, 373, 629856, 836, 11.010532500000409
837, 6.665658580130534, 46.57413760559846, 56.02596770094034, 0.09999999999999766, 775.0, 1278, 631134, 837, 37.51437039999837
838, 8.462728053526872, 46.93592143823385, 56.527207010341456, 0.10000000000000055, 135.0, 686, 631820, 838, 19.960392500001035
839, 6.474130355638184, 46.71346076547283, 56.19556841567227, 0.0999999999999992, 275.0, 876, 632696, 839, 25.833837300000596
840, 5.076915145061627, 46.752396752972324, 56.20233527771727, 0.09999999999999859, 235.0, 1002, 633698, 840, 29.189315399999032
841, 6.277778798243915, 46.809262266062724, 56.348007048019255, 0.10000000000000074, 75.0, 396, 634094, 841, 11.726230700000087
842, 4.738206260281025, 46.73852822061121, 56.192883655164366, 0.0999999999999975, 840.0, 1352, 635446, 842, 42.71579960000054
843, 5.821867357858997, 46.69319105737003, 56.12802864592752, 0.09999999999999763, 470.0, 1296, 636742, 843, 41.63646420000077
844, 4.293847745223225, 46.738555072432206, 56.16705448825221, 0.100000000000001, 110.0, 639, 637381, 844, 20.693320200000016
845, 5.811131138923372, 46.83693295324634, 56.31179062620608, 0.10000000000000071, 145.0, 668, 638049, 845, 21.330863499999396
846, 3.5901964922534044, 46.58397647920566, 55.95644987681673, 0.09999999999999847, 285.0, 1031, 639080, 846, 33.70286120000128
847, 4.778156171715359, 46.8154703264714, 56.30287547538422, 0.09999999999999758, 250.0, 1318, 640398, 847, 42.72425470000053
848, 5.746683002163881, 46.97502312089996, 56.429910914323564, 0.10000000000000095, 15.0, 577, 640975, 848, 18.621091999999408
849, 5.971625750431648, 47.082855318509615, 56.653823371300334, 0.1000000000000009, 115.0, 650, 641625, 849, 21.02346960000068
850, 7.689099661094329, 47.0862047403905, 56.67417528423166, 0.0999999999999978, 365.0, 1226, 642851, 850, 39.28945279999971
851, 4.131852049031172, 46.963908514056996, 56.412733208643246, 0.09999999999999883, 195.0, 949, 643800, 851, 31.029246000000057
852, 4.798714684123878, 46.93741145278468, 56.39916019461104, 0.09999999999999912, 230.0, 891, 644691, 852, 28.797283300000345
853, 5.232399936327497, 47.11534470419847, 56.65094634776807, 0.10000000000000085, 90.0, 655, 645346, 853, 21.097356500000387
854, 5.701787565578156, 46.97109520529199, 56.581839906887744, 0.1000000000000009, 70.0, 508, 645854, 854, 16.454434400000537
855, 4.354625145844536, 46.992535732139764, 56.50431359532368, 0.099999999999999, 275.0, 913, 646767, 855, 29.562009400000534
856, 7.390813968203803, 47.09244960419675, 56.6487891420405, 0.1000000000000007, 75.0, 376, 647143, 856, 12.233533399999942
857, 7.218464086117985, 47.06148130243475, 56.60497358170423, 0.09999999999999737, 335.0, 1408, 648551, 857, 45.96298349999961
858, 3.6041962643429426, 47.09341512263661, 56.57689085812636, 0.09999999999999808, 305.0, 1136, 649687, 858, 36.88798069999939
859, 4.890920051546009, 47.0745781439322, 56.60444445332522, 0.09999999999999998, 280.0, 756, 650443, 859, 24.711307300000044
860, 8.331524175212339, 47.13424243456052, 56.71370204878442, 0.10000000000000092, 215.0, 648, 651091, 860, 21.112356999999975
861, 7.493515456047225, 47.09391610824754, 56.67873623978168, 0.10000000000000092, 85.0, 542, 651633, 861, 17.911370599998918
862, 4.990579416331123, 46.984597235286934, 56.456903228759764, 0.09999999999999935, 240.0, 850, 652483, 862, 27.610492699999668
863, 7.0992347510061755, 47.16872966068584, 56.81406880577757, 0.09999999999999776, 370.0, 1241, 653724, 863, 40.495987800000876
864, 4.0447595008892945, 47.111939695800444, 56.58959364400479, 0.10000000000000019, 170.0, 729, 654453, 864, 24.084151800001564
865, 6.722684353733845, 47.03851344134357, 56.56398315135116, 0.1000000000000009, 105.0, 518, 654971, 865, 17.21283399999993
866, 4.936924808668463, 47.20505489550139, 56.79319826427259, 0.10000000000000071, 70.0, 380, 655351, 866, 12.646136299999853
867, 5.677892212496744, 46.935028513682255, 56.43143371700012, 0.09999999999999983, 125.0, 776, 656127, 867, 25.538052699999753
868, 5.712064994856082, 47.083975515847406, 56.65201422072642, 0.09999999999999774, 390.0, 1247, 657374, 868, 41.11973450000005
869, 3.121149256696989, 47.03649859592832, 56.478600217008044, 0.10000000000000064, 25.0, 348, 657722, 869, 11.650294400000348
870, 5.95040442054432, 47.07819692407711, 56.66117717570481, 0.09999999999999903, 230.0, 907, 658629, 870, 29.914292299999943
871, 4.416753738423619, 47.07128559120824, 56.54723206311141, 0.09999999999999895, 430.0, 922, 659551, 871, 30.65808130000005
872, 4.561939052826056, 46.94080195982763, 56.40306821483776, 0.10000000000000087, 30.0, 489, 660040, 872, 16.31175489999987
873, 4.632305939501453, 46.68245406320444, 56.10115218030605, 0.0999999999999977, 290.0, 1265, 661305, 873, 41.84294399999999
874, 5.14155367973206, 46.7207515795144, 56.222626336969775, 0.10000000000000099, 75.0, 631, 661936, 874, 20.994152799999938
875, 4.743808987746614, 46.59332059703751, 56.01551429765452, 0.09999999999999906, 215.0, 902, 662838, 875, 30.256449300000895
876, 5.17112087705438, 46.653223383611966, 56.049409233844344, 0.10000000000000073, 50.0, 386, 663224, 876, 13.0698926999994
877, 3.053586012527749, 46.62122081034892, 55.97142574207203, 0.10000000000000069, 10.0, 370, 663594, 877, 12.501665799998591
878, 5.802268611751712, 46.666126769402126, 56.101665364524536, 0.10000000000000049, 55.0, 692, 664286, 878, 23.102761599999212
879, 7.013358620768608, 46.60761138175788, 56.05288320286928, 0.09999999999999903, 225.0, 907, 665193, 879, 30.375925800000914
880, 4.3705471647220575, 46.569463146114686, 55.955398797140425, 0.10000000000000094, 95.0, 562, 665755, 880, 18.92244430000028
881, 7.609336485356068, 46.82139649581598, 56.36398064536395, 0.0999999999999978, 280.0, 1227, 666982, 881, 41.224688700000115
882, 6.586405367236729, 46.54081096205601, 55.9853438222131, 0.1000000000000009, 50.0, 516, 667498, 882, 17.245085699998526
883, 4.5045017369940314, 46.73638883824087, 56.143192959234185, 0.10000000000000085, 10.0, 474, 667972, 883, 16.086560500001724
884, 5.057957420654355, 46.76313978625882, 56.22186644769484, 0.09999999999999777, 330.0, 1240, 669212, 884, 41.67464889999974
885, 6.234811955822572, 46.67333422168608, 56.13400257018305, 0.10000000000000088, 65.0, 496, 669708, 885, 16.949745099998836
886, 5.750049444107704, 47.6432219344187, 57.29759785900377, 0.09999999999999822, 495.0, 1095, 670803, 886, 36.77145229999951
887, 5.233955328538076, 47.965335144504195, 57.65739648228028, 0.09999999999999702, 515.0, 1588, 672391, 887, 53.203309500000614
888, 7.334216632433058, 47.89074826731735, 57.66139919444234, 0.10000000000000099, 110.0, 631, 673022, 888, 21.55805220000002
889, 5.279896799880679, 47.95637943616139, 57.661397373715644, 0.09999999999999902, 230.0, 909, 673931, 889, 30.886168999999427
890, 4.379564662956529, 47.84866140153673, 57.49451182895236, 0.09999999999999906, 305.0, 900, 674831, 890, 30.638312099999894
891, 5.876658434249563, 47.74985903606902, 57.496026839160734, 0.1000000000000009, 115.0, 509, 675340, 891, 17.37164230000053
892, 7.547352980608228, 47.92944212727163, 57.71556356583518, 0.09999999999999923, 100.0, 870, 676210, 892, 29.592569899999944
893, 6.571704656163358, 48.00933021245289, 57.76147496478158, 0.09999999999999874, 365.0, 966, 677176, 893, 33.240028999998685
894, 7.7602270135754035, 47.94880269791171, 57.70732633426909, 0.09999999999999827, 615.0, 1083, 678259, 894, 37.01417559999936
895, 9.283191063421876, 48.01865299281789, 57.875715830788685, 0.10000000000000062, 30.0, 335, 678594, 895, 11.458946799999467
896, 6.778389981024323, 47.9381376875616, 57.70990046511552, 0.0999999999999979, 480.0, 1193, 679787, 896, 40.68043469999975
897, 8.960962831914781, 48.14127598605146, 57.87012606065269, 0.10000000000000088, 65.0, 503, 680290, 897, 17.382831000000806
898, 5.228844941768257, 48.20884595187205, 57.9310053507487, 0.0999999999999997, 170.0, 795, 681085, 898, 27.41576150000037
899, 4.661902502625957, 48.13026332140326, 57.83197694060684, 0.10000000000000073, 165.0, 667, 681752, 899, 22.92446579999887
900, 6.180151668255996, 48.177461236134604, 57.96231656212037, 0.09999999999999766, 380.0, 1283, 683035, 900, 44.46686539999973
901, 5.1165760348713585, 48.089510181421495, 57.81234347080599, 0.10000000000000049, 180.0, 693, 683728, 901, 25.007483199999115
902, 5.236259107708407, 48.24314486613909, 57.986307889790346, 0.10000000000000057, 120.0, 683, 684411, 902, 23.648603899999216
903, 3.5911137979597814, 48.20756886082311, 57.97740720164391, 0.10000000000000088, 75.0, 496, 684907, 903, 17.132113600000594
904, 3.936652489199762, 48.129004725805274, 57.83440684722549, 0.09999999999999741, 490.0, 1388, 686295, 904, 47.88287209999908
905, 4.04278142347478, 48.13978658472826, 57.883108565044886, 0.09999999999999974, 175.0, 788, 687083, 905, 27.44835019999846
906, 3.322641721560379, 48.05971431732178, 57.73409396610903, 0.10000000000000066, 55.0, 356, 687439, 906, 12.735731799999485
907, 6.445896995044847, 48.28841442661431, 58.09748585242352, 0.10000000000000085, 70.0, 655, 688094, 907, 22.928903699999864
908, 6.4795755861146, 48.17521297185621, 57.95991766278182, 0.09999999999999717, 570.0, 1502, 689596, 908, 52.95239490000131
909, 4.983230045173772, 48.068936796243115, 57.805976141662846, 0.09999999999999783, 575.0, 1219, 690815, 909, 44.1315711999996
910, 3.3051023651085316, 48.03956932102869, 57.69858096061497, 0.1000000000000008, 45.0, 436, 691251, 910, 15.62573330000123
911, 6.559590985564534, 48.0698561796208, 57.7863380943377, 0.09999999999999873, 290.0, 970, 692221, 911, 33.880038699999204
912, 4.511443478426129, 48.18516153260205, 57.95874098803859, 0.10000000000000081, 70.0, 658, 692879, 912, 23.005250700000033
913, 5.634501067951901, 47.986324202610525, 57.70359460502826, 0.09999999999999701, 365.0, 1594, 694473, 913, 56.03501250000045
914, 9.987159232656051, 48.11960090804886, 58.054528200757375, 0.09999999999999902, 145.0, 910, 695383, 914, 32.15114410000024
915, 5.871539010675691, 48.05286937137302, 57.80785143735597, 0.10000000000000046, 140.0, 695, 696078, 915, 24.488796400000865
916, 5.698422492011362, 48.028913414634474, 57.789031871368095, 0.09999999999999744, 570.0, 1374, 697452, 916, 48.148355999999694
917, 3.395030848066176, 47.98080844721518, 57.62505222352083, 0.10000000000000087, 150.0, 484, 697936, 917, 17.130761300000813
918, 5.864862859515207, 48.01968074696405, 57.71258855717523, 0.10000000000000082, 70.0, 448, 698384, 918, 16.139611599999625
919, 6.056301197103749, 48.10719263755669, 57.87362605164954, 0.09999999999999834, 160.0, 1062, 699446, 919, 37.619474200000695
920, 6.400537985536167, 48.08397441316224, 57.87026869964104, 0.0999999999999971, 745.0, 1539, 700985, 920, 54.72736680000162
921, 6.103204479386876, 48.06262475425498, 57.806118553383506, 0.0999999999999991, 270.0, 894, 701879, 921, 32.232284400000935
922, 10.232194841854476, 48.11096398637101, 57.94392412546519, 0.1000000000000001, 270.0, 740, 702619, 922, 26.25118619999921
923, 9.046082534392674, 48.04919577099028, 57.9096623678056, 0.10000000000000099, 65.0, 630, 703249, 923, 22.58395240000027
924, 7.985097099585945, 48.181237158934586, 58.08180716464, 0.1000000000000009, 70.0, 509, 703758, 924, 18.265432399999554
925, 4.173544375084486, 47.97519495171735, 57.651196632192175, 0.09999999999999742, 605.0, 1383, 705141, 925, 49.58424179999929
926, 6.565704844584284, 48.192555299012554, 58.013011845298436, 0.09999999999999896, 150.0, 920, 706061, 926, 32.81838749999952
927, 5.179823835214523, 48.13208827798225, 57.8819307954344, 0.0999999999999992, 270.0, 876, 706937, 927, 31.477536000000327
928, 4.916593032223838, 48.07873190507926, 57.85188697019599, 0.09999999999999983, 205.0, 777, 707714, 928, 27.985814599998776
929, 3.441551801273409, 48.07490948268345, 57.73338204014058, 0.10000000000000073, 70.0, 392, 708106, 929, 14.152973100000963
930, 4.559925969972633, 48.22503731993561, 57.94826157702309, 0.09999999999999931, 195.0, 857, 708963, 930, 31.026949999999488
931, 7.198311678753674, 48.21387345417711, 57.96782785960281, 0.09999999999999942, 250.0, 837, 709800, 931, 30.185696599999574
932, 5.750909718542786, 48.04592413282664, 57.79614053068862, 0.10000000000000035, 105.0, 708, 710508, 932, 25.473897900001248
933, 5.606232089041608, 48.01701733749525, 57.74151421943597, 0.0999999999999981, 635.0, 1130, 711638, 933, 40.98139749999973
934, 5.435458467310866, 47.94287917193245, 57.65653823100516, 0.10000000000000099, 60.0, 629, 712267, 934, 23.25673420000021
935, 6.020499371561693, 47.9968025231568, 57.70334614422305, 0.09999999999999769, 250.0, 1269, 713536, 935, 46.08157019999999
936, 5.379076992506033, 47.91010560883623, 57.59064964647784, 0.09999999999999712, 420.0, 1533, 715069, 936, 55.9275875000003
937, 7.453291742191603, 48.045476048417214, 57.81227401442918, 0.0999999999999991, 270.0, 893, 715962, 937, 32.284513499998866
938, 4.917928934113737, 48.02118796965407, 57.74571337078844, 0.09999999999999903, 300.0, 906, 716868, 938, 32.94493010000042
939, 3.891697752549023, 47.98643428771222, 57.64122960606559, 0.10000000000000087, 75.0, 488, 717356, 939, 18.25827869999921
940, 4.714582632669432, 47.942423479761665, 57.653246538843696, 0.10000000000000088, 100.0, 501, 717857, 940, 18.405819200001133
941, 8.383920446297115, 47.95230407797682, 57.73807500369127, 0.09999999999999896, 200.0, 921, 718778, 941, 34.25488450000012
942, 6.603314214210825, 48.09249169796603, 57.814361637511304, 0.09999999999999919, 375.0, 877, 719655, 942, 32.05876999999964
943, 7.285579847797843, 47.63277474925863, 57.39844634139611, 0.10000000000000087, 180.0, 491, 720146, 943, 18.081490900000063
944, 3.2766319571313227, 46.89411333759834, 56.36217886240694, 0.10000000000000095, 95.0, 573, 720719, 944, 21.09248900000057
945, 3.9293287456791877, 46.844213306455686, 56.29081530678541, 0.09999999999999834, 270.0, 1064, 721783, 945, 39.51518000000033
946, 6.553973664419287, 46.87111388285449, 56.405279142537694, 0.09999999999999977, 175.0, 785, 722568, 946, 28.609947200000533
947, 5.250131135133091, 46.90005787773311, 56.36860979554799, 0.09999999999999934, 260.0, 852, 723420, 947, 31.686707799999567
948, 5.870313621743792, 46.89940018233465, 56.383084234308875, 0.09999999999999772, 280.0, 1259, 724679, 948, 46.82408779999969
949, 4.674843555436036, 46.84807141458467, 56.274920828851144, 0.10000000000000073, 55.0, 389, 725068, 949, 14.576676200000293
950, 3.3823560638704717, 46.92284549522155, 56.4016069062102, 0.09999999999999981, 370.0, 779, 725847, 950, 28.783795100000134
951, 5.48469491075086, 47.065244827766996, 56.62841235841432, 0.09999999999999895, 175.0, 922, 726769, 951, 34.1626897999995
952, 4.359844554273696, 46.87331092691867, 56.31506142066647, 0.10000000000000098, 65.0, 642, 727411, 952, 23.996817799999917
953, 5.555293396797799, 46.914234810333085, 56.4027804849972, 0.09999999999999898, 180.0, 917, 728328, 953, 34.20570989999942
954, 4.701299178876703, 47.017460626171484, 56.53042705905053, 0.10000000000000099, 45.0, 620, 728948, 954, 23.04378059999908
955, 4.885762390601784, 46.91360782156917, 56.400703424196635, 0.100000000000001, 95.0, 638, 729586, 955, 23.79888149999897
956, 6.729884699644411, 47.114663551835456, 56.701661337824426, 0.09999999999999824, 325.0, 1088, 730674, 956, 40.5195175000008
957, 5.100869647651628, 47.246924192090574, 56.799130847182454, 0.0999999999999977, 610.0, 1264, 731938, 957, 47.459136800000124
958, 6.1405717048159785, 47.29179786189428, 56.84172659050928, 0.1000000000000009, 70.0, 511, 732449, 958, 19.1323725000002
959, 5.302677504009428, 47.14128452297245, 56.68676271240113, 0.09999999999999855, 300.0, 1009, 733458, 959, 37.960826200000156
960, 8.144486215425495, 47.297687047793545, 56.85408815336816, 0.10000000000000092, 185.0, 648, 734106, 960, 24.488331199998356
961, 4.191347461233392, 47.16260645032505, 56.67502176773145, 0.09999999999999845, 305.0, 1035, 735141, 961, 39.31536849999975
962, 3.5213559383556325, 47.23861279207117, 56.740812582128186, 0.10000000000000003, 215.0, 748, 735889, 962, 28.24427260000084
963, 5.569588687889419, 47.202684299301055, 56.739147464584256, 0.09999999999999701, 580.0, 1590, 737479, 963, 60.13599980000254
964, 7.534232141389703, 47.24189777250681, 56.97105612044201, 0.10000000000000084, 80.0, 463, 737942, 964, 18.12701399999787
965, 6.095980955417766, 47.32794657102059, 56.92417952916683, 0.09999999999999905, 80.0, 903, 738845, 965, 34.29071140000087
966, 4.753964657916087, 47.23453452654638, 56.7853016377206, 0.09999999999999751, 325.0, 1342, 740187, 966, 51.4729198999994
967, 5.982449670320466, 47.0783207484654, 56.64280843098958, 0.10000000000000091, 55.0, 525, 740712, 967, 20.04992409999977
968, 10.139170409453847, 47.08576302129946, 56.66178276082576, 0.1000000000000007, 80.0, 371, 741083, 968, 14.303131500000745
969, 6.220696789560034, 47.04908804948848, 56.56573964272368, 0.09999999999999787, 425.0, 1206, 742289, 969, 38.493121199997404
970, 5.4794620789528725, 47.11005535343047, 56.688146405633766, 0.09999999999999806, 545.0, 1141, 743430, 970, 36.7956617000018
971, 4.486289386078715, 47.104008078575134, 56.60825543403625, 0.09999999999999813, 425.0, 1120, 744550, 971, 35.87100239999927
972, 5.941834434738605, 47.10043573320865, 56.62453213887608, 0.09999999999999958, 140.0, 813, 745363, 972, 26.29444610000064
973, 5.820264229423379, 47.164409413496344, 56.63975740645496, 0.1000000000000009, 30.0, 511, 745874, 973, 16.442044299998088
974, 3.5596355758341565, 47.00807161943628, 56.466588054349785, 0.09999999999999867, 375.0, 981, 746855, 974, 31.811619100000826
975, 6.330488662941818, 47.12817076063648, 56.68958913946362, 0.10000000000000062, 90.0, 679, 747534, 975, 22.072858600000473
976, 7.285498694544602, 47.09009035190422, 56.5994665922519, 0.10000000000000071, 75.0, 668, 748202, 976, 21.684472100001585
977, 5.039753891681996, 47.194196287970534, 56.70981652498694, 0.09999999999999834, 285.0, 1062, 749264, 977, 34.0988718999979
978, 6.662845093350129, 47.12991088012169, 56.777700144669105, 0.10000000000000046, 195.0, 696, 749960, 978, 22.653366900001856
979, 4.263781921307061, 47.754515478025354, 57.36685180219977, 0.0999999999999993, 315.0, 859, 750819, 979, 28.010535000001255
980, 4.565244166250294, 47.574991576064974, 57.17915612094736, 0.1000000000000009, 105.0, 507, 751326, 980, 16.292618900002708
981, 4.877153547376992, 47.77333353463154, 57.39967002104014, 0.10000000000000082, 90.0, 449, 751775, 981, 14.546821899999486
982, 5.354692682592125, 47.674318701568374, 57.296866931854346, 0.09999999999999887, 175.0, 939, 752714, 982, 30.55768480000188
983, 6.239966644744655, 47.63794967363466, 57.257476324958965, 0.10000000000000052, 125.0, 689, 753403, 983, 22.535568400002376
984, 6.026326677485745, 47.703942829051705, 57.337040782168, 0.09999999999999779, 350.0, 1234, 754637, 984, 40.154867500001274
985, 5.379010639150737, 47.69153162931503, 57.3682925859171, 0.10000000000000048, 130.0, 694, 755331, 985, 22.582459500001278
986, 5.078727059019318, 47.80862899626339, 57.48280860256277, 0.09999999999999971, 135.0, 793, 756124, 986, 26.1824744000005
987, 5.789454446757162, 47.79215547303896, 57.45982222273543, 0.09999999999999894, 160.0, 925, 757049, 987, 30.172726500000863
988, 4.5998711601257325, 47.788336541748045, 57.41732270507813, 0.10000000000000099, 70.0, 625, 757674, 988, 20.38876149999851
989, 6.1591372966542375, 47.769171582398215, 57.427368848751755, 0.0999999999999981, 275.0, 1131, 758805, 989, 36.93393540000034
990, 3.6482473565840428, 47.695233851303286, 57.34235415046598, 0.10000000000000059, 70.0, 324, 759129, 990, 10.641673499998433
991, 6.75651667574068, 47.73366059810919, 57.39615428332674, 0.09999999999999751, 245.0, 1347, 760476, 991, 44.698013100001845
992, 4.426560516664368, 47.61777535741201, 57.19917007263549, 0.10000000000000071, 195.0, 668, 761144, 992, 21.992184599999746
993, 6.547716385604839, 47.63373374075911, 57.266903165239015, 0.10000000000000077, 160.0, 663, 761807, 993, 21.79755820000355
994, 7.196867081410716, 47.70242459604431, 57.40458235082267, 0.09999999999999878, 410.0, 956, 762763, 994, 31.448999600001116
995, 7.3362556569576265, 47.749644287109376, 57.466843727111815, 0.10000000000000088, 95.0, 500, 763263, 995, 16.669549799997185
996, 6.698222799542584, 47.629131967407744, 57.29212127234865, 0.09999999999999792, 285.0, 1185, 764448, 996, 39.148956400000316
997, 5.970284417656326, 47.62209985178227, 57.24461695659591, 0.10000000000000096, 125.0, 581, 765029, 997, 19.434182500001043
998, 6.585086781293787, 47.80945036056194, 57.51300649440035, 0.10000000000000085, 65.0, 470, 765499, 998, 15.777036600000429
999, 4.998349673718868, 47.69717823721454, 57.30764812005018, 0.09999999999999859, 430.0, 1002, 766501, 999, 33.295081799999025
1000, 4.702979450456404, 47.682468512276394, 57.264052475245, 0.10000000000000099, 170.0, 623, 767124, 1000, 20.644543700000213
1001, 6.5469229603555235, 47.66434872924998, 57.31691496194637, 0.0999999999999977, 340.0, 1262, 768386, 1001, 41.9760411999996
1002, 3.6428564600646496, 47.6462168898879, 57.25363936720853, 0.09999999999999944, 260.0, 836, 769222, 1002, 28.108269799999107
1003, 7.145675763903121, 47.621795590505954, 57.29634337494339, 0.09999999999999909, 200.0, 897, 770119, 1003, 30.055684299997665
1004, 5.156100851771594, 47.080838192326596, 56.58554442826403, 0.09999999999999985, 435.0, 773, 770892, 1004, 25.64514119999876
1005, 5.3570627946057705, 47.11476274127326, 56.63423989978802, 0.10000000000000078, 130.0, 662, 771554, 1005, 22.035703300000023
1006, 8.825101410781253, 47.15277920560354, 56.77233385270642, 0.09999999999999679, 380.0, 1736, 773290, 1006, 57.926264400000946
1007, 7.074013023346794, 47.25014848834773, 56.80088240929264, 0.10000000000000057, 130.0, 683, 773973, 1007, 23.0256432999995
1008, 6.229561361996149, 47.18446948407239, 56.759567652317074, 0.09999999999999903, 145.0, 906, 774879, 1008, 30.27010970000265
1009, 7.2365245817828985, 47.16556872351695, 56.714444314019154, 0.09999999999999885, 310.0, 944, 775823, 1009, 31.641801099998702
1010, 5.331495181176202, 47.20416367321768, 56.71363016508237, 0.09999999999999765, 380.0, 1291, 777114, 1010, 43.56459779999932
1011, 4.417906093765651, 47.19104005752071, 56.70320743437736, 0.10000000000000099, 70.0, 620, 777734, 1011, 21.044289199999184
1012, 5.713688276534857, 47.27615685241167, 56.914458324742874, 0.10000000000000053, 295.0, 688, 778422, 1012, 23.26001349999933
1013, 4.505061068967597, 47.03719101068273, 56.513679138601645, 0.10000000000000082, 110.0, 657, 779079, 1013, 22.345618999999715
1014, 6.334911471764582, 47.28193675281294, 56.87065103587219, 0.10000000000000034, 180.0, 711, 779790, 1014, 24.287740299998404
1015, 6.608507681104178, 47.074771563701894, 56.6099760881374, 0.10000000000000091, 170.0, 649, 780439, 1015, 21.91976749999958
1016, 5.978627569773044, 46.99253983079341, 56.460967076173304, 0.09999999999999931, 290.0, 855, 781294, 1016, 29.54960410000058
1017, 5.097343682185509, 46.988215605065456, 56.46605835468436, 0.10000000000000082, 35.0, 451, 781745, 1017, 15.439664900000935
1018, 4.154669433049342, 46.95307050784063, 56.38411644438994, 0.09999999999999826, 400.0, 1085, 782830, 1018, 37.12948300000062
1019, 5.6304591714712675, 46.8799815160322, 56.33078000114413, 0.09999999999999958, 280.0, 813, 783643, 1019, 27.98280480000176
1020, 3.319062438176971, 46.881146959295855, 56.29078934450105, 0.09999999999999934, 285.0, 852, 784495, 1020, 29.349508400002378
1021, 5.122166018987727, 46.85350879533236, 56.311742766598236, 0.0999999999999988, 255.0, 954, 785449, 1021, 32.35413630000039
1022, 6.906452902934465, 46.92512686379484, 56.44021304403923, 0.09999999999999831, 255.0, 1071, 786520, 1022, 38.00301480000053
1023, 5.847115270006494, 46.96783072294531, 56.50192159363521, 0.10000000000000096, 95.0, 587, 787107, 1023, 20.57872149999821
1024, 6.197126253450569, 46.991970950427515, 56.519342731125, 0.0999999999999993, 125.0, 859, 787966, 1024, 29.560490100000607
1025, 8.482563028547991, 46.992055203052274, 56.59372981051181, 0.1000000000000007, 70.0, 376, 788342, 1025, 12.967806699998619
1026, 6.954435143310117, 46.92235375892005, 56.39739290713063, 0.10000000000000074, 65.0, 397, 788739, 1026, 13.684468199997355
1027, 7.182452485794562, 46.90121758446524, 56.367848632709574, 0.10000000000000096, 165.0, 593, 789332, 1027, 20.581039599997894
1028, 8.131865942678727, 47.02631302357466, 56.59850405005036, 0.100000000000001, 150.0, 639, 789971, 1028, 22.41433870000037
1029, 5.5447720501995335, 47.102511848069696, 56.59439386535878, 0.09999999999999978, 220.0, 783, 790754, 1029, 27.02715040000112
1030, 6.848412851852725, 47.014122000158544, 56.566834617705936, 0.09999999999999773, 610.0, 1255, 792009, 1030, 47.03461059999972
1031, 8.906394792858427, 47.14846299468896, 56.6828914102634, 0.10000000000000099, 95.0, 622, 792631, 1031, 27.521444000001793
1032, 6.604366582506348, 47.006995908675655, 56.51277216019169, 0.09999999999999962, 210.0, 806, 793437, 1032, 33.43783640000038
1033, 6.250877948132649, 47.056910955735965, 56.55788633731135, 0.10000000000000087, 45.0, 491, 793928, 1033, 17.136529400002473
1034, 6.8024638148851775, 47.068863028653695, 56.65082881252688, 0.09999999999999817, 145.0, 1108, 795036, 1034, 38.72877659999722
1035, 5.022607313587849, 47.036165317760336, 56.49055469021757, 0.09999999999999946, 290.0, 831, 795867, 1035, 29.04908230000001
1036, 6.144564723439755, 47.05770903556578, 56.60530761390604, 0.09999999999999891, 115.0, 930, 796797, 1036, 32.19178329999704
1037, 6.060517195400907, 47.11677752063049, 56.64718455983632, 0.09999999999999858, 230.0, 1005, 797802, 1037, 34.97613049999927
1038, 7.015756930929522, 46.87662494160633, 56.312620693368366, 0.10000000000000092, 165.0, 543, 798345, 1038, 21.40765459999966
1039, 4.295144930273016, 46.98034220098335, 56.47785376611157, 0.09999999999999931, 160.0, 856, 799201, 1039, 31.319115799997235
1040, 4.735858297470094, 46.96710730407197, 56.49974801446085, 0.10000000000000035, 140.0, 708, 799909, 1040, 24.686933300003147
1041, 5.780089039846578, 47.76681346459822, 57.4003436868841, 0.09999999999999917, 210.0, 880, 800789, 1041, 30.301910700000008
1042, 6.581359401960695, 47.797041887037444, 57.53563340703895, 0.09999999999999967, 235.0, 799, 801588, 1042, 27.44076649999988
1043, 5.624127410569046, 47.89658654026253, 57.571626362472614, 0.09999999999999659, 600.0, 1890, 803478, 1043, 65.49596839999867
1044, 3.4958714967668056, 47.82942816925049, 57.41405094146729, 0.10000000000000088, 120.0, 500, 803978, 1044, 17.59411739999996
1045, 5.252420760471106, 47.92410463421657, 57.54507730379386, 0.10000000000000085, 105.0, 474, 804452, 1045, 16.75189600000158
1046, 8.36790331431504, 47.84269456008385, 57.56701372343918, 0.10000000000000021, 145.0, 725, 805177, 1046, 25.525786100002733
1047, 5.803743678632456, 47.93238821835055, 57.625436612726105, 0.09999999999999769, 345.0, 1267, 806444, 1047, 45.13725820000036
1048, 4.5713248979122865, 47.90681107838949, 57.574635732741584, 0.09999999999999941, 130.0, 840, 807284, 1048, 29.876632199997402
1049, 7.498665324930479, 48.01164708766609, 57.713893547568674, 0.10000000000000091, 155.0, 523, 807807, 1049, 18.43443589999879
1050, 8.946029371757438, 47.95116600368334, 57.788477546581326, 0.10000000000000064, 20.0, 345, 808152, 1050, 12.310419099998398
1051, 5.250995353468681, 47.78781304679311, 57.44512841258889, 0.10000000000000099, 65.0, 641, 808793, 1051, 22.897202600001037
1052, 5.870403623592095, 47.92068536689368, 57.59686846500925, 0.09999999999999966, 135.0, 801, 809594, 1052, 28.420523999997386
1053, 6.132485145872289, 47.55242096441002, 57.195445285556126, 0.10000000000000091, 90.0, 649, 810243, 1053, 23.146168499999476
1054, 4.982831219661706, 47.05462498280442, 56.55347004558374, 0.09999999999999798, 510.0, 1166, 811409, 1054, 41.473780199998146
1055, 5.241923809216623, 47.02457473416738, 56.48692913530936, 0.10000000000000067, 85.0, 361, 811770, 1055, 12.997458399997413
1056, 4.079566290443258, 47.04306198407381, 56.50672183876418, 0.09999999999999905, 95.0, 903, 812673, 1056, 32.379533299998
1057, 6.360890958726884, 46.99713204061996, 56.50594724211859, 0.09999999999999812, 360.0, 1123, 813796, 1057, 40.14578299999994
1058, 5.440007400368683, 46.97455759322681, 56.44932182299824, 0.09999999999999773, 400.0, 1252, 815048, 1058, 45.076588700001594
1059, 5.586908973568405, 47.04429209590737, 56.56387607848722, 0.09999999999999991, 160.0, 765, 815813, 1059, 27.763662500001374
1060, 6.5805875713986275, 46.927698613541374, 56.470606684352695, 0.10000000000000027, 225.0, 718, 816531, 1060, 25.73292710000169
1061, 4.693163891651413, 47.05637749758634, 56.518662085099656, 0.0999999999999982, 330.0, 1100, 817631, 1061, 39.64369430000079
1062, 5.706155212654407, 46.982999236325185, 56.53800941834967, 0.09999999999999946, 345.0, 830, 818461, 1062, 29.97835810000106
1063, 6.330325345649151, 47.06353848283462, 56.562503381140516, 0.09999999999999769, 485.0, 1267, 819728, 1063, 45.61489799999981
1064, 4.8786857839183835, 46.50282476912657, 55.89991144506866, 0.09999999999999962, 190.0, 806, 820534, 1064, 29.27112330000091
1065, 5.614212331390618, 46.198315602249615, 55.536269642246, 0.09999999999999785, 480.0, 1207, 821741, 1065, 43.523548799999844
1066, 3.5016825180668216, 46.19194209873378, 55.46017395461594, 0.09999999999999859, 250.0, 1001, 822742, 1066, 36.56920199999877
1067, 5.006454740749126, 46.250580899056544, 55.6029893561759, 0.09999999999999838, 225.0, 1053, 823795, 1067, 38.59925910000311
1068, 6.156290473020408, 46.22566849373947, 55.60836079781616, 0.09999999999999754, 280.0, 1331, 825126, 1068, 48.23576300000059
1069, 5.134010667444035, 46.11509930555987, 55.35876377372985, 0.10000000000000099, 155.0, 628, 825754, 1069, 23.05652380000174
1070, 7.238041370119767, 46.1809063093864, 55.58468848801048, 0.09999999999999867, 350.0, 981, 826735, 1070, 36.11442270000043
1071, 7.149769144874394, 46.18228454357947, 55.556406809566234, 0.10000000000000081, 115.0, 658, 827393, 1071, 23.96131890000106
1072, 4.127883567929391, 46.100789112449306, 55.342821607402726, 0.09999999999999873, 310.0, 969, 828362, 1072, 35.31404359999942
1073, 4.133694140252724, 46.19746890930309, 55.51116595964287, 0.09999999999999898, 195.0, 918, 829280, 1073, 33.8998505999989
1074, 4.065251092767657, 46.15129717269746, 55.41114629613291, 0.10000000000000075, 70.0, 404, 829684, 1074, 14.95279169999776
1075, 5.931261613979544, 46.03540763372107, 55.404635970757326, 0.09999999999999848, 280.0, 1027, 830711, 1075, 37.90957299999718
1076, 5.944007441522629, 46.01484747785863, 55.31407617708532, 0.10000000000000098, 105.0, 615, 831326, 1076, 23.023966900000232
1077, 6.228120659286574, 45.954441034163175, 55.29356657890062, 0.09999999999999802, 385.0, 1153, 832479, 1077, 43.23832839999886
1078, 7.247473206111307, 46.08511313734923, 55.4589757003972, 0.09999999999999783, 530.0, 1219, 833698, 1078, 45.67770920000112
1079, 6.980329313760866, 45.92680875805841, 55.24612222201582, 0.10000000000000094, 145.0, 552, 834250, 1079, 20.7198470000003
1080, 4.827349649614048, 45.94618133591254, 55.16260632040047, 0.09999999999999865, 595.0, 988, 835238, 1080, 37.041590700002416
1081, 5.545185205578606, 45.99327272578739, 55.25422104034297, 0.09999999999999788, 350.0, 1201, 836439, 1081, 44.705331499997556
1082, 7.2581803526285045, 45.92898038986626, 55.2307395060128, 0.09999999999999921, 115.0, 872, 837311, 1082, 32.16665129999819
1083, 4.414319166251157, 45.930104141600395, 55.19113632518519, 0.10000000000000099, 90.0, 627, 837938, 1083, 23.622462899998936
1084, 5.771761849388144, 45.96942123757269, 55.1815009095615, 0.10000000000000074, 115.0, 665, 838603, 1084, 24.639537800001563
1085, 5.874887440791902, 45.836492695527916, 55.11511202419506, 0.1000000000000006, 165.0, 680, 839283, 1085, 25.559085000000778
1086, 6.76594895603251, 45.869430641670014, 55.18221091415923, 0.09999999999999734, 340.0, 1416, 840699, 1086, 52.868273600000975
1087, 5.5167824170520365, 46.0225198357456, 55.287656639518566, 0.10000000000000067, 180.0, 673, 841372, 1087, 24.987652399999206
1088, 4.636283533871421, 45.80219362348985, 55.04519235189038, 0.09999999999999785, 350.0, 1207, 842579, 1088, 45.21667680000246
1089, 6.348877521319206, 45.85578414895287, 55.10804459855363, 0.1000000000000004, 180.0, 703, 843282, 1089, 26.680354200001602
1090, 6.439037107213818, 45.737067803569225, 55.017864542994005, 0.09999999999999923, 190.0, 870, 844152, 1090, 32.189797899998666
1091, 5.317668979146677, 45.82833839782489, 55.088828454011775, 0.09999999999999958, 460.0, 813, 844965, 1091, 30.470652699998027
1092, 5.334147450791186, 45.892697694922695, 55.162375323511974, 0.09999999999999791, 330.0, 1190, 846155, 1092, 44.75232070000129
1093, 6.4203984973863335, 45.92483682717251, 55.23935047541305, 0.09999999999999777, 375.0, 1237, 847392, 1093, 46.642518600001495
1094, 5.893386689225218, 46.042330683815464, 55.360389555939946, 0.09999999999999873, 395.0, 969, 848361, 1094, 36.297975000001315
1095, 7.412900828530914, 45.90886639795805, 55.24281763528523, 0.09999999999999713, 365.0, 1520, 849881, 1095, 57.167474500001845
1096, 6.208663819114367, 45.959929412841795, 55.257597300211586, 0.09999999999999812, 465.0, 1125, 851006, 1096, 42.779758600001514
1097, 6.846354375679453, 45.99540114202419, 55.35098514236322, 0.09999999999999881, 405.0, 952, 851958, 1097, 36.31812449999779
1098, 10.584281377206853, 45.96942545286712, 55.28240029681534, 0.10000000000000099, 140.0, 622, 852580, 1098, 23.844384899999568
1099, 7.7381642834727336, 45.81819691280071, 55.0933745194724, 0.09999999999999896, 395.0, 921, 853501, 1099, 34.83325740000146
1100, 7.533659103730437, 45.985806921777474, 55.288276022248056, 0.09999999999999817, 340.0, 1109, 854610, 1100, 42.54464590000134
1101, 6.173674961380806, 45.950378402029905, 55.23763737373033, 0.10000000000000027, 220.0, 718, 855328, 1101, 27.666350300001795
1102, 4.2497841869948605, 45.9121686735528, 55.12965262300583, 0.09999999999999898, 240.0, 916, 856244, 1102, 35.03213300000061
1103, 8.247983050534069, 45.92716364706716, 55.274152055497176, 0.10000000000000088, 100.0, 651, 856895, 1103, 24.797290300000896
1104, 6.914995611584099, 46.162799139092435, 55.48867104523374, 0.10000000000000092, 90.0, 548, 857443, 1104, 21.206384699999035
1105, 5.1240757587410775, 45.88345292035271, 55.105773436803375, 0.09999999999999808, 265.0, 1139, 858582, 1105, 43.530709200000274
1106, 7.496229493201466, 45.962448906142704, 55.22244709575554, 0.10000000000000048, 105.0, 694, 859276, 1106, 26.483948599998257
1107, 7.25993127612558, 46.03667678944712, 55.38795863273029, 0.10000000000000057, 110.0, 683, 859959, 1107, 26.374776399999973
1108, 5.067073206390031, 45.95370407550656, 55.218266866360494, 0.10000000000000057, 200.0, 684, 860643, 1108, 26.18479220000154
1109, 6.861152345387091, 46.0363076908982, 55.35634755035304, 0.09999999999999881, 320.0, 951, 861594, 1109, 36.72847130000082
1110, 7.88980257337337, 46.00376248489021, 55.35260306387655, 0.09999999999999819, 300.0, 1106, 862700, 1110, 42.35520270000052
1111, 6.71048312352453, 45.87837589010469, 55.16409815149778, 0.10000000000000096, 20.0, 587, 863287, 1111, 22.757122299997718
1112, 4.673873262643814, 46.0468654296875, 55.294161535644534, 0.10000000000000099, 80.0, 625, 863912, 1112, 24.24058960000184
1113, 5.40725045740426, 45.938542851430924, 55.2581326547497, 0.10000000000000071, 120.0, 668, 864580, 1113, 26.044394399999874
1114, 7.968167238805552, 46.00860436854029, 55.36209654880512, 0.09999999999999865, 215.0, 987, 865567, 1114, 38.48706360000142
1115, 5.088843453768641, 46.088461724917096, 55.34751150608063, 0.09999999999999877, 260.0, 960, 866527, 1115, 37.08080659999905
1116, 5.813601744234312, 46.01950658242408, 55.343913004333366, 0.0999999999999988, 165.0, 954, 867481, 1116, 36.65335679999771
1117, 5.514047735861329, 46.06282377995151, 55.35299319799766, 0.10000000000000099, 55.0, 634, 868115, 1117, 25.023590500000864
1118, 4.656641435336058, 46.05377441379643, 55.287253951028624, 0.09999999999999805, 390.0, 1147, 869262, 1118, 44.276875100000325
1119, 6.973164575625324, 45.749670326162914, 55.0184833604682, 0.09999999999999734, 520.0, 1417, 870679, 1119, 55.343608200000745
1120, 4.991826945756163, 45.7933738054548, 55.04823738098145, 0.10000000000000064, 75.0, 350, 871029, 1120, 13.988161199999013
1121, 6.3956039338589665, 45.66781677164822, 54.88063185446748, 0.1, 160.0, 751, 871780, 1121, 29.46403570000257
1122, 6.090385488288438, 45.72462583048802, 54.94132284253918, 0.09999999999999826, 265.0, 1087, 872867, 1122, 42.363603100002365
1123, 4.3527262069532355, 45.551127341107396, 54.714651354124626, 0.09999999999999958, 215.0, 813, 873680, 1123, 31.84678989999884
1124, 4.1084920195029175, 45.55439931965987, 54.710902640791716, 0.09999999999999848, 280.0, 1028, 874708, 1124, 40.32815390000178
1125, 6.947384797402578, 45.64819337780349, 54.89607619317833, 0.09999999999999776, 340.0, 1242, 875950, 1125, 48.574174099998345
1126, 3.553366989725166, 45.69493283165826, 54.913771092450176, 0.10000000000000092, 95.0, 540, 876490, 1126, 21.322022300002573
1127, 6.168541324946633, 45.66120552561913, 54.89844486953777, 0.10000000000000014, 225.0, 734, 877224, 1127, 29.039512299998023
1128, 5.902608824834596, 45.58122276333111, 54.75416115400227, 0.09999999999999809, 295.0, 1132, 878356, 1128, 44.48894250000012
1129, 6.36680015537312, 45.69029192518361, 54.940762781570385, 0.10000000000000099, 120.0, 634, 878990, 1129, 25.209873899999366
1130, 4.644513270258903, 45.699247618853036, 54.91815370785988, 0.09999999999999794, 855.0, 1180, 880170, 1130, 46.2696786000015
1131, 5.337379219607924, 45.8886285697889, 55.16992749508072, 0.10000000000000099, 170.0, 636, 880806, 1131, 25.521612799999275
1132, 6.77645515498499, 45.882949086643706, 55.15457960551217, 0.0999999999999972, 875.0, 1490, 882296, 1132, 59.13829049999913
1133, 8.27341350896278, 46.0389118071921, 55.36626073708488, 0.10000000000000099, 180.0, 622, 882918, 1133, 24.666193200002454
1134, 5.2918557582134, 45.859175425381466, 55.090566106770034, 0.09999999999999852, 260.0, 1018, 883936, 1134, 40.6196248999986
1135, 7.990514896722774, 45.85878693536956, 55.19255849982476, 0.09999999999999887, 190.0, 939, 884875, 1135, 37.26044120000006
1136, 3.380079814859508, 45.81205350677794, 54.9842987548915, 0.1000000000000004, 145.0, 703, 885578, 1136, 28.087087600000814
1137, 6.1357960242645015, 45.83315088919231, 55.06019081388201, 0.10000000000000082, 95.0, 448, 886026, 1137, 17.9757815999983
1138, 4.929920323025435, 45.84331199645996, 55.12561222076416, 0.09999999999999966, 215.0, 800, 886826, 1138, 32.554789300000266
1139, 5.958151404172032, 45.86514070780591, 55.11952918948549, 0.09999999999999971, 195.0, 792, 887618, 1139, 31.8501537000011
1140, 5.137565878007658, 45.70114607947553, 54.94349644282093, 0.09999999999999964, 115.0, 803, 888421, 1140, 32.81960459999755
1141, 3.462166583493685, 45.740184528360295, 54.92055097821333, 0.10000000000000075, 90.0, 403, 888824, 1141, 15.96321589999934
1142, 8.406313703304566, 45.966871651207526, 55.28628703443015, 0.10000000000000084, 210.0, 656, 889480, 1142, 26.5871017999998
1143, 8.291884337742932, 45.89413527953319, 55.159758201012245, 0.10000000000000099, 115.0, 624, 890104, 1143, 25.16425000000163
1144, 7.133490476770514, 45.924662288688346, 55.21469884567712, 0.09999999999999938, 225.0, 845, 890949, 1144, 34.08312540000043
1145, 6.192775430071547, 45.74824435622604, 55.013846450381806, 0.1000000000000008, 75.0, 432, 891381, 1145, 20.47992979999981
1146, 5.888634832428513, 45.75221475285592, 54.99507798119414, 0.10000000000000046, 160.0, 695, 892076, 1146, 31.301602800002
1147, 4.525534722874513, 45.80091411296174, 55.10470832235903, 0.10000000000000098, 90.0, 609, 892685, 1147, 28.74483749999854
1148, 8.23843068311758, 45.777726975609276, 55.02341395546408, 0.1000000000000006, 155.0, 680, 893365, 1148, 28.260782699999254
1149, 4.509173451165449, 45.802677445052865, 55.045772434902105, 0.09999999999999819, 255.0, 1103, 894468, 1149, 44.65449389999776
1150, 4.802172419728241, 45.722526514641594, 54.94064378292761, 0.1000000000000008, 30.0, 428, 894896, 1150, 17.49994069999957
1151, 8.003783873903254, 45.75369608041012, 55.02887663696752, 0.10000000000000091, 105.0, 528, 895424, 1151, 21.556615800000145
1152, 5.380495940737179, 45.74051589778135, 54.9670418555153, 0.09999999999999958, 230.0, 813, 896237, 1152, 32.778294200001255
1153, 6.46557175129293, 45.882747075643884, 55.14327577338161, 0.09999999999999946, 160.0, 830, 897067, 1153, 33.73182269999961
1154, 6.266460517377758, 45.9023058071583, 55.25861563411445, 0.10000000000000096, 130.0, 598, 897665, 1154, 24.455726299998787
1155, 7.002539897167042, 45.76626593845029, 55.075044326728914, 0.09999999999999731, 330.0, 1431, 899096, 1155, 57.59789079999973
1156, 5.895694907290414, 45.76962265200166, 54.954611085468514, 0.10000000000000081, 150.0, 658, 899754, 1156, 26.895452799999475
1157, 4.600920659873957, 45.70631073374807, 54.8798705206977, 0.0999999999999996, 170.0, 810, 900564, 1157, 34.26847199999975
1158, 4.7430176820979115, 45.77350091251925, 54.999799676843594, 0.09999999999999772, 350.0, 1258, 901822, 1158, 52.19437420000031
1159, 5.3217100825379875, 45.76596581803217, 55.049158044763516, 0.10000000000000099, 170.0, 629, 902451, 1159, 25.743949600000633
1160, 6.357055340068681, 45.68779356533423, 54.94980868002526, 0.10000000000000074, 140.0, 665, 903116, 1160, 27.27630499999941
1161, 5.524751575120533, 45.70459454368999, 54.977348135445865, 0.10000000000000085, 180.0, 655, 903771, 1161, 26.51102830000309
1162, 6.250260098953152, 45.82864811171347, 55.085673256299984, 0.09999999999999963, 215.0, 804, 904575, 1162, 32.73717659999966
1163, 6.544434112686555, 45.82536594216271, 55.07782780280887, 0.10000000000000024, 155.0, 721, 905296, 1163, 29.756250700000237
1164, 5.9573920645225735, 45.71741185026773, 54.99043993605781, 0.10000000000000062, 125.0, 679, 905975, 1164, 28.030349900000147
1165, 6.282869465939599, 45.80347693965681, 55.04837831047311, 0.09999999999999848, 200.0, 1026, 907001, 1165, 41.86215220000304
1166, 7.405976318701934, 45.82894161310089, 55.13823774959264, 0.09999999999999833, 340.0, 1068, 908069, 1166, 44.0974939000007
1167, 6.815488712687564, 45.79894641532586, 55.07136872337556, 0.0999999999999982, 490.0, 1099, 909168, 1167, 45.270758799997566
1168, 5.405175038508998, 45.801870597200114, 55.063389579930686, 0.09999999999999896, 170.0, 919, 910087, 1168, 38.14544300000125
1169, 4.975931009322405, 45.79923058319092, 55.0440064163208, 0.10000000000000088, 120.0, 500, 910587, 1169, 20.82628730000215
1170, 5.487141974514487, 45.638699250302075, 54.892623172910874, 0.09999999999999915, 275.0, 885, 911472, 1170, 36.58244339999874
1171, 6.071185127801803, 45.85478811668339, 55.163521973569495, 0.09999999999999964, 175.0, 802, 912274, 1171, 33.7221884999999
1172, 4.749615665226205, 45.79950785274878, 55.03161532966796, 0.09999999999999895, 170.0, 922, 913196, 1172, 38.997501800000464
1173, 7.611270431131824, 45.87790614562415, 55.24402610348984, 0.10000000000000078, 110.0, 426, 913622, 1173, 17.675146500001574
1174, 3.265924837655173, 45.746631347216095, 54.96679405065683, 0.10000000000000099, 105.0, 624, 914246, 1174, 26.17312359999778
1175, 3.373704516785402, 45.68709486606074, 54.89859901690016, 0.10000000000000075, 45.0, 408, 914654, 1175, 16.984101199999714
1176, 5.469371365906994, 45.654346447410674, 54.89513568365195, 0.09999999999999955, 245.0, 818, 915472, 1176, 34.25127919999795
1177, 6.000589197251673, 45.78575041235947, 55.04194259643555, 0.10000000000000084, 325.0, 656, 916128, 1177, 27.137748699999065
1178, 9.548717277690216, 46.0532598613221, 55.47573811095438, 0.10000000000000075, 10.0, 405, 916533, 1178, 16.846608199997718
1179, 6.802117741858102, 45.74658614315399, 55.00343058860465, 0.09999999999999798, 310.0, 1168, 917701, 1179, 48.83731660000194
1180, 6.893542155295749, 45.8147440928, 55.07247821048454, 0.09999999999999927, 230.0, 864, 918565, 1180, 36.41599779999888
1181, 5.5469123451340145, 45.741260418621216, 54.99694427090441, 0.09999999999999805, 185.0, 1145, 919710, 1181, 47.71406019999995
1182, 6.031484038160558, 44.940465484241216, 54.006928218530554, 0.09999999999999873, 120.0, 969, 920679, 1182, 40.60784599999897
1183, 4.062623690107426, 44.5603963926241, 53.52926594127308, 0.09999999999999987, 130.0, 770, 921449, 1183, 32.54322569999931
1184, 7.879300593902157, 44.553406113224085, 53.62433888760938, 0.10000000000000078, 95.0, 662, 922111, 1184, 28.15792220000003
1185, 5.91576218631479, 44.46457411653252, 53.460045430993524, 0.09999999999999891, 360.0, 930, 923041, 1185, 39.590410599997995
1186, 6.841087400765569, 44.60093218485515, 53.62959697139156, 0.09999999999999817, 575.0, 1110, 924151, 1186, 46.70108949999849
1187, 5.31644117478597, 44.51135101083247, 53.52264447204872, 0.10000000000000091, 195.0, 649, 924800, 1187, 27.354787000000215
1188, 5.579150177577732, 44.516263355549185, 53.5263638602139, 0.09999999999999883, 155.0, 947, 925747, 1188, 40.03082440000071
1189, 5.833505138096816, 44.48578056378921, 53.58485016999421, 0.10000000000000041, 75.0, 702, 926449, 1189, 29.56737250000151
1190, 4.774889944903391, 44.541083785878634, 53.522988030404754, 0.09999999999999895, 285.0, 924, 927373, 1190, 39.38197250000303
1191, 5.102143067759862, 44.63223126935187, 53.66033222013215, 0.09999999999999964, 225.0, 803, 928176, 1191, 34.03661629999988
1192, 5.773138226737445, 44.44003502375334, 53.46020985930986, 0.10000000000000091, 190.0, 521, 928697, 1192, 22.07478750000155
1193, 5.911811911247636, 44.528261732490144, 53.51638816725021, 0.09999999999999837, 325.0, 1055, 929752, 1193, 44.77869799999826
1194, 5.5034483948150665, 44.5394191104228, 53.54159015435216, 0.10000000000000081, 180.0, 658, 930410, 1194, 30.04004249999707
1195, 3.437868496801604, 44.55666452277859, 53.50787896399642, 0.10000000000000099, 165.0, 631, 931041, 1195, 26.56201140000121
1196, 6.093153043580118, 44.49115687779018, 53.520405049803394, 0.09999999999999884, 385.0, 945, 931986, 1196, 40.17316260000007
1197, 9.06324266431949, 44.5701884122423, 53.61568396772126, 0.10000000000000099, 70.0, 641, 932627, 1197, 27.784677600000578
1198, 6.774179388311511, 44.627844383105376, 53.73136830189923, 0.1000000000000009, 80.0, 511, 933138, 1198, 21.74631109999973
1199, 4.178919683270984, 44.50707851494683, 53.43629376898871, 0.09999999999999812, 440.0, 1125, 934263, 1199, 47.71446169999763
1200, 5.482287707674845, 44.54993457667875, 53.582318093339865, 0.09999999999999903, 305.0, 906, 935169, 1200, 38.82754849999765
1201, 4.049280365895023, 44.624111268336, 53.5964799942295, 0.09999999999999803, 185.0, 1151, 936320, 1201, 49.17476620000161
1202, 5.178741011561619, 44.62186683372215, 53.65496116920754, 0.09999999999999827, 295.0, 1080, 937400, 1202, 46.42843990000256
1203, 5.01753857608598, 44.66104206672082, 53.70973587036133, 0.10000000000000091, 95.0, 520, 937920, 1203, 22.437245599998278
1204, 7.628771095480624, 44.657861894176854, 53.749135872958114, 0.09999999999999805, 395.0, 1147, 939067, 1204, 49.248762800001714
1205, 6.610954862735268, 44.59451353465412, 53.59195249300477, 0.0999999999999981, 90.0, 1128, 940195, 1205, 48.89263740000024
1206, 6.161107357180463, 44.2440275533721, 53.189984312971504, 0.09999999999999819, 355.0, 1106, 941301, 1206, 47.69993450000038
1207, 8.108581448910954, 44.39670144549068, 53.465193197593926, 0.10000000000000096, 185.0, 644, 941945, 1207, 27.933815799999138
1208, 4.192576821942399, 44.368110356017624, 53.28822782753158, 0.10000000000000056, 85.0, 685, 942630, 1208, 29.430705700000544
1209, 5.440410261790742, 44.268679886533505, 53.22900290907475, 0.09999999999999806, 265.0, 1140, 943770, 1209, 49.10536779999893
1210, 6.249777595129617, 44.32209607052397, 53.267607649457425, 0.10000000000000077, 25.0, 411, 944181, 1210, 18.088318599999184
1211, 3.463384436672194, 44.25165906824862, 53.12615364476254, 0.10000000000000074, 25.0, 399, 944580, 1211, 17.2212709000014
1212, 5.8655751867333485, 44.350175857543945, 53.305234112090346, 0.09999999999999934, 270.0, 852, 945432, 1212, 36.84886390000247
1213, 5.233103635543175, 44.31145278309441, 53.27320649241673, 0.10000000000000073, 90.0, 393, 945825, 1213, 17.036751900002855
1214, 6.48477399070903, 44.362395828336126, 53.3475550566202, 0.09999999999999848, 325.0, 1028, 946853, 1214, 44.712960400000156
1215, 6.184380929410393, 44.24156238360815, 53.144490504550205, 0.09999999999999896, 320.0, 919, 947772, 1215, 39.8416830999995
1216, 5.7569555567989825, 44.363120341118965, 53.309279696631975, 0.10000000000000091, 120.0, 524, 948296, 1216, 22.6546500000004
1217, 4.476892308519961, 44.375566491097075, 53.353009369341244, 0.09999999999999912, 270.0, 892, 949188, 1217, 38.892187400000694
1218, 4.951010269164661, 43.98598699549568, 52.856520935316304, 0.09999999999999734, 360.0, 1421, 950609, 1218, 62.21096779999789
1219, 6.374711817823166, 43.70469620759822, 52.528627140265854, 0.10000000000000098, 100.0, 605, 951214, 1219, 26.456826400000864
1220, 5.207997512860526, 43.58839735386543, 52.393114887172416, 0.09999999999999751, 225.0, 1347, 952561, 1220, 59.259098800001084
1221, 4.839566812577723, 43.52040847142538, 52.322250110934476, 0.09999999999999971, 150.0, 792, 953353, 1221, 34.496843299999455
1222, 5.051163952063968, 43.590553528297946, 52.43485813286468, 0.10000000000000085, 145.0, 655, 954008, 1222, 28.80770190000112
1223, 5.23129396537655, 43.55314605625448, 52.34633343540837, 0.10000000000000064, 30.0, 349, 954357, 1223, 15.635698499998398
1224, 5.959102172627549, 43.56159652574628, 52.39429232392237, 0.09999999999999906, 250.0, 902, 955259, 1224, 39.598070500000176
1225, 7.623162849355909, 43.66110483551786, 52.5162351385784, 0.09999999999999858, 195.0, 1003, 956262, 1225, 43.840863000001264
1226, 6.985135682690608, 43.518974704151596, 52.3544314432182, 0.09999999999999772, 550.0, 1259, 957521, 1226, 55.495808199997555
1227, 5.129868339263067, 43.56754515979784, 52.33186886069008, 0.09999999999999902, 175.0, 908, 958429, 1227, 39.58594649999941
1228, 9.504675657763912, 43.693266947454404, 52.56309499846294, 0.09999999999999797, 350.0, 1173, 959602, 1228, 51.81567189999987
1229, 6.1106295840775635, 43.09915215819032, 51.79166543867205, 0.09999999999999731, 510.0, 1430, 961032, 1229, 63.13331180000023
1230, 6.1268046658803605, 43.00136426248725, 51.67150198680297, 0.09999999999999892, 150.0, 927, 961959, 1230, 41.041439399999945
1231, 4.292322312417741, 42.89638908424569, 51.52972476007152, 0.10000000000000096, 120.0, 597, 962556, 1231, 26.438553100000718
1232, 4.106175013001813, 42.84305043469545, 51.50572065135727, 0.1000000000000009, 120.0, 517, 963073, 1232, 23.103733300002204
1233, 7.539933338850704, 42.983725082913296, 51.762498920070435, 0.09999999999999898, 370.0, 917, 963990, 1233, 41.056057199999486
1234, 6.017726013232512, 42.961056203709504, 51.690413620962055, 0.10000000000000092, 100.0, 647, 964637, 1234, 29.13400140000158
1235, 4.9386100767890815, 42.86529187074642, 51.45969739894277, 0.10000000000000073, 60.0, 388, 965025, 1235, 17.254946400000335
1236, 6.789742833915379, 43.0088457452791, 51.712938670942265, 0.10000000000000066, 95.0, 674, 965699, 1236, 30.217159899999388
1237, 5.089023920568432, 42.87554343718463, 51.542721699500134, 0.09999999999999908, 195.0, 898, 966597, 1237, 40.51647139999841
1238, 7.5080377833274, 42.989916912617126, 51.72017918920224, 0.09999999999999869, 185.0, 978, 967575, 1238, 43.96924489999947
1239, 7.310366664648056, 42.980470815022784, 51.715151970757375, 0.09999999999999812, 430.0, 1125, 968700, 1239, 50.525294199997006
1240, 4.532145969078236, 42.911048799073654, 51.56987789166478, 0.0999999999999978, 295.0, 1228, 969928, 1240, 54.69916260000173
1241, 7.7352469228208065, 42.98138756532549, 51.73720272016326, 0.09999999999999878, 130.0, 956, 970884, 1241, 42.99789880000026
1242, 6.985435114661147, 43.01674190027901, 51.787844909779146, 0.09999999999999822, 420.0, 1098, 971982, 1242, 50.02648810000028
1243, 8.293216179597477, 43.14215693145306, 51.96506278051962, 0.09999999999999878, 195.0, 958, 972940, 1243, 43.45873070000016
1244, 6.435936656191437, 42.943652696183975, 51.60873323976212, 0.10000000000000071, 80.0, 381, 973321, 1244, 17.48783100000219
1245, 4.779119759041205, 43.005370426733826, 51.696725615057524, 0.09999999999999788, 290.0, 1201, 974522, 1245, 53.98967249999987
1246, 5.583532695898926, 43.062616087791675, 51.76878131076628, 0.09999999999999809, 480.0, 1135, 975657, 1246, 51.66413210000246
1247, 6.586419815628524, 43.017829515737965, 51.74467390217243, 0.10000000000000091, 45.0, 523, 976180, 1247, 23.8258093000004
1248, 4.9897133777129286, 42.947820732274, 51.68987364621506, 0.10000000000000073, 55.0, 388, 976568, 1248, 17.49382979999791
1249, 4.773287841330595, 43.112454088495696, 51.77839830896013, 0.10000000000000028, 105.0, 717, 977285, 1249, 32.609907800000656
1250, 6.151918766135589, 43.05890615414351, 51.803316916441304, 0.09999999999999652, 575.0, 1950, 979235, 1250, 88.21314859999984
1251, 7.5393843956233315, 43.004704876294646, 51.67764342982837, 0.10000000000000071, 60.0, 383, 979618, 1251, 17.494443399999
1252, 4.436407173614244, 42.61436870678051, 51.21712074073585, 0.09999999999999894, 260.0, 925, 980543, 1252, 42.15446869999869
1253, 6.553610401630039, 42.13919131154347, 50.691717373926224, 0.1000000000000006, 20.0, 329, 980872, 1253, 15.038760999999795
1254, 3.2113556121925697, 42.255050570051246, 50.73788561479325, 0.10000000000000098, 95.0, 642, 981514, 1254, 29.034804000002623
1255, 5.355984282686599, 42.343345915225854, 50.92148076346682, 0.09999999999999776, 245.0, 1243, 982757, 1255, 56.84480110000004
1256, 6.310066170863158, 42.26524254323216, 50.88639564917668, 0.0999999999999978, 425.0, 1229, 983986, 1256, 58.13797909999994
1257, 8.065022502018481, 42.274665352857134, 50.90067556957574, 0.09999999999999715, 555.0, 1519, 985505, 1257, 69.53030470000158
1258, 4.52980695337541, 42.25614954703403, 50.74000712907531, 0.0999999999999984, 350.0, 1047, 986552, 1258, 48.243361599998025
1259, 4.501722321852867, 42.14501539245248, 50.604261454194784, 0.09999999999999849, 550.0, 1024, 987576, 1259, 46.92092290000073
1260, 6.935008459939406, 42.26853225577591, 50.81077668605707, 0.10000000000000084, 40.0, 468, 988044, 1260, 21.37560840000151
1261, 6.330556472297099, 42.28025299352837, 50.88576349476945, 0.10000000000000037, 175.0, 707, 988751, 1261, 32.51514759999918
1262, 6.663457015382774, 42.12248071927703, 50.71539116441534, 0.10000000000000032, 380.0, 712, 989463, 1262, 32.877416899998934
1263, 3.8172285900484595, 42.22376243864537, 50.74014085711855, 0.10000000000000021, 230.0, 726, 990189, 1263, 33.44421019999936
1264, 3.5214145300643787, 42.5850948878697, 51.10353294735863, 0.10000000000000091, 100.0, 525, 990714, 1264, 24.113508599999477
1265, 9.36135850722335, 42.65040224212961, 51.38641902490989, 0.10000000000000087, 30.0, 485, 991199, 1265, 22.759675799999968
1266, 4.620344091403845, 42.54237031336095, 51.14765491053199, 0.0999999999999997, 220.0, 794, 991993, 1266, 36.4440840999996
1267, 6.872666204416561, 42.5750186290216, 51.23407045416876, 0.09999999999999921, 280.0, 872, 992865, 1267, 40.30100499999753
1268, 3.02256807966978, 42.48746183837556, 51.01919196695294, 0.10000000000000019, 305.0, 729, 993594, 1268, 33.74996170000304
1269, 9.062228010629232, 42.651922378540036, 51.3281339439979, 0.1000000000000009, 205.0, 650, 994244, 1269, 30.69771319999927
1270, 7.420817577156676, 42.836329873785914, 51.62514664178871, 0.10000000000000075, 140.0, 664, 994908, 1270, 30.819702199998574
1271, 5.526675418166601, 42.522239518339255, 51.086021935406386, 0.09999999999999877, 245.0, 961, 995869, 1271, 44.56613769999967
1272, 4.503646292286596, 42.64534527949182, 51.26551303495188, 0.09999999999999791, 240.0, 1191, 997060, 1272, 55.41672430000108
1273, 9.111438446201443, 42.51184993713541, 51.15023731869159, 0.1000000000000007, 90.0, 377, 997437, 1273, 17.599532799998997
1274, 5.01893425975081, 42.438435682346714, 51.06486078623814, 0.10000000000000091, 105.0, 649, 998086, 1274, 30.372685700000147
1275, 7.686326985506865, 42.54282578454856, 51.17186781132787, 0.09999999999999981, 275.0, 779, 998865, 1275, 36.58889289999934
1276, 5.858521702037555, 42.53429907157874, 51.12480763990396, 0.10000000000000099, 80.0, 622, 999487, 1276, 29.014352399997733
