,loss,mae,mean_q,mean_eps,episode_reward,nb_episode_steps,nb_steps,episode,duration
0,0,0,0,0,65.0,539,539,0,1.0748353000000002
1, 0, 0, 0, 0, 55.0, 395, 934, 1, 0.7822089999999999
2, 0, 0, 0, 0, 200.0, 972, 1906, 2, 1.8856172999999998
3, 0, 0, 0, 0, 270.0, 984, 2890, 3, 2.151381500000001
4, 0, 0, 0, 0, 425.0, 1204, 4094, 4, 2.4581336
5, 0, 0, 0, 0, 55.0, 399, 4493, 5, 0.992033499999998
6, 0, 0, 0, 0, 90.0, 398, 4891, 6, 1.2291358999999993
7, 0, 0, 0, 0, 190.0, 673, 5564, 7, 1.8090270000000004
8, 0, 0, 0, 0, 40.0, 504, 6068, 8, 1.0777963000000028
9, 0, 0, 0, 0, 50.0, 556, 6624, 9, 1.2294152999999994
10, 0, 0, 0, 0, 135.0, 499, 7123, 10, 1.397317900000001
11, 0, 0, 0, 0, 155.0, 745, 7868, 11, 2.3944873000000015
12, 0, 0, 0, 0, 85.0, 601, 8469, 12, 1.397361
13, 0, 0, 0, 0, 50.0, 377, 8846, 13, 0.8523762000000019
14, 0, 0, 0, 0, 245.0, 935, 9781, 14, 1.9901845999999992
15, 0, 0, 0, 0, 265.0, 929, 10710, 15, 1.9005498000000003
16, 0, 0, 0, 0, 180.0, 616, 11326, 16, 1.3962938999999963
17, 0, 0, 0, 0, 450.0, 1023, 12349, 17, 2.220193100000003
18, 0, 0, 0, 0, 240.0, 1287, 13636, 18, 2.6694579999999988
19, 0, 0, 0, 0, 135.0, 606, 14242, 19, 1.6349985999999959
20, 0, 0, 0, 0, 180.0, 667, 14909, 20, 1.4962088999999992
21, 0, 0, 0, 0, 155.0, 656, 15565, 21, 1.401867799999998
22, 0, 0, 0, 0, 45.0, 404, 15969, 22, 0.9998584000000008
23, 0, 0, 0, 0, 155.0, 634, 16603, 23, 1.3978800000000007
24, 0, 0, 0, 0, 255.0, 853, 17456, 24, 1.887330200000001
25, 0, 0, 0, 0, 10.0, 509, 17965, 25, 1.340229800000003
26, 0, 0, 0, 0, 125.0, 645, 18610, 26, 1.7778187999999986
27, 0, 0, 0, 0, 285.0, 1477, 20087, 27, 3.2723020000000034
28, 0, 0, 0, 0, 90.0, 624, 20711, 28, 1.343822000000003
29, 0, 0, 0, 0, 95.0, 642, 21353, 29, 1.2313432000000049
30, 0, 0, 0, 0, 255.0, 1250, 22603, 30, 2.496311399999996
31, 0, 0, 0, 0, 120.0, 517, 23120, 31, 1.1936852000000044
32, 0, 0, 0, 0, 65.0, 405, 23525, 32, 0.8902113000000043
33, 0, 0, 0, 0, 55.0, 426, 23951, 33, 0.9033760000000015
34, 0, 0, 0, 0, 140.0, 1164, 25115, 34, 2.535451000000002
35, 0, 0, 0, 0, 515.0, 954, 26069, 35, 2.1599072000000064
36, 0, 0, 0, 0, 30.0, 510, 26579, 36, 1.0541164000000123
37, 0, 0, 0, 0, 175.0, 661, 27240, 37, 1.377551099999991
38, 0, 0, 0, 0, 75.0, 484, 27724, 38, 0.964258000000001
39, 0, 0, 0, 0, 395.0, 1111, 28835, 39, 2.1244765
40, 0, 0, 0, 0, 245.0, 1046, 29881, 40, 1.994135
41, 0, 0, 0, 0, 385.0, 798, 30679, 41, 1.5393056999999999
42, 0, 0, 0, 0, 20.0, 592, 31271, 42, 1.1507110000000011
43, 0, 0, 0, 0, 55.0, 510, 31781, 43, 0.9948346000000043
44, 0, 0, 0, 0, 45.0, 558, 32339, 44, 1.0863616999999977
45, 0, 0, 0, 0, 255.0, 739, 33078, 45, 1.4382764000000066
46, 0, 0, 0, 0, 110.0, 664, 33742, 46, 1.3641454999999922
47, 0, 0, 0, 0, 210.0, 783, 34525, 47, 1.5274004999999988
48, 0, 0, 0, 0, 135.0, 765, 35290, 48, 1.442710599999998
49, 0, 0, 0, 0, 125.0, 643, 35933, 49, 1.2020916999999969
50, 0, 0, 0, 0, 380.0, 718, 36651, 50, 1.3516546999999974
51, 0, 0, 0, 0, 185.0, 757, 37408, 51, 1.4439344000000034
52, 0, 0, 0, 0, 105.0, 631, 38039, 52, 1.209779900000001
53, 0, 0, 0, 0, 20.0, 532, 38571, 53, 1.0457146999999907
54, 0, 0, 0, 0, 195.0, 947, 39518, 54, 1.839735300000001
55, 0, 0, 0, 0, 160.0, 859, 40377, 55, 1.7206919999999997
56, 0, 0, 0, 0, 135.0, 641, 41018, 56, 1.2585134999999923
57, 0, 0, 0, 0, 85.0, 458, 41476, 57, 0.9017942999999917
58, 0, 0, 0, 0, 35.0, 430, 41906, 58, 0.8384862999999996
59, 0, 0, 0, 0, 170.0, 987, 42893, 59, 1.946735700000005
60, 0, 0, 0, 0, 120.0, 628, 43521, 60, 1.484388199999998
61, 0, 0, 0, 0, 135.0, 784, 44305, 61, 1.717535600000005
62, 0, 0, 0, 0, 620.0, 1411, 45716, 62, 2.784098300000011
63, 0, 0, 0, 0, 135.0, 514, 46230, 63, 1.1212445999999971
64, 0, 0, 0, 0, 75.0, 371, 46601, 64, 0.8378690999999918
65, 0, 0, 0, 0, 85.0, 417, 47018, 65, 0.8902621999999951
66, 0, 0, 0, 0, 45.0, 401, 47419, 66, 0.8298079000000058
67, 0, 0, 0, 0, 105.0, 680, 48099, 67, 1.4176252999999974
68, 0, 0, 0, 0, 225.0, 864, 48963, 68, 1.7830979000000013
69, 0, 0, 0, 0, 120.0, 499, 49462, 69, 1.0493732999999992
70, 0, 0, 0, 0, 105.0, 831, 50293, 70, 1.7914142000000055
71, 0, 0, 0, 0, 210.0, 1052, 51345, 71, 2.165228499999998
72, 0, 0, 0, 0, 275.0, 1047, 52392, 72, 2.1569598999999897
73, 0, 0, 0, 0, 185.0, 657, 53049, 73, 1.4111781999999948
74, 0, 0, 0, 0, 120.0, 536, 53585, 74, 1.1599587000000042
75, 0, 0, 0, 0, 60.0, 443, 54028, 75, 1.0230119999999943
76, 0, 0, 0, 0, 430.0, 895, 54923, 76, 1.9035345000000063
77, 0, 0, 0, 0, 50.0, 517, 55440, 77, 1.1241818999999822
78, 0, 0, 0, 0, 35.0, 487, 55927, 78, 1.026219900000001
79, 0, 0, 0, 0, 105.0, 711, 56638, 79, 1.4696705000000065
80, 0, 0, 0, 0, 90.0, 371, 57009, 80, 0.7798043999999891
81, 0, 0, 0, 0, 110.0, 513, 57522, 81, 1.097431400000005
82, 0, 0, 0, 0, 230.0, 1007, 58529, 82, 2.0877068000000065
83, 0, 0, 0, 0, 115.0, 687, 59216, 83, 1.409595199999984
84, 0, 0, 0, 0, 245.0, 877, 60093, 84, 1.825778200000002
85, 0, 0, 0, 0, 80.0, 512, 60605, 85, 1.1063722000000098
86, 0, 0, 0, 0, 215.0, 782, 61387, 86, 1.615052999999989
87, 0, 0, 0, 0, 75.0, 447, 61834, 87, 0.9323401999999987
88, 0, 0, 0, 0, 125.0, 536, 62370, 88, 1.0836284000000092
89, 0, 0, 0, 0, 330.0, 693, 63063, 89, 1.460575299999988
90, 0, 0, 0, 0, 180.0, 496, 63559, 90, 1.2250476000000106
91, 0, 0, 0, 0, 105.0, 549, 64108, 91, 1.1935973999999874
92, 0, 0, 0, 0, 45.0, 525, 64633, 92, 1.1459329999999852
93, 0, 0, 0, 0, 110.0, 619, 65252, 93, 1.3031312999999898
94, 0, 0, 0, 0, 30.0, 521, 65773, 94, 1.1495315000000232
95, 0, 0, 0, 0, 115.0, 442, 66215, 95, 0.9612666999999817
96, 0, 0, 0, 0, 240.0, 797, 67012, 96, 1.6534886000000029
97, 0, 0, 0, 0, 470.0, 1111, 68123, 97, 2.3075682999999856
98, 0, 0, 0, 0, 165.0, 786, 68909, 98, 1.7083537999999976
99, 0, 0, 0, 0, 95.0, 557, 69466, 99, 1.2004788000000133
100, 0, 0, 0, 0, 110.0, 599, 70065, 100, 1.2996268999999927
101, 0, 0, 0, 0, 45.0, 416, 70481, 101, 0.8551666999999838
102, 0, 0, 0, 0, 110.0, 508, 70989, 102, 1.1239980999999943
103, 0, 0, 0, 0, 120.0, 457, 71446, 103, 1.0755696999999884
104, 0, 0, 0, 0, 110.0, 508, 71954, 104, 1.0734621000000004
105, 0, 0, 0, 0, 135.0, 674, 72628, 105, 1.406180599999999
106, 0, 0, 0, 0, 10.0, 509, 73137, 106, 1.1837904999999864
107, 0, 0, 0, 0, 90.0, 481, 73618, 107, 1.0420672000000195
108, 0, 0, 0, 0, 185.0, 703, 74321, 108, 1.4367845999999815
109, 0, 0, 0, 0, 600.0, 1415, 75736, 109, 2.6809007000000236
110, 0, 0, 0, 0, 70.0, 522, 76258, 110, 1.115844100000004
111, 0, 0, 0, 0, 120.0, 716, 76974, 111, 1.4849443999999892
112, 0, 0, 0, 0, 195.0, 739, 77713, 112, 1.5541780000000074
113, 0, 0, 0, 0, 220.0, 821, 78534, 113, 1.7384437000000048
114, 0, 0, 0, 0, 150.0, 690, 79224, 114, 1.467165300000005
115, 0, 0, 0, 0, 340.0, 806, 80030, 115, 1.6880287999999837
116, 0, 0, 0, 0, 180.0, 661, 80691, 116, 1.4268861000000186
117, 0, 0, 0, 0, 45.0, 474, 81165, 117, 1.1047097999999949
118, 0, 0, 0, 0, 85.0, 658, 81823, 118, 1.3739064000000099
119, 0, 0, 0, 0, 15.0, 392, 82215, 119, 0.8863644999999849
120, 0, 0, 0, 0, 110.0, 558, 82773, 120, 1.165448199999986
121, 0, 0, 0, 0, 355.0, 981, 83754, 121, 2.0194569999999885
122, 0, 0, 0, 0, 150.0, 760, 84514, 122, 1.6245797999999922
123, 0, 0, 0, 0, 125.0, 395, 84909, 123, 0.8317734999999971
124, 0, 0, 0, 0, 210.0, 1051, 85960, 124, 2.194317799999993
125, 0, 0, 0, 0, 65.0, 556, 86516, 125, 1.1916633999999817
126, 0, 0, 0, 0, 240.0, 853, 87369, 126, 1.7940483000000143
127, 0, 0, 0, 0, 100.0, 556, 87925, 127, 1.180890699999992
128, 0, 0, 0, 0, 80.0, 492, 88417, 128, 1.0488038999999958
129, 0, 0, 0, 0, 340.0, 978, 89395, 129, 2.057258200000007
130, 0, 0, 0, 0, 60.0, 417, 89812, 130, 1.602022500000004
131, 0, 0, 0, 0, 115.0, 523, 90335, 131, 1.3045696000000078
132, 0, 0, 0, 0, 150.0, 745, 91080, 132, 1.6507715999999846
133, 0, 0, 0, 0, 105.0, 451, 91531, 133, 1.228272099999998
134, 0, 0, 0, 0, 15.0, 631, 92162, 134, 1.466196999999994
135, 0, 0, 0, 0, 135.0, 468, 92630, 135, 0.9889273000000003
136, 0, 0, 0, 0, 95.0, 557, 93187, 136, 1.116985700000015
137, 0, 0, 0, 0, 80.0, 491, 93678, 137, 1.031095300000004
138, 0, 0, 0, 0, 110.0, 692, 94370, 138, 1.4322411999999929
139, 0, 0, 0, 0, 155.0, 537, 94907, 139, 1.0834502999999813
140, 0, 0, 0, 0, 40.0, 391, 95298, 140, 0.7685466000000076
141, 0, 0, 0, 0, 40.0, 367, 95665, 141, 0.8393085999999812
142, 0, 0, 0, 0, 160.0, 727, 96392, 142, 2.0650004999999965
143, 0, 0, 0, 0, 260.0, 820, 97212, 143, 1.68824189999998
144, 0, 0, 0, 0, 365.0, 1097, 98309, 144, 2.207657100000006
145, 0, 0, 0, 0, 110.0, 635, 98944, 145, 1.3566797999999949
146, 0, 0, 0, 0, 225.0, 937, 99881, 146, 1.8688116999999806
147, 47.366090844608976, 36.13328166674542, 47.31691095905919, 0.8194969000000001, 105.0, 678, 100559, 147, 5.522299299999986
148, 26.298820377422075, 35.98764180562582, 44.76359078149582, 0.8184717999999996, 35.0, 581, 101140, 148, 5.105642900000021
149, 21.611209774337716, 35.94125215844371, 44.41228354391032, 0.8171451999999997, 235.0, 893, 102033, 149, 8.428729599999997
150, 20.235251008806376, 35.991557813901245, 44.386275815647956, 0.8159337999999998, 55.0, 453, 102486, 150, 4.376010300000019
151, 20.43901702734801, 35.95951543412767, 44.294756640185106, 0.8151265000000003, 40.0, 444, 102930, 151, 4.046130100000028
152, 24.39487127501231, 36.02014530163545, 44.44514805537004, 0.8143524999999999, 75.0, 416, 103346, 152, 3.798745600000018
153, 20.914814102685703, 35.902640103573525, 44.18887726129722, 0.8133823000000001, 180.0, 662, 104008, 153, 7.504801199999974
154, 17.685473805282548, 35.88659618611921, 43.92279917733711, 0.8121709000000004, 220.0, 684, 104692, 154, 6.541704799999991
155, 21.27005560892933, 36.04376257672318, 44.24953073989057, 0.8110305999999999, 80.0, 583, 105275, 155, 5.3932537000000025
156, 22.567825943676393, 36.06340326206282, 44.02501020639553, 0.8097219999999999, 175.0, 871, 106146, 156, 9.695313099999964
157, 19.319789042281577, 35.90605656899522, 43.65780714042948, 0.8082873999999998, 210.0, 723, 106869, 157, 7.941720499999974
158, 17.420818808950298, 36.004783081407304, 43.761818481092696, 0.8067799, 220.0, 952, 107821, 158, 9.52599379999998
159, 17.029615125638166, 35.99010410416598, 43.70270428415072, 0.8054452000000002, 60.0, 531, 108352, 159, 4.957168300000035
160, 16.375838002952225, 36.02020534791704, 43.65304911730991, 0.8040106000000001, 520.0, 1063, 109415, 160, 9.308461599999987
161, 18.611681256563433, 36.15863644692205, 43.89063020675413, 0.8026075000000003, 80.0, 496, 109911, 161, 4.329306400000007
162, 12.566768459308935, 37.179265924001015, 44.93827632800151, 0.8016984999999999, 45.0, 514, 110425, 162, 5.010077600000045
163, 10.086464846871563, 37.31579751083531, 45.20599614959402, 0.8008867000000001, 45.0, 388, 110813, 163, 3.6756160000000477
164, 7.346661424921597, 37.279253500939454, 45.0217977061981, 0.7997085999999995, 160.0, 921, 111734, 164, 8.438851699999987
165, 9.449912922621342, 37.25132186088471, 45.15459766251375, 0.7981255000000003, 190.0, 838, 112572, 165, 8.4345146
166, 8.138450172109511, 37.316259032314264, 45.074348783030096, 0.7969078000000003, 35.0, 515, 113087, 166, 5.408639599999958
167, 8.644728937944711, 37.243432144720884, 45.08104058522315, 0.7956783999999999, 380.0, 851, 113938, 167, 8.2890084
168, 9.530985369020607, 37.287995165168645, 45.093453397737214, 0.7942833999999996, 110.0, 699, 114637, 168, 6.887158499999998
169, 8.743040384942747, 37.24657258067043, 45.072488655544646, 0.7927776999999999, 315.0, 974, 115611, 169, 9.598752899999965
170, 9.86294790312358, 37.31283288211881, 45.15340579373566, 0.7910218000000001, 230.0, 977, 116588, 170, 9.729740899999967
171, 5.961708600145011, 37.37007323900858, 45.095454136530556, 0.7895377000000001, 195.0, 672, 117260, 171, 6.925316299999963
172, 10.060202020454406, 37.32180678100586, 45.203318127441406, 0.7883704000000005, 120.0, 625, 117885, 172, 6.1874361000000135
173, 9.063545502853394, 37.386771548461915, 45.236859033203125, 0.7872453999999999, 105.0, 625, 118510, 173, 6.382617500000038
174, 8.374953007472426, 37.33031603214493, 45.10921802781483, 0.7858269999999993, 225.0, 951, 119461, 174, 10.698460899999986
175, 6.896065893816844, 37.38375915394466, 45.07846057709139, 0.7843509999999999, 105.0, 689, 120150, 175, 7.146723000000009
176, 9.75085330046084, 37.20464239984796, 45.04106752480596, 0.7831449999999996, 195.0, 651, 120801, 176, 6.542096700000002
177, 7.3016110033925505, 37.17826824910565, 44.996554524041976, 0.7816798, 295.0, 977, 121778, 177, 10.104432400000007
178, 6.4868022212832, 37.27967656653697, 45.12065001960814, 0.7802289999999998, 160.0, 635, 122413, 178, 6.79880019999996
179, 6.656869901208769, 37.1417828068402, 44.930015810471936, 0.7791003999999998, 155.0, 619, 123032, 179, 7.105928199999994
180, 8.415992410197807, 37.13508422946633, 44.9990640860109, 0.7779655, 100.0, 642, 123674, 180, 7.57416969999997
181, 7.483674259390682, 37.1505673378706, 44.85499070584774, 0.7769269000000001, 55.0, 512, 124186, 181, 5.946275300000025
182, 7.966994189473584, 37.10547109073696, 44.97144516061609, 0.7756858000000003, 150.0, 867, 125053, 182, 9.466088500000012
183, 5.926394807037554, 37.00468672702187, 44.69432989421644, 0.7745635000000001, 30.0, 380, 125433, 183, 4.293763200000001
184, 10.242044281627038, 37.128367448263816, 44.94726766221733, 0.7731244000000002, 305.0, 1219, 126652, 184, 12.806358799999998
185, 7.047900949673409, 37.087244069531614, 44.916898720273366, 0.7713064000000006, 190.0, 801, 127453, 185, 8.850908300000015
186, 6.225170865496084, 37.138911127281595, 44.91398496973489, 0.7701634000000002, 60.0, 469, 127922, 186, 5.423042400000043
187, 10.017065774527463, 37.08980244029652, 44.890590424971144, 0.7692462999999997, 105.0, 550, 128472, 187, 5.955023799999992
188, 8.440887272705153, 37.10560613835899, 44.95506268843864, 0.7682878000000001, 75.0, 515, 128987, 188, 5.599210699999958
189, 8.143236445941808, 37.004731294128796, 44.77051627972374, 0.7670908000000003, 435.0, 815, 129802, 189, 8.561311199999977
190, 9.382742780370698, 37.064446081647155, 44.8024225628393, 0.7657246000000003, 155.0, 703, 130505, 190, 7.348236799999995
191, 9.196987421889053, 37.237177905283474, 45.06014188967253, 0.7645447000000003, 80.0, 608, 131113, 191, 7.529653100000019
192, 8.775738397298596, 37.092278663065194, 44.80720956933169, 0.7631181999999995, 260.0, 977, 132090, 192, 11.867946699999948
193, 6.669224146345048, 37.18125580258533, 44.86266569771275, 0.7616890000000004, 105.0, 611, 132701, 193, 6.8153806999999915
194, 10.496057941589827, 37.11992118270309, 44.82746752044301, 0.7604100999999994, 185.0, 810, 133511, 194, 8.964201099999968
195, 7.122996430262885, 37.21691357937006, 44.91191499129586, 0.7593291999999999, 75.0, 391, 133902, 195, 4.142679199999975
196, 8.298033339427967, 37.207239038804, 44.89075872944851, 0.7586101000000002, 60.0, 408, 134310, 196, 4.576801499999988
197, 7.883549343731444, 37.02765972331419, 44.81487602298542, 0.7578180999999997, 125.0, 472, 134782, 197, 5.212980099999982
198, 9.913319769900728, 37.19895134386309, 44.936076354060155, 0.7566472000000003, 180.0, 829, 135611, 198, 9.33451500000001
199, 9.473776962010914, 37.28630767705786, 45.01212084238766, 0.7553115999999997, 110.0, 655, 136266, 199, 7.102870800000005
200, 8.679095049211584, 37.129761063979444, 44.82931264046511, 0.7541353, 105.0, 652, 136918, 200, 7.106855199999927
201, 8.448785719631603, 37.215090841617226, 44.91102661516681, 0.7528329999999999, 135.0, 795, 137713, 201, 8.342303099999981
202, 8.934635240233474, 37.253560178845575, 44.983455343856065, 0.7512868000000005, 210.0, 923, 138636, 202, 10.031314800000018
203, 6.826892938287485, 37.17235958008539, 44.832343442099436, 0.7498512999999998, 105.0, 672, 139308, 203, 7.1045394000000215
204, 7.111513872894805, 37.325526029778864, 45.04495783321193, 0.7488622000000001, 50.0, 427, 139735, 204, 4.517763399999922
205, 5.742740785194665, 37.5409136239053, 45.274334499463706, 0.7477227999999999, 140.0, 839, 140574, 205, 8.870170299999927
206, 7.86759861186931, 37.779474539505806, 45.62176174364592, 0.7461126999999997, 195.0, 950, 141524, 206, 9.934273699999949
207, 8.163978433183262, 37.85073978969029, 45.71367318289621, 0.7446277000000001, 110.0, 700, 142224, 207, 7.606482600000049
208, 6.320535231932812, 37.83988822760217, 45.69526767560718, 0.7434928000000002, 110.0, 561, 142785, 208, 6.3615312999999105
209, 6.314032623573901, 37.839836854783314, 45.627802409822976, 0.7425342999999998, 110.0, 504, 143289, 209, 5.774795799999993
210, 6.371345220280416, 37.697599387891366, 45.47038599072081, 0.7414867, 130.0, 660, 143949, 210, 7.32019600000001
211, 4.962798789574785, 37.838282189568524, 45.57052942257602, 0.7403329000000002, 105.0, 622, 144571, 211, 6.62869180000007
212, 6.441946326665973, 37.83247885384335, 45.678234541127075, 0.7391422000000004, 140.0, 701, 145272, 212, 7.501265500000045
213, 6.858428275322213, 37.85988810483147, 45.66828913548414, 0.7375321000000001, 300.0, 1088, 146360, 213, 11.944833499999959
214, 7.063893651197615, 37.768170168525295, 45.52438255987669, 0.7360057, 60.0, 608, 146968, 214, 6.688379399999917
215, 7.028449518124263, 37.79847679138184, 45.59981037902832, 0.7347835000000005, 105.0, 750, 147718, 215, 9.04392509999991
216, 6.743211474836521, 37.78768995533819, 45.60107127998186, 0.7334461000000002, 110.0, 736, 148454, 216, 8.535760600000003
217, 8.180703043086188, 37.951639011928016, 45.73130771092006, 0.7324056999999998, 75.0, 420, 148874, 217, 4.742593399999919
218, 6.682319576858629, 37.88447248851154, 45.69497131996967, 0.7313931999999999, 110.0, 705, 149579, 218, 7.50311350000004
219, 5.436134249520707, 37.9946300787561, 45.797468995912894, 0.7301232999999999, 110.0, 706, 150285, 219, 7.583536900000013
220, 4.839565452712272, 38.09103120379436, 45.866325446711784, 0.729136, 125.0, 391, 150676, 220, 4.1368334
221, 7.376627071423106, 38.27458101027083, 46.25026204326365, 0.7283295999999997, 105.0, 505, 151181, 221, 5.378508000000011
222, 4.927976821230937, 38.392059543464754, 46.321345552613465, 0.7273063000000001, 155.0, 632, 151813, 222, 6.705771999999911
223, 7.311757412795804, 38.23591273635534, 46.16733541970898, 0.7258654000000003, 285.0, 969, 152782, 223, 9.917097900000044
224, 5.110861900944432, 38.21557864360109, 46.06189152282978, 0.7241598999999994, 225.0, 926, 153708, 224, 9.333281300000067
225, 5.734590116836783, 38.27350335187077, 46.158118067798526, 0.7225453, 410.0, 868, 154576, 225, 8.982539999999972
226, 7.895314855572412, 38.30858063792301, 46.27639072574429, 0.7210827999999999, 185.0, 757, 155333, 226, 8.228648499999963
227, 5.973438870946303, 38.26159967081436, 46.16842931280073, 0.7197220000000001, 110.0, 755, 156088, 227, 8.464767800000004
228, 6.305129266915054, 38.16507398505737, 46.04031596377463, 0.7185771999999995, 105.0, 517, 156605, 228, 5.803411299999993
229, 4.6730411428564445, 38.28868888064129, 46.13195641060186, 0.7172263000000003, 180.0, 984, 157589, 229, 11.029381100000023
230, 4.507283130782334, 38.34541616966976, 46.281508824334075, 0.7159825, 30.0, 398, 157987, 230, 4.3882294
231, 5.897998014181174, 38.20758233011917, 46.00884052416907, 0.7151104000000003, 135.0, 571, 158558, 231, 6.43904550000002
232, 5.644793227276245, 38.38025817871094, 46.274368935126766, 0.7139035000000002, 160.0, 770, 159328, 232, 8.739645699999983
233, 5.624938871549523, 38.35968011199033, 46.29410099425045, 0.7126723, 105.0, 598, 159926, 233, 6.843301500000052
234, 6.342332461021368, 38.60568576897806, 46.52850055203839, 0.7116093999999997, 60.0, 583, 160509, 234, 7.244984100000011
235, 3.768989695025867, 38.56086038103879, 46.45428095339477, 0.7107418000000001, 45.0, 381, 160890, 235, 5.4001625999999305
236, 7.8777997739110255, 38.67525952110993, 46.701977960317414, 0.7096653999999997, 160.0, 815, 161705, 236, 9.59238629999993
237, 5.548457950781035, 38.73150896870639, 46.667048711664826, 0.7082416000000002, 160.0, 767, 162472, 237, 9.225731400000086
238, 5.530161581770347, 38.700523487842865, 46.681207280959526, 0.7069348000000001, 110.0, 685, 163157, 238, 8.176385299999993
239, 3.5052356058118703, 38.59162216024541, 46.49607419866412, 0.7058943999999995, 45.0, 471, 163628, 239, 5.631906200000003
240, 4.959895820852643, 38.58437230167517, 46.53000749617749, 0.7046622999999997, 270.0, 898, 164526, 240, 10.331587000000013
241, 7.1849259747027325, 38.671021710719195, 46.67398433808889, 0.7034374000000001, 55.0, 463, 164989, 241, 5.285408699999948
242, 5.134365820369602, 38.60181515540606, 46.583600446912975, 0.7026562, 85.0, 405, 165394, 242, 4.9304621
243, 3.6318716449451323, 38.54094492399525, 46.37421971171295, 0.7015869999999998, 180.0, 783, 166177, 243, 9.992224399999941
244, 6.447604311364038, 38.545007342383975, 46.525633070203995, 0.7003152999999998, 130.0, 630, 166807, 244, 7.512223899999981
245, 6.66757517956622, 38.651108951891885, 46.66958922046726, 0.6991641999999999, 120.0, 649, 167456, 245, 7.8301872000000685
246, 5.7964570085933405, 38.66879771216638, 46.662029608925366, 0.6979888, 105.0, 657, 168113, 246, 8.096043699999996
247, 4.552009640759427, 38.62556962895825, 46.5548403113287, 0.6965524, 185.0, 939, 169052, 247, 11.12894700000004
248, 4.176796120116787, 38.42944561866022, 46.312896383962325, 0.6943123000000002, 460.0, 1550, 170602, 248, 18.838004400000045
249, 3.060626506332367, 38.2493998901644, 46.05660408694728, 0.6925203999999999, 105.0, 441, 171043, 249, 5.3030577999999196
250, 4.557371810958499, 38.283668576195126, 46.13649446759905, 0.691651, 105.0, 525, 171568, 250, 6.71323289999998
251, 3.3617358005978364, 38.285696200861224, 46.112702934643785, 0.6903261999999996, 210.0, 947, 172515, 251, 11.851729500000033
252, 6.691419900305981, 38.285209245027154, 46.23789663301984, 0.6888052, 105.0, 743, 173258, 252, 9.220110399999953
253, 7.971392718362219, 38.343582313443406, 46.344407399495445, 0.6874074999999997, 180.0, 810, 174068, 253, 10.00371610000002
254, 3.612647388643081, 38.29922126630031, 46.11922191479884, 0.6862860999999996, 80.0, 436, 174504, 254, 5.166215199999897
255, 5.327279359194517, 38.406842120537696, 46.30984754139179, 0.6850215999999998, 185.0, 969, 175473, 255, 11.642192499999965
256, 4.089656054834825, 38.283408266007555, 46.14622594369305, 0.6833764, 210.0, 859, 176332, 256, 10.602940499999931
257, 6.599882577304487, 38.39243467764002, 46.33091507326578, 0.6820443999999997, 135.0, 621, 176953, 257, 8.429910699999937
258, 4.3127057188625875, 38.217893702038644, 46.023405165361936, 0.6808770999999999, 300.0, 676, 177629, 258, 8.363286799999969
259, 9.031197405723775, 38.400250566782745, 46.34909713211423, 0.6797025999999999, 120.0, 629, 178258, 259, 7.685110899999927
260, 6.33910390580142, 38.31388258404202, 46.22836978700426, 0.6781645000000005, 260.0, 1080, 179338, 260, 13.471902799999953
261, 5.459839222359335, 38.24019163912953, 46.12557835596514, 0.6764607999999996, 225.0, 813, 180151, 261, 10.510816499999919
262, 5.421677052847775, 38.150748748389375, 46.00299951855531, 0.6746724999999999, 155.0, 1174, 181325, 262, 14.006952100000035
263, 3.1235934267780796, 38.03519937858818, 45.772999177067916, 0.6730363000000001, 110.0, 644, 181969, 263, 9.044286800000009
264, 4.354578992333568, 38.04668565343638, 45.872153022641044, 0.6719077000000001, 105.0, 610, 182579, 264, 7.791862100000117
265, 4.642226571475502, 38.03051258600293, 45.83744284557227, 0.6704955999999993, 220.0, 959, 183538, 265, 12.274903100000074
266, 3.882028407398486, 37.99441895282242, 45.81515169250352, 0.6688279000000001, 210.0, 894, 184432, 266, 11.095957400000088
267, 4.660341437825237, 38.0283321104854, 45.880222793946785, 0.6672763000000005, 65.0, 830, 185262, 267, 10.01460659999998
268, 4.939120403434857, 38.02495180842388, 45.89745481330228, 0.6659317000000001, 125.0, 664, 185926, 268, 8.320739300000014
269, 4.4337799382160314, 38.10350756823274, 45.9497270623678, 0.6649002999999999, 85.0, 482, 186408, 269, 6.628943200000094
270, 4.405262851624319, 37.9658134189354, 45.740728997942156, 0.6641119, 75.0, 394, 186802, 270, 5.543869399999949
271, 6.531552445645942, 38.03836750651515, 45.899426606644035, 0.6629833, 210.0, 860, 187662, 271, 11.337766500000043
272, 3.127592254160107, 38.01815983869027, 45.76426534238069, 0.6615883000000001, 195.0, 690, 188352, 272, 8.878425600000128
273, 7.147771701194752, 38.05474939472721, 45.9607907774171, 0.6603562000000002, 180.0, 679, 189031, 273, 8.958101599999964
274, 5.253118426374155, 37.975239163628146, 45.800173149166596, 0.6591502, 120.0, 661, 189692, 274, 8.600467900000012
275, 6.340526671674198, 38.332015868945, 46.225847109770164, 0.6579936999999999, 150.0, 624, 190316, 275, 8.309367600000087
276, 5.921274936536918, 38.53392572096259, 46.50468040571461, 0.6568443999999998, 215.0, 653, 190969, 276, 8.939051899999868
277, 4.698754323163852, 38.647701771438264, 46.61800080638821, 0.6558849999999999, 80.0, 413, 191382, 277, 5.353956500000095
278, 4.576599043376165, 38.50730990168445, 46.41451780180584, 0.6547951000000002, 165.0, 798, 192180, 278, 10.757737099999986
279, 9.106080744574243, 38.490752619310726, 46.63460045530085, 0.6537177999999999, 20.0, 399, 192579, 279, 5.227140599999984
280, 4.8435203620866565, 38.50707523050317, 46.40277243862633, 0.6523947999999999, 485.0, 1071, 193650, 280, 13.939350800000057
281, 5.33739949689996, 38.39990517370085, 46.29002750368046, 0.6507127, 160.0, 798, 194448, 281, 10.332890500000076
282, 4.90673936928591, 38.44590886791101, 46.367663860321045, 0.6493537000000001, 140.0, 712, 195160, 282, 9.77589520000015
283, 3.0337942749141686, 38.38196902121267, 46.24193931395008, 0.6482664999999997, 60.0, 496, 195656, 283, 7.300430900000038
284, 2.9985679477571026, 38.50140562547526, 46.33898312866452, 0.6473646999999999, 50.0, 506, 196162, 284, 6.872142599999961
285, 4.114027702569364, 38.510050919420436, 46.45659770344134, 0.6461911000000001, 165.0, 798, 196960, 285, 10.96259659999987
286, 5.1372334596915445, 38.55043854042773, 46.528638659894376, 0.6448906000000001, 80.0, 647, 197607, 286, 8.731383599999845
287, 6.442034857271581, 38.535140047267994, 46.52934060777937, 0.6439555, 65.0, 392, 197999, 287, 5.307804499999975
288, 3.717219441162695, 38.52157074365861, 46.45324460197897, 0.6430059999999999, 110.0, 663, 198662, 288, 8.771624900000006
289, 3.8714246608537577, 38.50602902949109, 46.40018467708098, 0.6411331000000002, 620.0, 1418, 200080, 289, 19.06171089999998
290, 8.225439370392714, 38.45169295101124, 46.4562259915088, 0.6394438, 40.0, 459, 200539, 290, 6.105819599999904
291, 3.4445287539993314, 38.380470745315044, 46.297681821159145, 0.6382189, 440.0, 902, 201441, 291, 12.593878399999994
292, 4.70745600221774, 38.491164251157855, 46.385032340201406, 0.6367392999999999, 110.0, 742, 202183, 292, 9.957795000000033
293, 6.761238257479824, 38.479796023150676, 46.44870579788108, 0.6355206999999998, 120.0, 612, 202795, 293, 8.161359299999958
294, 4.177378164859593, 38.49662914372943, 46.444866703246454, 0.6346153000000001, 25.0, 394, 203189, 294, 5.493482300000096
295, 4.183632497965675, 38.48162677017684, 46.38202588189508, 0.6333877000000004, 250.0, 970, 204159, 295, 13.449773800000003
296, 4.489135605948312, 38.41417168309449, 46.31101157173278, 0.6321745, 135.0, 378, 204537, 296, 4.970365299999912
297, 6.171238833863013, 38.432538738687526, 46.45801840241022, 0.6314806, 115.0, 393, 204930, 297, 5.889353799999981
298, 3.6742297402904396, 38.38537619406717, 46.30879154539945, 0.6305113, 105.0, 684, 205614, 298, 11.067781299999979
299, 2.832479083645325, 38.38466761295038, 46.234873131407255, 0.6293206, 45.0, 639, 206253, 299, 9.090500600000041
300, 4.571010362859858, 38.38209597851646, 46.289638087187534, 0.6279589000000004, 215.0, 874, 207127, 300, 11.787360999999919
301, 4.6662803789302805, 38.408964596117116, 46.25317080216228, 0.6264802000000002, 170.0, 769, 207896, 301, 11.123027300000103
302, 4.7610164721456405, 38.440422637330975, 46.378941132247085, 0.6252013000000002, 115.0, 652, 208548, 302, 9.687359900000047
303, 3.889302481492197, 38.37565019918895, 46.209906333431455, 0.6239584000000002, 120.0, 729, 209277, 303, 10.175172799999928
304, 2.8939411903228187, 38.45455096223208, 46.347707316327636, 0.6227461, 105.0, 618, 209895, 304, 8.489887400000043
305, 3.9958568832660646, 38.418478124738954, 46.32664804400349, 0.621748, 30.0, 491, 210386, 305, 6.98120310000013
306, 3.8530032736835658, 38.31765879272784, 46.1981322929342, 0.6206257000000001, 440.0, 756, 211142, 306, 10.835019800000055
307, 4.850638213053346, 38.32176090621948, 46.23019687652588, 0.6190453000000002, 260.0, 1000, 212142, 307, 14.500522000000046
308, 2.7203576179879003, 38.2951072160851, 46.158984849290256, 0.6175386999999999, 100.0, 674, 212816, 308, 10.128350699999828
309, 7.072596720676431, 38.35666067016837, 46.371980707539755, 0.616465, 125.0, 519, 213335, 309, 7.432777400000077
310, 6.200278392585738, 38.35529934469202, 46.35807397596787, 0.6154318000000001, 175.0, 629, 213964, 310, 8.990417100000059
311, 3.890812447276509, 38.314794081160166, 46.15846126519361, 0.6139387000000003, 290.0, 1030, 214994, 311, 14.949064099999987
312, 3.9065944879111276, 38.29552641105305, 46.14024944270804, 0.6125157999999999, 155.0, 551, 215545, 312, 8.088542400000051
313, 5.365380869958571, 38.30245686130782, 46.18899795856882, 0.6115545999999998, 65.0, 517, 216062, 313, 7.544370600000093
314, 4.894501928357977, 38.40758340887, 46.39427903724304, 0.6103215999999998, 165.0, 853, 216915, 314, 12.358024000000114
315, 2.804488640030225, 38.398869988226124, 46.284671799854564, 0.6091353999999998, 45.0, 465, 217380, 315, 6.934383900000057
316, 2.5893667018707887, 38.396238972228254, 46.23866898336528, 0.6083523999999999, 90.0, 405, 217785, 316, 6.189525400000093
317, 2.481730868675045, 38.333746988748764, 46.189164702425295, 0.6076386999999999, 80.0, 388, 218173, 317, 5.644716199999948
318, 3.939919094018417, 38.41359478789981, 46.303373914661975, 0.606835, 30.0, 505, 218678, 318, 7.332902500000046
319, 3.6277016262596997, 38.35559592012083, 46.1998093779014, 0.6057046, 105.0, 751, 219429, 319, 11.350345800000014
320, 5.242865003663704, 39.12393957500809, 47.297459060575335, 0.6042952000000001, 210.0, 815, 220244, 320, 12.80034240000009
321, 9.01365536885798, 40.64472953620774, 49.24416033264316, 0.6032097999999999, 60.0, 391, 220635, 321, 5.933607799999891
322, 12.396286905572122, 40.875894653553864, 49.47778480880115, 0.6025051, 20.0, 392, 221027, 322, 5.968639400000029
323, 4.082124504038525, 40.68190413925248, 49.112550648335876, 0.6017976999999999, 110.0, 394, 221421, 323, 6.12830380000014
324, 6.683120492345108, 40.735756493918174, 49.19546289378798, 0.6006528999999998, 245.0, 878, 222299, 324, 13.10330789999989
325, 5.897204648383063, 40.71229343500612, 49.13802512414855, 0.5990671000000002, 300.0, 884, 223183, 325, 13.391228100000035
326, 4.997382151201335, 40.701548226743355, 49.08895351881578, 0.5974416999999996, 240.0, 922, 224105, 326, 14.623016100000086
327, 7.255622958002309, 40.67733761635248, 49.226874955645854, 0.5960422000000001, 65.0, 633, 224738, 327, 9.46027950000007
328, 5.840896469435682, 40.66614350514432, 49.03164263449952, 0.5950422999999998, 100.0, 478, 225216, 328, 7.061892100000023
329, 7.376700397361727, 40.622279805295605, 49.063302250469434, 0.5941225000000001, 80.0, 544, 225760, 329, 8.450558499999943
330, 6.545799159081209, 40.56837442488897, 49.196966053190685, 0.5932549, 75.0, 420, 226180, 330, 6.27690419999999
331, 6.30837117069266, 40.727297105310996, 49.10348748213408, 0.5919255999999996, 325.0, 1057, 227237, 331, 15.579688900000065
332, 5.317111524656547, 40.62628581898856, 48.93003215280414, 0.5903677, 160.0, 674, 227911, 332, 10.461315100000093
333, 4.675652183250067, 40.60619433103096, 49.012194737949976, 0.5892516999999997, 125.0, 566, 228477, 333, 9.266428399999995
334, 4.240390784509489, 40.558832694190215, 48.87065705667764, 0.5879943999999998, 125.0, 831, 229308, 334, 12.958145800000011
335, 7.1189912223731575, 40.66420319845091, 49.120920802062415, 0.5864832999999997, 210.0, 848, 230156, 335, 13.233368100000007
336, 8.422653428056421, 41.39917000197363, 49.934712357408415, 0.5853772, 50.0, 381, 230537, 336, 5.774926900000082
337, 6.258684121463822, 41.33864737072905, 49.89803936234582, 0.5838696999999997, 620.0, 1294, 231831, 337, 20.37547910000012
338, 5.806512115052315, 41.310661296395466, 49.78608869945015, 0.5818258000000002, 210.0, 977, 232808, 338, 15.885787400000027
339, 7.442882001900491, 41.492895234086134, 50.11567219741472, 0.5803570000000002, 90.0, 655, 233463, 339, 10.527993100000003
340, 4.429136973922141, 41.28165875375271, 49.76336321234703, 0.5793066999999998, 30.0, 512, 233975, 340, 7.960255099999813
341, 6.214938236911989, 41.50889291911545, 50.05401374639007, 0.5781510999999998, 210.0, 772, 234747, 341, 11.881310900000017
342, 6.975612517886481, 41.28474901256528, 49.82941140741688, 0.5764357000000001, 335.0, 1134, 235881, 342, 17.9046386
343, 7.008323991566561, 41.26798938365465, 49.79199633651905, 0.5750145999999999, 35.0, 445, 236326, 343, 7.622566600000027
344, 6.2236741451362585, 41.432638586303334, 50.02402066595761, 0.5734477, 430.0, 1296, 237622, 344, 20.471867599999996
345, 5.516068258784443, 41.47459842819293, 50.04221705179885, 0.5717566, 70.0, 583, 238205, 345, 9.331203300000197
346, 4.229308989987696, 41.40490005220144, 49.923902560891975, 0.5707792, 45.0, 503, 238708, 346, 8.100826999999981
347, 3.6787215822560775, 41.285756926605664, 49.76788132893291, 0.5699539, 50.0, 414, 239122, 347, 6.6585666999999376
348, 4.192209136703156, 41.39611774722472, 49.90890872610063, 0.5687659, 200.0, 906, 240028, 348, 14.101124099999879
349, 6.542614610410625, 42.42320251464844, 51.18003428058122, 0.5669595999999998, 555.0, 1101, 241129, 349, 17.60945229999993
350, 7.462580190563579, 42.42732913638797, 51.21828862796673, 0.5652864999999998, 165.0, 758, 241887, 350, 11.487281300000177
351, 5.432287298171732, 42.3999309429117, 51.14096436417541, 0.5636736999999996, 375.0, 1034, 242921, 351, 15.23820139999998
352, 7.759428413328444, 42.313917947645805, 51.01489078781103, 0.5622004000000002, 90.0, 603, 243524, 352, 9.274362500000052
353, 4.281663987580456, 42.43048635045758, 51.06201454420073, 0.5611509999999997, 30.0, 563, 244087, 353, 8.764976899999965
354, 7.44006132545371, 42.45119293363781, 51.25227156970351, 0.5599161999999998, 360.0, 809, 244896, 354, 13.150569399999995
355, 6.657803546457194, 42.4434320192604, 51.16556299612419, 0.5588344000000001, 30.0, 393, 245289, 355, 6.45035619999976
356, 6.92609271381137, 42.37667037165442, 51.13064336222271, 0.5578615000000002, 150.0, 688, 245977, 356, 11.481123000000025
357, 5.328530071939164, 42.51754739959939, 51.24758635421642, 0.5564989000000001, 305.0, 826, 246803, 357, 12.809679100000267
358, 5.153569741730104, 42.38009158351965, 51.154010259617145, 0.5554476999999999, 50.0, 342, 247145, 358, 5.618213700000069
359, 5.311751647283338, 42.34671415944394, 50.971329184909706, 0.5543532999999998, 165.0, 874, 248019, 359, 14.706700299999738
360, 4.08658131289838, 42.347500001952085, 51.07892602135632, 0.5531446000000001, 120.0, 469, 248488, 360, 7.962323999999626
361, 6.714874752864543, 42.336956884959854, 51.04803935817031, 0.5517892, 315.0, 1037, 249525, 361, 18.029276799999934
362, 6.11412262992795, 42.43527587816283, 51.211244204448, 0.5501169999999999, 215.0, 821, 250346, 362, 14.126829899999848
363, 6.863530614790326, 42.554984679724505, 51.34460733381966, 0.5488911999999999, 140.0, 541, 250887, 363, 9.702189999999973
364, 6.427700897631822, 42.60054198088469, 51.3808720002351, 0.5477968000000001, 195.0, 675, 251562, 364, 11.53028170000016
365, 6.287067552074427, 42.57625095437213, 51.318686874901374, 0.5465989000000003, 160.0, 656, 252218, 365, 11.862897500000145
366, 7.479083641303911, 42.704323094685876, 51.497393442789715, 0.5456035, 45.0, 450, 252668, 366, 6.670683400000144
367, 4.594285053386503, 42.53406206766764, 51.19658015908935, 0.5443398999999999, 200.0, 954, 253622, 367, 14.262903599999845
368, 6.695804654389192, 42.558726786588004, 51.298178655166154, 0.5430429999999999, 35.0, 487, 254109, 368, 9.502193499999976
369, 4.406950012753695, 42.6365694534181, 51.358616479154, 0.5422636, 30.0, 379, 254488, 369, 6.81124170000021
370, 5.2165176790397965, 42.585396112316715, 51.292175209435236, 0.5414292999999998, 105.0, 548, 255036, 370, 9.09298089999993
371, 4.4028078245678595, 42.556519235525855, 51.21996833020308, 0.5405932000000001, 90.0, 381, 255417, 371, 5.50019919999977
372, 6.210363047296266, 42.48345002209976, 51.210665494847625, 0.5397922, 145.0, 509, 255926, 372, 7.158247600000323
373, 8.648994494588619, 42.58799066888281, 51.409149819109814, 0.5387364999999997, 110.0, 664, 256590, 373, 9.281117200000153
374, 6.517020011554019, 42.56377048218275, 51.32677413893431, 0.5372623000000001, 470.0, 974, 257564, 374, 13.950230400000237
375, 5.699531820114177, 42.500312037399944, 51.23712039711736, 0.5358177999999996, 125.0, 631, 258195, 375, 9.465860699999666
376, 6.22116460246462, 42.50389866310906, 51.14540530446512, 0.5349268, 50.0, 359, 258554, 376, 5.1390800000003765
377, 7.092079757711616, 42.44293332249113, 51.19022619560156, 0.5338846000000002, 230.0, 799, 259353, 377, 11.981951899999785
378, 8.405281527014449, 42.59119386076927, 51.35597156286239, 0.5325895000000002, 85.0, 640, 259993, 378, 8.60366490000024
379, 6.987806025294947, 41.728759901989065, 50.29896039464515, 0.5310316, 210.0, 1091, 261084, 379, 15.175416799999766
380, 6.891834740291901, 41.718857142277535, 50.292627191267954, 0.5295826, 100.0, 519, 261603, 380, 7.693279099999927
381, 5.522573463207946, 41.65933516748567, 50.193812234061106, 0.5283973000000002, 190.0, 798, 262401, 381, 11.367142000000058
382, 5.256325032180689, 41.69804894154466, 50.23091959315022, 0.5271076000000001, 100.0, 635, 263036, 382, 8.515386099999887
383, 4.762112970687504, 41.76071381042211, 50.287285131979765, 0.5259249999999998, 125.0, 679, 263715, 383, 9.527691100000084
384, 6.2399542181011745, 41.810136419281996, 50.46799686840942, 0.5245920999999997, 140.0, 802, 264517, 384, 10.815073799999936
385, 4.934032751902525, 41.79914509920263, 50.32323695548438, 0.5234148999999999, 45.0, 506, 265023, 385, 6.747082800000044
386, 6.677150480783307, 41.58427772179847, 50.11847261676874, 0.5225581, 45.0, 446, 265469, 386, 6.162258999999722
387, 3.9218725303110604, 41.76049359842611, 50.28539187154069, 0.5218749999999999, 55.0, 313, 265782, 387, 4.350726500000292
388, 7.155096818416102, 41.7540443652385, 50.40601588584281, 0.5210605, 80.0, 592, 266374, 388, 8.079066199999943
389, 4.787297573681352, 41.691769311338746, 50.19360613754228, 0.5199031000000003, 200.0, 694, 267068, 389, 9.425481300000229
390, 5.763345822974011, 41.742345130257725, 50.31618641638809, 0.5184703, 155.0, 898, 267966, 390, 12.088939499999924
391, 4.407824771299406, 41.6567281016597, 50.20814559371383, 0.5166901, 345.0, 1080, 269046, 391, 14.57885879999958
392, 7.092741704060578, 41.628983081226615, 50.30464691511342, 0.5152069, 110.0, 568, 269614, 392, 7.648048099999869
393, 8.447490575467855, 41.73284025951824, 50.35109854166487, 0.5142888999999999, 25.0, 452, 270066, 393, 6.31311020000021
394, 4.931542664556436, 41.864937943471986, 50.40708445831084, 0.5133708999999997, 80.0, 568, 270634, 394, 7.934101700000156
395, 5.716160063489169, 41.749092798019646, 50.292895456599695, 0.5123367999999999, 65.0, 581, 271215, 395, 8.07678900000019
396, 4.879365668726895, 41.7951261897287, 50.293008752925665, 0.5112127000000001, 140.0, 668, 271883, 396, 9.058907900000122
397, 4.561609182347742, 41.821352519346085, 50.38116920556915, 0.5098105, 255.0, 890, 272773, 397, 12.238903200000095
398, 5.427199339069295, 41.79645430693152, 50.34671887737966, 0.5083939, 170.0, 684, 273457, 398, 9.441969500000141
399, 4.229856366999448, 41.638366436958314, 50.154506044387816, 0.5070583000000002, 155.0, 800, 274257, 399, 10.936888600000202
400, 4.062845406880522, 41.734672047566285, 50.30345380835841, 0.5052645999999997, 225.0, 1193, 275450, 400, 16.725504699999874
401, 5.159363803276483, 41.59402425483634, 50.127140045166016, 0.5038929999999999, 35.0, 331, 275781, 401, 4.611986399999751
402, 4.5556838681977805, 41.82093626658122, 50.395262735540214, 0.5030011000000001, 90.0, 660, 276441, 402, 9.379991600000267
403, 7.230878377771662, 41.80795408550062, 50.45908709528903, 0.5015008000000001, 175.0, 1007, 277448, 403, 13.998496799999884
404, 5.083460986801211, 41.82060467782628, 50.39071212311969, 0.49966209999999983, 415.0, 1036, 278484, 404, 14.494475500000135
405, 5.41273053278768, 41.82528783906766, 50.402218472860696, 0.49817619999999996, 100.0, 615, 279099, 405, 8.574600199999622
406, 3.611476629432933, 41.75369775706324, 50.232433674253265, 0.49710070000000006, 80.0, 580, 279679, 406, 8.518740799999705
407, 4.038048375744295, 41.93688078487621, 50.564537540558845, 0.4956301, 220.0, 1054, 280733, 407, 15.243538400000034
408, 3.3544139947416713, 41.89751115817468, 50.418486042701694, 0.49412530000000005, 80.0, 618, 281351, 408, 8.68896360000008
409, 5.018822357787478, 41.959723067907476, 50.62006385117532, 0.49277799999999994, 160.0, 879, 282230, 409, 12.385384299999714
410, 5.701666704951281, 42.01955527569874, 50.64120575318854, 0.4916880999999999, 55.0, 332, 282562, 410, 4.590176700000029
411, 5.621357430547956, 41.94127555852514, 50.55396352285427, 0.4901050000000005, 345.0, 1427, 283989, 411, 19.680021699999998
412, 4.610752870941344, 42.038605664619475, 50.60380583933551, 0.4883473, 10.0, 526, 284515, 412, 7.454048499999772
413, 5.290642126098923, 41.923926809559696, 50.50257123177913, 0.48727360000000003, 130.0, 667, 285182, 413, 9.207601200000227
414, 5.93406004621414, 42.00894312581462, 50.56548599059692, 0.4862242, 80.0, 499, 285681, 414, 6.959119999999984
415, 5.100601833884003, 41.978288614653856, 50.55812936781129, 0.48476980000000025, 380.0, 1117, 286798, 415, 15.578217499999937
416, 3.1394902759364673, 41.91673464699397, 50.46370355515253, 0.4831975, 185.0, 630, 287428, 416, 8.71817850000025
417, 3.1909996898924198, 41.81286915561609, 50.340496244884676, 0.4822714000000001, 80.0, 399, 287827, 417, 5.578531999999996
418, 3.22632723007004, 41.95118364579131, 50.50215389146012, 0.4815550000000001, 105.0, 397, 288224, 418, 5.638906799999859
419, 6.0021770475511875, 41.87692192273262, 50.507515801323784, 0.48056590000000016, 110.0, 702, 288926, 419, 10.143543099999988
420, 5.218916738925851, 41.96471554615776, 50.62460929851242, 0.4792249, 140.0, 788, 289714, 420, 10.99989830000004
421, 5.776673137944004, 42.14952819986116, 50.81312632876935, 0.4778371000000001, 130.0, 754, 290468, 421, 10.627790800000184
422, 4.412025077586964, 42.33266460438467, 50.973357233235255, 0.4762900000000002, 215.0, 965, 291433, 422, 13.469736600000033
423, 5.499638529417043, 42.230753743229585, 50.92140133769367, 0.4748581, 80.0, 626, 292059, 423, 8.933308300000135
424, 6.615883964863379, 42.471723811945715, 51.22220723769244, 0.47357560000000015, 90.0, 799, 292858, 424, 11.39944400000013
425, 4.421783366006055, 42.38283780324373, 51.073223854998034, 0.47223100000000023, 190.0, 695, 293553, 425, 10.345309600000292
426, 4.216240295335466, 42.42121616999308, 51.07679903360061, 0.47102229999999995, 135.0, 648, 294201, 426, 9.151466600000276
427, 4.010580737090312, 42.29806223680198, 50.948288807285486, 0.46937260000000003, 460.0, 1185, 295386, 427, 16.94728840000016
428, 4.103136812916232, 42.39675501187642, 51.01928896903992, 0.46765809999999997, 155.0, 720, 296106, 428, 10.28106149999985
429, 3.936921859927037, 42.39223040721963, 51.02690281200602, 0.4661227, 280.0, 986, 297092, 429, 14.131919100000232
430, 4.198414164694161, 42.33420393853214, 50.99539047113344, 0.4645909, 210.0, 716, 297808, 430, 10.614940099999785
431, 4.728997289797046, 42.31919617562924, 50.9707143819557, 0.463231, 255.0, 795, 298603, 431, 11.901489899999888
432, 4.809141411874457, 42.33009770506021, 51.02613039919321, 0.46128879999999994, 520.0, 1363, 299966, 432, 19.642887299999984
433, 3.768025922090773, 42.1420849257471, 50.716359612621744, 0.45958599999999994, 30.0, 529, 300495, 433, 7.770662500000071
434, 3.048035655760561, 42.10054145627967, 50.661388794467726, 0.4584789999999996, 140.0, 701, 301196, 434, 10.294329700000162
435, 4.48978693522053, 42.09399148446542, 50.71633955402139, 0.45748359999999993, 95.0, 405, 301601, 435, 5.902724300000045
436, 4.88185902580804, 42.150024431832826, 50.739297600266354, 0.4565395, 160.0, 644, 302245, 436, 9.704091800000242
437, 4.229223780542891, 42.27340408039984, 50.95984102053063, 0.45547840000000006, 50.0, 535, 302780, 437, 7.790721399999711
438, 6.871455704473883, 42.062757547423836, 50.74412465158427, 0.45465580000000005, 90.0, 379, 303159, 438, 5.535010900000088
439, 9.489304847201813, 42.207637740586414, 51.04403812137386, 0.4537953999999999, 105.0, 577, 303736, 439, 8.239672700000028
440, 4.194392482710318, 42.048268338553925, 50.68670441961696, 0.4524337000000002, 180.0, 936, 304672, 440, 13.181426000000101
441, 5.07744364730253, 42.12719636914023, 50.77698427815491, 0.45103600000000005, 120.0, 617, 305289, 441, 8.686813499999971
442, 4.836113246087428, 42.059781129210144, 50.65930825080071, 0.44983720000000027, 175.0, 715, 306004, 442, 10.109713000000284
443, 5.028042930682783, 42.112385271282804, 50.73545183880898, 0.44792920000000036, 660.0, 1405, 307409, 443, 20.647766600000068
444, 4.723528546087031, 42.120182530546565, 50.74836847712937, 0.44598249999999984, 120.0, 758, 308167, 444, 10.808168799999748
445, 3.6870729533105964, 42.010743947208674, 50.5575621257766, 0.4444398999999999, 215.0, 956, 309123, 445, 13.654249900000195
446, 3.073670922924007, 42.22913855809953, 50.8154545255897, 0.44313579999999975, 130.0, 493, 309616, 446, 7.046820099999877
447, 4.988533093993153, 42.26687092055923, 50.90906998418993, 0.44191089999999983, 180.0, 868, 310484, 447, 12.403507300000001
448, 4.539600915508115, 42.362306190031305, 51.05180503114661, 0.4402179999999999, 290.0, 1013, 311497, 448, 15.572085199999947
449, 2.7973194944427506, 42.31385538626236, 50.88616872760779, 0.4387275999999999, 70.0, 643, 312140, 449, 9.847866999999951
450, 4.456278397680335, 42.310481601802515, 50.98055433910632, 0.43740279999999976, 215.0, 829, 312969, 450, 12.750164999999924
451, 3.1364137588654244, 42.40714659554618, 51.03519098009382, 0.4360266999999997, 155.0, 700, 313669, 451, 10.830178100000012
452, 5.612942454304715, 42.307107826515484, 51.00601508686081, 0.4343032000000001, 385.0, 1215, 314884, 452, 18.626711599999908
453, 5.740058460417278, 42.435960120270806, 51.17316547604593, 0.4321998999999998, 520.0, 1122, 316006, 453, 17.572278599999663
454, 4.225430161235817, 42.390323236169095, 51.098691423575715, 0.43073829999999996, 15.0, 502, 316508, 454, 7.872598300000391
455, 3.767400868735905, 42.269074227493235, 50.870129854304864, 0.4294665999999999, 215.0, 911, 317419, 455, 14.091154599999754
456, 6.155755615864809, 42.333289036383995, 51.06816219060849, 0.42808509999999994, 45.0, 624, 318043, 456, 9.883989500000098
457, 4.772620594817451, 42.35579044156225, 51.009078148784475, 0.42720939999999996, 30.0, 349, 318392, 457, 5.4739927000000534
458, 4.722827887367503, 42.27562811555373, 50.98970263977797, 0.4261590999999998, 215.0, 818, 319210, 458, 12.749227000000246
459, 5.794366402930331, 42.24841820073495, 50.98667428871358, 0.42478119999999986, 325.0, 713, 319923, 459, 11.34468969999989
460, 5.338188469651515, 41.99531564289393, 50.594266305604485, 0.4236120999999999, 75.0, 586, 320509, 460, 9.107566600000155
461, 4.71882052722836, 41.788804225485784, 50.33383506633771, 0.4222575999999998, 360.0, 919, 321428, 461, 14.38049090000004
462, 3.700753705061835, 41.75709867769955, 50.325011668761086, 0.42084369999999993, 340.0, 652, 322080, 462, 10.357911499999773
463, 5.123045102112709, 41.652494457490405, 50.191869930345185, 0.41968359999999993, 165.0, 637, 322717, 463, 9.977885199999946
464, 5.003874463069456, 41.73380022006312, 50.252417460639144, 0.41850639999999995, 125.0, 671, 323388, 464, 11.074107500000082
465, 4.830856988123899, 41.736911020565444, 50.27254652533579, 0.4172734, 110.0, 699, 324087, 465, 11.169097299999976
466, 7.163572158711226, 41.86453464140952, 50.499584605005495, 0.4162140999999999, 90.0, 478, 324565, 466, 7.553735599999982
467, 4.306895616040315, 41.698618727697294, 50.227418539301304, 0.41533119999999996, 55.0, 503, 325068, 467, 7.913157100000262
468, 6.511305545956731, 41.786794560556196, 50.38910231456805, 0.41452479999999997, 110.0, 393, 325461, 468, 6.210158599999886
469, 6.620759708251925, 41.731682121929516, 50.33366441867344, 0.4135608999999999, 95.0, 678, 326139, 469, 10.743052700000135
470, 4.55508393219604, 41.64937206593955, 50.16231713062379, 0.4123602999999999, 110.0, 656, 326795, 470, 10.40633969999999
471, 6.53489475374668, 41.73588740284393, 50.32154988556077, 0.41095719999999974, 165.0, 903, 327698, 471, 14.471433299999717
472, 5.236415451468888, 41.66682154969399, 50.18207782721667, 0.4094199999999998, 220.0, 805, 328503, 472, 12.846951699999863
473, 7.217175272927237, 41.61962110346014, 50.18470278653231, 0.4079628999999998, 210.0, 814, 329317, 473, 12.824313000000075
474, 3.8272330267489822, 41.71153811671308, 50.22157729881397, 0.4064850999999998, 200.0, 828, 330145, 474, 13.128046599999834
475, 4.4571590123493765, 41.851574391464865, 50.4157369837334, 0.40502619999999995, 300.0, 793, 330938, 475, 12.6044294000003
476, 4.216120726599399, 41.86439184141067, 50.40848685321551, 0.4038453999999999, 90.0, 519, 331457, 476, 8.365287999999964
477, 3.9447346263909124, 41.986022619298986, 50.552769435848205, 0.4028787999999999, 60.0, 555, 332012, 477, 9.46225719999984
478, 6.623743682808253, 41.82575285528001, 50.46503484902061, 0.40180419999999994, 120.0, 639, 332651, 478, 10.389955899999677
479, 9.89521554341901, 42.07662005116278, 50.83432870582029, 0.4007556999999998, 45.0, 526, 333177, 479, 8.548444000000018
480, 4.137628367836173, 41.985596179060764, 50.5679551613128, 0.3998061999999999, 75.0, 529, 333706, 480, 8.473737399999663
481, 4.238406939194961, 41.90070802707865, 50.449509533968836, 0.3984390999999998, 440.0, 990, 334696, 481, 15.93529269999999
482, 3.9272343653467403, 42.00319337270346, 50.53516404600028, 0.39695049999999993, 135.0, 664, 335360, 482, 10.882678899999974
483, 3.9144846574089476, 41.836819374758896, 50.4010917547658, 0.3957012999999999, 260.0, 724, 336084, 483, 11.924492600000121
484, 5.1717218230643045, 41.89220023997856, 50.4850282966471, 0.3946167999999999, 60.0, 481, 336565, 484, 7.937132999999903
485, 5.204732250984154, 41.822253871896415, 50.35834633171891, 0.3938616999999998, 60.0, 358, 336923, 485, 5.771653799999967
486, 4.146187169583578, 41.82251249610698, 50.3844504664606, 0.3925926999999998, 250.0, 1052, 337975, 486, 17.269922100000258
487, 3.799133950089027, 41.83009455606379, 50.36459333290081, 0.3909312999999999, 285.0, 794, 338769, 487, 12.810416199999963
488, 4.019149265259273, 41.90616310474484, 50.47634941662929, 0.38975229999999994, 20.0, 516, 339285, 488, 8.603756200000134
489, 4.388886166446532, 41.8929819033422, 50.48967249812106, 0.38856519999999994, 230.0, 803, 340088, 489, 13.163182499999948
490, 5.654855463673389, 41.98016724852232, 50.625878258834504, 0.38698659999999985, 255.0, 951, 341039, 490, 15.472827099999904
491, 4.380293723759082, 41.99225210749664, 50.58433263213995, 0.3854223999999999, 330.0, 787, 341826, 491, 13.056091200000083
492, 2.841003336541846, 41.87224389090756, 50.40216202905335, 0.3843595, 80.0, 394, 342220, 492, 6.459722499999771
493, 4.589734795868472, 42.08719617470928, 50.663208217304174, 0.3833001999999999, 210.0, 783, 343003, 493, 12.801235100000213
494, 6.781151691413025, 42.01842605358667, 50.71792803034908, 0.3819447999999999, 155.0, 723, 343726, 494, 12.306651899999906
495, 4.695028689005292, 42.15790346361839, 50.7807962522496, 0.3804922, 320.0, 891, 344617, 495, 14.634838199999649
496, 3.031732946825333, 41.973887516902046, 50.49455317961864, 0.3793393, 35.0, 390, 345007, 496, 6.405868499999997
497, 2.701410708180316, 41.95865196916284, 50.460695036084545, 0.3785193999999999, 50.0, 521, 345528, 497, 8.753497500000321
498, 4.82723693350347, 42.046952047608904, 50.72009275024785, 0.3777544, 25.0, 329, 345857, 498, 5.475246700000298
499, 5.5959710631222235, 42.06513270704959, 50.68226271436808, 0.3764998000000001, 400.0, 1065, 346922, 499, 17.55970040000011
500, 7.892978547220947, 42.07684603498026, 50.77335431385625, 0.3749545, 190.0, 652, 347574, 500, 11.36683690000018
501, 4.884654088673818, 42.0158914844322, 50.6257057027441, 0.3735226, 335.0, 939, 348513, 501, 15.565764599999966
502, 4.191753996668134, 41.95375462779849, 50.61918339015931, 0.37222029999999995, 35.0, 508, 349021, 502, 8.351651500000116
503, 4.33900819386391, 41.99809443799755, 50.569898866902925, 0.3709099000000001, 210.0, 948, 349969, 503, 16.437785000000076
504, 4.49098435348206, 42.136874558457045, 50.73145958578631, 0.36932859999999995, 125.0, 809, 350778, 504, 13.62177789999987
505, 5.922396428762627, 42.155894149533594, 50.78528097209974, 0.3682107999999999, 105.0, 433, 351211, 505, 7.701950600000146
506, 5.492773579046595, 42.1741818734981, 50.80377437480684, 0.366985, 245.0, 929, 352140, 506, 15.509716399999888
507, 5.11921487512698, 42.2196030339029, 50.82654231684045, 0.36505180000000004, 605.0, 1219, 353359, 507, 20.43818420000025
508, 3.768430585088298, 42.03795626719333, 50.630964981108505, 0.3634876000000001, 40.0, 519, 353878, 508, 8.782644600000367
509, 6.378141643453355, 42.2392021250502, 50.905428057519075, 0.36225009999999996, 255.0, 856, 354734, 509, 14.841100000000097
510, 5.036977921821943, 42.12721407668152, 50.75446236921836, 0.3605949999999999, 285.0, 983, 355717, 510, 16.729326499999843
511, 3.965556174474103, 42.15231939588274, 50.74182103838239, 0.3590802999999999, 125.0, 700, 356417, 511, 11.8837853
512, 3.5008159201600653, 42.08537241012331, 50.63242901047341, 0.3576564999999999, 250.0, 882, 357299, 512, 15.070416999999907
513, 5.638932997629973, 42.18248902097273, 50.82075837787829, 0.35592219999999986, 295.0, 1045, 358344, 513, 17.5539875999998
514, 6.880773372422933, 42.32069417888751, 50.968776787541245, 0.35429229999999995, 215.0, 766, 359110, 514, 13.289956200000233
515, 8.471278458009667, 42.2299688605852, 50.92310033818727, 0.353017, 135.0, 651, 359761, 515, 10.904429000000164
516, 6.956099332873582, 43.00431286890094, 51.83443516728364, 0.35124669999999997, 185.0, 1316, 361077, 516, 22.11668230000032
517, 4.118565223019594, 43.10634946519402, 51.895960182141344, 0.34949710000000006, 85.0, 628, 361705, 517, 10.607979200000045
518, 5.961299535208221, 43.109776381788585, 52.03559192295732, 0.3485142999999999, 45.0, 464, 362169, 518, 7.754543000000012
519, 5.49882380778098, 43.14839992086396, 51.980504727545586, 0.34738929999999996, 180.0, 786, 362955, 519, 13.758786800000053
520, 5.979869644590348, 43.1370710942117, 52.06279603699694, 0.34559920000000005, 425.0, 1203, 364158, 520, 20.36275020000039
521, 3.208163845809704, 43.069440648240864, 51.81384650716242, 0.34375329999999993, 205.0, 848, 365006, 521, 14.378399600000193
522, 3.159878123797969, 43.04189896057985, 51.76300436413599, 0.3425409999999999, 55.0, 499, 365505, 522, 8.385458499999913
523, 3.9104964575570103, 43.116433392664426, 51.90583808558762, 0.34152669999999996, 95.0, 628, 366133, 523, 10.856604799999786
524, 4.693705630686975, 43.00761185676821, 51.837659971175654, 0.34026399999999996, 150.0, 775, 366908, 524, 14.034648199999992
525, 4.932864723816131, 43.08842810462503, 51.926390153520245, 0.3385873000000001, 315.0, 1088, 367996, 525, 20.74804529999983
526, 8.043935438708484, 43.2037415365571, 52.111038944096244, 0.33686650000000007, 215.0, 824, 368820, 526, 16.636369100000138
527, 5.917872431258854, 43.1722021886997, 52.00886259206622, 0.3356541999999998, 45.0, 523, 369343, 527, 10.489731699999993
528, 3.7313596571761147, 43.0117306665138, 51.78992613156637, 0.33440589999999987, 175.0, 864, 370207, 528, 17.650863800000025
529, 4.866878000789969, 42.810070178778886, 51.584498532299925, 0.33326289999999986, 60.0, 406, 370613, 529, 7.6834773999999015
530, 3.4886426049639185, 43.12065901000643, 51.89650736046185, 0.33190929999999996, 390.0, 1098, 371711, 530, 19.788091700000223
531, 3.1672962026036893, 43.06099205410358, 51.82950672660906, 0.3305718999999999, 50.0, 388, 372099, 531, 6.843360600000324
532, 3.7110848523849667, 43.05398777473805, 51.85305399118468, 0.3296035, 150.0, 688, 372787, 532, 11.949136300000191
533, 3.613555463553547, 43.105143059929496, 51.84950178475689, 0.32798349999999976, 290.0, 1112, 373899, 533, 19.85855730000003
534, 3.3743601127999594, 42.994521286216546, 51.72852140217158, 0.32651559999999985, 100.0, 519, 374418, 534, 9.14572999999973
535, 2.932121041566814, 42.87413465595681, 51.56116683588362, 0.32545719999999995, 70.0, 657, 375075, 535, 11.384168999999929
536, 4.52268923402682, 43.062154984976424, 51.88227306777217, 0.32413959999999997, 105.0, 807, 375882, 536, 14.020489500000167
537, 7.2475388575485855, 43.06682038757036, 51.963624243466356, 0.32303169999999987, 35.0, 424, 376306, 537, 7.39390160000039
538, 3.3829027089020887, 43.00515872766368, 51.75510432509664, 0.3213963999999999, 680.0, 1393, 377699, 538, 24.657017800000176
539, 4.156928577096515, 43.01190980353578, 51.751943286767656, 0.31904380000000004, 590.0, 1221, 378920, 539, 21.38683899999978
540, 2.9658730818272225, 43.017277382387974, 51.74609584619503, 0.31721769999999994, 155.0, 808, 379728, 540, 14.226153999999951
541, 3.936287968067357, 43.147821685345505, 51.965823130363965, 0.31587399999999993, 115.0, 685, 380413, 541, 12.425673799999458
542, 5.627127718728418, 43.30975645045469, 52.196118659463004, 0.3146517999999998, 40.0, 673, 381086, 542, 12.090376399999514
543, 5.298666838145702, 43.290131356783, 52.13789886046793, 0.31356459999999997, 135.0, 535, 381621, 543, 9.569668099999944
544, 6.525535295898225, 43.27589905567658, 52.155419325217224, 0.3125917, 55.0, 546, 382167, 544, 9.610448800000086
545, 5.695032710968986, 43.287722949833835, 52.14803467979727, 0.3115198, 105.0, 645, 382812, 545, 11.584156799999619
546, 5.2586477731862225, 43.19828658672016, 52.014127318179135, 0.30994209999999983, 335.0, 1108, 383920, 546, 19.990449500000068
547, 6.74922957304074, 43.30114430737166, 52.15371333805888, 0.3078388, 335.0, 1229, 385149, 547, 22.50238360000003
548, 4.815648202540537, 43.11259627990286, 51.872988743161265, 0.3061035999999999, 125.0, 699, 385848, 548, 12.519164599999385
549, 2.980046452524991, 43.10042244327226, 51.83909362143182, 0.3048615999999999, 150.0, 681, 386529, 549, 12.564698099999987
550, 2.86176198125566, 43.15943334744946, 51.9170692304498, 0.30385449999999997, 50.0, 438, 386967, 550, 8.021431699999994
551, 5.4603720371198685, 43.24282311236112, 52.070046645319174, 0.3027555999999999, 120.0, 783, 387750, 551, 14.929024899999604
552, 3.7089862605276966, 43.20357694774094, 52.03994025591124, 0.3013560999999999, 260.0, 772, 388522, 552, 14.247271700000056
553, 7.284880699599085, 43.23522145294946, 52.130788238777605, 0.3001168, 135.0, 605, 389127, 553, 11.282322600000043
554, 2.9882663554600337, 43.091557906491914, 51.8355123770498, 0.2990790999999998, 65.0, 548, 389675, 554, 10.412090400000125
555, 4.620340545109646, 42.9069938613983, 51.593201231813715, 0.2978343999999999, 185.0, 835, 390510, 555, 16.412379499999588
556, 9.169791747300126, 42.703582614368656, 51.56704004963317, 0.29662299999999997, 70.0, 511, 391021, 556, 9.513464600000589
557, 4.113015339129111, 42.6377566746303, 51.28790669801856, 0.2956275999999999, 115.0, 595, 391616, 557, 11.152897699999812
558, 6.067433281635814, 42.725827394252335, 51.42754481501942, 0.2941569999999999, 330.0, 1039, 392655, 558, 18.902942300000177
559, 5.000436468263548, 42.717731635419305, 51.431202418730166, 0.29255499999999995, 105.0, 741, 393396, 559, 13.550567000000228
560, 2.8431537465325425, 42.67554594396235, 51.3249561393654, 0.2915605, 35.0, 364, 393760, 560, 6.598640899999737
561, 3.5603060147364687, 42.539980265363376, 51.170019696106266, 0.29051649999999996, 215.0, 796, 394556, 561, 15.253404699999919
562, 3.0033838350016766, 42.669809584740975, 51.33413942321723, 0.2887911999999998, 435.0, 1121, 395677, 562, 20.64796210000077
563, 6.933507122110915, 42.646276500530924, 51.419652635199945, 0.28719999999999984, 125.0, 647, 396324, 563, 11.924440599999798
564, 2.9710152051993646, 42.610012494027615, 51.224606208503246, 0.2861569, 115.0, 512, 396836, 564, 9.572455600000467
565, 7.188790691450098, 42.70887952463754, 51.481987107136405, 0.2854089999999999, 20.0, 319, 397155, 565, 5.971388899999511
566, 8.156630500766282, 42.62153908108773, 51.37641084013724, 0.28411120000000006, 355.0, 1123, 398278, 566, 21.295504899999287
567, 4.510502627102247, 42.646322411843336, 51.34688358035092, 0.2820267999999999, 645.0, 1193, 399471, 567, 21.963249299999916
568, 7.484723156877348, 42.67317635957006, 51.49858205810228, 0.28060839999999987, 45.0, 383, 399854, 568, 7.109897699999237
569, 4.304189685561502, 42.268138875791436, 50.83270684938698, 0.2795562999999999, 230.0, 786, 400640, 569, 14.823111799999424
570, 4.824604445304437, 42.28692367824213, 50.91956049929119, 0.27773199999999987, 340.0, 1241, 401881, 570, 23.685236400000576
571, 3.822814694701922, 42.19076760328625, 50.79421188557043, 0.2760048999999999, 185.0, 678, 402559, 571, 12.759525000000394
572, 2.916737931405208, 42.26444143323756, 50.863573323434856, 0.2749123, 130.0, 536, 403095, 572, 10.046670400000039
573, 4.765654899880513, 42.2074024314311, 50.81531413633432, 0.2738268999999999, 140.0, 670, 403765, 573, 12.954555199999959
574, 6.788465260696619, 42.2964505399211, 51.04899875293213, 0.27250299999999994, 150.0, 801, 404566, 574, 15.209674699999596
575, 4.768522305442649, 42.26962517229326, 50.915260142343904, 0.2706084999999998, 320.0, 1304, 405870, 575, 25.17049120000047
576, 4.771650488933791, 42.24018021534554, 50.87580705725628, 0.26897949999999987, 80.0, 506, 406376, 576, 9.552967599999647
577, 3.9298976684647737, 42.1416085609355, 50.71705747844597, 0.26793100000000003, 45.0, 659, 407035, 577, 13.031046900000547
578, 4.80930288727938, 42.17784575596909, 50.78937687318018, 0.2667510999999999, 180.0, 652, 407687, 578, 12.481152700000166
579, 7.752706253388348, 42.36630882711972, 51.12259037691004, 0.2657817999999999, 45.0, 425, 408112, 579, 8.452907999999297
580, 3.889023042312174, 42.231913145269125, 50.781941640510134, 0.26483499999999993, 185.0, 627, 408739, 580, 12.094122600000446
581, 4.131488155509155, 42.23370003617759, 50.7687346052546, 0.26375050000000005, 15.0, 578, 409317, 581, 11.188907699999618
582, 4.339455187320709, 42.20657565155215, 50.80380748511813, 0.2624914, 170.0, 821, 410138, 582, 15.538846299999932
583, 3.8167141797674167, 42.50169755514566, 51.173311283062034, 0.26105949999999994, 125.0, 770, 410908, 583, 14.687241799999356
584, 3.1751219919909897, 42.4251332612631, 51.03118107762022, 0.2597805999999999, 115.0, 651, 411559, 584, 12.706360899999709
585, 5.358724192071971, 42.5134286384362, 51.19724516234646, 0.2587276, 65.0, 519, 412078, 585, 10.32789909999974
586, 4.637973337353509, 42.48188235442049, 51.149330622782834, 0.2575647999999999, 265.0, 773, 412851, 586, 14.944218499999806
587, 4.504144932985525, 42.47970987112702, 51.17370109487853, 0.2563803999999999, 70.0, 543, 413394, 587, 10.670179499999904
588, 5.98329138598944, 42.369332194658526, 51.01874563898736, 0.2552419, 160.0, 722, 414116, 588, 14.063490599999568
589, 5.378851036192979, 42.39405863335792, 51.04700541858615, 0.2539999, 100.0, 658, 414774, 589, 12.947615900000528
590, 3.9919317302274844, 42.36258734268894, 50.99744766370385, 0.2524923999999999, 605.0, 1017, 415791, 590, 20.200074499999573
591, 3.4952502178103315, 42.377388313005746, 51.000303935632594, 0.2508849999999999, 285.0, 769, 416560, 591, 14.874570900000435
592, 4.402048095712414, 42.267751728404654, 50.90604705810547, 0.24984639999999997, 70.0, 385, 416945, 592, 7.508390999999392
593, 5.1223190556307445, 42.39762700028404, 50.99799887030642, 0.24894369999999993, 125.0, 618, 417563, 593, 12.030699199999617
594, 3.209948272473901, 42.42085398736401, 51.02411121118848, 0.24790599999999993, 105.0, 535, 418098, 594, 11.023535899999843
595, 5.118955485171592, 42.35955364586877, 51.036956415801754, 0.24654609999999993, 225.0, 976, 419074, 595, 19.595273599999928
596, 2.926891570358644, 42.33550313715878, 50.919208918635555, 0.2452123, 20.0, 506, 419580, 596, 10.273855100000219
597, 7.051261878912869, 42.21932896331846, 50.890102460259854, 0.2442915999999999, 5.0, 517, 420097, 597, 10.317233800000395
598, 3.643311624860734, 41.4860764587176, 49.92921839597346, 0.2430981999999999, 70.0, 809, 420906, 598, 16.002575099999376
599, 6.274054654734147, 41.40677022743985, 49.8728676602185, 0.24169239999999992, 195.0, 753, 421659, 599, 15.421711999999388
600, 3.517626047902894, 41.46984893419312, 49.90764745448572, 0.23978439999999981, 455.0, 1367, 423026, 600, 27.128744099999494
601, 4.734827201479994, 41.40338500137524, 49.81467610917738, 0.2378502999999999, 180.0, 782, 423808, 601, 15.542256700000507
602, 3.547432689968688, 41.46202986157781, 49.89293450523021, 0.23639319999999994, 210.0, 837, 424645, 602, 16.94729019999977
603, 3.883305054324248, 41.49486296129363, 49.92865966912801, 0.2346922, 360.0, 1053, 425698, 603, 21.316974899999877
604, 2.5379070543270457, 41.47410936153907, 49.857935672080046, 0.23344659999999995, 20.0, 331, 426029, 604, 6.600354500000321
605, 4.993199352523406, 41.49896250114166, 49.9567700063582, 0.23252319999999996, 365.0, 695, 426724, 605, 13.984861699999783
606, 5.2342004308743135, 41.46614464896066, 49.930643208821614, 0.23095269999999996, 140.0, 1050, 427774, 606, 21.64743989999988
607, 6.214341530748036, 41.713298041302224, 50.23342671269956, 0.2294901999999999, 30.0, 575, 428349, 607, 12.158579800000552
608, 7.988976299762726, 41.54454111977229, 50.130419201321075, 0.22840569999999996, 110.0, 630, 428979, 608, 12.765615300000718
609, 2.9499941998372665, 41.413803801639304, 49.80592122337815, 0.2271286, 185.0, 789, 429768, 609, 15.98745340000005
610, 2.710674310347292, 41.0608919514299, 49.38365225769332, 0.22584879999999996, 155.0, 633, 430401, 610, 12.905264999999417
611, 5.697720165525607, 40.79228708755002, 49.16051883901973, 0.22469139999999982, 155.0, 653, 431054, 611, 13.953323499999897
612, 4.155937369266836, 40.80303629462221, 49.096069137874295, 0.22323699999999996, 195.0, 963, 432017, 612, 19.744249200000013
613, 3.185252028797065, 40.81956520777769, 49.082498341254094, 0.22168089999999996, 100.0, 766, 432783, 613, 15.717392100000325
614, 3.9646146556583504, 40.71655863745738, 48.98871034525209, 0.2204605, 110.0, 590, 433373, 614, 12.462860999999975
615, 6.329691251097909, 40.69840436269977, 49.02637305719855, 0.2190807999999999, 205.0, 943, 434316, 615, 19.88903669999945
616, 5.851993963794456, 40.726966553127646, 48.99910545840706, 0.2175336999999999, 105.0, 776, 435092, 616, 16.017241399999875
617, 5.845428969929249, 40.81875991407548, 49.14470889408004, 0.21600549999999996, 45.0, 922, 436014, 617, 18.829559800000425
618, 3.634293921647494, 40.713258007033865, 48.988510178930966, 0.2140822, 280.0, 1215, 437229, 618, 25.17479370000001
619, 3.5331135602111274, 40.65639780307638, 48.91199566303999, 0.2123622999999999, 140.0, 696, 437925, 619, 14.580862399999205
620, 5.418264751894432, 40.830499147114004, 49.19777447884543, 0.21096639999999997, 215.0, 855, 438780, 620, 17.43677089999983
621, 4.368891205167165, 40.828024512529375, 49.110041165351866, 0.20904489999999992, 335.0, 1280, 440060, 621, 26.145394699999997
622, 5.21789355117738, 40.802202943537516, 49.12292019908507, 0.20710719999999996, 245.0, 873, 440933, 622, 18.098067599999922
623, 4.730870379701905, 40.72891921812786, 49.00865289439326, 0.2059488999999999, 90.0, 414, 441347, 623, 8.56934369999999
624, 5.246639345605126, 40.66703509450306, 48.9500052449307, 0.20465019999999998, 345.0, 1029, 442376, 624, 21.22248690000015
625, 7.979368776852085, 40.95095569856705, 49.38344561053861, 0.20316609999999996, 85.0, 620, 442996, 625, 12.852254899999934
626, 4.423101656279096, 40.742969677012454, 49.02301678093531, 0.20193849999999997, 255.0, 744, 443740, 626, 15.598512300000039
627, 4.426374956927817, 40.73983586918224, 49.02346807537657, 0.20055610000000001, 95.0, 792, 444532, 627, 18.87331819999963
628, 4.540829631800835, 40.79583222804926, 49.11751979925694, 0.19914129999999994, 195.0, 780, 445312, 628, 16.783608599999752
629, 4.389526188138439, 40.93552285068369, 49.286037460116475, 0.19798299999999985, 35.0, 507, 445819, 629, 10.792830700000195
630, 5.1193422080202495, 40.792215068688556, 49.12335748708203, 0.1970460999999999, 80.0, 534, 446353, 630, 11.529518700000153
631, 5.086569119295845, 40.81664283961466, 49.12575585003857, 0.19577709999999993, 135.0, 876, 447229, 631, 18.533232199999475
632, 4.064980209113094, 40.78234517389011, 49.067848023725915, 0.19412019999999988, 305.0, 965, 448194, 632, 20.881112799999755
633, 3.4557849589018197, 40.790851689728214, 49.112381110392825, 0.19229319999999994, 160.0, 1065, 449259, 633, 22.744232099999863
634, 5.771747062118479, 40.84150740749152, 49.19402863258539, 0.19075419999999996, 65.0, 645, 449904, 634, 14.058165600000393
635, 4.051249420793813, 40.592820635028914, 48.83364223654753, 0.1896228999999999, 110.0, 612, 450516, 635, 13.418034900000748
636, 5.4781076130299375, 40.614131887080305, 48.91267273789745, 0.18822249999999996, 200.0, 944, 451460, 636, 20.142746700000316
637, 2.589070666700382, 40.58123283479958, 48.802907404794155, 0.18700659999999986, 110.0, 407, 451867, 637, 8.810815100000582
638, 4.051372908873607, 40.698279144234355, 48.97288142264456, 0.18559900000000001, 240.0, 1157, 453024, 638, 24.7140801000005
639, 3.5039658368030704, 40.569858333966344, 48.80077566188415, 0.18381429999999999, 135.0, 826, 453850, 639, 18.28013209999972
640, 5.910679032417512, 40.520710425801795, 48.77670445772681, 0.1827072999999999, 50.0, 404, 454254, 640, 8.653891800000565
641, 4.068411681805048, 40.549446154707155, 48.83966989892994, 0.18149859999999995, 130.0, 939, 455193, 641, 20.121853999999985
642, 4.5719304028275705, 40.56807570182082, 48.86579372092945, 0.18006129999999995, 145.0, 658, 455851, 642, 14.366934100000435
643, 5.8551586861996086, 40.7135387332848, 49.0034444960182, 0.17911719999999998, 65.0, 391, 456242, 643, 8.488386199999695
644, 5.579139285823281, 40.679337396671635, 49.01910799502494, 0.17773389999999994, 195.0, 1146, 457388, 644, 25.281840999999986
645, 4.440122072637593, 40.583242019074426, 48.78770976520558, 0.17544519999999994, 465.0, 1397, 458785, 645, 30.635637999999744
646, 6.411745869130879, 40.569765711354684, 48.88806406796633, 0.17336889999999988, 385.0, 910, 459695, 646, 19.815861799999766
647, 3.1251651964293505, 40.44656783615996, 48.5990183063134, 0.17164809999999994, 235.0, 1002, 460697, 647, 21.87491659999978
648, 4.92215339790094, 40.24989154269038, 48.43009538459484, 0.1701621999999999, 80.0, 649, 461346, 648, 14.25702050000018
649, 8.090289708627358, 40.37847174728344, 48.68195986048795, 0.1690254999999999, 140.0, 614, 461960, 649, 13.791962900000726
650, 4.5584355358937305, 40.340077376677094, 48.547949753582735, 0.16785279999999989, 110.0, 689, 462649, 650, 15.307702499999323
651, 2.732056694519189, 40.32990285378915, 48.504503356085884, 0.16674669999999994, 50.0, 540, 463189, 651, 11.734963099999732
652, 3.6252494654447482, 40.28459991185011, 48.45326040487374, 0.16554879999999988, 120.0, 791, 463980, 652, 17.063874999999825
653, 5.611328550387879, 40.30800647735596, 48.566871808026285, 0.16417089999999995, 110.0, 740, 464720, 653, 16.670635700000275
654, 5.484226559683016, 40.297651504666035, 48.4998682829449, 0.16267779999999993, 190.0, 919, 465639, 654, 20.561405900000864
655, 7.566018969421314, 40.2496630268256, 48.510496643320955, 0.1608795999999999, 200.0, 1079, 466718, 655, 24.95129679999991
656, 7.179783775333332, 40.37371922651214, 48.636306471888794, 0.1589049999999999, 270.0, 1115, 467833, 656, 24.94840760000079
657, 4.9243159325372785, 40.322334373451746, 48.5171902732066, 0.1572876999999999, 140.0, 682, 468515, 657, 15.238119200000256
658, 3.9875204072227977, 40.19377607784883, 48.30122818682701, 0.15605649999999993, 230.0, 686, 469201, 658, 15.281946199999766
659, 3.1401970289468357, 40.3344369737553, 48.47548575909277, 0.1549152999999999, 100.0, 582, 469783, 659, 13.451590000000579
660, 3.5599631670259293, 39.690388721284414, 47.691802698771156, 0.15344649999999993, 285.0, 1050, 470833, 660, 25.002014799999415
661, 5.440067368938732, 39.547753309675535, 47.62920010516347, 0.15197319999999992, 40.0, 587, 471420, 661, 14.63544439999987
662, 5.258656989495471, 39.66581983320884, 47.71846741115296, 0.15043059999999991, 580.0, 1127, 472547, 662, 27.7851926000003
663, 4.813631143374368, 39.532976861794786, 47.569586634635925, 0.14855229999999997, 205.0, 960, 473507, 663, 20.936031999999614
664, 6.249493233966631, 39.67247304583477, 47.78696100912545, 0.1468117, 395.0, 974, 474481, 664, 21.05143560000033
665, 4.246780253963085, 39.56107293594327, 47.56126291955326, 0.1455237999999999, 85.0, 457, 474938, 665, 10.082088500000282
666, 3.919751244306282, 39.642199495237335, 47.67276676671362, 0.14454189999999995, 155.0, 634, 475572, 666, 13.977651300000616
667, 4.0158361024696, 39.58768360982601, 47.61806983246411, 0.1428453999999999, 375.0, 1251, 476823, 667, 27.674043800000618
668, 5.026123546323541, 39.585866049564245, 47.60034799286814, 0.14112549999999996, 115.0, 660, 477483, 668, 14.779724399999395
669, 4.190326891494113, 39.62532032088728, 47.63288385504919, 0.13971609999999995, 345.0, 906, 478389, 669, 19.998238400000446
670, 5.084505006955325, 39.63669023440995, 47.712335812226506, 0.13795749999999993, 285.0, 1048, 479437, 670, 23.18440820000069
671, 3.709437585970045, 39.764089330215775, 47.846635098878664, 0.1363725999999999, 125.0, 713, 480150, 671, 15.754571500000566
672, 7.184776504806588, 40.39352310373542, 48.634665103440874, 0.13509009999999994, 200.0, 712, 480862, 672, 16.42019470000014
673, 4.29165725983228, 40.3660259023863, 48.55636136970155, 0.13360239999999995, 265.0, 941, 481803, 673, 22.722287500000675
674, 3.6479160601072174, 40.354778838672225, 48.502913742614304, 0.13212999999999994, 110.0, 695, 482498, 674, 16.945756699999947
675, 4.7838492667429655, 40.41930990334017, 48.598503208543406, 0.13060809999999995, 195.0, 996, 483494, 675, 24.319605199999387
676, 3.7664347768241315, 40.53268907890945, 48.75571313945254, 0.12866859999999988, 545.0, 1159, 484653, 676, 28.00491779999993
677, 4.0738924903525024, 40.4515119182637, 48.68387188166099, 0.1266696999999999, 630.0, 1062, 485715, 677, 25.964433999999528
678, 5.568469037944856, 40.39697754569676, 48.634241326373555, 0.12467889999999991, 255.0, 1150, 486865, 678, 28.848222800000258
679, 5.232281433153584, 40.51936162925628, 48.75088371828378, 0.12289689999999996, 120.0, 830, 487695, 679, 20.37951290000001
680, 5.102904215520757, 40.48505340387792, 48.70787327882474, 0.12112929999999994, 215.0, 1134, 488829, 680, 28.86742670000058
681, 5.843895079320148, 40.46679643623729, 48.70747037532212, 0.11916189999999989, 370.0, 1052, 489881, 681, 25.80673149999984
682, 7.305861919018485, 40.82195860544841, 49.19588452293759, 0.11783709999999993, 75.0, 420, 490301, 682, 10.596537700000226
683, 4.378041976246505, 40.84417513092263, 49.097802136769886, 0.11671569999999994, 110.0, 826, 491127, 683, 21.36754539999947
684, 4.268170898250316, 40.86494672633207, 49.150390345535, 0.11523519999999991, 225.0, 819, 491946, 684, 20.22642840000026
685, 3.9714465422160248, 40.877068125001216, 49.18625835217127, 0.11359539999999996, 315.0, 1003, 492949, 685, 25.126263999999537
686, 3.0089522925327006, 40.777942854425184, 48.99345173006473, 0.11236149999999992, 60.0, 368, 493317, 686, 9.146844999999303
687, 3.639663914833026, 40.96439184601774, 49.26298656660257, 0.11133189999999993, 95.0, 776, 494093, 687, 19.82041560000016
688, 4.878283499351314, 40.72987701942971, 49.00243537490432, 0.11003409999999994, 165.0, 666, 494759, 688, 16.691445100000237
689, 2.911091411508239, 40.67977096337635, 48.87889824063562, 0.1087479999999999, 380.0, 763, 495522, 689, 19.22039820000009
690, 4.8116990557297115, 40.912472532150595, 49.267606684502134, 0.10772289999999993, 40.0, 376, 495898, 690, 9.49732529999983
691, 5.108738305855719, 40.86853878778816, 49.18099146945196, 0.10687239999999991, 110.0, 569, 496467, 691, 14.788094499999715
692, 6.253656421639674, 40.97214101053465, 49.33893756789855, 0.1056879999999999, 115.0, 747, 497214, 692, 18.674507800000356
693, 3.538636622644553, 40.797398239971, 49.01740730397692, 0.1043415999999999, 170.0, 749, 497963, 693, 18.784689099999923
694, 4.639095266280627, 40.73041713679278, 48.96376629228945, 0.10288989999999991, 285.0, 864, 498827, 694, 22.520527500000753
695, 3.8040444176923485, 40.842689266204836, 49.08498323917389, 0.10139229999999992, 105.0, 800, 499627, 695, 20.408098599999903
696, 3.688511437618075, 40.996740758875426, 49.32020502835284, 0.1001922692189897, 70.0, 653, 500280, 696, 16.540653300000486
697, 7.002742746493697, 41.2414235044493, 49.623292854691464, 0.10000000000000078, 80.0, 419, 500699, 697, 10.732789400000001
698, 2.93032245705938, 41.252004348269885, 49.55682845920106, 0.10000000000000075, 80.0, 409, 501108, 698, 10.343541899999764
699, 5.2044052487119625, 41.166807437161786, 49.54746565312577, 0.09999999999999992, 135.0, 763, 501871, 699, 20.058893999999782
700, 5.986139621198751, 41.1895608828618, 49.598523609454816, 0.09999999999999842, 285.0, 1040, 502911, 700, 26.391732899999624
701, 4.6698215315517055, 41.165777288058386, 49.51719572757469, 0.09999999999999848, 275.0, 1028, 503939, 701, 26.795958699999574
702, 5.267851907329783, 41.206300586170414, 49.58400618820041, 0.0999999999999985, 445.0, 1022, 504961, 702, 26.076575299999604
703, 5.632832125629026, 41.282147268606565, 49.69347759718963, 0.099999999999999, 215.0, 913, 505874, 703, 23.36133659999996
704, 5.1599182369120955, 41.27094187055315, 49.64347264766693, 0.09999999999999813, 310.0, 1120, 506994, 704, 29.327391600000738
705, 6.6615003864515385, 41.32151305932793, 49.744436624238816, 0.09999999999999816, 200.0, 1112, 508106, 705, 28.713077200000043
706, 4.720182982329243, 41.27979064587237, 49.654915649148435, 0.09999999999999845, 385.0, 1034, 509140, 706, 27.513288300000568
707, 4.09153923799797, 41.09301809194137, 49.38036688979791, 0.10000000000000087, 25.0, 490, 509630, 707, 12.76768439999978
708, 4.947044395167638, 41.0771629058563, 49.43860554623532, 0.10000000000000074, 135.0, 666, 510296, 708, 17.28591520000009
709, 4.582184644919487, 41.09798087424727, 49.458770477929505, 0.10000000000000091, 160.0, 529, 510825, 709, 13.668879699999707
710, 4.863378312691902, 41.04825488957773, 49.371030437136156, 0.10000000000000099, 85.0, 618, 511443, 710, 16.610330600000452
711, 5.907986836422639, 41.063957701533674, 49.42777733860245, 0.10000000000000077, 40.0, 415, 511858, 711, 11.0768779
712, 4.718191042774382, 40.96110048801209, 49.25273414839412, 0.09999999999999987, 335.0, 771, 512629, 712, 20.035732899999857
713, 5.6831557557375225, 41.03420385478232, 49.37909174643421, 0.09999999999999938, 190.0, 844, 513473, 713, 23.60098299999936
714, 4.151419633993828, 40.93537602583407, 49.208004228763215, 0.09999999999999863, 215.0, 991, 514464, 714, 27.15365180000026
715, 4.198802486392575, 41.05014926184127, 49.40163338074182, 0.09999999999999827, 435.0, 1082, 515546, 715, 28.437054199999693
716, 4.507047939207641, 41.035229317360596, 49.351860910880035, 0.09999999999999792, 480.0, 1187, 516733, 716, 32.8238209000001
717, 9.36089391062874, 41.152896686759405, 49.641157169702964, 0.10000000000000055, 310.0, 687, 517420, 717, 17.986753500000304
718, 11.027045249132625, 41.05930165707807, 49.45100526685839, 0.10000000000000084, 45.0, 462, 517882, 718, 12.068567399999665
719, 2.931318715089896, 40.93060956682478, 49.14470500037784, 0.09999999999999809, 550.0, 1134, 519016, 719, 30.533323200000268
720, 8.094151561098052, 40.93928410456731, 49.289668377534845, 0.09999999999999838, 290.0, 1053, 520069, 720, 27.81826060000003
721, 5.872496380807315, 39.99238507718925, 48.10284770253193, 0.10000000000000075, 180.0, 664, 520733, 721, 17.674536100000296
722, 6.863204612555327, 39.9825811598036, 48.15484365298424, 0.0999999999999996, 190.0, 810, 521543, 722, 22.130287500000122
723, 4.622045657771676, 40.121575699639074, 48.26398804542418, 0.10000000000000062, 185.0, 679, 522222, 723, 18.07751980000012
724, 4.928210930714199, 40.04000662468575, 48.216415216256905, 0.09999999999999913, 105.0, 888, 523110, 724, 23.6714850999997
725, 7.910830463242576, 40.045041282897145, 48.20633328922694, 0.10000000000000091, 60.0, 533, 523643, 725, 14.700346399999944
726, 6.188736500871646, 39.99837093600979, 48.18426435396269, 0.09999999999999987, 170.0, 770, 524413, 726, 20.67431149999993
727, 7.087645764258851, 40.001182266348756, 48.17057896369159, 0.09999999999999785, 210.0, 1211, 525624, 727, 32.718534999999974
728, 5.456781662234496, 39.99571846185192, 48.08671212965442, 0.09999999999999863, 390.0, 992, 526616, 728, 26.71511820000069
729, 4.281818397023848, 40.062849453517366, 48.14525938488188, 0.10000000000000078, 75.0, 420, 527036, 729, 11.353796299999885
730, 6.944052358348686, 40.082548259252526, 48.300788014768116, 0.09999999999999755, 465.0, 1328, 528364, 730, 36.09506629999942
731, 6.5325790259428675, 40.0739479354482, 48.22197354224421, 0.10000000000000091, 110.0, 527, 528891, 731, 14.357121999999436
732, 5.042573870091463, 39.90182580899136, 47.995635966832225, 0.10000000000000096, 125.0, 587, 529478, 732, 16.022973500000262
733, 5.229916741711561, 39.956882584162095, 48.068828017358264, 0.10000000000000091, 115.0, 533, 530011, 733, 14.4145153999998
734, 5.327898963118892, 39.860365350562404, 47.96684767634993, 0.10000000000000088, 80.0, 498, 530509, 734, 13.986334299999726
735, 2.956584163516725, 39.85680166023138, 47.86899693210687, 0.09999999999999933, 220.0, 853, 531362, 735, 23.464924200000496
736, 5.935885198997415, 39.897394462253736, 48.05423707547395, 0.10000000000000084, 120.0, 460, 531822, 736, 12.526861600000302
737, 4.599498325718142, 39.897469046626625, 47.97394321570682, 0.09999999999999802, 420.0, 1153, 532975, 737, 31.906504599999607
738, 6.821601444981683, 39.891043673458974, 48.064795491992776, 0.09999999999999899, 395.0, 914, 533889, 738, 25.087283200000456
739, 5.0459695452550895, 39.870737286450826, 47.98101022925211, 0.10000000000000078, 180.0, 661, 534550, 739, 18.139791200000218
740, 5.412434396685607, 39.9068727989168, 47.95953041427371, 0.09999999999999755, 405.0, 1327, 535877, 740, 36.83596050000051
741, 3.7885620336336414, 39.7854865026131, 47.836967934807426, 0.10000000000000094, 145.0, 556, 536433, 741, 15.180858400000034
742, 4.91258142332753, 39.83753182601456, 47.97374794356146, 0.09999999999999962, 155.0, 807, 537240, 742, 22.065265600000203
743, 2.5627802750173427, 39.82915430444074, 47.852092129112854, 0.09999999999999941, 150.0, 839, 538079, 743, 23.88852610000049
744, 4.421336714764357, 39.816757253413144, 47.89112290092137, 0.0999999999999977, 295.0, 1265, 539344, 744, 34.68896870000026
745, 4.999864445225178, 39.919688162865576, 48.07453896163346, 0.10000000000000098, 30.0, 616, 539960, 745, 25.575824400000783
746, 4.143371484627134, 39.81069680438539, 47.83840222892614, 0.1000000000000009, 110.0, 518, 540478, 746, 17.583738899999844
747, 4.934037563899024, 39.80802978956995, 47.86054203332948, 0.09999999999999873, 205.0, 968, 541446, 747, 32.0471249000002
748, 2.761379955655662, 39.754626279496875, 47.78269486508127, 0.10000000000000091, 130.0, 531, 541977, 748, 19.306399500000225
749, 7.338708105364662, 39.77670868865485, 47.91598049085022, 0.09999999999999952, 125.0, 823, 542800, 749, 23.566188699999657
750, 5.962745985677166, 39.73500423431396, 47.81561747827838, 0.09999999999999777, 385.0, 1240, 544040, 750, 39.91119230000004
751, 5.08344092789032, 39.831727434060134, 47.90834118907053, 0.09999999999999766, 290.0, 1282, 545322, 751, 39.09509590000016
752, 5.473382803832342, 39.91720617983025, 48.02115612639347, 0.09999999999999845, 515.0, 1033, 546355, 752, 33.9290675000002
753, 2.9684652291059495, 39.84548681030273, 47.86849118041992, 0.10000000000000099, 140.0, 625, 546980, 753, 17.566629099999773
754, 6.692070764483024, 39.7950778889491, 47.94612803775172, 0.09999999999999855, 240.0, 1011, 547991, 754, 26.557540200000403
755, 5.713357480290203, 39.77644366935148, 47.82922243667861, 0.09999999999999885, 285.0, 944, 548935, 755, 31.691034299999956
756, 4.5558864769293645, 39.78874406360445, 47.85840913361194, 0.10000000000000031, 70.0, 714, 549649, 756, 26.674970799999755
757, 2.996199296598854, 39.98819802164549, 48.07833201296416, 0.10000000000000088, 110.0, 494, 550143, 757, 18.00071089999983
758, 4.47535405646671, 40.036026193638044, 48.113238185343114, 0.09999999999999971, 110.0, 792, 550935, 758, 23.02115379999941
759, 4.1210683367814225, 40.18962984935493, 48.35361026958296, 0.10000000000000099, 175.0, 628, 551563, 759, 18.704474399999526
760, 3.6502173604998287, 40.049318502908584, 48.17945820697471, 0.09999999999999888, 330.0, 937, 552500, 760, 28.30008749999979
761, 6.132994081919997, 40.10982301259964, 48.27704828206495, 0.09999999999999835, 260.0, 1059, 553559, 761, 30.594606800000292
762, 9.058892509656264, 40.311440487035966, 48.685731042951545, 0.10000000000000096, 50.0, 596, 554155, 762, 17.77519620000021
763, 3.7335623724815936, 40.21538558831582, 48.338189633993004, 0.09999999999999945, 215.0, 832, 554987, 763, 23.85406739999962
764, 3.6763398825176177, 40.16964840359158, 48.28963528587705, 0.10000000000000099, 175.0, 630, 555617, 764, 18.32667070000025
765, 9.441485479406335, 40.145563862540506, 48.47466404654763, 0.10000000000000081, 50.0, 440, 556057, 765, 16.159819499998775
766, 5.425910725917923, 40.03169779088688, 48.17949128652522, 0.10000000000000031, 170.0, 713, 556770, 766, 24.733547300000282
767, 3.1330156645245766, 40.04904118012846, 48.14026617200187, 0.10000000000000032, 185.0, 712, 557482, 767, 22.515251000000717
768, 4.6616149457489575, 40.0118446143339, 48.12654762991722, 0.10000000000000069, 70.0, 369, 557851, 768, 11.347594499999104
769, 3.4191680282191945, 40.069527912746224, 48.13938448886022, 0.0999999999999982, 205.0, 1101, 558952, 769, 35.61815470000147
770, 6.790137503848467, 40.16562601444473, 48.34681323800553, 0.10000000000000099, 235.0, 634, 559586, 770, 20.759440499999982
771, 3.8567462638020515, 39.957709809026774, 48.01211025870058, 0.10000000000000064, 125.0, 676, 560262, 771, 23.49185380000017
772, 6.4145303301431325, 39.70921356075413, 47.78759476378724, 0.10000000000000069, 50.0, 364, 560626, 772, 11.124320599999919
773, 6.709934466828902, 39.88260324796041, 48.03170282500131, 0.10000000000000062, 45.0, 336, 560962, 773, 10.921200200000385
774, 4.85467404922605, 39.78556310559407, 47.83114206582421, 0.09999999999999758, 245.0, 1315, 562277, 774, 36.01876450000054
775, 5.839734823198863, 39.79107275286925, 47.907851515464415, 0.10000000000000077, 75.0, 412, 562689, 775, 10.886055900000429
776, 5.216823982557765, 39.71558466664067, 47.788767125871445, 0.10000000000000092, 55.0, 648, 563337, 776, 17.78405489999932
777, 7.050887991467394, 39.595298795466974, 47.65571920575295, 0.09999999999999887, 125.0, 941, 564278, 777, 24.680467099999078
778, 6.838441990657776, 39.719580903870536, 47.7595253685708, 0.09999999999999722, 480.0, 1482, 565760, 778, 40.03184390000024
779, 6.092850275419451, 39.67402235922712, 47.76965004977468, 0.09999999999999745, 380.0, 1367, 567127, 779, 38.29782210000121
780, 5.023365016259007, 39.69927309837647, 47.714362577494505, 0.09999999999999813, 430.0, 1121, 568248, 780, 31.737215099999958
781, 6.856625314438066, 39.727951150347096, 47.85974683539812, 0.10000000000000095, 75.0, 645, 568893, 781, 18.27829869999914
782, 4.107411650731602, 39.62515202894568, 47.60733957545643, 0.0999999999999989, 220.0, 935, 569828, 782, 26.91370629999983
783, 4.386668474197462, 39.350458948986784, 47.29726505993013, 0.09999999999999964, 170.0, 802, 570630, 783, 23.330868799999735
784, 5.76224059886262, 39.410935733299354, 47.461901292876796, 0.1000000000000007, 40.0, 377, 571007, 784, 10.686159900000348
785, 3.039137734958959, 39.28921145460565, 47.21823161942798, 0.09999999999999996, 100.0, 757, 571764, 785, 20.288880099999005
786, 3.7063883395028223, 39.23289194894493, 47.20567816113113, 0.09999999999999921, 235.0, 872, 572636, 786, 24.06832570000006
787, 3.9530049412575003, 39.256215530017926, 47.18121127443716, 0.10000000000000055, 140.0, 687, 573323, 787, 19.031682800001363
788, 4.314400180774165, 39.265827265864374, 47.22263865707559, 0.0999999999999978, 365.0, 1229, 574552, 788, 35.24663599999985
789, 4.286048206928614, 39.20162079158362, 47.181713368964076, 0.09999999999999745, 280.0, 1369, 575921, 789, 39.256713599999784
790, 4.235576942622781, 39.267633036764444, 47.1440048447114, 0.10000000000000088, 20.0, 499, 576420, 790, 14.645837699999902
791, 2.820815595764369, 39.197917434840164, 47.11629652341976, 0.09999999999999949, 190.0, 826, 577246, 791, 25.417255500000465
792, 3.2349182553738953, 39.22332572171008, 47.1284007796322, 0.10000000000000088, 50.0, 498, 577744, 792, 14.363348699998824
793, 3.0563063005666358, 39.14658910054094, 47.052855004716854, 0.10000000000000078, 70.0, 662, 578406, 793, 19.16692090000106
794, 5.45661304336279, 39.329206767657126, 47.356015029528464, 0.0999999999999981, 250.0, 1128, 579534, 794, 32.977042900000015
795, 2.9018339003530866, 39.067301841593945, 46.93331375995248, 0.10000000000000044, 170.0, 699, 580233, 795, 20.323483000000124
796, 5.909924235474857, 38.888605338300586, 46.798713022573835, 0.10000000000000049, 180.0, 692, 580925, 796, 19.96917559999929
797, 3.3445666969535996, 38.924315214984375, 46.77113163860038, 0.0999999999999973, 485.0, 1441, 582366, 797, 42.205902499999866
798, 3.882609753397064, 38.975906623926335, 46.84165510463254, 0.09999999999999776, 485.0, 1242, 583608, 798, 36.62848660000054
799, 4.953172395419203, 38.90424148718931, 46.75898019576508, 0.10000000000000071, 45.0, 383, 583991, 799, 11.332616500001677
800, 3.600761836299882, 38.899011320757445, 46.81155396862143, 0.09999999999999938, 170.0, 845, 584836, 800, 24.66559899999993
801, 5.139080060488785, 38.93445531758035, 46.88789283784099, 0.10000000000000023, 60.0, 723, 585559, 801, 21.454430699999648
802, 4.56015862236192, 38.815670883061784, 46.65035115896057, 0.09999999999999841, 245.0, 1044, 586603, 802, 30.6167035999988
803, 3.5976644505087463, 38.82036200458517, 46.67550259453223, 0.0999999999999997, 110.0, 794, 587397, 803, 23.287061099999846
804, 7.95880042275411, 39.013841747694926, 46.9581713350843, 0.10000000000000081, 215.0, 659, 588056, 804, 20.05534710000029
805, 4.608393693256783, 38.920739057938185, 46.820723006008485, 0.09999999999999835, 240.0, 1061, 589117, 805, 31.397352099998898
806, 3.863755539736122, 38.9464553007439, 46.80736391342695, 0.09999999999999963, 190.0, 804, 589921, 806, 23.951337699998476
807, 3.9325046385668183, 39.18048263967854, 47.10126919332705, 0.09999999999999822, 470.0, 1095, 591016, 807, 32.43308820000129
808, 4.972646998606622, 39.224767906188966, 47.226399028778076, 0.09999999999999859, 265.0, 1000, 592016, 808, 29.770536199999697
809, 5.460195267942629, 39.20976117798327, 47.165254778435255, 0.09999999999999987, 190.0, 771, 592787, 809, 23.099267800000234
810, 5.221990978735048, 39.188633652984116, 47.06521259186468, 0.09999999999999844, 325.0, 1037, 593824, 810, 30.512886399999843
811, 3.1982097163607803, 39.0868063142028, 46.95728061531163, 0.10000000000000074, 65.0, 395, 594219, 811, 12.128446299999268
812, 2.532262698871883, 39.18371809311113, 47.11671507827879, 0.10000000000000071, 55.0, 381, 594600, 812, 11.67486370000006
813, 6.8811542306199165, 39.263237654978276, 47.30438580823019, 0.10000000000000094, 120.0, 646, 595246, 813, 19.008293899998534
814, 4.951234923042948, 39.160881708538724, 47.127921113513764, 0.10000000000000099, 125.0, 630, 595876, 814, 18.675216899999214
815, 5.608757636068848, 39.134393398454954, 47.06156007656036, 0.09999999999999791, 340.0, 1189, 597065, 815, 37.211198900000454
816, 7.685789759529035, 39.24190331449603, 47.22382594099139, 0.0999999999999996, 345.0, 808, 597873, 816, 24.02887120000014
817, 3.899929172672741, 39.206948393211114, 47.13118214176174, 0.0999999999999983, 225.0, 1073, 598946, 817, 32.56905139999981
818, 4.8323071905761585, 39.21325153713611, 47.17898337504362, 0.09999999999999842, 205.0, 1041, 599987, 818, 33.29605410000113
819, 5.684739992728094, 38.38623381467387, 46.25422520083801, 0.09999999999999913, 235.0, 887, 600874, 819, 31.352625600000465
820, 3.877707236436839, 38.28749776623913, 46.03704189587061, 0.10000000000000062, 115.0, 679, 601553, 820, 19.82934700000078
821, 4.842009055644794, 38.39057916264201, 46.17363264394361, 0.10000000000000053, 180.0, 688, 602241, 821, 20.854516899999
822, 4.930317960480272, 38.338516891834345, 46.14717774058497, 0.09999999999999928, 305.0, 860, 603101, 822, 26.497422300000835
823, 6.306743524750148, 38.42936415421335, 46.22402919683241, 0.09999999999999755, 255.0, 1330, 604431, 823, 39.906337899999926
824, 2.482325250577956, 38.35909432703906, 46.094051785988384, 0.10000000000000075, 75.0, 404, 604835, 824, 12.712923499999306
825, 4.542930265197265, 38.42016099352355, 46.206159800067354, 0.09999999999999788, 350.0, 1199, 606034, 825, 35.5046497000003
826, 3.891764723748531, 38.395009792422, 46.16772058428805, 0.10000000000000052, 80.0, 689, 606723, 826, 20.78437760000088
827, 5.632584764728277, 38.39486323428738, 46.17835283533326, 0.09999999999999887, 180.0, 939, 607662, 827, 28.839267900000777
828, 4.664668569247229, 38.473110877143014, 46.25862072646016, 0.09999999999999863, 385.0, 990, 608652, 828, 29.87017890000061
829, 5.526175202294815, 38.3927798930561, 46.19042271332276, 0.10000000000000055, 160.0, 687, 609339, 829, 21.28215470000032
830, 4.623013489562826, 38.29517727993725, 46.104462119370744, 0.10000000000000062, 120.0, 679, 610018, 830, 20.76505840000027
831, 2.826912434889546, 38.38472073390011, 46.10284109960629, 0.10000000000000085, 80.0, 474, 610492, 831, 14.367436999998972
832, 3.868788279231182, 38.14836004655138, 45.8848585567886, 0.10000000000000094, 60.0, 556, 611048, 832, 17.25989479999953
833, 6.303617544627035, 38.32754329334606, 46.1304117177988, 0.10000000000000071, 75.0, 385, 611433, 833, 12.014587499999834
834, 7.116808897172444, 38.43387477434279, 46.281277326197404, 0.10000000000000084, 60.0, 459, 611892, 834, 13.992607399999542
835, 5.268956410071002, 38.36652413238945, 46.16272468791729, 0.1000000000000009, 65.0, 509, 612401, 835, 15.781393000001117
836, 8.06103972899608, 38.3169729227354, 46.14404641393243, 0.10000000000000066, 50.0, 351, 612752, 836, 10.777162500000486
837, 7.21336489121266, 38.31451736630506, 46.12806905636583, 0.10000000000000063, 175.0, 677, 613429, 837, 21.225379299999986
838, 5.861736234837245, 38.39137809634826, 46.198273060853, 0.10000000000000073, 90.0, 386, 613815, 838, 12.1542429000001
839, 5.6101590699326085, 38.345527034935756, 46.07943634055943, 0.10000000000000069, 60.0, 671, 614486, 839, 20.696892399999342
840, 7.637500047057031, 38.34991185910234, 46.155621959412954, 0.10000000000000098, 140.0, 642, 615128, 840, 19.76355180000064
841, 4.012964510344542, 38.228585166197554, 45.943736813618585, 0.09999999999999842, 515.0, 1040, 616168, 841, 33.111005299999306
842, 3.9815726537543994, 38.288450323251574, 46.00576400756836, 0.1000000000000009, 170.0, 650, 616818, 842, 20.158320300000923
843, 5.0408724071638416, 38.27981337136554, 46.07528605226611, 0.10000000000000069, 175.0, 671, 617489, 843, 21.216224600000714
844, 6.093890721557065, 38.247664134479265, 46.050213864706095, 0.0999999999999995, 240.0, 824, 618313, 844, 26.094293000000107
845, 2.8516549807603395, 38.318791072604334, 46.03658693458891, 0.10000000000000098, 105.0, 617, 618930, 845, 19.067162299999836
846, 5.792250781508951, 38.29719314484692, 46.07805504578288, 0.0999999999999994, 290.0, 843, 619773, 846, 26.824025800000527
847, 3.8261520341865234, 38.35719477658038, 46.12227931075542, 0.10000000000000099, 110.0, 631, 620404, 847, 19.66479050000089
848, 4.359271222870998, 38.39215149580449, 46.183354150081755, 0.09999999999999902, 215.0, 909, 621313, 848, 28.033037500001228
849, 4.669099721598299, 38.33688135713203, 46.09560380352142, 0.09999999999999822, 175.0, 1095, 622408, 849, 34.90082470000016
850, 6.295098466549333, 38.358756832813654, 46.20899852842796, 0.09999999999999769, 410.0, 1270, 623678, 850, 40.38036359999933
851, 5.005052656744733, 38.34063737657335, 46.162919225810484, 0.0999999999999996, 180.0, 810, 624488, 851, 25.154601500000354
852, 3.3923747372195776, 38.2071427367753, 45.87787489457564, 0.10000000000000096, 135.0, 594, 625082, 852, 18.587522399999216
853, 2.8455780763114014, 38.30764509385345, 46.02274263002265, 0.0999999999999993, 145.0, 859, 625941, 853, 27.57890579999912
854, 2.9056624218821527, 38.321108281335164, 46.014169178452605, 0.1000000000000008, 75.0, 430, 626371, 854, 13.367231199999878
855, 4.847183518428302, 38.3425490187518, 46.107215092472586, 0.10000000000000066, 30.0, 353, 626724, 855, 11.237577899999451
856, 5.5001106813253084, 38.286936540235466, 46.05065506570514, 0.09999999999999964, 180.0, 803, 627527, 856, 25.290977600001497
857, 3.004064074440357, 38.268607024378426, 46.02889936562352, 0.0999999999999991, 280.0, 894, 628421, 857, 28.630672100000083
858, 6.522042689953259, 38.266451713650724, 46.07684791919797, 0.10000000000000053, 125.0, 688, 629109, 858, 21.66936480000004
859, 5.834313985082363, 38.27847168635281, 46.05848918801723, 0.10000000000000099, 100.0, 641, 629750, 859, 19.749342299999626
860, 5.176901553978663, 37.857753090130046, 45.583029652743654, 0.09999999999999706, 680.0, 1558, 631308, 860, 59.64178979999997
861, 6.475408230546643, 37.83794314440559, 45.57719817442052, 0.10000000000000063, 20.0, 340, 631648, 861, 11.74973940000018
862, 2.932390456653985, 37.72557649425432, 45.39646379620421, 0.10000000000000075, 110.0, 408, 632056, 862, 13.92488880000019
863, 4.2956682079136375, 37.78440540313721, 45.402224548339845, 0.10000000000000088, 85.0, 500, 632556, 863, 16.968667000001005
864, 2.735791099772169, 37.673127111413436, 45.25835561829105, 0.10000000000000099, 130.0, 621, 633177, 864, 20.40570160000061
865, 5.738433367564021, 37.603200900591794, 45.247954175479684, 0.10000000000000098, 100.0, 642, 633819, 865, 20.195970599999782
866, 4.2514879804807615, 37.77328331095218, 45.471865436670456, 0.09999999999999766, 500.0, 1277, 635096, 866, 42.887536200001705
867, 5.6522460385572675, 37.74627989012988, 45.42653820561428, 0.10000000000000031, 125.0, 714, 635810, 867, 24.440881500000614
868, 3.7279422420250925, 37.6933320041514, 45.30963776774426, 0.09999999999999787, 375.0, 1205, 637015, 868, 44.377478899999915
869, 4.599184735417366, 37.68112699720594, 45.292615814208986, 0.10000000000000082, 40.0, 450, 637465, 869, 16.031195699999444
870, 4.216076582174573, 37.76503860490005, 45.434515142645445, 0.09999999999999891, 185.0, 932, 638397, 870, 32.5301359999994
871, 5.863459014697227, 37.71331118374336, 45.39546526932135, 0.10000000000000084, 105.0, 656, 639053, 871, 27.033301699999356
872, 6.126726551029065, 37.735096577124075, 45.467120120810876, 0.09999999999999869, 260.0, 977, 640030, 872, 38.645327800000814
873, 4.122594114684597, 37.80392545466897, 45.41021092061737, 0.09999999999999808, 510.0, 1137, 641167, 873, 45.5129323000001
874, 2.8770160115961954, 37.679773623549096, 45.31481739104263, 0.1000000000000009, 105.0, 508, 641675, 874, 20.89704999999958
875, 3.047515946613573, 37.84313822420938, 45.462426929836916, 0.10000000000000057, 165.0, 683, 642358, 875, 28.14239930000076
876, 2.8596147030505206, 37.789378370260046, 45.420580712641865, 0.10000000000000055, 120.0, 687, 643045, 876, 26.613955500000884
877, 4.751686411524008, 37.767817542603886, 45.43179897042819, 0.09999999999999727, 480.0, 1451, 644496, 877, 59.07637199999954
878, 5.837043081128042, 37.821428508525685, 45.524814639583674, 0.09999999999999906, 250.0, 901, 645397, 878, 35.24079239999992
879, 3.813580990914839, 37.688255982226636, 45.32162134905896, 0.10000000000000075, 210.0, 664, 646061, 879, 25.380055300000095
880, 2.73732255971862, 37.779557473087515, 45.362988741281434, 0.10000000000000085, 80.0, 471, 646532, 880, 18.692599100000734
881, 5.1793564788527195, 37.81749884936274, 45.45966352912181, 0.09999999999999828, 270.0, 1078, 647610, 881, 42.470505299999786
882, 6.618086164853133, 37.78830064820849, 45.596912163348236, 0.10000000000000067, 120.0, 363, 647973, 882, 15.445184399999562
883, 8.701793450015513, 37.8608795852058, 45.61495181977042, 0.09999999999999855, 235.0, 1012, 648985, 883, 40.098044200000004
884, 2.756677477094379, 37.731617452802446, 45.296409606933594, 0.10000000000000056, 160.0, 685, 649670, 884, 31.4313205999988
885, 4.6283176797070125, 37.73905901738107, 45.449177271735245, 0.10000000000000067, 65.0, 363, 650033, 885, 14.242915799999537
886, 4.544517345844962, 38.026141055481176, 45.705529647665394, 0.09999999999999809, 475.0, 1132, 651165, 886, 35.50033499999881
887, 5.425787594659114, 38.18709197389499, 46.00568176900619, 0.10000000000000063, 160.0, 677, 651842, 887, 20.980906500000856
888, 5.490280501524607, 38.018210698445635, 45.70004268391927, 0.10000000000000002, 230.0, 750, 652592, 888, 24.361577700001362
889, 6.150026347678419, 37.932296765498705, 45.67353908155463, 0.10000000000000098, 135.0, 607, 653199, 889, 19.414444800000638
890, 4.7591758355519875, 38.02901117018439, 45.71744723395915, 0.1000000000000005, 150.0, 691, 653890, 890, 21.395744800000102
891, 5.56116863766044, 38.10023229196118, 45.80968480413034, 0.10000000000000063, 170.0, 677, 654567, 891, 21.81339520000074
892, 5.559442506912421, 38.012987061748355, 45.81305844014085, 0.1000000000000009, 80.0, 508, 655075, 892, 15.801685800000996
893, 5.677799929870088, 38.04268391008322, 45.80984070397526, 0.10000000000000049, 75.0, 692, 655767, 893, 22.272710299999744
894, 5.5439325472511225, 38.17873768332304, 45.93344066111724, 0.10000000000000091, 65.0, 533, 656300, 894, 20.334968799999842
895, 3.012340470817354, 38.04798629760742, 45.67054854781539, 0.10000000000000066, 140.0, 675, 656975, 895, 23.999794800000018
896, 5.9367244704727415, 38.09561352685509, 45.77523906459749, 0.10000000000000094, 200.0, 646, 657621, 896, 22.783087399999204
897, 4.0819636129259145, 38.01942629621208, 45.6974631733977, 0.09999999999999844, 455.0, 1038, 658659, 897, 37.202668600000834
898, 2.9206648019499313, 38.09311104712085, 45.76337935545734, 0.1000000000000008, 100.0, 428, 659087, 898, 15.245394999999917
899, 5.501903140469443, 38.054404101794276, 45.78579922768637, 0.09999999999999883, 135.0, 948, 660035, 899, 34.415988700000526
900, 5.795558882849311, 38.09126367507706, 45.842482809846864, 0.0999999999999989, 195.0, 934, 660969, 900, 33.1854887999998
901, 5.494570572329022, 38.13591448784831, 45.875509038253675, 0.0999999999999986, 210.0, 997, 661966, 901, 35.24884150000071
902, 4.988948295568116, 38.10369397997856, 45.82238131165504, 0.100000000000001, 70.0, 640, 662606, 902, 22.84898500000054
903, 5.9085781853080235, 38.18579468663379, 45.92179478474984, 0.09999999999999952, 230.0, 823, 663429, 903, 29.438961600000766
904, 5.654961147961085, 38.08230817628944, 45.825972150719686, 0.09999999999999896, 150.0, 920, 664349, 904, 35.28896619999978
905, 4.963337948783896, 38.199939027944005, 45.923958983457176, 0.10000000000000074, 215.0, 665, 665014, 905, 23.374052400000437
906, 4.292166538812496, 38.07668808360159, 45.78410266946863, 0.10000000000000092, 120.0, 648, 665662, 906, 22.534895799999504
907, 6.873095739494871, 38.13878969106164, 45.86436224572452, 0.10000000000000087, 195.0, 486, 666148, 907, 16.98912609999934
908, 6.151819911848964, 38.18563730117173, 45.976078609741684, 0.09999999999999848, 225.0, 1026, 667174, 908, 34.726831899999524
909, 3.7692719350199937, 37.99924385547638, 45.680440376389704, 0.09999999999999935, 205.0, 848, 668022, 909, 29.318497100000968
910, 5.01767839177046, 38.212952663501106, 45.969366908073425, 0.10000000000000071, 10.0, 384, 668406, 910, 13.069574700000885
911, 4.7912709244225535, 38.10781500012812, 45.81211726797565, 0.10000000000000055, 175.0, 686, 669092, 911, 25.012621200001377
912, 3.5657434559151446, 38.13075294281517, 45.83312530091355, 0.09999999999999909, 215.0, 895, 669987, 912, 36.35844189999989
913, 3.5777332170976703, 37.84744812986636, 45.44712847478225, 0.09999999999999933, 275.0, 853, 670840, 913, 31.989396599999964
914, 4.567428384266846, 37.847624542019894, 45.55334059803199, 0.10000000000000038, 100.0, 705, 671545, 914, 25.098759199998312
915, 5.535904255603348, 37.8523258804917, 45.622417335395696, 0.10000000000000074, 170.0, 666, 672211, 915, 23.20239269999911
916, 5.968376371036419, 38.00131627185993, 45.75686172445091, 0.10000000000000071, 50.0, 379, 672590, 916, 13.474776900000506
917, 5.074823935163317, 37.81169825014861, 45.4691704282109, 0.10000000000000096, 105.0, 644, 673234, 917, 23.249314900000172
918, 8.001131645221683, 37.99534387391398, 45.77405785225533, 0.10000000000000099, 150.0, 629, 673863, 918, 21.587788800001363
919, 2.7426772946839804, 37.815840542971436, 45.425134621085704, 0.09999999999999902, 230.0, 910, 674773, 919, 32.12898689999929
920, 6.704121606114699, 37.82536836526875, 45.569156511395576, 0.09999999999999906, 90.0, 902, 675675, 920, 31.2706390000003
921, 4.645255047708271, 37.87827674835083, 45.55011382734919, 0.0999999999999986, 430.0, 996, 676671, 921, 34.6127278999993
922, 8.494538223926632, 37.88952508608977, 45.6321945476389, 0.10000000000000073, 140.0, 667, 677338, 922, 23.00846559999991
923, 3.777683410180233, 37.7973851576084, 45.39941356240249, 0.10000000000000084, 100.0, 656, 677994, 923, 25.192412700000204
924, 2.9837168394849543, 37.86476692456878, 45.479364770182066, 0.10000000000000066, 50.0, 356, 678350, 924, 14.224324999999226
925, 4.205981232234796, 37.757659839188044, 45.42081036220172, 0.09999999999999942, 255.0, 837, 679187, 925, 29.163116800000353
926, 5.908754094171936, 37.97562626429966, 45.72157690626111, 0.10000000000000099, 150.0, 637, 679824, 926, 22.277284699999655
927, 3.668599965949172, 37.82542984886507, 45.47173511454489, 0.09999999999999905, 310.0, 904, 680728, 927, 31.736569199998485
928, 5.556782041100869, 37.87116098261591, 45.56764470570123, 0.09999999999999752, 385.0, 1340, 682068, 928, 47.27455849999933
929, 4.831809644825001, 37.84924981067178, 45.538429171756654, 0.09999999999999953, 135.0, 819, 682887, 929, 28.775560600000972
930, 2.902562991564596, 37.80930467260551, 45.41276642069891, 0.09999999999999824, 510.0, 1089, 683976, 930, 38.647711999999956
931, 5.083519761214198, 37.9289078435402, 45.63914951126145, 0.10000000000000085, 85.0, 654, 684630, 931, 22.97064379999938
932, 4.8362466461942, 37.860884877958185, 45.5275913861939, 0.09999999999999848, 270.0, 1028, 685658, 932, 36.538210299999264
933, 4.453164769325084, 37.89166897314566, 45.57449625745232, 0.10000000000000092, 120.0, 648, 686306, 933, 22.692979299999934
934, 5.4121995993434115, 37.93564727458548, 45.653097534179686, 0.10000000000000038, 180.0, 705, 687011, 934, 24.946320899998682
935, 3.0375949769201926, 37.89017427735409, 45.49371354054596, 0.10000000000000096, 30.0, 590, 687601, 935, 21.48262800000157
936, 4.34940369874239, 37.93819311609808, 45.576236429754296, 0.10000000000000091, 130.0, 530, 688131, 936, 18.589197100000092
937, 5.898083914913003, 37.84943999587101, 45.56198251911693, 0.09999999999999865, 245.0, 987, 689118, 937, 34.97796749999907
938, 4.302349912431387, 37.978226389203755, 45.67320002449883, 0.10000000000000088, 55.0, 504, 689622, 938, 18.70555779999995
939, 4.659328484662941, 37.84011861256191, 45.52186529432024, 0.10000000000000042, 45.0, 700, 690322, 939, 25.425837700000557
940, 4.4139159312997105, 37.83266600584373, 45.48077189127604, 0.10000000000000073, 20.0, 390, 690712, 940, 13.903866199998447
941, 4.557608034962799, 37.6900301593089, 45.37944623601367, 0.10000000000000057, 150.0, 684, 691396, 941, 24.67669940000087
942, 6.194328411337583, 37.87124695558777, 45.639523512424994, 0.09999999999999899, 165.0, 914, 692310, 942, 30.166442800000368
943, 4.683858324247082, 37.858270503967766, 45.57530157735029, 0.10000000000000099, 170.0, 635, 692945, 943, 21.47382109999853
944, 4.423998880159596, 37.71446812671164, 45.329717801964804, 0.10000000000000069, 45.0, 368, 693313, 944, 12.858214300000327
945, 6.5596837800512295, 37.78909046678658, 45.51463925120342, 0.10000000000000075, 110.0, 664, 693977, 945, 21.94876590000058
946, 3.075209849674446, 37.86470920297675, 45.462331725751525, 0.10000000000000078, 190.0, 662, 694639, 946, 21.994605500000034
947, 6.2807394852776985, 37.862399920995585, 45.625659967429925, 0.09999999999999988, 160.0, 769, 695408, 947, 26.197779000000082
948, 4.930964935666052, 37.90271317019447, 45.607137758379906, 0.09999999999999906, 185.0, 901, 696309, 948, 30.315250800000285
949, 5.757908244384986, 37.8774131364626, 45.567917214923916, 0.09999999999999921, 160.0, 874, 697183, 949, 34.07663119999961
950, 3.3031373696244177, 37.75582018800043, 45.37123420297803, 0.09999999999999858, 350.0, 1005, 698188, 950, 38.53164959999958
951, 5.396496496891576, 37.85539928572233, 45.48889570416144, 0.10000000000000085, 50.0, 477, 698665, 951, 18.61018839999997
952, 4.899278631517964, 37.866909947549146, 45.52245611867597, 0.09999999999999984, 190.0, 775, 699440, 952, 29.80090630000086
953, 2.8069525403044526, 37.904469762529644, 45.58147897417583, 0.10000000000000088, 90.0, 504, 699944, 953, 19.8703278999983
954, 5.159605237508908, 37.69725878133714, 45.340465893535495, 0.10000000000000099, 170.0, 636, 700580, 954, 24.56270459999905
955, 4.633902150114028, 37.57531481733718, 45.15830057649948, 0.10000000000000099, 150.0, 626, 701206, 955, 23.804788199999166
956, 7.628878198433582, 37.66578819169427, 45.37665811705699, 0.09999999999999826, 385.0, 1085, 702291, 956, 41.24775319999935
957, 6.562506895230322, 37.707955135426054, 45.446962564763886, 0.09999999999999808, 525.0, 1136, 703427, 957, 43.60858449999978
958, 2.9335013469777156, 37.58792091098711, 45.148407248970024, 0.09999999999999921, 230.0, 873, 704300, 958, 33.38036850000026
959, 6.397338105537595, 37.64322935537185, 45.31775631382097, 0.09999999999999801, 305.0, 1159, 705459, 959, 43.90922580000006
960, 5.83188772073423, 37.609217263223336, 45.2625372286432, 0.09999999999999788, 375.0, 1198, 706657, 960, 46.62114219999967
961, 4.313595130175047, 37.61297124834462, 45.200413622546925, 0.09999999999999919, 270.0, 879, 707536, 961, 33.888371999999436
962, 4.6827524386249015, 37.700879837501205, 45.31207468063288, 0.10000000000000052, 150.0, 689, 708225, 962, 26.421284199999718
963, 4.700638673740105, 37.61503151562454, 45.24527238849444, 0.09999999999999837, 420.0, 1054, 709279, 963, 40.64193829999931
964, 5.134806780608005, 37.609573455518515, 45.27711293800026, 0.09999999999999944, 155.0, 836, 710115, 964, 32.46550670000033
965, 8.570202046528806, 37.629866159635526, 45.40390734498287, 0.10000000000000098, 155.0, 602, 710717, 965, 23.54146849999961
966, 3.6535154523620545, 37.789455169005414, 45.41260360483922, 0.09999999999999841, 320.0, 1044, 711761, 966, 40.768944100000226
967, 4.0056433969944525, 37.79834062678504, 45.48224995030153, 0.0999999999999982, 525.0, 1101, 712862, 967, 42.84025130000009
968, 3.874174083835683, 37.86998295237017, 45.541509893419935, 0.10000000000000009, 130.0, 741, 713603, 968, 29.255826399999933
969, 5.039841804040253, 37.81346657991739, 45.50450351393239, 0.09999999999999729, 345.0, 1446, 715049, 969, 57.632056999998895
970, 4.930161533573981, 37.76411426243802, 45.43125573356452, 0.09999999999999686, 445.0, 1689, 716738, 970, 72.98266390000026
971, 2.4493133030478624, 37.78431855798037, 45.38643499852303, 0.10000000000000081, 110.0, 443, 717181, 971, 23.931117500000255
972, 2.862033292456135, 37.83339562341181, 45.43872966067329, 0.10000000000000071, 45.0, 382, 717563, 972, 18.219100800000888
973, 4.511222805684207, 37.77565057030476, 45.4228660433131, 0.09999999999999798, 275.0, 1167, 718730, 973, 54.274437000000034
974, 5.000455866985935, 37.71461517956792, 45.370972510097786, 0.09999999999999795, 320.0, 1176, 719906, 974, 80.98067340000125
975, 3.721299408403812, 38.0890529844496, 45.7577086130778, 0.10000000000000092, 90.0, 540, 720446, 975, 37.690111900001284
976, 6.576235383434903, 38.12174109865803, 45.913162427648125, 0.09999999999999792, 365.0, 1186, 721632, 976, 61.840766299999814
977, 5.818361561113131, 38.14435945300881, 45.92391094592733, 0.09999999999999921, 160.0, 872, 722504, 977, 46.54340869999942
978, 4.943667246588045, 38.044729612974486, 45.780514116343376, 0.09999999999999791, 350.0, 1189, 723693, 978, 62.811923000001116
979, 4.83512451367598, 38.12289616402159, 45.87123562089095, 0.0999999999999981, 285.0, 1128, 724821, 979, 62.02462469999955
980, 3.4030309849558327, 38.01530485433257, 45.68745302969742, 0.09999999999999763, 380.0, 1294, 726115, 980, 71.85301029999937
981, 4.298855508285956, 38.11030860833901, 45.84097346665853, 0.09999999999999773, 485.0, 1253, 727368, 981, 67.73443309999857
982, 4.024656506791001, 38.12358419145857, 45.85129313151042, 0.0999999999999984, 395.0, 1050, 728418, 982, 56.63519749999978
983, 5.859612928575088, 38.03264287419381, 45.78390260337673, 0.0999999999999983, 385.0, 1074, 729492, 983, 58.26300809999884
984, 4.955756299878002, 37.81397741398913, 45.453176579576855, 0.0999999999999981, 240.0, 1128, 730620, 984, 61.23136870000053
985, 4.906222601002648, 37.63956745626473, 45.2424398916453, 0.09999999999999865, 255.0, 988, 731608, 985, 56.82999610000115
986, 5.632845803946681, 37.706304381715604, 45.340705811807574, 0.10000000000000041, 115.0, 702, 732310, 986, 46.141419499999756
987, 4.4142067417538655, 37.6078072754426, 45.23147216852564, 0.09999999999999952, 230.0, 822, 733132, 987, 48.462613199999396
988, 6.17624048183581, 37.71881148441607, 45.400658295608345, 0.09999999999999881, 250.0, 951, 734083, 988, 61.4830493999998
989, 6.613733778731929, 37.663661793216626, 45.32312097009072, 0.10000000000000087, 120.0, 653, 734736, 989, 39.238763800000015
990, 3.9604391592065635, 37.60503885008448, 45.19869805754517, 0.0999999999999974, 600.0, 1390, 736126, 990, 81.33425400000124
991, 4.138113161090945, 37.695171606345255, 45.42093803530834, 0.10000000000000098, 135.0, 610, 736736, 991, 41.43014559999938
992, 4.897634180108453, 37.66896806097334, 45.30014544687453, 0.10000000000000099, 90.0, 628, 737364, 992, 100.97000549999939
993, 4.829694958378776, 37.5767861926077, 45.19922254646257, 0.09999999999999841, 260.0, 1046, 738410, 993, 101.81937389999985
994, 5.730481766005164, 37.64306379151576, 45.27531146447635, 0.1000000000000009, 145.0, 515, 738925, 994, 107.61121159999857
995, 3.880208047203858, 37.47601706226211, 45.086916799789385, 0.09999999999999809, 260.0, 1133, 740058, 995, 165.66207769999892
996, 4.880527636556326, 37.22395747760777, 44.7850996533013, 0.09999999999999908, 130.0, 899, 740957, 996, 155.4685055000009
997, 8.22725237680204, 36.939776333895594, 44.53011493315053, 0.10000000000000067, 30.0, 363, 741320, 997, 19.839631999999256
998, 4.733975839923463, 37.229920417441846, 44.78282459584544, 0.09999999999999842, 325.0, 1043, 742363, 998, 43.2930168999992
999, 4.262498731647308, 37.29229385654131, 44.7787794801924, 0.10000000000000095, 80.0, 576, 742939, 999, 24.618605600000592
1000, 5.283026167545779, 37.182712429308495, 44.69020534579077, 0.09999999999999828, 300.0, 1078, 744017, 1000, 45.14502920000086
1001, 5.452167415633517, 37.18581260313095, 44.762234619964076, 0.09999999999999781, 345.0, 1223, 745240, 1001, 50.1702693999996
1002, 5.527331097839187, 37.08595378126078, 44.58826804279688, 0.09999999999999963, 210.0, 804, 746044, 1002, 33.08800979999978
1003, 5.233937585325489, 37.31547450041876, 44.834522370189035, 0.09999999999999745, 645.0, 1366, 747410, 1003, 57.01466719999917
1004, 2.804122498337347, 37.18135982950817, 44.69975207678984, 0.10000000000000052, 185.0, 689, 748099, 1004, 31.701841199999762
1005, 6.363312847386315, 37.19704489692105, 44.77602624734771, 0.09999999999999787, 285.0, 1204, 749303, 1005, 130.45855010000014
1006, 2.7685237196968178, 37.27070231037088, 44.7433827407961, 0.10000000000000069, 85.0, 369, 749672, 1006, 60.938717500001076
1007, 6.036045798288795, 36.88705764558959, 44.41539698551294, 0.09999999999999815, 355.0, 1118, 750790, 1007, 178.4567618000001
1008, 5.272157719135997, 36.75338620774484, 44.22124918339926, 0.09999999999999944, 210.0, 836, 751626, 1008, 62.67149440000139
1009, 6.368757437578021, 36.78639848016853, 44.31163919866542, 0.10000000000000087, 170.0, 653, 752279, 1009, 41.62829790000069
1010, 6.045345884136329, 36.73493634329902, 44.204622287942904, 0.09999999999999971, 185.0, 792, 753071, 1010, 42.366224900000816
1011, 5.864930701363087, 36.66966006469727, 44.12537213134765, 0.10000000000000099, 25.0, 625, 753696, 1011, 27.068977599999926
1012, 4.3004375590486115, 36.78584661218288, 44.21420892556168, 0.0999999999999989, 160.0, 934, 754630, 1012, 39.67004679999991
1013, 4.729615004921379, 36.80618802485319, 44.24828730146148, 0.10000000000000057, 190.0, 683, 755313, 1013, 30.738051399997858
1014, 4.715077789882863, 36.717096912009374, 44.14708715677261, 0.09999999999999751, 525.0, 1344, 756657, 1014, 58.636386300000595
1015, 4.511567990282091, 36.72915578061256, 44.16988764292952, 0.09999999999999819, 305.0, 1104, 757761, 1015, 48.89533490000031
1016, 3.9067012743110867, 36.78025372013165, 44.211149404003365, 0.10000000000000099, 100.0, 628, 758389, 1016, 27.08679470000061
1017, 6.809718894097131, 36.792994238309554, 44.340287103903535, 0.10000000000000092, 35.0, 647, 759036, 1017, 28.71212039999955
1018, 4.350214595112108, 36.6244771945092, 44.0491255335654, 0.09999999999999984, 165.0, 775, 759811, 1018, 33.426729999999225
1019, 3.0435099199205684, 36.67159856200033, 44.06988240623178, 0.10000000000000096, 120.0, 643, 760454, 1019, 28.213250400000106
1020, 5.397861508693628, 36.800486887624125, 44.281689485232675, 0.10000000000000088, 65.0, 499, 760953, 1020, 22.231072299997322
1021, 7.874567334145136, 36.75652286507575, 44.24942615530999, 0.10000000000000091, 90.0, 521, 761474, 1021, 22.5136093000001
1022, 3.2228883478458563, 36.637408942043194, 43.99577918477578, 0.10000000000000088, 80.0, 505, 761979, 1022, 22.95210319999751
1023, 5.84767739038421, 36.62784802841242, 44.13775445653051, 0.09999999999999952, 195.0, 823, 762802, 1023, 35.68941189999896
1024, 5.939822504224267, 36.86677714893653, 44.37712020874024, 0.0999999999999997, 115.0, 795, 763597, 1024, 34.84670069999993
1025, 4.626238471680935, 36.6751244518335, 44.067152683862076, 0.09999999999999794, 370.0, 1181, 764778, 1025, 52.10189330000139
1026, 7.51915335567248, 36.6878234768702, 44.214204781452345, 0.09999999999999937, 265.0, 847, 765625, 1026, 36.567695300000196
1027, 4.0456634526966075, 36.56164848668494, 43.95614081190566, 0.09999999999999838, 295.0, 1052, 766677, 1027, 50.94133040000088
1028, 5.463952420900266, 36.709386667918636, 44.13329075464134, 0.09999999999999724, 555.0, 1464, 768141, 1028, 64.76880309999979
1029, 5.165295812737068, 36.709706339244526, 44.13964558930675, 0.09999999999999752, 355.0, 1338, 769479, 1029, 59.565931099998124
1030, 6.1285236723994085, 36.62949564069977, 44.111247077662284, 0.10000000000000071, 85.0, 382, 769861, 1030, 16.834675400001288
1031, 4.639061909177039, 36.546354444149344, 43.96847176706972, 0.09999999999999742, 355.0, 1383, 771244, 1031, 60.44959190000009
1032, 5.711047906764261, 36.66159830617381, 44.133450845571666, 0.10000000000000082, 25.0, 455, 771699, 1032, 20.096166199997242
1033, 4.332142523664004, 36.52594497182887, 43.936725898847975, 0.09999999999999969, 155.0, 797, 772496, 1033, 35.54260830000203
1034, 4.768853023482923, 36.58969972533757, 44.03487341744559, 0.10000000000000024, 95.0, 721, 773217, 1034, 32.1337609000002
1035, 4.990103786991488, 36.5773549096986, 44.04905120275354, 0.10000000000000094, 20.0, 558, 773775, 1035, 25.90298629999961
1036, 4.134602407749364, 36.64071406834368, 44.076014656951465, 0.10000000000000094, 45.0, 552, 774327, 1036, 25.005334200002835
1037, 6.8273946361398785, 36.524230199416884, 43.908200578641164, 0.09999999999999974, 285.0, 788, 775115, 1037, 36.116144700001314
1038, 4.0029701097762285, 36.62858638682949, 44.05901525795208, 0.09999999999999883, 105.0, 948, 776063, 1038, 43.08500360000107
1039, 5.141817739536997, 36.61517868482998, 44.01156179615528, 0.09999999999999926, 185.0, 865, 776928, 1039, 38.72617309999987
1040, 4.818911056859153, 36.59770697094145, 44.03691356113979, 0.10000000000000091, 115.0, 525, 777453, 1040, 23.808881699998892
1041, 4.156059263007982, 36.54939571380615, 43.96887761797224, 0.10000000000000064, 55.0, 350, 777803, 1041, 15.944346199998108
1042, 4.762336247678225, 36.620902595065886, 44.06170346339544, 0.09999999999999751, 380.0, 1344, 779147, 1042, 60.82308800000101
1043, 4.991605313043542, 36.58980286735849, 44.004618969160255, 0.09999999999999983, 170.0, 776, 779923, 1043, 34.944376499999635
1044, 3.972952814224198, 36.10186680771235, 43.38952667356476, 0.10000000000000099, 105.0, 635, 780558, 1044, 29.698253300000943
1045, 4.286862492592064, 36.169092933418824, 43.523446930560866, 0.10000000000000087, 80.0, 485, 781043, 1045, 22.93824609999865
1046, 4.7120768982721, 36.092070456326866, 43.40394980143132, 0.09999999999999944, 90.0, 836, 781879, 1046, 38.40202340000178
1047, 6.10420774975022, 36.07774262645393, 43.39524368813629, 0.09999999999999792, 540.0, 1186, 783065, 1047, 59.56399650000094
1048, 2.855850059357194, 35.92493172450695, 43.15021057542798, 0.10000000000000094, 35.0, 553, 783618, 1048, 26.762122200001613
1049, 4.0183051224149136, 36.150485958838416, 43.49603057234255, 0.1000000000000009, 95.0, 511, 784129, 1049, 23.28330900000219
1050, 4.974387584518695, 36.123109980597015, 43.452479586393935, 0.10000000000000052, 185.0, 690, 784819, 1050, 30.30001280000215
1051, 4.625323356423422, 36.04252194377864, 43.306881268224984, 0.09999999999999831, 340.0, 1070, 785889, 1051, 48.084678899998835
1052, 4.829570643069977, 36.09331611639178, 43.42232720326569, 0.09999999999999762, 420.0, 1298, 787187, 1052, 61.769260199998826
1053, 5.640358529517866, 36.12675070106437, 43.51968724428696, 0.10000000000000085, 135.0, 654, 787841, 1053, 28.997215200000937
1054, 3.8752960668383802, 36.04226197606977, 43.32324817252424, 0.10000000000000099, 105.0, 631, 788472, 1054, 28.717644799999107
1055, 6.977912418308301, 36.12697349824517, 43.471686564311725, 0.09999999999999819, 380.0, 1105, 789577, 1055, 48.928313000000344
1056, 6.242510105585417, 36.186793605361984, 43.52786380444948, 0.100000000000001, 80.0, 638, 790215, 1056, 30.808923000000505
1057, 6.110042762305908, 36.241406581523336, 43.606190793753086, 0.09999999999999808, 580.0, 1138, 791353, 1057, 49.07553380000172
1058, 4.4670452214682355, 36.16008385029245, 43.504403118377034, 0.09999999999999795, 135.0, 1175, 792528, 1058, 50.42998930000249
1059, 5.005843665940682, 36.11130717332939, 43.420151270128535, 0.10000000000000085, 80.0, 654, 793182, 1059, 31.745546099999046
1060, 5.674705456155058, 36.21857795008906, 43.600532344743314, 0.09999999999999898, 160.0, 918, 794100, 1060, 37.7497650999976
1061, 2.8258584911850364, 36.075584732402454, 43.37423322851008, 0.10000000000000081, 95.0, 440, 794540, 1061, 17.395376500000566
1062, 5.58456913639013, 36.08539098190935, 43.45823732663507, 0.10000000000000017, 95.0, 730, 795270, 1062, 31.742868599998474
1063, 3.918167203124012, 36.11934128307527, 43.39269948005676, 0.09999999999999863, 305.0, 992, 796262, 1063, 40.51693790000354
1064, 4.40235553895491, 36.21915409132108, 43.56213934895628, 0.09999999999999741, 315.0, 1388, 797650, 1064, 58.95066630000292
1065, 5.7634490312575695, 36.224155811348346, 43.63320971016932, 0.10000000000000074, 65.0, 396, 798046, 1065, 19.050149599999713
1066, 2.8655250720167285, 36.11370678553506, 43.37007644693688, 0.10000000000000071, 110.0, 378, 798424, 1066, 17.515019700000266
1067, 4.415403976221102, 36.15025919795515, 43.45415144847579, 0.0999999999999986, 225.0, 996, 799420, 1067, 48.5809193999994
1068, 6.916594908115822, 36.34859658880373, 43.74341040115516, 0.09999999999999878, 180.0, 958, 800378, 1068, 45.2903570999988
1069, 8.828042674177357, 36.82682737653106, 44.44677227273638, 0.09999999999999826, 315.0, 1084, 801462, 1069, 44.17809569999736
1070, 4.5625209292786515, 36.55703838643508, 43.99051599584541, 0.10000000000000045, 105.0, 698, 802160, 1070, 29.288720500000636
1071, 6.95279221583337, 36.83281714699485, 44.28017920019792, 0.0999999999999989, 335.0, 935, 803095, 1071, 36.97634449999896
1072, 4.719742247682821, 36.733158867997055, 44.17496563587515, 0.09999999999999837, 215.0, 1054, 804149, 1072, 42.86960800000088
1073, 4.861294076326651, 36.76149162191947, 44.18971064219887, 0.10000000000000057, 110.0, 683, 804832, 1073, 27.071921999999176
1074, 3.840450720419773, 36.769630973155685, 44.20656193831028, 0.10000000000000099, 140.0, 624, 805456, 1074, 25.0304670000005
1075, 4.077353699025901, 36.771768151988155, 44.2112921606976, 0.10000000000000095, 105.0, 575, 806031, 1075, 22.552578300001187
1076, 6.498984125428348, 36.78758087919451, 44.275594897386505, 0.09999999999999906, 400.0, 902, 806933, 1076, 37.15844129999823
1077, 4.344539257914514, 36.710650226954, 44.122404561933045, 0.10000000000000073, 35.0, 391, 807324, 1077, 16.085755200001586
1078, 6.0542331989078475, 36.782458815972014, 44.29234811067581, 0.09999999999999877, 230.0, 960, 808284, 1078, 40.989338399998815
1079, 3.653859494102439, 36.78769313632034, 44.250249091721585, 0.09999999999999992, 115.0, 762, 809046, 1079, 31.36409249999997
1080, 5.976116447069361, 36.66732310065561, 44.12869462895926, 0.09999999999999962, 280.0, 806, 809852, 1080, 36.05478139999832
1081, 7.340264068932586, 36.379773808051695, 43.79251091418255, 0.09999999999999769, 290.0, 1269, 811121, 1081, 61.66067420000036
1082, 3.8991621220398933, 36.24227855694039, 43.56392581018104, 0.10000000000000085, 90.0, 654, 811775, 1082, 29.89761129999897
1083, 4.214268554173983, 36.292521165375014, 43.6520263541458, 0.10000000000000096, 125.0, 585, 812360, 1083, 25.320345899999666
1084, 2.6598014275585937, 36.22061227904964, 43.51696017308889, 0.10000000000000074, 65.0, 394, 812754, 1084, 16.650384399999894
1085, 6.191564605037371, 36.24003491210937, 43.6400048828125, 0.1000000000000007, 85.0, 375, 813129, 1085, 16.006537799999933
1086, 3.840631981167877, 36.249313948447245, 43.573755381400126, 0.099999999999999, 165.0, 912, 814041, 1086, 38.55427520000012
1087, 4.322877189742271, 36.30150688969812, 43.62273256168809, 0.09999999999999928, 440.0, 860, 814901, 1087, 38.390952699999616
1088, 5.842387003765407, 36.27902910839179, 43.64577590155397, 0.10000000000000045, 120.0, 698, 815599, 1088, 34.484131799999886
1089, 5.059393657276751, 36.3384660920155, 43.69155868793608, 0.09999999999999842, 195.0, 1043, 816642, 1089, 49.98600830000214
1090, 2.7513382413622796, 36.26544386613971, 43.57584488008508, 0.10000000000000087, 170.0, 653, 817295, 1090, 30.645747599999595
1091, 6.208044432162184, 36.36845215270936, 43.74557785903541, 0.09999999999999852, 350.0, 1018, 818313, 1091, 44.5331256999998
1092, 3.5837133278711195, 36.384588141039195, 43.734867756625256, 0.10000000000000075, 50.0, 664, 818977, 1092, 28.636007500001142
1093, 5.865433184908205, 36.28212788717109, 43.634237792804385, 0.09999999999999816, 230.0, 1114, 820091, 1093, 46.43227520000073
1094, 5.3692978183896125, 36.1001418844446, 43.47328398134801, 0.09999999999999779, 370.0, 1232, 821323, 1094, 55.15117610000016
1095, 4.960770268975957, 36.025370907929776, 43.355156398843405, 0.09999999999999956, 200.0, 815, 822138, 1095, 39.62508749999688
1096, 5.9139238374408825, 36.03642435887063, 43.35770166678022, 0.10000000000000095, 70.0, 645, 822783, 1096, 29.302760200000193
1097, 5.7589037266969685, 36.085050375802176, 43.42854850115095, 0.0999999999999992, 300.0, 875, 823658, 1097, 40.37964210000064
1098, 4.408927720421614, 36.050461372928595, 43.36042815055891, 0.09999999999999924, 140.0, 869, 824527, 1098, 45.08068790000107
1099, 4.6011498823851165, 36.03805576541467, 43.321787817035606, 0.10000000000000071, 170.0, 668, 825195, 1099, 29.720720499997697
1100, 4.826418201484433, 36.036696691789004, 43.351375421000434, 0.09999999999999734, 310.0, 1417, 826612, 1100, 59.69355060000089
1101, 4.9146586015022615, 35.899993220217496, 43.17420486361866, 0.1000000000000005, 140.0, 691, 827303, 1101, 28.617142000002787
1102, 5.036882715974535, 35.96692202758789, 43.26386392211914, 0.0999999999999992, 540.0, 875, 828178, 1102, 38.795209500000055
1103, 3.9961944348140945, 36.08429695144901, 43.38909663223639, 0.10000000000000087, 100.0, 492, 828670, 1103, 20.824302799999714
1104, 3.893531095363059, 35.95018985316438, 43.20380202239414, 0.10000000000000091, 25.0, 530, 829200, 1104, 23.3259887000022
1105, 2.7732701572443705, 36.02346839674984, 43.26582566801324, 0.10000000000000075, 155.0, 664, 829864, 1105, 31.048057699998026
1106, 6.266845138422886, 36.2961171278313, 43.70757208677074, 0.09999999999999858, 265.0, 1005, 830869, 1106, 43.331806199999846
1107, 5.579637674201109, 36.37947928163056, 43.809442502211176, 0.09999999999999684, 550.0, 1702, 832571, 1107, 77.09662080000271
1108, 3.6664479853821472, 36.43403266047088, 43.75357727802975, 0.10000000000000034, 130.0, 710, 833281, 1108, 31.173793199999636
1109, 4.018707868176985, 36.449572451581176, 43.8577402915692, 0.09999999999999852, 175.0, 1017, 834298, 1109, 45.45260010000129
1110, 4.980243688749218, 36.42944272409156, 43.79415581906207, 0.09999999999999767, 425.0, 1273, 835571, 1110, 60.0619351000023
1111, 5.545498551666121, 36.32419210624476, 43.72417756090482, 0.09999999999999923, 195.0, 871, 836442, 1111, 36.190679600000294
1112, 8.770526425622183, 36.42822865192397, 43.909365427309616, 0.10000000000000034, 145.0, 711, 837153, 1112, 29.867033300000912
1113, 7.328746068524197, 36.40453592755578, 43.82797113873742, 0.1000000000000004, 140.0, 704, 837857, 1113, 29.013305099997524
1114, 8.033444159016478, 36.358900631175324, 43.77069011279043, 0.09999999999999926, 195.0, 867, 838724, 1114, 37.36689810000098
1115, 3.739080644553391, 36.418860138916386, 43.812415285808285, 0.10000000000000084, 75.0, 656, 839380, 1115, 27.483426699996926
1116, 6.962790115632243, 36.26043615179547, 43.64395667900473, 0.10000000000000096, 50.0, 590, 839970, 1116, 25.896001400000387
1117, 4.126077633406601, 36.31758788015328, 43.668903491450294, 0.09999999999999767, 275.0, 1275, 841245, 1117, 53.726559599999746
1118, 3.0832095018759067, 36.338184091996176, 43.65284887041364, 0.10000000000000087, 115.0, 490, 841735, 1118, 21.11457480000172
1119, 6.059887467032414, 36.22537938715738, 43.6391939683394, 0.10000000000000077, 60.0, 418, 842153, 1119, 17.56232159999854
1120, 5.286221507619194, 36.40215134363071, 43.7765988811296, 0.09999999999999945, 165.0, 833, 842986, 1120, 35.52448579999691
1121, 6.013021645182139, 36.34837792136452, 43.72728802569501, 0.10000000000000071, 65.0, 385, 843371, 1121, 18.16550179999831
1122, 4.195522343789318, 36.34836806660205, 43.72288305991519, 0.09999999999999905, 175.0, 904, 844275, 1122, 38.045783499997924
1123, 4.058023004063348, 36.40091211338808, 43.76183493105476, 0.10000000000000067, 150.0, 673, 844948, 1123, 27.864338299998053
1124, 4.533225682827662, 36.37163279071544, 43.76796664351937, 0.0999999999999997, 200.0, 795, 845743, 1124, 34.854299300001
1125, 3.7393613842205475, 36.39029163021152, 43.77000279345755, 0.10000000000000085, 65.0, 472, 846215, 1125, 20.28323729999829
1126, 6.498241638121156, 36.343193148346224, 43.70356166776835, 0.10000000000000092, 75.0, 547, 846762, 1126, 23.038963899998635
1127, 5.093896775840576, 36.28440475463867, 43.62922324115083, 0.10000000000000091, 40.0, 524, 847286, 1127, 22.65700520000246
1128, 4.20057056542385, 36.31470515214428, 43.67313259848515, 0.09999999999999738, 445.0, 1402, 848688, 1128, 61.71637570000166
1129, 3.798990266849077, 36.36337077225605, 43.73694920975456, 0.09999999999999952, 135.0, 821, 849509, 1129, 34.48728719999781
1130, 5.759577934033565, 36.3632655080534, 43.77439455641914, 0.10000000000000062, 190.0, 679, 850188, 1130, 29.6945444999983
1131, 4.312145945877698, 36.04390182495117, 43.374022864192895, 0.09999999999999926, 195.0, 865, 851053, 1131, 39.88316080000004
1132, 6.057115177985261, 36.08392736038875, 43.44389567349126, 0.10000000000000016, 240.0, 732, 851785, 1132, 31.128538600001775
1133, 4.560699380678303, 36.04516876562861, 43.38856263925101, 0.0999999999999984, 420.0, 1048, 852833, 1133, 45.79028349999862
1134, 5.088996819029951, 35.843644153076774, 43.15668855907484, 0.09999999999999781, 670.0, 1222, 854055, 1134, 52.24830610000208
1135, 5.276506818606201, 36.038896505259935, 43.30039196760295, 0.09999999999999909, 235.0, 895, 854950, 1135, 37.92138640000121
1136, 5.515833126323727, 36.03539398266719, 43.35743249012874, 0.10000000000000091, 175.0, 520, 855470, 1136, 23.080137600001763
1137, 7.198845412264725, 36.019037863183094, 43.39677127684949, 0.0999999999999985, 255.0, 1021, 856491, 1137, 44.971016299998155
1138, 3.487623428112284, 35.961619018780844, 43.215292224701116, 0.09999999999999805, 235.0, 1147, 857638, 1138, 51.393508199998905
1139, 5.746909389730679, 35.971293756475, 43.241948457288494, 0.09999999999999991, 195.0, 764, 858402, 1139, 33.849209100000735
1140, 4.102262515777891, 35.94700129075484, 43.28700773065741, 0.10000000000000094, 60.0, 550, 858952, 1140, 23.482796499996766
1141, 5.54518773380693, 35.99515949262606, 43.32521328559289, 0.10000000000000095, 95.0, 572, 859524, 1141, 25.83649779999905
1142, 5.83200248257417, 35.66836677505554, 42.93797917880326, 0.09999999999999717, 455.0, 1502, 861026, 1142, 64.67166110000107
1143, 8.931511356747693, 35.598304956651134, 42.9513629117458, 0.09999999999999945, 145.0, 834, 861860, 1143, 35.563575399999536
1144, 3.620224214834959, 35.43738067880474, 42.54110232518593, 0.09999999999999876, 240.0, 963, 862823, 1144, 42.396030099997006
1145, 3.005002236256747, 35.351107993946776, 42.44442704752289, 0.1000000000000009, 75.0, 517, 863340, 1145, 22.547963900000468
1146, 3.1451491590172864, 35.60298964624319, 42.7874461862616, 0.1000000000000006, 55.0, 331, 863671, 1146, 14.448520300000382
1147, 8.19366127927603, 35.4806179940903, 42.775867272071366, 0.09999999999999916, 165.0, 883, 864554, 1147, 38.85852489999888
1148, 8.522924651992247, 35.57418926310095, 42.903681732556834, 0.09999999999999963, 110.0, 805, 865359, 1148, 34.866282399998454
1149, 5.225818593584934, 35.49155816809134, 42.69726833011441, 0.09999999999999885, 300.0, 942, 866301, 1149, 41.65611960000024
1150, 2.746884873524929, 35.449054792523384, 42.578661342461906, 0.10000000000000071, 85.0, 384, 866685, 1150, 16.80675920000067
1151, 4.866086378958812, 35.575110987937954, 42.779193668303755, 0.09999999999999892, 520.0, 927, 867612, 1151, 40.55403159999696
1152, 7.414200595656982, 35.515726860883646, 42.73270799140601, 0.09999999999999959, 185.0, 811, 868423, 1152, 36.27195320000101
1153, 4.485869725280017, 35.472047430136335, 42.68280465262277, 0.10000000000000024, 165.0, 721, 869144, 1153, 32.08929480000006
1154, 4.043109782161021, 35.459062802622334, 42.643927514190366, 0.09999999999999866, 195.0, 986, 870130, 1154, 44.3921388000017
1155, 2.8889625644345314, 35.44626334617878, 42.61158228597583, 0.10000000000000088, 70.0, 493, 870623, 1155, 22.09568930000023
1156, 4.315887099948729, 35.53181745398859, 42.717724211319634, 0.09999999999999963, 140.0, 805, 871428, 1156, 35.39430370000264
1157, 4.483288104376797, 35.446258550692974, 42.64831699365567, 0.10000000000000078, 175.0, 661, 872089, 1157, 29.117496999999275
1158, 3.9338300717144534, 35.4888507988883, 42.65260361872013, 0.09999999999999787, 240.0, 1203, 873292, 1158, 57.639992899999925
1159, 4.697659066004436, 35.43011594510056, 42.6258122271974, 0.09999999999999831, 155.0, 1069, 874361, 1159, 48.68845770000189
1160, 3.726851105758883, 35.63000296958606, 42.79087900711318, 0.10000000000000091, 120.0, 649, 875010, 1160, 28.75758169999972
1161, 5.6448465935276735, 35.53841369197054, 42.75467825835606, 0.0999999999999997, 230.0, 795, 875805, 1161, 35.668379099999584
1162, 5.406998353078961, 35.50512788112347, 42.75821963090163, 0.10000000000000091, 135.0, 520, 876325, 1162, 30.626930500002345
1163, 5.045451482254292, 35.58452199968657, 42.79969002965182, 0.09999999999999891, 185.0, 932, 877257, 1163, 49.24024869999994
1164, 2.8636977084953346, 35.438671795117116, 42.60369047011519, 0.09999999999999758, 695.0, 1318, 878575, 1164, 67.95046549999824
1165, 3.625850000214286, 35.49482792029692, 42.66245379324132, 0.09999999999999769, 630.0, 1271, 879846, 1165, 64.12972990000344
1166, 5.729549366344561, 35.46181917297706, 42.67954829355304, 0.09999999999999912, 220.0, 890, 880736, 1166, 51.68728890000057
1167, 6.705836118195191, 35.441167191808006, 42.675200037209386, 0.0999999999999986, 250.0, 996, 881732, 1167, 47.21318330000213
1168, 4.175315979340557, 35.51826623580998, 42.66955618251205, 0.10000000000000044, 320.0, 699, 882431, 1168, 30.593519099998957
1169, 6.074228794969986, 35.471767354424244, 42.71718151432855, 0.1, 130.0, 751, 883182, 1169, 33.66878309999811
1170, 3.971443434861884, 35.464720942155836, 42.62933230686805, 0.09999999999999827, 275.0, 1081, 884263, 1170, 48.19671340000059
1171, 6.693227792166929, 35.416213692372416, 42.6250154772519, 0.1000000000000006, 125.0, 681, 884944, 1171, 29.65803909999886
1172, 3.8085490761197467, 35.46564796339876, 42.64030654319889, 0.09999999999999767, 250.0, 1273, 886217, 1172, 65.83787909999955
1173, 2.6353575102752367, 35.47618326861016, 42.61631486776021, 0.09999999999999966, 110.0, 801, 887018, 1173, 43.587017099998775
1174, 3.723666285518527, 35.48933151530158, 42.680333533233984, 0.09999999999999772, 515.0, 1258, 888276, 1174, 66.24322519999987
1175, 4.270110119377589, 35.513222636310495, 42.75495970209572, 0.09999999999999905, 335.0, 903, 889179, 1175, 47.31341720000273
1176, 5.826087105709972, 35.51630201422444, 42.728221822405395, 0.09999999999999962, 190.0, 807, 889986, 1176, 41.81378060000134
1177, 8.741891899067594, 35.77697244322444, 43.06710982035442, 0.1000000000000006, 20.0, 332, 890318, 1177, 17.444299099999625
1178, 3.9027638430804967, 35.797135979290964, 43.053795912929864, 0.09999999999999822, 275.0, 1095, 891413, 1178, 56.96861839999838
1179, 5.018762248389312, 35.80410704824138, 43.08652738279897, 0.09999999999999959, 390.0, 812, 892225, 1179, 42.744133899999724
1180, 4.734939585542962, 35.78713277972083, 43.02951376479586, 0.09999999999999823, 275.0, 1093, 893318, 1180, 57.61151059999975
1181, 5.019831266368026, 35.79662060511502, 43.06744237242559, 0.09999999999999883, 220.0, 949, 894267, 1181, 50.50535189999937
1182, 2.587674040225351, 35.79284743878343, 42.970226710629404, 0.10000000000000074, 60.0, 397, 894664, 1182, 20.57030289999966
1183, 4.24980619064159, 35.67755692478284, 42.92994549673355, 0.1000000000000009, 100.0, 514, 895178, 1183, 26.87796359999993
1184, 6.069965045086509, 35.83748648130611, 43.15137036778757, 0.09999999999999894, 220.0, 926, 896104, 1184, 49.069554400000925
1185, 6.584815108207564, 35.84276380439253, 43.14349757005113, 0.09999999999999803, 285.0, 1148, 897252, 1185, 60.34070579999752
1186, 5.961891172772371, 35.831009460122964, 43.071697473526, 0.10000000000000098, 60.0, 608, 897860, 1186, 32.1062849000009
1187, 2.65518332159218, 35.73651915676922, 42.96633109953118, 0.0999999999999978, 375.0, 1227, 899087, 1187, 64.56927870000072
1188, 6.052573722694664, 36.098801356396464, 43.490192653270014, 0.09999999999999822, 355.0, 1097, 900184, 1188, 58.07172139999966
1189, 7.3204061419932875, 37.44724417352057, 45.20838382275073, 0.10000000000000071, 75.0, 385, 900569, 1189, 20.334451299997454
1190, 4.155524661051809, 37.380446252452685, 44.90198234797846, 0.10000000000000092, 120.0, 541, 901110, 1190, 28.25193290000243
1191, 4.140143049188586, 37.348589262678395, 44.92997851753626, 0.0999999999999987, 240.0, 974, 902084, 1191, 51.64546319999863
1192, 4.739507150688191, 37.30123973834222, 44.870231738339875, 0.09999999999999888, 350.0, 937, 903021, 1192, 49.75722179999866
1193, 4.32376142599997, 37.331243370667174, 44.908735823228376, 0.09999999999999747, 430.0, 1361, 904382, 1193, 72.26947839999775
1194, 5.443116007212567, 37.34694819795913, 44.94466942681207, 0.09999999999999845, 310.0, 1035, 905417, 1194, 55.70530569999755
1195, 4.527875596246658, 37.32305623812553, 44.88006331614959, 0.09999999999999706, 460.0, 1560, 906977, 1195, 83.29631460000019
1196, 3.516555376087918, 37.33085436540492, 44.844549725102446, 0.0999999999999985, 220.0, 1020, 907997, 1196, 54.592837000000145
1197, 4.879118073330476, 37.37922548147348, 44.96500335106483, 0.10000000000000073, 50.0, 390, 908387, 1197, 20.638026600001467
1198, 3.4938110957292827, 37.31451860423052, 44.8503187981901, 0.0999999999999997, 265.0, 794, 909181, 1198, 42.75931579999815
1199, 5.676015744141702, 37.233203832780205, 44.82597315946489, 0.09999999999999758, 330.0, 1314, 910495, 1199, 70.70659390000219
1200, 4.814208418079, 36.930552790536375, 44.42845839723698, 0.09999999999999803, 520.0, 1149, 911644, 1200, 61.804585300000326
1201, 4.832110014685895, 36.96014519035816, 44.49430459737778, 0.09999999999999988, 125.0, 768, 912412, 1201, 41.86201449999862
1202, 6.076607797445724, 36.98538055003989, 44.560376719893696, 0.09999999999999766, 360.0, 1284, 913696, 1202, 68.90399609999804
1203, 2.6275368342430783, 36.94834244010281, 44.38566322190583, 0.0999999999999994, 240.0, 841, 914537, 1203, 45.29630530000213
1204, 4.693128124527309, 37.0611113479172, 44.55636189225791, 0.10000000000000052, 160.0, 690, 915227, 1204, 37.54194880000068
1205, 2.619586073142421, 37.06776418058102, 44.55124449057265, 0.100000000000001, 160.0, 638, 915865, 1205, 34.69756349999807
1206, 5.6546251977656965, 37.002253724150385, 44.52891669025057, 0.09999999999999715, 650.0, 1517, 917382, 1206, 82.09613259999969
1207, 3.783235246221637, 37.017125330622186, 44.534559691341414, 0.10000000000000066, 160.0, 674, 918056, 1207, 36.31441740000082
1208, 3.8407933473221685, 36.98183533022157, 44.47099100102894, 0.09999999999999806, 250.0, 1142, 919198, 1208, 62.080029199998535
1209, 5.440931328759353, 37.167914330596616, 44.72668021010579, 0.09999999999999866, 240.0, 986, 920184, 1209, 54.087693199999194
1210, 4.005260500816111, 37.99199537269969, 45.718307821469615, 0.10000000000000091, 100.0, 526, 920710, 1210, 28.93380260000049
1211, 6.449026565228585, 38.0124817538362, 45.76107214003508, 0.10000000000000034, 150.0, 711, 921421, 1211, 38.21187120000104
1212, 5.894940823282708, 38.11141992626768, 45.89805575284091, 0.1000000000000008, 110.0, 660, 922081, 1212, 36.40722459999961
1213, 6.223783548768616, 38.071051874687754, 45.85844805236381, 0.09999999999999813, 150.0, 1122, 923203, 1213, 60.766234099999565
1214, 4.262222988384146, 37.99641227722168, 45.691056659112824, 0.10000000000000087, 65.0, 482, 923685, 1214, 26.015170200000284
1215, 4.539744032765083, 38.09936229077584, 45.82122728253868, 0.09999999999999795, 375.0, 1178, 924863, 1215, 64.46881159999975
1216, 4.534840421663981, 38.08834937044405, 45.80174122154196, 0.09999999999999802, 295.0, 1154, 926017, 1216, 63.458130200000596
1217, 7.996393745676393, 38.12217683640738, 46.015804752470956, 0.10000000000000088, 15.0, 504, 926521, 1217, 27.240417799999705
1218, 2.8379454838087255, 38.140079100172706, 45.79130090934276, 0.09999999999999837, 425.0, 1054, 927575, 1218, 58.24614680000013
1219, 6.431334180783036, 38.09044760520305, 45.9269874948974, 0.09999999999999921, 330.0, 872, 928447, 1219, 48.356023899999855
1220, 4.5695689093016565, 38.02780114558705, 45.72533073759916, 0.10000000000000057, 160.0, 684, 929131, 1220, 37.84045100000003
1221, 7.291452077922283, 38.21616927502202, 45.99584321788713, 0.0999999999999985, 195.0, 1020, 930151, 1221, 56.11903439999878
1222, 3.618355338254337, 38.30700681875418, 46.02285043429224, 0.09999999999999983, 385.0, 777, 930928, 1222, 42.32142609999937
1223, 4.109062430499661, 38.40366002170164, 46.18429356168311, 0.09999999999999827, 270.0, 1081, 932009, 1223, 60.33432510000057
1224, 5.296545750503677, 38.185221821192364, 45.976406733194985, 0.09999999999999871, 235.0, 972, 932981, 1224, 53.44223469999997
1225, 5.460659898442046, 38.23222889381631, 46.02355515356089, 0.09999999999999999, 140.0, 754, 933735, 1225, 41.99040850000165
1226, 4.630898505603204, 38.30437338027596, 46.06967734753246, 0.09999999999999833, 360.0, 1065, 934800, 1226, 58.61078019999695
1227, 4.174382660643962, 38.32209613458897, 46.075644524116825, 0.10000000000000087, 80.0, 492, 935292, 1227, 27.49840160000167
1228, 4.179946647769507, 38.30563694710905, 46.07844422971411, 0.0999999999999989, 165.0, 934, 936226, 1228, 52.13387420000072
1229, 5.4562139226548, 38.328445858752865, 46.09820215232584, 0.09999999999999763, 435.0, 1295, 937521, 1229, 71.79593269999896
1230, 9.141876911486357, 38.37828046105774, 46.29675077945552, 0.10000000000000092, 90.0, 534, 938055, 1230, 29.60686859999987
1231, 4.678580856829218, 38.32522453477891, 46.08647138509319, 0.0999999999999974, 300.0, 1393, 939448, 1231, 77.47580880000169
1232, 5.656428711999346, 38.3276560748065, 46.11622060543645, 0.09999999999999884, 245.0, 945, 940393, 1232, 52.24926499999856
1233, 4.813938545640449, 38.293718003390126, 45.960738756503275, 0.10000000000000063, 5.0, 342, 940735, 1233, 19.523000199998933
1234, 4.799542379738004, 38.40010566475951, 46.23339560591144, 0.10000000000000092, 55.0, 648, 941383, 1234, 35.932111399997666
1235, 5.527535768459215, 38.468063695961256, 46.271129091072574, 0.10000000000000073, 105.0, 391, 941774, 1235, 21.718495999997685
1236, 5.783307979644184, 38.35112709490586, 46.19534655595929, 0.09999999999999862, 170.0, 994, 942768, 1236, 55.46605439999985
1237, 5.117150873669143, 38.35363410900326, 46.12820612959877, 0.10000000000000099, 80.0, 618, 943386, 1237, 35.23237850000078
1238, 3.8883051924454937, 38.34660289302753, 46.07157172427815, 0.09999999999999977, 150.0, 785, 944171, 1238, 44.425027400000545
1239, 4.691489878436551, 38.367521059513095, 46.153683909773825, 0.09999999999999766, 200.0, 1280, 945451, 1239, 71.90960569999879
1240, 6.053906846870978, 38.390238474528, 46.252523829142255, 0.10000000000000002, 180.0, 750, 946201, 1240, 41.897362100000464
1241, 5.474726565678915, 38.41152390020865, 46.21563219847503, 0.09999999999999827, 165.0, 1080, 947281, 1241, 60.71114170000146
1242, 4.898548058816913, 38.318537528054755, 46.05006835892884, 0.10000000000000063, 35.0, 342, 947623, 1242, 20.220311000000947
1243, 6.03800708340595, 38.30330914867167, 46.08150153257409, 0.10000000000000073, 25.0, 392, 948015, 1243, 21.81635660000029
1244, 3.7546940794747177, 38.29442814022779, 45.99788258833532, 0.10000000000000052, 100.0, 689, 948704, 1244, 40.957599699999264
1245, 2.458942165925303, 38.39748517490222, 46.13841016541304, 0.10000000000000073, 80.0, 393, 949097, 1245, 22.279173199996876
1246, 3.066487538204453, 38.47617367054823, 46.225230760532206, 0.10000000000000062, 135.0, 679, 949776, 1246, 38.22428900000159
1247, 3.9956118321555336, 38.32266880291378, 46.07784997343822, 0.10000000000000098, 160.0, 611, 950387, 1247, 34.24480069999845
1248, 5.896320030444222, 38.39751385350671, 46.22715503166927, 0.09999999999999935, 280.0, 849, 951236, 1248, 48.71481119999953
1249, 9.522141684880276, 38.441313418085706, 46.3347184186924, 0.10000000000000088, 15.0, 501, 951737, 1249, 28.437703699997655
1250, 5.190822492678792, 38.42196401822365, 46.18483176797123, 0.10000000000000096, 100.0, 590, 952327, 1250, 33.76585900000282
1251, 6.492333294308118, 38.37628123181015, 46.08701266272593, 0.10000000000000066, 25.0, 354, 952681, 1251, 20.159623399998964
1252, 3.6118107000015733, 38.26610872799292, 46.03609322426014, 0.10000000000000091, 70.0, 532, 953213, 1252, 30.469358700000157
1253, 2.8553387015078835, 38.32808886612221, 46.03099765816753, 0.10000000000000087, 25.0, 487, 953700, 1253, 27.465682099998958
1254, 6.790974643637032, 38.497067421164665, 46.322323726849916, 0.09999999999999955, 145.0, 818, 954518, 1254, 39.651333999998315
1255, 4.56261651740505, 38.32671847496792, 46.08648747068817, 0.10000000000000087, 85.0, 653, 955171, 1255, 31.335458600002312
1256, 3.028719032890932, 38.370568796016244, 46.12521799578938, 0.09999999999999898, 165.0, 916, 956087, 1256, 43.77605760000006
1257, 3.4724988660357825, 38.34532491531146, 46.066464160953146, 0.09999999999999855, 210.0, 1011, 957098, 1257, 48.108923499999946
1258, 6.379464570280527, 38.26906153647957, 46.08388100154645, 0.10000000000000035, 125.0, 709, 957807, 1258, 34.40280960000018
1259, 6.265516032504716, 38.3898868560791, 46.19858267988477, 0.09999999999999813, 485.0, 1120, 958927, 1259, 54.056292599998415
1260, 5.429305731908594, 38.3895057278429, 46.20256018742724, 0.09999999999999898, 225.0, 916, 959843, 1260, 44.304036199999246
1261, 3.680903964448782, 37.84928927171885, 45.49956510502412, 0.09999999999999978, 125.0, 783, 960626, 1261, 38.32346369999868
1262, 7.5526819682997965, 37.816166902283655, 45.55793513891832, 0.09999999999999798, 210.0, 1166, 961792, 1262, 56.91540130000067
1263, 4.046210465825694, 37.8250840218908, 45.44844369653001, 0.10000000000000052, 120.0, 689, 962481, 1263, 33.32690559999901
1264, 6.37350712807039, 37.83883576887859, 45.534016030250534, 0.09999999999999903, 220.0, 906, 963387, 1264, 43.76044080000065
1265, 4.251567084694383, 37.761889291639946, 45.4073077434331, 0.10000000000000075, 65.0, 402, 963789, 1265, 19.5836218000004
1266, 5.142100780309313, 37.80419875812019, 45.519977535459354, 0.10000000000000094, 50.0, 559, 964348, 1266, 27.212930000001506
1267, 8.252229561000618, 37.86538391113281, 45.65836643389802, 0.1000000000000007, 145.0, 670, 965018, 1267, 32.59982789999776
1268, 4.974023020060783, 37.772382471625605, 45.394528979346866, 0.09999999999999874, 120.0, 966, 965984, 1268, 47.140857499998674
1269, 5.467519837640115, 37.78299460719474, 45.48805834642097, 0.10000000000000075, 65.0, 402, 966386, 1269, 19.5885223999976
1270, 6.181568494273557, 37.86407267858112, 45.53232867377145, 0.10000000000000088, 30.0, 504, 966890, 1270, 25.08078110000133
1271, 5.281846247696522, 37.89196628442927, 45.622842469623095, 0.10000000000000092, 90.0, 538, 967428, 1271, 26.06291809999675
1272, 3.5316488484711948, 37.76677569990737, 45.38047234427017, 0.09999999999999996, 195.0, 758, 968186, 1272, 37.00027069999851
1273, 4.001360390732222, 37.79948688400126, 45.425330737818065, 0.10000000000000092, 65.0, 535, 968721, 1273, 25.82589029999872
1274, 2.784008908454932, 37.761947674458256, 45.30960611524529, 0.10000000000000067, 45.0, 358, 969079, 1274, 17.615245299999515
1275, 5.685084177931479, 37.915445008360756, 45.62776358846993, 0.09999999999999769, 535.0, 1266, 970345, 1275, 62.2860639999999
1276, 3.048561393424149, 38.34532440982918, 46.05905559113926, 0.0999999999999977, 395.0, 1263, 971608, 1276, 61.83745740000086
1277, 4.950057689024478, 38.278788769230836, 46.06363076694301, 0.09999999999999945, 170.0, 833, 972441, 1277, 41.764790100001846
1278, 4.458649972430844, 38.352592770106796, 46.151227141792745, 0.10000000000000014, 185.0, 733, 973174, 1278, 36.580713899998955
1279, 4.926074472668002, 38.3540633034972, 46.147456321574495, 0.10000000000000092, 95.0, 538, 973712, 1279, 26.539634799999476
1280, 4.892323573081015, 38.37657241743518, 46.19917206759361, 0.09999999999999867, 355.0, 981, 974693, 1280, 48.11919050000142
1281, 5.876589907955108, 38.37763845519781, 46.17688907805228, 0.09999999999999766, 305.0, 1279, 975972, 1281, 63.010868299999856
1282, 5.255730931496646, 38.38980890465616, 46.129262178745854, 0.09999999999999898, 150.0, 916, 976888, 1282, 45.34448899999916
1283, 5.317178620033794, 38.28694931030273, 46.166516638861765, 0.10000000000000082, 55.0, 450, 977338, 1283, 22.55203139999867
1284, 3.6943499161747893, 38.345798591999596, 46.10182323735845, 0.10000000000000098, 75.0, 613, 977951, 1284, 30.155977200000052
1285, 2.6442131756671836, 38.176054992112036, 45.865940225535425, 0.09999999999999959, 355.0, 812, 978763, 1285, 40.513530600001104
1286, 3.5726943576193992, 38.35024162655785, 46.104490712483724, 0.0999999999999984, 205.0, 1050, 979813, 1286, 51.95027180000034
1287, 4.7796644667308295, 38.20084046352659, 45.934865624505996, 0.09999999999999887, 330.0, 939, 980752, 1287, 46.17179599999872
1288, 5.115321061783988, 38.30057385676366, 46.05215856251158, 0.09999999999999845, 245.0, 1033, 981785, 1288, 51.46794800000134
1289, 5.928350030496575, 38.34060768633924, 46.16544249989838, 0.09999999999999883, 220.0, 949, 982734, 1289, 47.247112000000925
1290, 3.4797999456764837, 38.309259646459, 46.0403855464818, 0.10000000000000057, 80.0, 683, 983417, 1290, 33.49054370000158
1291, 4.728402471999007, 38.227212844356416, 45.99590331046812, 0.10000000000000099, 90.0, 620, 984037, 1291, 31.57504599999811
1292, 3.5605716698169707, 38.276564601353236, 45.97293065534319, 0.0999999999999992, 105.0, 875, 984912, 1292, 43.9460304000022
1293, 4.895120479177259, 38.287980133320865, 46.05290317948246, 0.10000000000000049, 55.0, 693, 985605, 1293, 34.48607659999834
1294, 4.978006363513849, 38.26950517209273, 46.02082194427066, 0.10000000000000092, 75.0, 647, 986252, 1294, 32.73832670000047
1295, 2.54675421224169, 38.15943701762073, 45.82181256222275, 0.09999999999999935, 285.0, 848, 987100, 1295, 42.117291400001704
1296, 6.258025413406571, 38.24468259359388, 46.03066487523503, 0.09999999999999765, 260.0, 1287, 988387, 1296, 64.55379810000159
1297, 5.87660275488353, 38.077500114756184, 45.801986877189194, 0.10000000000000098, 80.0, 605, 988992, 1297, 30.745532599998114
1298, 7.726354808409548, 38.26091245649035, 46.063988439177585, 0.09999999999999927, 275.0, 863, 989855, 1298, 43.343257900000026
1299, 7.128832114484155, 38.3137096602451, 46.11311192584157, 0.10000000000000098, 135.0, 599, 990454, 1299, 30.384441300000617
1300, 6.452737194961972, 38.306025430184825, 46.09606572469075, 0.10000000000000066, 100.0, 675, 991129, 1300, 33.77726090000215
1301, 5.81507912846922, 38.187769078844376, 45.98054008775085, 0.10000000000000085, 80.0, 655, 991784, 1301, 33.19198400000096
1302, 3.8936764206390655, 38.25678059263164, 46.00242397670765, 0.0999999999999985, 230.0, 1021, 992805, 1302, 51.18117690000145
1303, 4.395833742936397, 38.22548533938928, 45.94908168507415, 0.10000000000000067, 50.0, 361, 993166, 1303, 18.23097400000188
1304, 3.0312956910219886, 38.161193638463175, 45.85364074091758, 0.10000000000000099, 35.0, 620, 993786, 1304, 31.24744279999868
1305, 7.464012173071657, 38.371393862458845, 46.14087933609166, 0.10000000000000073, 75.0, 388, 994174, 1305, 19.99559600000066
1306, 5.787338778187691, 38.28676146386375, 46.079771734963, 0.10000000000000034, 130.0, 710, 994884, 1306, 35.6746381999983
1307, 4.084934744645249, 38.19673363304892, 45.9014879385002, 0.1000000000000009, 55.0, 506, 995390, 1307, 25.98367259999941
1308, 7.979446863916518, 38.35638263510368, 46.2499599299155, 0.09999999999999754, 330.0, 1331, 996721, 1308, 67.73941360000026
1309, 4.1568154838196065, 38.26086652001669, 46.0110738813415, 0.1000000000000009, 95.0, 516, 997237, 1309, 26.000292799999443
1310, 4.7609998318894595, 38.24275338461008, 46.02835470517275, 0.09999999999999704, 365.0, 1579, 998816, 1310, 80.28367720000097
