,loss,mae,mean_q,mean_eps,episode_reward,nb_episode_steps,nb_steps,episode,duration
0,0,0,0,0,185.0,834,834,0,1.7534536999999997
1, 0, 0, 0, 0, 135.0, 641, 1475, 1, 1.3738051000000002
2, 0, 0, 0, 0, 135.0, 686, 2161, 2, 1.4658587
3, 0, 0, 0, 0, 210.0, 953, 3114, 3, 2.0774649999999983
4, 0, 0, 0, 0, 120.0, 632, 3746, 4, 1.4693661999999996
5, 0, 0, 0, 0, 110.0, 373, 4119, 5, 0.8298652000000004
6, 0, 0, 0, 0, 105.0, 512, 4631, 6, 1.1438725999999981
7, 0, 0, 0, 0, 105.0, 698, 5329, 7, 1.498354299999999
8, 0, 0, 0, 0, 210.0, 1016, 6345, 8, 2.2050889
9, 0, 0, 0, 0, 65.0, 411, 6756, 9, 1.0521617000000028
10, 0, 0, 0, 0, 45.0, 442, 7198, 10, 1.0272728999999998
11, 0, 0, 0, 0, 210.0, 685, 7883, 11, 1.4541474
12, 0, 0, 0, 0, 105.0, 618, 8501, 12, 1.383632500000001
13, 0, 0, 0, 0, 180.0, 728, 9229, 13, 1.7646148000000004
14, 0, 0, 0, 0, 125.0, 558, 9787, 14, 1.1842718999999988
15, 0, 0, 0, 0, 135.0, 818, 10605, 15, 1.7527510000000035
16, 0, 0, 0, 0, 65.0, 650, 11255, 16, 1.3601839000000027
17, 0, 0, 0, 0, 215.0, 820, 12075, 17, 1.744386200000001
18, 0, 0, 0, 0, 90.0, 388, 12463, 18, 0.8427492000000001
19, 0, 0, 0, 0, 185.0, 928, 13391, 19, 1.8345580000000012
20, 0, 0, 0, 0, 145.0, 749, 14140, 20, 1.5057338000000016
21, 0, 0, 0, 0, 255.0, 931, 15071, 21, 1.9019155000000012
22, 0, 0, 0, 0, 210.0, 767, 15838, 22, 1.5619583999999946
23, 0, 0, 0, 0, 135.0, 777, 16615, 23, 1.6070682999999946
24, 0, 0, 0, 0, 110.0, 747, 17362, 24, 1.572445199999997
25, 0, 0, 0, 0, 120.0, 751, 18113, 25, 1.4978853
26, 0, 0, 0, 0, 225.0, 838, 18951, 26, 1.7327537999999976
27, 0, 0, 0, 0, 30.0, 431, 19382, 27, 0.9148291999999998
28, 0, 0, 0, 0, 365.0, 829, 20211, 28, 1.6691410999999974
29, 0, 0, 0, 0, 155.0, 783, 20994, 29, 1.6483265999999972
30, 0, 0, 0, 0, 110.0, 670, 21664, 30, 1.3991128000000046
31, 0, 0, 0, 0, 105.0, 655, 22319, 31, 1.3475857000000033
32, 0, 0, 0, 0, 120.0, 728, 23047, 32, 1.4910937999999945
33, 0, 0, 0, 0, 20.0, 457, 23504, 33, 0.9504374000000055
34, 0, 0, 0, 0, 65.0, 666, 24170, 34, 1.3335036000000002
35, 0, 0, 0, 0, 120.0, 670, 24840, 35, 1.3488096000000027
36, 0, 0, 0, 0, 85.0, 520, 25360, 36, 1.0507974000000004
37, 0, 0, 0, 0, 65.0, 592, 25952, 37, 1.2001847000000083
38, 0, 0, 0, 0, 120.0, 743, 26695, 38, 1.5101865999999973
39, 0, 0, 0, 0, 150.0, 677, 27372, 39, 1.4074846999999977
40, 0, 0, 0, 0, 135.0, 765, 28137, 40, 1.5698167999999981
41, 0, 0, 0, 0, 120.0, 753, 28890, 41, 1.4976984000000044
42, 0, 0, 0, 0, 165.0, 858, 29748, 42, 1.7020167000000015
43, 0, 0, 0, 0, 120.0, 822, 30570, 43, 1.7060567000000049
44, 0, 0, 0, 0, 105.0, 669, 31239, 44, 1.3599996999999888
45, 0, 0, 0, 0, 210.0, 797, 32036, 45, 1.6640972000000005
46, 0, 0, 0, 0, 45.0, 392, 32428, 46, 0.8362276999999949
47, 0, 0, 0, 0, 35.0, 384, 32812, 47, 0.812590599999993
48, 0, 0, 0, 0, 135.0, 606, 33418, 48, 1.24677650000001
49, 0, 0, 0, 0, 225.0, 903, 34321, 49, 1.8449675000000099
50, 0, 0, 0, 0, 110.0, 582, 34903, 50, 1.2086736000000116
51, 0, 0, 0, 0, 180.0, 746, 35649, 51, 1.5456226999999956
52, 0, 0, 0, 0, 155.0, 809, 36458, 52, 1.6808627999999999
53, 0, 0, 0, 0, 135.0, 513, 36971, 53, 1.0632851999999957
54, 0, 0, 0, 0, 180.0, 777, 37748, 54, 1.618766700000009
55, 0, 0, 0, 0, 210.0, 807, 38555, 55, 1.6807133000000078
56, 0, 0, 0, 0, 210.0, 808, 39363, 56, 1.7249015000000014
57, 0, 0, 0, 0, 105.0, 661, 40024, 57, 1.3757413999999955
58, 0, 0, 0, 0, 105.0, 358, 40382, 58, 0.7362231999999977
59, 0, 0, 0, 0, 230.0, 809, 41191, 59, 1.6803627999999975
60, 0, 0, 0, 0, 265.0, 1187, 42378, 60, 2.5640525000000025
61, 0, 0, 0, 0, 210.0, 794, 43172, 61, 1.7012737000000016
62, 0, 0, 0, 0, 210.0, 793, 43965, 62, 1.698216599999995
63, 0, 0, 0, 0, 235.0, 842, 44807, 63, 1.7648591999999894
64, 0, 0, 0, 0, 120.0, 746, 45553, 64, 1.5059116999999986
65, 0, 0, 0, 0, 105.0, 671, 46224, 65, 1.3986103999999955
66, 0, 0, 0, 0, 120.0, 747, 46971, 66, 1.7071945
67, 0, 0, 0, 0, 125.0, 661, 47632, 67, 1.4543225000000035
68, 0, 0, 0, 0, 110.0, 667, 48299, 68, 1.508217700000003
69, 0, 0, 0, 0, 155.0, 806, 49105, 69, 2.1657748000000083
70, 0, 0, 0, 0, 80.0, 397, 49502, 70, 0.842059699999993
71, 0, 0, 0, 0, 110.0, 753, 50255, 71, 1.5066041999999982
72, 0, 0, 0, 0, 225.0, 1492, 51747, 72, 3.0007650999999953
73, 0, 0, 0, 0, 210.0, 780, 52527, 73, 1.6721699999999942
74, 0, 0, 0, 0, 180.0, 894, 53421, 74, 1.8952513999999923
75, 0, 0, 0, 0, 105.0, 616, 54037, 75, 1.3298839999999927
76, 0, 0, 0, 0, 210.0, 825, 54862, 76, 1.7542078000000032
77, 0, 0, 0, 0, 220.0, 790, 55652, 77, 1.6753419999999863
78, 0, 0, 0, 0, 310.0, 1412, 57064, 78, 2.9129073000000005
79, 0, 0, 0, 0, 190.0, 872, 57936, 79, 1.940733300000005
80, 0, 0, 0, 0, 60.0, 367, 58303, 80, 0.7996005999999909
81, 0, 0, 0, 0, 180.0, 796, 59099, 81, 1.662274100000019
82, 0, 0, 0, 0, 65.0, 397, 59496, 82, 0.8419490999999937
83, 0, 0, 0, 0, 60.0, 400, 59896, 83, 0.8669314999999926
84, 0, 0, 0, 0, 110.0, 607, 60503, 84, 1.3348891999999921
85, 0, 0, 0, 0, 80.0, 412, 60915, 85, 0.9033606000000134
86, 0, 0, 0, 0, 135.0, 752, 61667, 86, 1.5890550000000019
87, 0, 0, 0, 0, 70.0, 644, 62311, 87, 1.3554068999999913
88, 0, 0, 0, 0, 75.0, 411, 62722, 88, 0.8497025000000065
89, 0, 0, 0, 0, 155.0, 680, 63402, 89, 1.4404109000000176
90, 0, 0, 0, 0, 105.0, 386, 63788, 90, 0.8455507999999838
91, 0, 0, 0, 0, 320.0, 761, 64549, 91, 1.668186100000014
92, 0, 0, 0, 0, 80.0, 391, 64940, 92, 0.8416608999999937
93, 0, 0, 0, 0, 180.0, 813, 65753, 93, 1.6736247000000049
94, 0, 0, 0, 0, 120.0, 827, 66580, 94, 1.7535220000000038
95, 0, 0, 0, 0, 120.0, 820, 67400, 95, 1.8013463000000058
96, 0, 0, 0, 0, 120.0, 769, 68169, 96, 1.6169194000000005
97, 0, 0, 0, 0, 50.0, 562, 68731, 97, 1.2327252999999985
98, 0, 0, 0, 0, 135.0, 783, 69514, 98, 1.7602892000000168
99, 0, 0, 0, 0, 125.0, 778, 70292, 99, 1.6475199000000202
100, 0, 0, 0, 0, 50.0, 398, 70690, 100, 0.8774501000000043
101, 0, 0, 0, 0, 120.0, 779, 71469, 101, 1.7563558999999884
102, 0, 0, 0, 0, 50.0, 517, 71986, 102, 1.126533299999977
103, 0, 0, 0, 0, 105.0, 742, 72728, 103, 1.626411499999989
104, 0, 0, 0, 0, 100.0, 644, 73372, 104, 1.45249290000001
105, 0, 0, 0, 0, 50.0, 393, 73765, 105, 0.8427397999999755
106, 0, 0, 0, 0, 105.0, 599, 74364, 106, 1.2927420999999981
107, 0, 0, 0, 0, 515.0, 1524, 75888, 107, 3.184601499999985
108, 0, 0, 0, 0, 210.0, 1463, 77351, 108, 2.920404899999994
109, 0, 0, 0, 0, 160.0, 786, 78137, 109, 1.8026574000000153
110, 0, 0, 0, 0, 155.0, 789, 78926, 110, 1.760651700000011
111, 0, 0, 0, 0, 165.0, 765, 79691, 111, 1.5427885999999944
112, 0, 0, 0, 0, 155.0, 812, 80503, 112, 1.6243331999999953
113, 0, 0, 0, 0, 80.0, 447, 80950, 113, 0.9579457000000104
114, 0, 0, 0, 0, 75.0, 398, 81348, 114, 0.8578335999999922
115, 0, 0, 0, 0, 225.0, 930, 82278, 115, 1.8929061000000047
116, 0, 0, 0, 0, 155.0, 770, 83048, 116, 1.6036301000000037
117, 0, 0, 0, 0, 130.0, 742, 83790, 117, 1.5607662999999832
118, 0, 0, 0, 0, 75.0, 719, 84509, 118, 1.4535575999999821
119, 0, 0, 0, 0, 210.0, 865, 85374, 119, 1.759663900000021
120, 0, 0, 0, 0, 210.0, 916, 86290, 120, 1.8983737000000076
121, 0, 0, 0, 0, 180.0, 768, 87058, 121, 1.6112189000000114
122, 0, 0, 0, 0, 215.0, 923, 87981, 122, 1.9048281999999972
123, 0, 0, 0, 0, 180.0, 793, 88774, 123, 1.6196468000000266
124, 0, 0, 0, 0, 130.0, 762, 89536, 124, 1.5931582000000049
125, 0, 0, 0, 0, 55.0, 383, 89919, 125, 0.799724800000007
126, 0, 0, 0, 0, 230.0, 997, 90916, 126, 2.110549500000019
127, 0, 0, 0, 0, 160.0, 776, 91692, 127, 1.6380373000000077
128, 0, 0, 0, 0, 160.0, 835, 92527, 128, 1.817655000000002
129, 0, 0, 0, 0, 225.0, 969, 93496, 129, 2.0056069000000036
130, 0, 0, 0, 0, 110.0, 650, 94146, 130, 1.4008367000000135
131, 0, 0, 0, 0, 120.0, 678, 94824, 131, 1.4012537000000123
132, 0, 0, 0, 0, 175.0, 826, 95650, 132, 1.7141647999999918
133, 0, 0, 0, 0, 180.0, 800, 96450, 133, 1.7101897000000008
134, 0, 0, 0, 0, 105.0, 668, 97118, 134, 1.4326138000000128
135, 0, 0, 0, 0, 135.0, 785, 97903, 135, 1.7166165999999805
136, 0, 0, 0, 0, 215.0, 944, 98847, 136, 2.1238724000000104
137, 0, 0, 0, 0, 210.0, 865, 99712, 137, 1.7743575000000078
138, 63.851890825162265, 83.78887937833296, 105.62626466528373, 0.8195751999999998, 335.0, 760, 100472, 138, 5.091250000000002
139, 39.80207779394329, 83.52808584561005, 103.3777412920367, 0.8188255000000001, 65.0, 362, 100834, 139, 3.2543416999999977
140, 31.68390919160152, 83.7197865748751, 102.70060644287994, 0.8180029000000003, 110.0, 552, 101386, 140, 5.38746900000001
141, 30.305892899839154, 83.5082427285809, 102.2848975721554, 0.8167923999999993, 180.0, 793, 102179, 141, 7.643809599999997
142, 27.43132617963212, 83.42629192556653, 101.84836794648852, 0.8156754999999997, 120.0, 448, 102627, 142, 4.2034132
143, 28.961890997869443, 83.44786179194811, 101.76786392432257, 0.8147737, 110.0, 554, 103181, 143, 5.085717599999981
144, 23.216453157275556, 83.4131987927908, 101.45232941730913, 0.8136774999999999, 85.0, 664, 103845, 144, 6.08962630000002
145, 28.8102874528333, 83.59233970835729, 101.62735111604488, 0.8121934, 120.0, 985, 104830, 145, 8.895983300000012
146, 24.124792098069516, 83.39838128340871, 101.28024297941033, 0.8108452000000002, 75.0, 513, 105343, 146, 4.683965599999965
147, 29.567155953417434, 83.54254755060724, 101.53681521720074, 0.8100450999999999, 110.0, 376, 105719, 147, 3.5646017000000256
148, 26.15021291564655, 83.42086131586505, 101.25732112068661, 0.8090839, 110.0, 692, 106411, 148, 6.228218799999979
149, 25.19564643718025, 83.59738217407943, 101.34638741151694, 0.8080012000000002, 135.0, 511, 106922, 149, 4.736421500000006
150, 25.170214934727117, 83.41316469002258, 100.99184023571746, 0.8071893999999997, 55.0, 391, 107313, 150, 3.714808000000005
151, 23.764396885982016, 83.51220362895243, 101.01496977185148, 0.8061048999999998, 180.0, 814, 108127, 151, 7.917002400000001
152, 22.649215901125768, 83.40742115579593, 100.85668328157655, 0.8046658000000002, 180.0, 785, 108912, 152, 7.451673999999969
153, 23.09830274203324, 83.4536980266607, 100.90239693942728, 0.8034831999999998, 90.0, 529, 109441, 153, 5.030987600000003
154, 26.168811485076162, 83.22037262508543, 100.62979135720362, 0.8023024000000003, 155.0, 783, 110224, 154, 7.422409499999958
155, 16.294918569854293, 82.0698841118763, 99.08173858103287, 0.8007319000000002, 155.0, 962, 111186, 155, 9.111505600000044
156, 15.602053038504442, 82.04500746630464, 99.07465120076168, 0.7994215, 110.0, 494, 111680, 156, 4.696076199999993
157, 16.65068785085059, 82.05651012553946, 99.11419317210573, 0.798436, 155.0, 601, 112281, 157, 5.69748229999999
158, 11.964982195425842, 82.01321407900018, 99.05467270996611, 0.7974703, 30.0, 472, 112753, 158, 4.520510399999978
159, 15.200322238440366, 81.99016412164747, 99.13513554838515, 0.796609, 80.0, 485, 113238, 159, 4.634560000000022
160, 15.537530855973813, 82.084195942584, 99.24223423155287, 0.7956046000000001, 120.0, 631, 113869, 160, 6.167014600000016
161, 15.620977813262654, 81.9949692946214, 99.00337591403868, 0.7945569999999996, 125.0, 533, 114402, 161, 5.129511100000002
162, 17.081083649646008, 82.16135422048461, 99.2720805021358, 0.7931944000000004, 225.0, 981, 115383, 162, 9.335659599999985
163, 14.510712485858772, 81.99792923465851, 98.89131581818253, 0.7916976999999996, 135.0, 682, 116065, 163, 6.543326399999955
164, 14.329145567697884, 81.96913872368516, 99.0356048825336, 0.7905718, 95.0, 569, 116634, 164, 5.568777399999988
165, 13.430274589356287, 81.93545969716318, 98.82809880396702, 0.7896736, 55.0, 429, 117063, 165, 3.9921084000000064
166, 15.103665603098001, 82.03469942158556, 99.00820925413912, 0.7882155999999999, 485.0, 1191, 118254, 166, 11.31496530000004
167, 15.052985028185525, 81.87348457595586, 98.73804550360528, 0.7860573999999995, 160.0, 1207, 119461, 167, 11.932549800000004
168, 22.022173694056324, 82.40457550367626, 99.41028726836781, 0.7840233999999999, 420.0, 1053, 120514, 168, 10.475200500000028
169, 16.51709918479699, 83.0043266311087, 99.89794392668443, 0.7826086000000001, 155.0, 519, 121033, 169, 5.074433700000043
170, 18.583742473794878, 82.93379378153905, 99.8841807838957, 0.7808400999999996, 600.0, 1446, 122479, 170, 13.881558200000029
171, 17.29339501833051, 82.81611609582457, 99.7612285119882, 0.7788438999999999, 160.0, 772, 123251, 171, 7.5648281
172, 17.837085447962277, 82.83876566221876, 99.7763860798731, 0.7775424999999996, 105.0, 674, 123925, 172, 6.535455000000013
173, 19.18469477641518, 82.82868538382237, 99.6686004693461, 0.7764345999999999, 80.0, 557, 124482, 173, 5.517965100000026
174, 18.46647806968943, 82.93527474300238, 99.88485847257338, 0.7753924000000001, 60.0, 601, 125083, 174, 5.75673740000002
175, 18.659709398416762, 82.73861463019189, 99.62467960601157, 0.7741747000000003, 135.0, 752, 125835, 175, 7.296152600000028
176, 19.741548445058424, 82.80960371623668, 99.82257263420163, 0.7729174000000004, 105.0, 645, 126480, 176, 6.238206600000012
177, 20.94082610191271, 82.8462168155228, 99.75871874477598, 0.7715061999999995, 225.0, 923, 127403, 177, 9.526585099999977
178, 19.443769303280202, 82.84138485597227, 99.71550327229649, 0.7698097, 165.0, 962, 128365, 178, 9.790677700000003
179, 19.826518848823692, 82.74426180765099, 99.64495468701459, 0.7683327999999999, 110.0, 679, 129044, 179, 7.000481700000023
180, 19.656823349320128, 82.80928509644788, 99.8098681029246, 0.7671871000000001, 80.0, 594, 129638, 180, 6.054430799999977
181, 17.792454469588495, 82.78644400038478, 99.66691448721468, 0.7658712999999997, 425.0, 868, 130506, 181, 8.660574300000007
182, 19.65714458501626, 82.79436513894203, 99.77745452041889, 0.7640424999999998, 290.0, 1164, 131670, 182, 11.751908300000082
183, 20.12359078080369, 82.77703563388414, 99.7436762223621, 0.7625512, 110.0, 493, 132163, 183, 4.984179499999982
184, 17.626592399139174, 82.85282915341456, 99.78790204358319, 0.7615153000000002, 110.0, 658, 132821, 184, 6.629291299999977
185, 19.22516127614414, 82.77048428105373, 99.76699882956112, 0.7600051000000004, 460.0, 1020, 133841, 185, 10.540345600000023
186, 19.914664744100264, 82.81210460047568, 99.75324518019153, 0.7583895999999999, 120.0, 775, 134616, 186, 7.841285900000003
187, 16.995490069333055, 82.88756985849312, 99.73829497776386, 0.7571584000000001, 80.0, 593, 135209, 187, 6.031235299999935
188, 17.749827697857008, 82.79672316267684, 99.64015135069151, 0.7557922000000001, 210.0, 925, 136134, 188, 9.424685299999965
189, 18.106838366798627, 82.83118781504797, 99.58401682196288, 0.7542586000000002, 120.0, 779, 136913, 189, 7.84520329999998
190, 21.139284854387714, 82.70608386854185, 99.64501145634338, 0.7530643000000001, 105.0, 548, 137461, 190, 5.5786458999999695
191, 19.623339678627243, 82.75922270860717, 99.65971238315576, 0.7520014, 180.0, 633, 138094, 191, 6.3076697000000195
192, 18.83578073565107, 82.7421366837773, 99.62394036341757, 0.7504453, 415.0, 1096, 139190, 192, 10.906630899999982
193, 17.670708835413844, 82.88544917684379, 99.81307060229373, 0.7489018000000002, 135.0, 619, 139809, 193, 6.473390800000061
194, 13.83979828520997, 83.28983881702162, 100.20463555740983, 0.7480162, 65.0, 365, 140174, 194, 3.8540418000000045
195, 15.432199915741474, 83.88626126933504, 101.07614092111956, 0.7471053999999999, 150.0, 647, 140821, 195, 7.190300999999977
196, 12.941043047605032, 83.84176116669133, 100.99943528769106, 0.7458220000000003, 210.0, 779, 141600, 196, 8.057329399999958
197, 12.27493767324759, 83.84620889157665, 101.03678718099789, 0.7442388999999998, 210.0, 980, 142580, 197, 9.775498299999981
198, 14.379806790381076, 83.86583356871904, 101.10574819848146, 0.7427691999999999, 155.0, 653, 143233, 198, 6.617361500000015
199, 15.922706208606, 83.83572710326521, 101.06466548301873, 0.7414812999999998, 110.0, 778, 144011, 199, 7.782995599999936
200, 11.4243745303668, 83.91785606776502, 101.0177702516268, 0.7402384000000001, 105.0, 603, 144614, 200, 6.066055800000072
201, 13.94648063465439, 83.89625669347829, 101.14485554859556, 0.7392781000000003, 125.0, 464, 145078, 201, 4.668849799999975
202, 13.229105884009622, 83.79953584995727, 100.98282677168203, 0.7381467999999997, 135.0, 793, 145871, 202, 7.844206600000007
203, 12.945584698114544, 83.85859767595927, 100.93625828623772, 0.7367419000000001, 230.0, 768, 146639, 203, 7.469919899999923
204, 10.752688993035324, 83.89428260661563, 101.0336153146759, 0.7353720999999995, 135.0, 754, 147393, 204, 7.517251699999974
205, 13.534150893065972, 83.82821408845966, 101.05651914611343, 0.7343451999999999, 50.0, 387, 147780, 205, 3.839835899999912
206, 12.475711781021614, 83.89903507099903, 101.06944089035423, 0.7336090000000001, 105.0, 431, 148211, 206, 4.324152700000013
207, 13.692564479046307, 83.98183158553601, 101.13420318230845, 0.7325577999999995, 105.0, 737, 148948, 207, 7.362374000000045
208, 13.600391133958304, 83.75556388038257, 100.90468844421227, 0.7315498, 65.0, 383, 149331, 208, 3.8624999000001026
209, 10.905959552342303, 83.83695500620296, 100.92268361938133, 0.7305643000000002, 115.0, 712, 150043, 209, 7.188699400000019
210, 11.845998603168507, 83.63543710574298, 100.73722020001479, 0.7294123000000003, 105.0, 568, 150611, 210, 5.681995700000016
211, 9.106796663853807, 83.58124903577021, 100.60597857422503, 0.7282017999999998, 145.0, 777, 151388, 211, 7.895854200000031
212, 10.77090584146266, 83.49111420587198, 100.63734965292824, 0.7269588999999997, 155.0, 604, 151992, 212, 6.025258000000008
213, 9.235830356473997, 83.58011109359622, 100.5837034931333, 0.7258437999999998, 110.0, 635, 152627, 213, 6.31674529999998
214, 12.401091654832959, 83.56049275366759, 100.67109617689327, 0.7245909999999999, 435.0, 757, 153384, 214, 7.572479900000076
215, 10.258846374704117, 83.60933358464413, 100.67480100106778, 0.7231870000000001, 155.0, 803, 154187, 215, 8.110019299999976
216, 12.569009959952172, 83.62996895870506, 100.74048932054127, 0.7216209999999997, 225.0, 937, 155124, 216, 9.49793790000001
217, 11.192130010962313, 83.545568519246, 100.70186278760696, 0.7201629999999999, 125.0, 683, 155807, 217, 6.859676900000068
218, 7.549571226258855, 83.46975629408281, 100.41318646106092, 0.7188930999999998, 140.0, 728, 156535, 218, 7.424905300000091
219, 10.441215469884053, 83.60407515767166, 100.6775063741998, 0.7178715999999999, 75.0, 407, 156942, 219, 4.1937198999999055
220, 9.978659950817624, 83.53853913148244, 100.58189118703207, 0.7166413000000001, 260.0, 960, 157902, 220, 9.85574269999995
221, 11.964609705735924, 83.50025592315106, 100.62526575863558, 0.7149556000000006, 230.0, 913, 158815, 221, 9.281032500000038
222, 11.412679774662047, 83.5421212814706, 100.51254428221733, 0.7136577999999999, 15.0, 529, 159344, 222, 5.488354700000059
223, 12.562747914929036, 83.5293643835819, 100.6172198461107, 0.712855, 50.0, 363, 159707, 223, 3.76956430000007
224, 7.6486538701233675, 83.56114636994975, 100.57748624578393, 0.71209, 60.0, 487, 160194, 224, 5.007434200000034
225, 10.342673201668532, 83.38070799175061, 100.39101273386102, 0.7110532000000004, 135.0, 665, 160859, 225, 6.765429599999948
226, 9.124316056682305, 83.3615055734461, 100.41191952878779, 0.7098211000000001, 110.0, 704, 161563, 226, 7.423370900000009
227, 9.444811841886136, 83.3490677919825, 100.31415001964923, 0.7084611999999999, 325.0, 807, 162370, 227, 8.912807899999962
228, 11.668429386442986, 83.52766478165336, 100.68567668527797, 0.7074243999999998, 55.0, 345, 162715, 228, 3.7770916000000625
229, 10.552626160268458, 83.3195068762169, 100.37589017500788, 0.7065343000000001, 75.0, 644, 163359, 229, 7.030373899999972
230, 8.778494709059778, 83.3036104869143, 100.27245422214051, 0.7052185000000002, 225.0, 818, 164177, 230, 9.06026600000007
231, 10.896661020558456, 83.36426193075408, 100.40232918939161, 0.7038037000000001, 210.0, 754, 164931, 231, 8.28233560000001
232, 11.558811487189601, 83.31723391518418, 100.37966465484553, 0.7027102000000001, 100.0, 461, 165392, 232, 5.132978800000046
233, 9.343655582963692, 83.30970683948918, 100.31773496781702, 0.7015590999999995, 125.0, 818, 166210, 233, 8.942656600000078
234, 8.394673319487216, 83.43890139749841, 100.51834934828781, 0.7004241999999999, 35.0, 443, 166653, 234, 4.940781000000015
235, 10.856981755939184, 83.39106744504443, 100.32535222870072, 0.699337, 200.0, 765, 167418, 235, 8.301810499999988
236, 10.059411156013875, 83.35120323366449, 100.40490998990181, 0.6977962000000002, 185.0, 947, 168365, 236, 10.511216699999977
237, 11.733993804899061, 83.37095480972195, 100.50450678286344, 0.6962193999999996, 170.0, 805, 169170, 237, 8.763030699999945
238, 9.949198387243266, 83.31445730244455, 100.21408367742059, 0.6949080999999998, 155.0, 652, 169822, 238, 7.301980999999955
239, 9.490065463537869, 82.94866121331216, 99.91220935656432, 0.6931359999999995, 320.0, 1317, 171139, 239, 14.554772899999989
240, 6.826746910810471, 82.86654323503083, 99.72033022712259, 0.6914917000000002, 95.0, 510, 171649, 240, 5.53492110000002
241, 8.540560157140096, 82.81535460408529, 99.73173007202148, 0.6903576999999997, 180.0, 750, 172399, 241, 8.36379050000005
242, 9.62964948013425, 82.80895382881164, 99.71142738342286, 0.6889627, 145.0, 800, 173199, 242, 8.87638990000005
243, 11.242557905419043, 82.77963221117798, 99.72795037830367, 0.6877620999999999, 15.0, 534, 173733, 243, 5.994284100000073
244, 10.505432212071677, 82.78809270977808, 99.75075952156902, 0.6866326, 185.0, 721, 174454, 244, 8.108628799999906
245, 9.400374467360688, 82.78423955090624, 99.62121490895137, 0.6854563, 30.0, 586, 175040, 245, 6.657843000000071
246, 8.60578025422676, 82.75357549776214, 99.64186795710334, 0.6842035000000003, 210.0, 806, 175846, 246, 9.013197799999944
247, 7.652401776019064, 82.81367093674166, 99.68055841170853, 0.6829102000000004, 120.0, 631, 176477, 247, 7.141796400000089
248, 8.83477788283446, 82.85486132185036, 99.82163836042457, 0.6818607999999996, 80.0, 535, 177012, 248, 6.1521702000000005
249, 7.924503691160059, 82.87744200893107, 99.79611741619007, 0.680878, 30.0, 557, 177569, 249, 6.336212899999964
250, 7.713575233142977, 82.84153904777746, 99.768884567407, 0.6798133000000001, 105.0, 626, 178195, 250, 7.041991200000098
251, 7.60910346737941, 82.83445728659787, 99.7325765793673, 0.6785686000000003, 310.0, 757, 178952, 251, 8.646297899999922
252, 9.031136178254732, 83.02477660954087, 99.97874276425095, 0.6772726000000003, 135.0, 683, 179635, 252, 7.647429099999954
253, 7.523734623274835, 82.31363887657113, 99.00809917839206, 0.6759964, 180.0, 735, 180370, 253, 8.43306460000008
254, 7.800439155929886, 81.64795589909222, 98.29434730394206, 0.6747778, 80.0, 619, 180989, 254, 7.001094500000136
255, 10.687347001151034, 81.71969208681494, 98.5602531528712, 0.6738616000000001, 50.0, 399, 181388, 255, 4.612152299999934
256, 9.386600731206144, 81.79097433705859, 98.50602981437284, 0.6727636000000002, 165.0, 821, 182209, 256, 9.466230499999938
257, 10.189482112358617, 81.69990289934707, 98.40551697421515, 0.6716835999999999, 75.0, 379, 182588, 257, 4.419515400000137
258, 8.18230970595694, 81.72029081238102, 98.36260247399964, 0.6704559999999994, 170.0, 985, 183573, 258, 11.236047800000051
259, 8.010256989365502, 81.66385352004309, 98.29493120208822, 0.6685624000000002, 210.0, 1119, 184692, 259, 12.871135999999979
260, 7.039901905631338, 81.70325555168812, 98.33333726013338, 0.6664834000000002, 240.0, 1191, 185883, 260, 13.655373499999996
261, 7.926300628649738, 81.69070403703809, 98.37342021878392, 0.6643882000000004, 425.0, 1137, 187020, 261, 13.036594400000013
262, 9.592980938911438, 81.62967774963379, 98.32899098205566, 0.6629149, 55.0, 500, 187520, 262, 5.738804299999856
263, 6.155464132951799, 81.75276385512308, 98.35974864424946, 0.6620797, 55.0, 428, 187948, 263, 5.059199700000136
264, 7.711063685258889, 81.73990623716827, 98.43159291754125, 0.6610437999999998, 180.0, 723, 188671, 264, 8.383340500000031
265, 8.531301683372101, 81.70025923737383, 98.34217299739872, 0.6593760999999995, 285.0, 1130, 189801, 265, 13.033091400000103
266, 6.511553025397525, 81.16411870482621, 97.69812822281176, 0.6576526000000003, 180.0, 785, 190586, 266, 9.260469600000079
267, 7.740612777951044, 81.13530302420675, 97.69463738809085, 0.6561406000000001, 185.0, 895, 191481, 267, 10.577341299999944
268, 9.033959018653638, 81.11155647871963, 97.7223010540598, 0.6546070000000003, 180.0, 809, 192290, 268, 9.388692199999923
269, 5.291462826237798, 81.02080497479821, 97.47570547632003, 0.6534856000000001, 20.0, 437, 192727, 269, 5.139436899999964
270, 9.809165067257275, 81.07624354579572, 97.68733579435005, 0.6525189999999995, 85.0, 637, 193364, 270, 7.638007199999947
271, 8.735564207886728, 81.11417641017748, 97.7049522952757, 0.6510141999999994, 250.0, 1035, 194399, 271, 12.224834399999963
272, 5.916769302635464, 81.06982094631502, 97.54644680141077, 0.6493546000000001, 165.0, 809, 195208, 272, 9.678663899999947
273, 6.297351449601998, 81.03259353153801, 97.53049799655003, 0.6477750999999999, 265.0, 946, 196154, 273, 11.198830199999975
274, 7.945894496412728, 80.98470056488758, 97.52202623021884, 0.6463522000000003, 130.0, 635, 196789, 274, 7.59449090000021
275, 6.579039073044277, 81.14034942259272, 97.63585867364722, 0.6451831, 120.0, 664, 197453, 275, 7.936517000000094
276, 8.865726538481768, 81.06278489765369, 97.68172924049185, 0.6436621000000002, 210.0, 1026, 198479, 276, 12.204472399999986
277, 8.183907833236914, 81.0381246997464, 97.54482245622734, 0.6420133000000002, 380.0, 806, 199285, 277, 9.675968500000181
278, 11.314886875666076, 81.08311684200571, 97.65014518377806, 0.6406966000000003, 105.0, 657, 199942, 278, 7.872322499999882
279, 7.598184116305271, 81.49973509458276, 98.0582925370596, 0.6395491, 110.0, 618, 200560, 279, 7.379841400000032
280, 6.414881887501234, 81.6404972494465, 98.27162413401146, 0.6376788999999998, 225.0, 1460, 202020, 280, 17.52713770000014
281, 5.503999991878789, 81.50489513537022, 98.02796019309478, 0.6360211, 80.0, 382, 202402, 281, 4.629152900000008
282, 7.604854625648987, 81.65145622209678, 98.30844484246431, 0.6345783999999998, 205.0, 1221, 203623, 282, 14.68301489999999
283, 9.465181789691227, 81.69291551145788, 98.46721457564124, 0.6328881999999997, 145.0, 657, 204280, 283, 7.978028499999937
284, 7.900846793227608, 81.49703515143622, 98.0939656666347, 0.6316920999999999, 310.0, 672, 204952, 284, 8.210603099999844
285, 5.701706321655418, 81.57002520389695, 98.16326684745954, 0.6305869, 65.0, 556, 205508, 285, 6.777085499999885
286, 5.407972250264167, 81.66977966865993, 98.31578842000512, 0.6294952000000003, 125.0, 657, 206165, 286, 7.967901100000063
287, 9.034353084651483, 81.65547995162684, 98.35255722832957, 0.6283629999999999, 105.0, 601, 206766, 287, 7.40869170000019
288, 8.826940782135352, 81.53916223843892, 98.187116086483, 0.6274764999999999, 35.0, 384, 207150, 288, 4.595366700000113
289, 5.817013462579328, 81.55857388365503, 98.12425140181398, 0.6264424000000001, 215.0, 765, 207915, 289, 9.303924400000142
290, 7.609833649503506, 81.61980766978691, 98.30584507453733, 0.6253111, 45.0, 492, 208407, 290, 6.056570899999997
291, 5.772463901055292, 81.6564102568157, 98.2786322875344, 0.6245208999999998, 80.0, 386, 208793, 291, 4.7858329000000595
292, 4.149720553973579, 81.65069440674174, 98.21925563650159, 0.6235381, 135.0, 706, 209499, 292, 8.70921670000007
293, 8.322513031489304, 81.51772145675952, 98.23871687378711, 0.6224805999999999, 90.0, 469, 209968, 293, 5.826815899999929
294, 13.555269729654682, 81.21153298967836, 98.01746946125361, 0.6215913999999997, 65.0, 519, 210487, 294, 6.471705400000019
295, 11.225383510059645, 81.33237823862315, 98.07495284814854, 0.620686, 65.0, 487, 210974, 295, 5.951377699999966
296, 6.145691668248241, 81.1417855728026, 97.63183231816458, 0.6199138000000001, 65.0, 371, 211345, 296, 4.60987769999997
297, 8.061523325534056, 81.28546095083881, 97.82676865533487, 0.6189003999999998, 110.0, 755, 212100, 297, 9.370460599999888
298, 5.711857553253222, 81.26913252787374, 97.81577054891154, 0.6173253999999996, 310.0, 995, 213095, 298, 12.271239400000013
299, 6.5380932066101884, 81.25015240725037, 97.74294124805164, 0.6157836999999999, 155.0, 718, 213813, 299, 8.902878800000053
300, 9.245493276370604, 81.15989068243825, 97.74930287285623, 0.6146487999999998, 70.0, 543, 214356, 300, 6.7832899
301, 7.823339961498164, 81.11877175713327, 97.65897130409567, 0.6132348999999999, 155.0, 1028, 215384, 301, 12.786197800000082
302, 11.976159106150527, 81.24104492331224, 98.01515449272408, 0.6117363999999996, 130.0, 637, 216021, 302, 8.026885499999935
303, 7.914915984263644, 81.21625641584396, 97.77745076417924, 0.6105870999999998, 40.0, 640, 216661, 303, 8.074116799999956
304, 4.208467255016596, 81.14447591822675, 97.61698158099927, 0.6095512, 85.0, 511, 217172, 304, 6.434444900000017
305, 7.852273200499526, 81.10211014208211, 97.69091522423929, 0.6086935, 35.0, 442, 217614, 305, 5.481789800000115
306, 7.661089117400838, 81.2064710046253, 97.7985590635425, 0.6078024999999999, 65.0, 548, 218162, 306, 6.927779699999974
307, 6.639398507616628, 81.19997945814276, 97.72663951471223, 0.6064137999999997, 245.0, 995, 219157, 307, 12.623350600000094
308, 8.09696076153238, 81.2110556082664, 97.80502690163804, 0.6046794999999998, 225.0, 932, 220089, 308, 11.713817600000084
309, 8.412274861324045, 80.76522551351071, 97.22164863031833, 0.6033825999999998, 100.0, 509, 220598, 309, 6.539706799999976
310, 8.135755135554534, 80.89345278226412, 97.36761118962214, 0.6023395, 135.0, 650, 221248, 310, 8.225955699999986
311, 6.134218046824567, 80.92364879295667, 97.34867240988305, 0.6011722, 95.0, 647, 221895, 311, 8.231164600000056
312, 7.322529591502046, 80.89128624346617, 97.37650068543797, 0.5999644000000003, 135.0, 695, 222590, 312, 8.916444499999898
313, 5.716980557058997, 80.89685690274803, 97.31620793262019, 0.5987530000000002, 135.0, 651, 223241, 313, 8.363977199999908
314, 7.50300782345056, 81.00183359225417, 97.46685710881941, 0.5977557999999997, 125.0, 457, 223698, 314, 5.7811635999999
315, 7.524626632048113, 80.87483253735024, 97.36755542627117, 0.5965399, 210.0, 894, 224592, 315, 11.433045499999935
316, 6.494819356491102, 80.95109263682525, 97.47832541497762, 0.5951989, 15.0, 596, 225188, 316, 7.677437199999986
317, 6.712281083249297, 80.99273937285258, 97.42159413043117, 0.5943186999999999, 80.0, 382, 225570, 317, 4.90388229999985
318, 8.928754661928481, 81.0670483686561, 97.65685273686815, 0.5935077999999998, 110.0, 519, 226089, 318, 6.687940600000047
319, 5.852032931322026, 80.96726194531074, 97.4321450096975, 0.5920407999999996, 305.0, 1111, 227200, 319, 14.247802699999966
320, 6.7024763377983705, 80.84560048397204, 97.31344620705777, 0.5902786000000001, 315.0, 847, 228047, 320, 10.962138700000196
321, 6.203464159897482, 80.90895135154919, 97.34623458316419, 0.588988, 115.0, 587, 228634, 321, 7.632649999999785
322, 4.947583716913572, 80.95132509389317, 97.40189589115612, 0.5881005999999999, 70.0, 399, 229033, 322, 5.260566400000016
323, 6.171534519926038, 80.78155679288118, 97.18027558534041, 0.5874102999999999, 45.0, 368, 229401, 323, 4.742762300000095
324, 6.373027105180044, 80.94938567976833, 97.41055815127972, 0.5866822, 45.0, 441, 229842, 324, 5.737075200000163
325, 6.604509399833664, 81.0146132622311, 97.573757371766, 0.5857192, 105.0, 629, 230471, 325, 8.2727668
326, 6.649467796541107, 81.28913668327525, 97.91556599418524, 0.5847985000000001, 45.0, 394, 230865, 326, 5.008041300000059
327, 9.960817204450997, 81.11002752349133, 97.69848744378449, 0.5836437999999998, 185.0, 889, 231754, 327, 11.665916499999867
328, 7.984329936542303, 81.10910930026516, 97.70072032219201, 0.5823063999999998, 45.0, 597, 232351, 328, 7.831236600000011
329, 7.333109441739709, 81.04643666225931, 97.50599272354789, 0.5814379000000001, 75.0, 368, 232719, 329, 4.877387900000031
330, 7.1433158747522585, 81.15782439181885, 97.70021500151302, 0.580231, 210.0, 973, 233692, 330, 12.681713899999977
331, 6.6053689628901004, 81.06348323133092, 97.5440181578645, 0.5784831999999999, 170.0, 969, 234661, 331, 12.568544700000075
332, 7.081033738313523, 81.06923273330091, 97.5525322105128, 0.5768992, 135.0, 791, 235452, 332, 11.321237499999825
333, 6.402380176771411, 81.0325978339752, 97.56313093549254, 0.5755644999999999, 110.0, 692, 236144, 333, 10.451889100000017
334, 7.230413473166355, 80.99368205517908, 97.48521442687421, 0.5738770000000001, 230.0, 1183, 237327, 334, 18.243566900000133
335, 7.517488733874441, 80.97351573989752, 97.48424344067993, 0.5719852, 240.0, 919, 238246, 335, 16.95144449999998
336, 8.562528340381665, 81.27532188472321, 97.91549907902038, 0.5707954000000001, 80.0, 403, 238649, 336, 7.206678199999942
337, 5.249273358289338, 81.05538515906947, 97.453719592157, 0.5700898, 30.0, 381, 239030, 337, 6.010058900000104
338, 5.638161822898577, 81.07990864090749, 97.58806555526995, 0.5691682000000002, 155.0, 643, 239673, 338, 10.095843099999911
339, 7.16642664510338, 80.70292497574424, 97.12310064354273, 0.5679649, 140.0, 694, 240367, 339, 10.666070699999864
340, 8.726013809322591, 80.28448507819377, 96.6510762112961, 0.5668930000000001, 55.0, 497, 240864, 340, 7.7960364999999
341, 5.000241405617744, 80.2642036923382, 96.56445669700038, 0.565894, 145.0, 613, 241477, 341, 10.420517400000108
342, 9.861910394915713, 80.32576636172462, 96.74186196588661, 0.5649976, 80.0, 383, 241860, 342, 6.3775419999999485
343, 5.878904448205586, 80.36446778034914, 96.74931770085458, 0.5641362999999998, 75.0, 574, 242434, 343, 9.663794399999915
344, 5.958395786052756, 80.2550925013007, 96.59470813023059, 0.5629879, 155.0, 702, 243136, 344, 11.952899099999968
345, 6.892904308086005, 80.29483801259781, 96.64348034355967, 0.5617927, 65.0, 626, 243762, 345, 15.532089000000042
346, 8.58292402420193, 80.31884442269802, 96.71015621721745, 0.5607685000000001, 90.0, 512, 244274, 346, 11.491772900000115
347, 8.743688446321919, 80.2690526104282, 96.68747498842505, 0.5597514999999996, 110.0, 618, 244892, 347, 10.599780499999952
348, 5.693119603630895, 80.31878472477025, 96.62624930967945, 0.5587282000000001, 45.0, 519, 245411, 348, 9.282517000000098
349, 10.394228176172678, 80.25367841844435, 96.70522532277293, 0.5579146, 75.0, 385, 245796, 349, 6.482469300000048
350, 6.943980235655129, 80.40506505031212, 96.73761486227995, 0.5570172999999997, 120.0, 612, 246408, 350, 8.978764700000056
351, 5.79863036437044, 80.32564368499935, 96.65612751163849, 0.5560066, 100.0, 511, 246919, 351, 7.02915639999992
352, 8.993453615176008, 80.3688254025903, 96.79517287704418, 0.5550013000000001, 135.0, 606, 247525, 352, 8.300107099999877
353, 8.63365857247453, 80.43689799497784, 96.86751108828379, 0.5536612000000001, 200.0, 883, 248408, 353, 11.827361799999835
354, 6.304635103058628, 80.40174487256628, 96.81168963214544, 0.5524093, 45.0, 508, 248916, 354, 6.984675599999946
355, 8.075582776335283, 80.3510906858778, 96.73195943955339, 0.5509747, 205.0, 1086, 250002, 355, 18.500632499999938
356, 6.614305393270792, 80.62573403182, 97.0328268182005, 0.5491315000000002, 265.0, 962, 250964, 356, 21.425519299999905
357, 8.296566512241938, 80.54510834737837, 96.97561787212763, 0.54766, 210.0, 673, 251637, 357, 15.9383914
358, 5.927592448570775, 80.59001876636563, 96.96339872676279, 0.5462776, 100.0, 863, 252500, 358, 13.15937729999996
359, 6.305569893528358, 80.4729718631217, 96.8772288926842, 0.5449995999999999, 100.0, 557, 253057, 359, 8.513183499999968
360, 8.980539388655247, 80.52253124880873, 96.95320392175054, 0.5437144000000003, 255.0, 871, 253928, 360, 14.028921699999955
361, 6.453941749825197, 80.54939790613511, 96.90198371310194, 0.5418594999999998, 210.0, 1190, 255118, 361, 18.742125400000077
362, 6.006755362619704, 80.51385892731489, 96.87814461441569, 0.5403988, 20.0, 433, 255551, 362, 6.6644068999999035
363, 6.144757638206793, 80.49707481448856, 96.88870996662034, 0.5392648, 380.0, 827, 256378, 363, 12.71041409999998
364, 5.487645547099159, 80.49829752702452, 96.81005488348084, 0.5379616, 135.0, 621, 256999, 364, 9.958959200000209
365, 6.842592466698143, 80.49271069673964, 96.88110242656167, 0.5362488999999999, 470.0, 1282, 258281, 365, 21.705226699999912
366, 5.999245213132968, 80.39327873394643, 96.71320015886705, 0.5344695999999998, 180.0, 695, 258976, 366, 11.34760580000011
367, 7.706838807355054, 80.52817189452136, 96.92958414023704, 0.5329548999999998, 155.0, 988, 259964, 367, 15.408678799999961
368, 5.507624818569774, 80.36840986574255, 96.67456454026481, 0.5316237999999998, 110.0, 491, 260455, 368, 7.65639259999989
369, 7.015575832581218, 80.30899122696889, 96.65460056594655, 0.5306131000000001, 80.0, 632, 261087, 369, 9.93202250000013
370, 9.465663831660201, 80.32697216012625, 96.80089199130096, 0.5292387999999999, 195.0, 895, 261982, 370, 13.774545599999783
371, 6.8690898658308255, 80.32658750943128, 96.65841095207273, 0.5277366999999998, 120.0, 774, 262756, 371, 12.21265459999995
372, 5.696321836288383, 80.36871780767673, 96.66831433552068, 0.5261176, 390.0, 1025, 263781, 372, 16.141208000000006
373, 6.4740717420211205, 80.33084214039339, 96.68954324966822, 0.5248440999999999, 25.0, 390, 264171, 373, 6.28642519999994
374, 8.119740104423714, 80.36719415838068, 96.73373693490957, 0.5238001, 120.0, 770, 264941, 374, 12.204919599999812
375, 7.550874477227529, 80.25400363498264, 96.59357621934679, 0.5224996, 100.0, 675, 265616, 375, 10.674673999999868
376, 5.917141510681673, 80.3270308642793, 96.6523370267359, 0.5212783000000002, 125.0, 682, 266298, 376, 10.728209500000048
377, 6.266870429365984, 80.43809458299509, 96.7652509523005, 0.5198698000000003, 210.0, 883, 267181, 377, 14.059023499999967
378, 7.1077049348178925, 80.42476561262801, 96.87911582923866, 0.5184757000000003, 155.0, 666, 267847, 378, 11.375095899999906
379, 6.862556901597327, 80.33303555440347, 96.6846261154353, 0.5169511000000002, 675.0, 1028, 268875, 379, 22.403066800000033
380, 5.972144129266553, 80.34221059495263, 96.64803626277067, 0.5153085999999999, 210.0, 797, 269672, 380, 19.086782700000185
381, 7.306845101542355, 79.98309768718639, 96.33005760311535, 0.5136075999999998, 315.0, 1093, 270765, 381, 29.305053000000044
382, 8.211627177367866, 79.86394733301326, 96.23942385818879, 0.5121397000000001, 95.0, 538, 271303, 382, 14.814393899999686
383, 6.156253492204446, 79.8531649224841, 96.09656008230884, 0.5112153999999999, 100.0, 489, 271792, 383, 11.423434099999668
384, 5.794404162277263, 79.81315842084254, 96.01439036197014, 0.5102722000000001, 35.0, 559, 272351, 384, 14.717639599999984
385, 7.399591132553656, 79.83937902118436, 96.11840812721063, 0.5094073, 80.0, 402, 272753, 385, 11.193930699999783
386, 7.92844912415902, 79.90890444181782, 96.20155474684321, 0.5081688999999999, 460.0, 974, 273727, 386, 27.552983699999913
387, 5.72514965000138, 79.84259299182017, 96.05524858713879, 0.5067036999999999, 120.0, 654, 274381, 387, 18.685996199999863
388, 7.634295741997419, 79.8892723975643, 96.11500983084402, 0.5056687, 40.0, 496, 274877, 388, 14.015226600000005
389, 6.580466371474556, 79.8024796211189, 96.01135889093547, 0.5044537000000001, 205.0, 854, 275731, 389, 23.632312700000057
390, 6.8204854948784615, 79.89138231151227, 96.14023935292745, 0.5029372000000001, 170.0, 831, 276562, 390, 19.242018200000075
391, 5.939988624166559, 79.8673842202132, 96.13217082168117, 0.5016547000000001, 110.0, 594, 277156, 391, 10.886938799999825
392, 5.798049738775186, 79.93790042230992, 96.16480578646633, 0.5002966000000002, 195.0, 915, 278071, 392, 25.90255890000026
393, 6.841537782826005, 79.8680130812809, 96.12489796258626, 0.4987252000000001, 210.0, 831, 278902, 393, 24.326733800000056
394, 8.26458957700924, 79.86342162766717, 96.1523967966375, 0.49711690000000003, 500.0, 956, 279858, 394, 26.87838039999997
395, 7.436474913284286, 79.14084192453244, 95.19519741359927, 0.4956075999999999, 140.0, 721, 280579, 395, 12.192349500000091
396, 4.714662496671818, 78.97641313005202, 94.97798132565943, 0.49404969999999987, 240.0, 1010, 281589, 396, 18.866391300000032
397, 5.472389462008183, 78.9398538130748, 94.93563390252388, 0.4926430000000001, 20.0, 553, 282142, 397, 9.72013489999972
398, 6.7191500962031405, 78.99343583078095, 95.11289889403064, 0.4916106999999999, 60.0, 594, 282736, 398, 11.577539999999772
399, 5.288127075083249, 79.01571659628944, 95.08458308284335, 0.4901302000000002, 300.0, 1051, 283787, 399, 23.126106500000333
400, 5.716150805281782, 79.07448720469058, 95.11282733806128, 0.48881349999999996, 55.0, 412, 284199, 400, 14.604615199999898
401, 7.451337899744339, 78.96529449990572, 95.10037644795794, 0.48813039999999985, 55.0, 347, 284546, 401, 15.14172469999994
402, 9.503793655305493, 78.9420090440304, 95.17976708763997, 0.4872447999999999, 120.0, 637, 285183, 402, 26.003633400000126
403, 8.76993134524308, 79.07320046518363, 95.22480278763116, 0.48621249999999994, 70.0, 510, 285693, 403, 22.424595800000134
404, 7.929796006425941, 79.02996822479041, 95.15004720623241, 0.4848237999999999, 165.0, 1033, 286726, 404, 39.65724510000018
405, 7.432876235227796, 78.93005995207196, 94.99587747115123, 0.4833253, 120.0, 632, 287358, 405, 23.790820599999734
406, 8.641079833200813, 78.9527946806302, 94.99080877930578, 0.48226329999999995, 85.0, 548, 287906, 406, 20.20636080000031
407, 7.608623643761606, 78.95540028083616, 95.03546084427252, 0.4808845, 470.0, 984, 288890, 407, 36.42151389999981
408, 5.626895186648345, 78.85578629329726, 94.83038364467717, 0.4794597999999999, 40.0, 599, 289489, 408, 23.415983999999753
409, 6.526149499775637, 78.91859489098951, 94.94770612525056, 0.47833839999999983, 190.0, 647, 290136, 409, 23.62087670000028
410, 6.418232531891161, 78.87618790041421, 94.90237620871233, 0.47719720000000004, 115.0, 621, 290757, 410, 23.15705799999978
411, 6.6349894316836275, 78.86263145892873, 94.85778979025501, 0.47603800000000007, 95.0, 667, 291424, 411, 26.615158500000234
412, 7.607509838596021, 78.88114440524885, 94.97812629360226, 0.47466910000000007, 210.0, 854, 292278, 412, 33.99358600000005
413, 7.2491421149645605, 78.73244235046909, 94.79391795753413, 0.47347929999999994, 95.0, 468, 292746, 413, 17.934616500000175
414, 5.188654389507518, 78.8944433977504, 94.89565097405287, 0.4726071999999999, 70.0, 501, 293247, 414, 17.460964099999728
415, 6.762791729738884, 78.93870184843676, 95.03974886011899, 0.4717953999999999, 65.0, 401, 293648, 415, 17.492155899999943
416, 7.569446873349639, 78.81220852778507, 94.81946315765381, 0.4709665, 80.0, 520, 294168, 416, 21.165887799999837
417, 5.93323051456769, 78.93261560071416, 94.93580186667563, 0.46964169999999994, 265.0, 952, 295120, 417, 35.445810300000176
418, 12.522500168258215, 78.90617529083701, 95.059542389477, 0.46829529999999986, 50.0, 544, 295664, 418, 20.350214099999903
419, 6.142147234187294, 78.90296506881714, 94.94199170821753, 0.46724409999999994, 165.0, 624, 296288, 419, 25.506280199999765
420, 5.590068312169725, 78.89607934424339, 94.93951526636144, 0.46608039999999995, 180.0, 669, 296957, 420, 26.36272360000021
421, 6.9700634845176435, 78.78255780178723, 94.80637072259648, 0.46500039999999987, 65.0, 531, 297488, 421, 20.590127300000404
422, 6.889160416134938, 78.87767759246142, 94.93253157919298, 0.4637197000000002, 105.0, 892, 298380, 422, 36.1548542999999
423, 6.095609620152187, 78.97237805966978, 94.99392149183485, 0.46247950000000015, 130.0, 486, 298866, 423, 18.000296799999887
424, 7.826618812071001, 78.85134715025129, 94.89098952177265, 0.4613103999999998, 220.0, 813, 299679, 424, 21.62334359999977
425, 9.140747009920624, 81.07299642502886, 97.58248474313028, 0.45986319999999986, 95.0, 795, 300474, 425, 13.903511499999695
426, 9.605738879544221, 82.6300751843215, 99.49752040780214, 0.45844299999999977, 240.0, 783, 301257, 426, 13.76721469999984
427, 4.641844143714811, 82.56589953417848, 99.28731828135223, 0.4573729, 50.0, 406, 301663, 427, 7.196846199999982
428, 7.3954404864365255, 82.66311770863304, 99.43465068049876, 0.4563721, 180.0, 706, 302369, 428, 13.64085759999989
429, 7.8168340890456625, 82.58020785325482, 99.38309142609641, 0.45477459999999986, 415.0, 1069, 303438, 429, 19.120035200000075
430, 5.534896072297589, 82.5654355617756, 99.27249009396549, 0.4534291000000001, 90.0, 426, 303864, 430, 7.651658899999802
431, 5.4939653613283985, 82.54568795688817, 99.25566915605889, 0.4526065000000001, 135.0, 488, 304352, 431, 8.84294009999985
432, 5.2560179534605, 82.60881064032431, 99.34891602252162, 0.45137079999999985, 240.0, 885, 305237, 432, 16.60275989999991
433, 7.388665365524033, 82.65448928551261, 99.44885551222791, 0.44964820000000005, 260.0, 1029, 306266, 433, 18.7123974000001
434, 6.502846719051565, 82.64040219810099, 99.41954833782272, 0.4479067, 175.0, 906, 307172, 434, 19.800672900000336
435, 6.824105485120425, 82.58833429909343, 99.3368767068113, 0.4465099, 180.0, 646, 307818, 435, 17.855190299999776
436, 8.410412516724598, 82.61045214220569, 99.37776463597386, 0.4456288, 65.0, 333, 308151, 436, 11.262213299999985
437, 8.12683166509127, 82.58896543882686, 99.39455385178296, 0.44446599999999986, 245.0, 959, 309110, 437, 33.683046099999956
438, 6.198496494901348, 82.50508597339743, 99.22142995277916, 0.4430259999999999, 120.0, 641, 309751, 438, 25.292595999999776
439, 6.973403860480417, 82.26926567541301, 98.92399705707697, 0.4417974999999999, 180.0, 724, 310475, 439, 22.957726000000093
440, 8.055298185110356, 82.25542335637269, 98.99318082007134, 0.44033499999999987, 215.0, 901, 311376, 440, 35.80103529999997
441, 9.238461922865305, 82.34686556004766, 99.14658332938579, 0.43892109999999973, 155.0, 670, 312046, 441, 26.56952820000015
442, 9.272521387198251, 82.2433556044649, 99.03324137857098, 0.43786720000000007, 20.0, 501, 312547, 442, 15.597283600000083
443, 9.778433367839227, 82.17587041121263, 98.91886549729567, 0.4369482999999999, 120.0, 520, 313067, 443, 16.847002900000007
444, 7.65524393468389, 82.18506403556933, 98.82859646765542, 0.4361004999999999, 30.0, 422, 313489, 444, 13.324619099999836
445, 6.205349454423645, 82.23674053150219, 98.88235181718916, 0.4348197999999997, 460.0, 1001, 314490, 445, 38.740959700000076
446, 5.394914315838644, 82.35582960307791, 99.01831271964755, 0.43336269999999993, 135.0, 618, 315108, 446, 21.21392509999987
447, 6.841692669622934, 82.44189775761087, 99.14517228994796, 0.4324447, 35.0, 402, 315510, 447, 15.524594099999831
448, 5.936598454749855, 82.230063930867, 98.87434819603446, 0.43172559999999993, 20.0, 397, 315907, 448, 16.66015819999984
449, 6.117410775841977, 82.38395836803032, 99.09312419250647, 0.43102, 55.0, 387, 316294, 449, 15.961992699999882
450, 6.598788765448482, 82.22160822123038, 98.90981056149266, 0.4296007, 275.0, 1190, 317484, 450, 43.574881600000026
451, 6.9343343892419185, 82.1724500775836, 98.8527321596026, 0.4280995, 105.0, 478, 317962, 451, 15.859750099999928
452, 7.068792519740539, 82.22333972975545, 98.9556973489097, 0.42666939999999987, 295.0, 1111, 319073, 452, 46.6072151000003
453, 8.535955437370355, 82.35389745803107, 99.09735325404576, 0.4250646999999999, 135.0, 672, 319745, 453, 28.257621400000062
454, 6.277898837613244, 81.69821235461113, 98.23010307703262, 0.42403869999999994, 70.0, 468, 320213, 454, 14.765447400000085
455, 7.680506396900184, 80.92598248087964, 97.52602646262211, 0.4231576, 45.0, 511, 320724, 455, 16.61312560000033
456, 5.236164163359824, 80.88824826128342, 97.24469977266648, 0.4222080999999999, 75.0, 544, 321268, 456, 18.255818399999953
457, 9.156647315553386, 81.05550838513973, 97.62491305971326, 0.4212451, 120.0, 526, 321794, 457, 21.903713100000004
458, 6.129296293727052, 80.99010415689985, 97.39318144444701, 0.42016240000000005, 215.0, 677, 322471, 458, 27.373398400000042
459, 8.184481079973862, 81.0858339130213, 97.61459225254576, 0.41898880000000005, 100.0, 627, 323098, 459, 20.62209989999974
460, 7.256765577698422, 80.96753624889338, 97.41760647259768, 0.4178466999999998, 135.0, 642, 323740, 460, 20.660275000000183
461, 7.847119403348851, 80.98472944980652, 97.50770775434479, 0.41693319999999995, 75.0, 373, 324113, 461, 12.652392499999678
462, 6.7071693057135535, 81.03982633891859, 97.51649552194695, 0.4157425, 485.0, 950, 325063, 462, 36.626093800000035
463, 6.373600384177164, 80.97498101361458, 97.4018361371869, 0.4140360999999999, 290.0, 946, 326009, 463, 37.23082059999979
464, 6.6144224615875356, 81.09751337224787, 97.67952181288034, 0.41274910000000004, 105.0, 484, 326493, 464, 16.072595000000092
465, 6.035123424459603, 80.90770433409413, 97.3027718403841, 0.4116889000000001, 120.0, 694, 327187, 465, 25.54887719999988
466, 6.992998443750235, 81.00690369826097, 97.46577293982872, 0.41047930000000005, 180.0, 650, 327837, 466, 29.389881199999763
467, 5.218026971121218, 80.97832367636941, 97.35649011154806, 0.40945869999999984, 135.0, 484, 328321, 467, 20.11805540000023
468, 6.621128329961123, 81.00494900221538, 97.40856099482559, 0.4077496, 735.0, 1415, 329736, 468, 52.13140680000015
469, 6.455042963420662, 81.37333775560062, 97.90606738130252, 0.40578489999999995, 145.0, 768, 330504, 469, 23.67732000000069
470, 8.383362392511438, 81.50739574432373, 98.08122926599839, 0.4043592999999999, 180.0, 816, 331320, 470, 30.99599709999984
471, 8.719023782332739, 81.64579012044271, 98.35696364339192, 0.4032874, 105.0, 375, 331695, 471, 16.8972033
472, 7.511725461755513, 81.67413968334866, 98.27320363085558, 0.4024872999999999, 105.0, 514, 332209, 472, 23.95361270000012
473, 5.235478551191475, 81.65836938753333, 98.17075269603501, 0.4016475999999999, 55.0, 419, 332628, 473, 18.10490639999989
474, 8.020874136818732, 81.64758194091975, 98.21516250088018, 0.4000348000000001, 465.0, 1373, 334001, 474, 54.999333699999625
475, 6.804472966573128, 81.62161026154486, 98.2549431722169, 0.3983518, 45.0, 497, 334498, 475, 19.324048200000107
476, 6.073178486670622, 81.57410100140149, 98.13886479083999, 0.39705129999999983, 195.0, 948, 335446, 476, 34.84782720000021
477, 6.10350562127269, 81.42614004952567, 97.87601793250259, 0.39575710000000003, 60.0, 490, 335936, 477, 23.56196
478, 5.907813582031024, 81.61734970180974, 98.1526430383583, 0.3950047, 30.0, 346, 336282, 478, 16.826797699999588
479, 4.901597470680411, 81.5458019167878, 98.06168355128561, 0.3942289, 110.0, 516, 336798, 479, 24.894258199999967
480, 7.159842838343469, 81.6725004733679, 98.2551855285311, 0.3926115999999999, 275.0, 1281, 338079, 480, 49.356011699999726
481, 6.1533987520429525, 81.63499194561672, 98.18491434067445, 0.39082600000000006, 125.0, 703, 338782, 481, 31.49023119999947
482, 4.76101835269625, 81.54973029036549, 98.02346523558896, 0.3898674999999999, 25.0, 362, 339144, 482, 12.304236400000264
483, 7.6043345788080146, 81.69470655315685, 98.29308778257501, 0.388954, 140.0, 653, 339797, 483, 23.21994469999936
484, 7.393537994346019, 81.54985067202387, 98.13466294945913, 0.38760760000000005, 200.0, 843, 340640, 484, 33.170106399999895
485, 7.411822769622447, 81.46336035021471, 98.00398406821972, 0.3859929999999999, 245.0, 951, 341591, 485, 41.0170592000004
486, 4.883679852067005, 81.39916107541039, 97.86139798845564, 0.38475909999999985, 90.0, 420, 342011, 486, 13.868118499999582
487, 7.955073929154983, 81.53107165913337, 98.08906085751902, 0.3836980000000001, 180.0, 759, 342770, 487, 31.041157399999975
488, 10.14448542796885, 81.53784729060108, 98.21604459983868, 0.3825261999999999, 95.0, 543, 343313, 488, 27.81721379999999
489, 5.988040963879653, 81.55673868088495, 98.10880446661086, 0.38165950000000004, 40.0, 420, 343733, 489, 18.88348970000061
490, 10.683377081636218, 81.38524414369982, 97.96034173460991, 0.3809242, 55.0, 397, 344130, 490, 18.07439400000021
491, 8.047663739827627, 81.52544863083783, 98.10839986240163, 0.3799548999999999, 135.0, 680, 344810, 491, 23.253538099999787
492, 8.352421963647776, 81.46183063374275, 98.05587370140927, 0.37859319999999974, 210.0, 833, 345643, 492, 33.335142500000075
493, 7.061755045044301, 81.5267632224343, 98.13047110432326, 0.37713069999999976, 385.0, 792, 346435, 493, 37.531965899999705
494, 8.006103927615412, 81.44274054909374, 97.97071249399589, 0.37586529999999996, 55.0, 614, 347049, 494, 28.17678210000031
495, 8.472920575872399, 81.564363594342, 98.19376637164811, 0.3748339, 95.0, 532, 347581, 495, 23.229322799999863
496, 6.140831236845082, 81.48810695907444, 98.04439200243904, 0.3739843000000001, 50.0, 412, 347993, 496, 13.774941100000433
497, 6.648748215586253, 81.62057410520205, 98.17297336648866, 0.37273689999999987, 200.0, 974, 348967, 497, 40.920155499999964
498, 6.3532246191490875, 81.57029758487735, 98.13441266813078, 0.3712609, 125.0, 666, 349633, 498, 32.090716099999554
499, 6.7920916047913655, 81.91128416030604, 98.53748990029129, 0.36982539999999997, 300.0, 929, 350562, 499, 33.13654610000049
500, 8.271574008370282, 82.151765100546, 98.8558273952274, 0.3684502, 155.0, 599, 351161, 500, 23.499297499999557
501, 8.456192754805087, 82.13660581148588, 98.8733487877479, 0.36732609999999993, 155.0, 650, 351811, 501, 29.564803899999788
502, 6.170268058728106, 82.10767973522323, 98.759569473849, 0.36591579999999974, 230.0, 917, 352728, 502, 37.013289699999405
503, 4.607848994823855, 82.29513921816486, 98.92598127464946, 0.3647638000000001, 15.0, 363, 353091, 503, 14.565603099999862
504, 5.45785961669208, 82.17358882528953, 98.8169694521874, 0.36395199999999983, 30.0, 539, 353630, 504, 26.621739199999865
505, 5.7004707946998305, 82.33309559418353, 99.02996792127666, 0.36268030000000007, 170.0, 874, 354504, 505, 33.33896689999983
506, 7.3423501238206725, 82.163235882461, 98.84701468915513, 0.3612286, 345.0, 739, 355243, 506, 31.648984100000234
507, 6.915266272119987, 82.1844012920673, 98.87481896816156, 0.36003699999999994, 140.0, 585, 355828, 507, 28.339540300000408
508, 8.085970463974228, 82.2077268756804, 98.88944928945739, 0.35868699999999987, 190.0, 915, 356743, 508, 40.48234609999963
509, 5.315964595653499, 82.16763808177068, 98.78966599244337, 0.3573018999999999, 155.0, 624, 357367, 509, 29.297328100000414
510, 5.80577765598874, 82.11933936238135, 98.76518713952338, 0.35604099999999983, 270.0, 777, 358144, 510, 37.04412180000054
511, 6.887594903269822, 82.26838304208412, 98.96811888307707, 0.3549115, 135.0, 478, 358622, 511, 20.163625999999567
512, 5.583626813853586, 82.25996375483507, 98.94743993961612, 0.35383689999999995, 335.0, 716, 359338, 512, 27.698184099999708
513, 8.541185531878437, 82.14508326043268, 98.86511428104296, 0.35257059999999996, 170.0, 691, 360029, 513, 33.017010700000355
514, 9.29652998130629, 81.94110370504445, 98.64350290598719, 0.35134839999999995, 170.0, 667, 360696, 514, 32.59460119999949
515, 7.582920543976364, 81.97821444026455, 98.65648704955758, 0.35037819999999986, 110.0, 411, 361107, 515, 17.15209700000014
516, 8.09771609334451, 81.81481436963351, 98.45906845668577, 0.3490542999999998, 225.0, 1060, 362167, 516, 24.420280000000275
517, 6.717574106294031, 81.89965295076881, 98.53864261373974, 0.34725970000000006, 310.0, 934, 363101, 517, 21.055307800000264
518, 7.963484331074229, 81.89121450761859, 98.54441088808781, 0.3452905, 440.0, 1254, 364355, 518, 25.401793400000315
519, 7.548792931169606, 81.8901316782062, 98.49344575003292, 0.3429604, 415.0, 1335, 365690, 519, 29.698229399999946
520, 6.864382488629218, 81.82032647817945, 98.40645197818154, 0.34112619999999994, 150.0, 703, 366393, 520, 15.28404319999936
521, 5.820334208516267, 81.81066088935438, 98.37527696164652, 0.33993009999999985, 155.0, 626, 367019, 521, 13.973382799999854
522, 6.634933582863872, 81.8582281161697, 98.53503726132789, 0.33863139999999997, 120.0, 817, 367836, 522, 20.480054399999972
523, 7.18830876308367, 81.80824826121545, 98.40538616766766, 0.3373984, 105.0, 553, 368389, 523, 16.146709999999985
524, 5.72111445956723, 81.88360342100346, 98.46785448383352, 0.33657849999999995, 80.0, 358, 368747, 524, 11.09413239999958
525, 7.160828607626388, 81.86565677019956, 98.47441244017728, 0.33506019999999986, 390.0, 1329, 370076, 525, 40.97608029999992
526, 8.47240875462691, 81.5481652486892, 98.17385647183373, 0.33310809999999996, 240.0, 840, 370916, 526, 26.20905109999967
527, 7.6437885068121, 81.50624113816481, 98.04343445376573, 0.33195430000000004, 25.0, 442, 371358, 527, 13.686695399999735
528, 7.587781060935736, 81.49316721826263, 98.07094797656204, 0.33059259999999985, 330.0, 1071, 372429, 528, 44.65251100000023
529, 8.277385115623474, 81.5164436482605, 98.08989487050019, 0.3288564999999999, 340.0, 858, 373287, 529, 43.31921779999993
530, 5.846567512652968, 81.53115527912722, 98.08178353174931, 0.3274471, 145.0, 708, 373995, 530, 30.31520089999958
531, 6.910374158309382, 81.53277004896623, 98.03072390826071, 0.32587119999999997, 465.0, 1043, 375038, 531, 57.36974589999954
532, 6.865193761575171, 81.65009287063839, 98.1940256827531, 0.32430519999999996, 225.0, 697, 375735, 532, 36.82516349999969
533, 9.327413260416574, 81.54905467258587, 98.24122180977886, 0.3232395999999999, 25.0, 487, 376222, 533, 24.16316209999968
534, 5.7645340269636645, 81.51364714126093, 98.05411074743415, 0.32238459999999997, 50.0, 463, 376685, 534, 26.4425154999999
535, 8.50293752684691, 81.60492341061855, 98.21855420979323, 0.32137569999999993, 110.0, 658, 377343, 535, 31.844423300000017
536, 7.340795066931718, 81.59012006302954, 98.08237785016986, 0.32014449999999994, 180.0, 710, 378053, 536, 30.556554900000265
537, 6.327346534998321, 81.51746006312595, 98.0102456755897, 0.31899159999999993, 105.0, 571, 378624, 537, 29.670478000000003
538, 6.767851621285664, 81.49043396903502, 98.03710702290184, 0.3179025999999999, 85.0, 639, 379263, 538, 37.55491089999941
539, 8.331270013219537, 81.58204666089661, 98.1652098712741, 0.31646979999999997, 240.0, 953, 380216, 539, 45.381003799999235
540, 8.303437392371908, 81.6002216355289, 98.14986450091776, 0.3145509999999999, 455.0, 1179, 381395, 540, 70.29598160000023
541, 6.225285247019771, 81.61015131726244, 98.17700733237552, 0.31270869999999995, 80.0, 868, 382263, 541, 45.30147440000019
542, 6.360066117516247, 81.52462398215377, 97.96643513646619, 0.31158819999999987, 90.0, 377, 382640, 542, 18.61703359999956
543, 6.34018076983897, 81.59016627287787, 98.12708986338508, 0.31042359999999997, 215.0, 917, 383557, 543, 48.58630960000028
544, 8.558716022077649, 81.68958657363365, 98.29729694059526, 0.3092851, 55.0, 348, 383905, 544, 18.04735449999953
545, 6.287041801947062, 81.65844432226295, 98.19102525554719, 0.30814839999999993, 180.0, 915, 384820, 545, 43.20348800000011
546, 8.065593724604007, 81.69805022063079, 98.3521472620081, 0.3067174, 135.0, 675, 385495, 546, 34.01621780000005
547, 8.321746193936892, 81.76552987605967, 98.39423904882739, 0.3055176999999999, 215.0, 658, 386153, 547, 32.5448252999995
548, 9.184139770141897, 81.77488245428565, 98.39283593325692, 0.3045889, 60.0, 374, 386527, 548, 16.879129300000386
549, 5.13500721137019, 81.65990357781848, 98.192408719028, 0.30363579999999996, 135.0, 685, 387212, 549, 38.62711670000044
550, 8.085198352571394, 81.61154238122408, 98.17405159747014, 0.30214089999999993, 165.0, 976, 388188, 550, 52.313422600000195
551, 6.268539962652641, 81.55541180518834, 98.06074063543824, 0.30031839999999993, 210.0, 1049, 389237, 551, 61.7280810000002
552, 9.393642051790136, 81.78767400110037, 98.42857595639391, 0.2982952, 235.0, 1199, 390436, 552, 70.88064149999991
553, 10.470383122120753, 82.32910565417198, 99.21238796624414, 0.29667069999999995, 70.0, 606, 391042, 553, 36.18517890000021
554, 9.206304206378615, 82.16159494077442, 98.90990079085212, 0.2953323999999999, 475.0, 881, 391923, 554, 50.82128130000001
555, 4.953512774858003, 82.14693832397461, 98.73397348324458, 0.29419389999999984, 25.0, 384, 392307, 555, 29.17363949999981
556, 10.208129891951495, 82.25271947082696, 99.04747493379716, 0.2929149999999998, 320.0, 1037, 393344, 556, 65.35790409999936
557, 6.980071082860231, 82.08097981770834, 98.68254299587673, 0.2911716999999999, 245.0, 900, 394244, 557, 49.377310200000466
558, 8.964322961115165, 82.21540532550755, 98.94569473945776, 0.28975509999999993, 175.0, 674, 394918, 558, 38.19843209999999
559, 6.463191293268686, 82.21274111005995, 98.84527863396539, 0.2886949, 20.0, 504, 395422, 559, 27.135800999999447
560, 10.523867337866518, 82.19757289676876, 98.97362921937855, 0.28766800000000003, 110.0, 637, 396059, 560, 36.47545360000004
561, 5.128477187526163, 82.13990057340524, 98.72800511958121, 0.28658799999999984, 10.0, 563, 396622, 561, 36.74149380000017
562, 5.887501647291649, 82.16523123926339, 98.79705695670218, 0.28521459999999993, 245.0, 963, 397585, 562, 47.73833289999948
563, 8.466493442300873, 82.0998615412047, 98.82347324269462, 0.2837412999999999, 160.0, 674, 398259, 563, 39.90977440000006
564, 6.221991690153575, 82.04732009297577, 98.64204357842713, 0.28232019999999997, 245.0, 905, 399164, 564, 48.09189100000003
565, 5.579795799059831, 82.39753845275155, 99.09068921055247, 0.28105029999999986, 50.0, 506, 399670, 565, 24.63311690000046
566, 7.109599247214657, 81.67086888800215, 98.23383783069622, 0.2799990999999999, 180.0, 662, 400332, 566, 36.06452950000039
567, 7.930170130719872, 81.2458977197346, 97.77055504447536, 0.2788560999999999, 185.0, 608, 400940, 567, 32.60212849999971
568, 7.07906961686703, 81.1373987760211, 97.62742443979862, 0.277561, 295.0, 831, 401771, 568, 44.156494900000325
569, 9.25439289525665, 81.31388427471292, 97.83784338852455, 0.2762911, 130.0, 580, 402351, 569, 29.800563199999488
570, 7.7579053048695075, 81.17693743934218, 97.6684768889013, 0.2751867999999999, 60.0, 647, 402998, 570, 31.713119500000175
571, 5.02055949917986, 81.08192003100184, 97.45967884517022, 0.2741121999999999, 140.0, 547, 403545, 571, 32.2238741000001
572, 8.480739665550463, 81.22428327410408, 97.7539180798477, 0.2728188999999999, 230.0, 890, 404435, 572, 50.679169
573, 5.997119038744527, 81.14287801961817, 97.58476593998365, 0.2712897999999999, 115.0, 809, 405244, 573, 41.57963970000037
574, 5.511313391896888, 81.15608057557017, 97.55092763495513, 0.27024399999999993, 30.0, 353, 405597, 574, 19.786595800000214
575, 6.718563236477898, 81.14203991153376, 97.62239840403267, 0.2689299999999999, 455.0, 1107, 406704, 575, 57.18191360000037
576, 7.6759767010119395, 81.15320056908232, 97.61704712478158, 0.26744679999999993, 80.0, 541, 407245, 576, 31.183788800000002
577, 4.733324178181361, 81.17625738196672, 97.57233154652248, 0.26634159999999996, 120.0, 687, 407932, 577, 41.173440700000356
578, 6.039221243554377, 81.13335006835452, 97.59165667347699, 0.2652715, 45.0, 502, 408434, 578, 27.031084700000065
579, 7.128289438379199, 81.14528106606525, 97.65261480082636, 0.2644885, 50.0, 368, 408802, 579, 18.5391982000001
580, 4.5289983623906185, 81.3197760965025, 97.79035550273356, 0.26383239999999986, 60.0, 361, 409163, 580, 20.833781199999976
581, 6.651781848537812, 81.19782832201103, 97.64821966562067, 0.2629189, 130.0, 654, 409817, 581, 40.636752700000216
582, 7.47664764847797, 80.99743289553172, 97.47502472455146, 0.26150319999999994, 200.0, 919, 410736, 582, 46.59875790000024
583, 8.366928188288783, 80.93674032738868, 97.41395623633203, 0.2603376999999999, 80.0, 376, 411112, 583, 21.711830899999768
584, 5.489280265762975, 80.90319722953785, 97.23370376287723, 0.2594026, 120.0, 663, 411775, 584, 37.56147890000011
585, 6.019499108075295, 80.96920902329003, 97.42715633315528, 0.25813539999999996, 215.0, 745, 412520, 585, 39.43684060000032
586, 10.162122623532202, 81.16914561994389, 97.70383525044038, 0.2570338, 80.0, 479, 412999, 586, 27.851928699999917
587, 5.2344274732067175, 80.8921280194046, 97.20754778295532, 0.25588449999999996, 255.0, 798, 413797, 587, 43.63658410000062
588, 6.136639371104197, 80.97309227085194, 97.37037500885748, 0.2540872, 410.0, 1199, 414996, 588, 72.3119730999997
589, 6.617993245338556, 80.85736793334735, 97.25529124600169, 0.2525212, 95.0, 541, 415537, 589, 22.771383299999798
590, 8.374126901473675, 81.02103710873588, 97.51192257866185, 0.2511748, 220.0, 955, 416492, 590, 23.604822099999183
591, 5.879096240612673, 80.90796101386911, 97.2860359793226, 0.2499498999999999, 75.0, 406, 416898, 591, 9.260173799999393
592, 6.901066043977498, 80.97955890412027, 97.45158526527845, 0.24899230000000003, 135.0, 658, 417556, 592, 16.09883720000107
593, 6.071123417894891, 80.87408320650141, 97.2734938276575, 0.24776559999999995, 235.0, 705, 418261, 593, 14.259646299999076
594, 5.621080127991226, 80.88973216052469, 97.22752096446138, 0.24634269999999997, 235.0, 876, 419137, 594, 17.515807800000402
595, 7.081361213952252, 81.00464103554285, 97.45658525214138, 0.24503139999999987, 135.0, 581, 419718, 595, 11.808028199999171
596, 8.27118590261036, 80.38508729973938, 96.7649918465948, 0.24363369999999993, 360.0, 972, 420690, 596, 19.59051890000046
597, 9.66075854179534, 80.20574606693152, 96.52877157962683, 0.24246189999999984, 55.0, 330, 421020, 597, 6.6290171000000555
598, 6.932496001506486, 80.15626255412926, 96.41968553281077, 0.2415555999999999, 60.0, 677, 421697, 598, 13.42621390000022
599, 7.361227937936783, 80.31685114080256, 96.60227031360974, 0.24045129999999998, 70.0, 550, 422247, 599, 10.928354300000137
600, 5.885760437315843, 80.22122495756375, 96.36163444218673, 0.2394991, 75.0, 508, 422755, 600, 10.02497349999976
601, 6.611929281770278, 80.37300912521926, 96.62311990866175, 0.23862699999999995, 70.0, 461, 423216, 601, 9.501059899999746
602, 4.579706809173028, 80.14839843051885, 96.34594786400889, 0.23766129999999994, 130.0, 612, 423828, 602, 12.445181799999773
603, 8.4865309393811, 80.46084148814377, 96.83727468842442, 0.2366469999999999, 85.0, 515, 424343, 603, 10.388818500001435
604, 4.949245913042908, 80.15397097875201, 96.36063726515997, 0.23561649999999998, 100.0, 630, 424973, 604, 12.63219299999946
605, 6.950862565865884, 80.27948772723857, 96.60483570979191, 0.2344644999999999, 120.0, 650, 425623, 605, 13.053561599999739
606, 5.882007775513025, 80.25042751752413, 96.50435840900127, 0.23294349999999997, 285.0, 1040, 426663, 606, 21.425081999999747
607, 4.475565361851704, 80.25543907302583, 96.49532080553249, 0.2314063, 155.0, 668, 427331, 607, 13.760710500000641
608, 7.017832862994363, 80.27550172805786, 96.4930120437376, 0.23035869999999992, 30.0, 496, 427827, 608, 10.417757900000652
609, 5.265120190103477, 80.36971213082286, 96.69312257855852, 0.22943079999999996, 45.0, 535, 428362, 609, 13.629809699999896
610, 8.45967042100045, 80.40756151753087, 96.75378174320343, 0.22839129999999988, 95.0, 620, 428982, 610, 14.52333440000075
611, 4.730742690088905, 80.2819334338444, 96.51641433742923, 0.22732659999999993, 60.0, 563, 429545, 611, 10.893951899999593
612, 7.002191666283035, 80.12979047249227, 96.34225645655762, 0.2263401999999999, 75.0, 533, 430078, 612, 10.430190499999298
613, 8.010881838559742, 79.37745109639145, 95.49541266156255, 0.22526739999999998, 135.0, 659, 430737, 613, 12.396098000001075
614, 6.027305627286231, 79.3456585984995, 95.41272796787092, 0.22414689999999993, 125.0, 586, 431323, 614, 10.867956800000684
615, 5.871879647974719, 79.44036874232819, 95.52984148650583, 0.22255120000000003, 350.0, 1187, 432510, 615, 22.271527899998546
616, 7.238327066615175, 79.48565463449472, 95.60126831206769, 0.22094109999999997, 100.0, 602, 433112, 616, 11.784895999999208
617, 5.631896435702219, 79.45464839140574, 95.53330555756887, 0.21953529999999996, 290.0, 960, 434072, 617, 17.973223799999687
618, 7.503467155574578, 79.44049172988666, 95.57463096280404, 0.21775779999999995, 200.0, 1015, 435087, 618, 19.281613299999663
619, 5.997025528000733, 79.46609632401943, 95.52150299639595, 0.21568239999999986, 460.0, 1291, 436378, 619, 24.42676439999923
620, 5.441455897140863, 79.537830564177, 95.6843176392524, 0.21380589999999994, 145.0, 794, 437172, 620, 15.198860500000592
621, 5.25170595638752, 79.49177783203125, 95.5444607421875, 0.21252879999999996, 85.0, 625, 437797, 621, 11.923137799998585
622, 7.7301630175920755, 79.40973455109511, 95.50409462127847, 0.21111219999999994, 315.0, 949, 438746, 622, 18.382249399999637
623, 6.8298099528209795, 79.33148397548565, 95.49957419431061, 0.20982429999999994, 140.0, 482, 439228, 623, 9.955823600001168
624, 5.989116800745038, 79.51257085551559, 95.5767125675651, 0.20852739999999995, 275.0, 959, 440187, 624, 19.69814529999894
625, 5.677863680560464, 79.85699462890625, 95.99496405044987, 0.206614, 390.0, 1167, 441354, 625, 24.376227200000358
626, 8.748564981554956, 79.97344659067673, 96.23389632969209, 0.2047771, 260.0, 874, 442228, 626, 18.472321200000806
627, 7.289091709389901, 79.90374944637983, 96.0916909535726, 0.2032885, 260.0, 780, 443008, 627, 16.872364499999094
628, 8.542603501821365, 79.9033975431076, 96.07288674417597, 0.20172879999999996, 290.0, 953, 443961, 628, 19.86909139999989
629, 6.782411914657462, 79.91823112381088, 96.14659962954221, 0.20035629999999993, 100.0, 572, 444533, 629, 12.40070569999989
630, 7.963458538800478, 79.91607481002808, 96.09924983978271, 0.19948149999999992, 80.0, 400, 444933, 630, 8.476702600000863
631, 8.070351079836257, 79.92541659775601, 96.1506503707904, 0.19836819999999997, 155.0, 837, 445770, 631, 17.956940699999905
632, 4.7212984595786445, 79.89409716442378, 95.99300265071368, 0.19690209999999986, 185.0, 792, 446562, 632, 16.679506300000867
633, 6.931303793932468, 79.98390476203767, 96.2016115098086, 0.19514619999999996, 395.0, 1159, 447721, 633, 24.307679800000187
634, 6.802578523196915, 79.82346760536566, 95.94695609327613, 0.19331019999999996, 340.0, 881, 448602, 634, 18.608593300001303
635, 5.866427093776427, 79.7928026975037, 95.9625375576904, 0.191683, 185.0, 927, 449529, 635, 19.7178229000001
636, 7.1330209949805345, 80.01058487324595, 96.24723015796836, 0.18988839999999996, 425.0, 1067, 450596, 636, 22.792762299999595
637, 6.657611595707781, 79.95989282645431, 96.09144267661898, 0.18846909999999995, 50.0, 510, 451106, 637, 10.924081200000728
638, 5.827506617201326, 80.03548207529273, 96.22043145766281, 0.18762669999999992, 20.0, 426, 451532, 638, 9.014271199999712
639, 8.336883420807107, 80.1459632116901, 96.38226234288912, 0.18658989999999998, 315.0, 726, 452258, 639, 15.456131699998878
640, 5.654018413674619, 80.04371413730439, 96.24108794757298, 0.18533169999999993, 125.0, 672, 452930, 640, 14.493331799998487
641, 6.841704928063451, 80.11354873728864, 96.35723722216109, 0.18376839999999997, 530.0, 1065, 453995, 641, 22.730870199999117
642, 5.134343073661353, 80.0280837304396, 96.16225465729002, 0.18213129999999994, 225.0, 754, 454749, 642, 16.15217279999888
643, 4.747982027169619, 79.92110867413155, 95.99622972453543, 0.1811079999999999, 30.0, 383, 455132, 643, 8.291912400000001
644, 6.673002052076042, 80.06330387095079, 96.26297068468389, 0.18009009999999992, 90.0, 748, 455880, 644, 16.35194279999996
645, 8.536028001726288, 80.13056884188832, 96.40154440706128, 0.17889309999999992, 95.0, 582, 456462, 645, 12.602483200000279
646, 7.00063427808922, 80.08694274011661, 96.29187849663003, 0.1777833999999999, 115.0, 651, 457113, 646, 14.151395299999422
647, 6.282240805663283, 80.05961505061624, 96.28734957260458, 0.17660889999999993, 45.0, 654, 457767, 647, 14.186369999999442
648, 6.167884882653656, 80.07136234931627, 96.25940795728422, 0.17537409999999992, 135.0, 718, 458485, 648, 15.633873599999788
649, 5.531220483557778, 80.25136651459688, 96.4851880470418, 0.17400339999999995, 320.0, 805, 459290, 649, 17.47159079999983
650, 7.548359934904168, 80.21627632692798, 96.4783233158172, 0.17276859999999994, 85.0, 567, 459857, 650, 12.20828480000091
651, 7.998127834278236, 79.7470185161846, 95.9683394054854, 0.17181459999999993, 155.0, 493, 460350, 651, 10.960641699999542
652, 5.998390612926554, 79.87237389508415, 96.08670303120333, 0.1707588999999999, 135.0, 680, 461030, 652, 14.802947199999835
653, 7.687850990839739, 79.72911586471855, 95.91705083950481, 0.16973199999999997, 15.0, 461, 461491, 653, 10.101302799999758
654, 7.730759351124694, 79.7484622941349, 95.94618825388478, 0.16808859999999998, 440.0, 1365, 462856, 654, 29.81372079999892
655, 5.916022332859974, 79.74093766305961, 95.81008284699683, 0.16612569999999996, 265.0, 816, 463672, 655, 17.923831000000064
656, 6.003781323939043, 79.63125741689302, 95.75768967707798, 0.16492599999999988, 55.0, 517, 464189, 656, 11.606904300000679
657, 7.280478310178626, 79.79754829966078, 95.93592694637712, 0.16384689999999993, 180.0, 682, 464871, 657, 15.01479819999986
658, 8.753888028170566, 79.74182621736705, 95.97482591238081, 0.16265349999999987, 150.0, 644, 465515, 658, 14.122710699999516
659, 7.109475876210154, 79.69161174041784, 95.81794499733142, 0.16130979999999995, 350.0, 849, 466364, 659, 18.65368760000092
660, 7.480408724528133, 79.7994211012857, 95.95908790722228, 0.15972489999999995, 165.0, 912, 467276, 660, 20.20183989999896
661, 11.010300174583753, 79.75532683658392, 96.02882709127547, 0.15808149999999987, 285.0, 914, 468190, 661, 20.192235799999253
662, 4.615287582537062, 79.75347708986517, 95.81535340024713, 0.15623289999999992, 265.0, 1140, 469330, 662, 25.532382499999585
663, 5.2404479707570175, 79.00476442354031, 94.97710089784849, 0.15389379999999997, 455.0, 1459, 470789, 663, 32.313270900000134
664, 9.252384507670778, 78.49889071234341, 94.52612686157227, 0.15221529999999994, 70.0, 406, 471195, 664, 9.088497700000516
665, 6.197568070767008, 78.4411979151386, 94.3196673659296, 0.15101109999999995, 265.0, 932, 472127, 665, 20.802803399999902
666, 5.475840528683327, 78.28536474379203, 94.08627877898893, 0.14948019999999995, 345.0, 769, 472896, 666, 17.24259610000081
667, 7.7048734785831074, 78.4273397284039, 94.34841137255653, 0.1477260999999999, 520.0, 1180, 474076, 667, 26.445575899999312
668, 8.64969352381183, 78.43661076681954, 94.3137586890877, 0.1461096999999999, 105.0, 616, 474692, 668, 13.8797158999987
669, 7.175071439490869, 78.35305160805781, 94.26813799506473, 0.14487669999999997, 200.0, 754, 475446, 669, 17.122546700000385
670, 5.825135235961125, 78.47377090331246, 94.32396835597433, 0.14363919999999997, 70.0, 621, 476067, 670, 13.98521989999972
671, 5.767699611722492, 78.33915309111278, 94.16512202223142, 0.14238909999999994, 125.0, 768, 476835, 671, 17.30979649999972
672, 6.225479425881162, 78.3739097211614, 94.19472487465629, 0.14089239999999995, 280.0, 895, 477730, 672, 20.140345799998613
673, 6.227061049344377, 78.43640280347613, 94.28947647819982, 0.13912119999999994, 245.0, 1073, 478803, 673, 24.205405900000187
674, 6.485593791840556, 78.48184020396239, 94.38961726383144, 0.13742289999999993, 205.0, 814, 479617, 674, 18.510309999999663
675, 8.849666278235818, 78.3555456460062, 94.29305187388195, 0.1359945999999999, 135.0, 773, 480390, 675, 17.661126299999523
676, 5.058230712376427, 78.20657405798305, 93.96333214048006, 0.1346743, 130.0, 694, 481084, 676, 15.872865599998477
677, 6.2148956158080475, 78.45439832262598, 94.30457647731731, 0.1330191999999999, 430.0, 1145, 482229, 677, 26.261787199999162
678, 6.4620986855646345, 78.35326588006667, 94.24228223164876, 0.13140549999999993, 95.0, 648, 482877, 678, 14.935792400001446
679, 5.238974976614117, 78.2336323928833, 94.08885471343994, 0.13028229999999996, 65.0, 600, 483477, 679, 13.735062699999617
680, 7.346285716460027, 78.30302653425508, 94.17474670220135, 0.12901959999999996, 125.0, 803, 484280, 680, 18.47280800000044
681, 5.380013117283868, 78.28127596707742, 94.12071890772286, 0.12763899999999995, 65.0, 731, 485011, 681, 16.720606099999713
682, 8.521423347481974, 78.36472535309969, 94.2797381817853, 0.1263735999999999, 140.0, 675, 485686, 682, 15.715943699999116
683, 6.784137195838031, 78.37394340649712, 94.22955482721005, 0.1251027999999999, 215.0, 737, 486423, 683, 16.961041900000055
684, 9.002473915526863, 78.41864048688568, 94.3884025435786, 0.1237923999999999, 80.0, 719, 487142, 684, 16.622328400000697
685, 4.937603614392501, 78.48148993149545, 94.28916355244165, 0.12240369999999991, 265.0, 824, 487966, 685, 18.971647800000937
686, 6.72805943503109, 78.2998747680326, 94.18387618553605, 0.12133719999999995, 55.0, 361, 488327, 686, 8.446257100000366
687, 4.8375316966046835, 78.49280281275348, 94.32015436724888, 0.12051819999999985, 60.0, 549, 488876, 687, 12.742665300000226
688, 5.722750996178324, 78.32802884933459, 94.1792571146292, 0.11894139999999989, 265.0, 1203, 490079, 688, 27.871049600000333
689, 7.3263543001954226, 77.47539689040346, 93.2129106370913, 0.11745999999999993, 55.0, 443, 490522, 689, 10.381822699999248
690, 6.329682745134577, 77.56291054800047, 93.24001596870151, 0.11642679999999996, 165.0, 705, 491227, 690, 16.468979799999943
691, 8.594147199055014, 77.69468589498526, 93.49413405585084, 0.11516409999999991, 130.0, 698, 491925, 691, 16.335855000001175
692, 5.511909636718183, 77.62777027831271, 93.30482154917495, 0.11338029999999986, 340.0, 1284, 493209, 692, 29.818699999999808
693, 5.285643422917316, 77.5808018160942, 93.28991647591268, 0.11162619999999988, 45.0, 665, 493874, 693, 15.491098599999532
694, 6.635464857442904, 77.51611861536058, 93.24151668440824, 0.11039049999999996, 140.0, 708, 494582, 694, 16.57620980000138
695, 8.005314082779535, 77.73252822131646, 93.56408881210699, 0.10938429999999993, 40.0, 410, 494992, 695, 9.667202000000543
696, 4.8760549791256, 77.56851140107953, 93.18562748365444, 0.10840419999999992, 165.0, 679, 495671, 696, 15.942900399999417
697, 5.411085690135386, 77.56257887158336, 93.19264155974058, 0.10712979999999993, 170.0, 737, 496408, 697, 17.339535299999625
698, 8.975141329882723, 77.66031459461558, 93.52626828280363, 0.10587249999999995, 235.0, 660, 497068, 698, 15.489531200000783
699, 6.957542355181557, 77.64243032121816, 93.36492187197845, 0.10473309999999994, 60.0, 606, 497674, 699, 14.311472800000047
700, 7.569830124308954, 77.79109961165432, 93.59208077711683, 0.10375389999999993, 45.0, 482, 498156, 700, 11.320149500001207
701, 4.784333788949972, 77.53299069252743, 93.19120465418335, 0.1027548999999999, 60.0, 628, 498784, 701, 15.068689600000653
702, 7.884107049441208, 77.59938435761825, 93.38286090519118, 0.10136169999999986, 95.0, 920, 499704, 702, 21.880778000000646
703, 10.607976621439901, 76.87039241467492, 92.59673805883375, 0.10008940203389724, 70.0, 885, 500589, 703, 20.884875499999907
704, 6.519669898124628, 76.5744550270258, 92.08472831548646, 0.0999999999999983, 460.0, 1075, 501664, 704, 25.469720499999312
705, 7.997611512899747, 76.54412969694889, 92.03918857407639, 0.10000000000000055, 135.0, 686, 502350, 705, 16.337410800000725
706, 7.5741571764085895, 76.57976779603122, 92.0479394678484, 0.10000000000000082, 35.0, 456, 502806, 706, 10.859407500000088
707, 6.570152938896345, 76.57559698017872, 92.04194233759624, 0.09999999999999908, 330.0, 899, 503705, 707, 21.48251270000037
708, 6.123613218395244, 76.49609676058739, 91.97421128271402, 0.10000000000000096, 35.0, 593, 504298, 708, 14.148439200000212
709, 7.283747370513308, 76.65455526071828, 92.23268943733268, 0.0999999999999993, 440.0, 858, 505156, 709, 20.51443140000083
710, 5.729719239451158, 76.58709673254425, 91.98942255441368, 0.10000000000000075, 25.0, 403, 505559, 710, 9.621789200000421
711, 6.758163537139901, 76.62961047690732, 92.11894702494925, 0.099999999999997, 775.0, 1603, 507162, 711, 38.241123399999196
712, 5.622308200594757, 76.59621407381223, 92.08472007541106, 0.0999999999999972, 625.0, 1487, 508649, 712, 36.13359750000018
713, 7.4412898743025195, 76.80407225547664, 92.3748306491879, 0.0999999999999994, 265.0, 842, 509491, 713, 20.309550500000114
714, 6.304811684243101, 76.49174302918105, 91.95259583769398, 0.10000000000000096, 55.0, 586, 510077, 714, 14.155017300001418
715, 7.169250319963173, 76.2059499044267, 91.67315248459104, 0.10000000000000088, 55.0, 504, 510581, 715, 12.138206499999797
716, 6.789268240163547, 75.99143039697186, 91.33110110686316, 0.10000000000000098, 55.0, 617, 511198, 716, 15.148718599999484
717, 6.3183083930999855, 76.06498558809518, 91.43008289140525, 0.09999999999999833, 310.0, 1067, 512265, 717, 25.85285119999935
718, 6.290351288083637, 76.20935188823596, 91.59432263100615, 0.10000000000000078, 140.0, 662, 512927, 718, 16.185477699998955
719, 6.842885748949492, 75.96321006359105, 91.32934688282859, 0.09999999999999974, 190.0, 789, 513716, 719, 19.52911789999962
720, 5.117378523767884, 76.08550757792459, 91.441187582443, 0.1000000000000007, 160.0, 670, 514386, 720, 16.39367250000032
721, 7.222621126745337, 76.08552379813246, 91.53673863564768, 0.09999999999999891, 110.0, 930, 515316, 721, 22.915204699998867
722, 7.316028866333284, 76.02917381052042, 91.41482961718893, 0.10000000000000057, 175.0, 683, 515999, 722, 17.193948800000726
723, 5.646793752627553, 76.1224819913386, 91.47987131288431, 0.10000000000000007, 100.0, 742, 516741, 723, 18.60504189999847
724, 6.647943559467619, 76.09102636192277, 91.495056185806, 0.10000000000000057, 95.0, 684, 517425, 724, 17.001981800000067
725, 7.194189230701211, 76.27320141209029, 91.7394185589361, 0.09999999999999971, 110.0, 793, 518218, 725, 19.702340800000457
726, 6.472224124670029, 76.17032302246093, 91.55414096679688, 0.10000000000000099, 125.0, 625, 518843, 726, 15.671081099999356
727, 5.939107113240058, 76.17503614964774, 91.60213857877557, 0.09999999999999848, 290.0, 1026, 519869, 727, 25.336701500000345
728, 5.684121016333373, 75.96091829609666, 91.35140461391873, 0.09999999999999888, 145.0, 936, 520805, 728, 23.167619100000593
729, 5.846187634861528, 76.00039580772663, 91.30543350821058, 0.10000000000000075, 85.0, 406, 521211, 729, 10.090114900000117
730, 7.1181157512620175, 75.95502450164415, 91.38674798921255, 0.10000000000000094, 150.0, 561, 521772, 730, 14.07046149999951
731, 7.944121949385813, 75.8543693188951, 91.24175500798475, 0.10000000000000071, 130.0, 669, 522441, 731, 16.628257500000473
732, 4.870233124210721, 75.84083954493205, 91.11348572231475, 0.10000000000000069, 40.0, 672, 523113, 732, 16.90899189999982
733, 6.779386467804993, 75.82082626409992, 91.1661749281022, 0.09999999999999809, 440.0, 1135, 524248, 733, 28.15821490000053
734, 5.436769634178248, 75.92691698996276, 91.27368634400769, 0.10000000000000099, 90.0, 631, 524879, 734, 15.783368300000802
735, 7.401995906185004, 75.80101269767398, 91.18603926613217, 0.10000000000000069, 150.0, 672, 525551, 735, 16.762262599999303
736, 7.363099989962511, 75.84656793388736, 91.19460125040388, 0.09999999999999828, 310.0, 1076, 526627, 736, 26.82650359999934
737, 5.5850082239525465, 75.88300289003189, 91.20802389026362, 0.09999999999999915, 205.0, 885, 527512, 737, 22.13494290000017
738, 5.693757756922271, 75.82507656223171, 91.16597278301532, 0.10000000000000082, 95.0, 455, 527967, 738, 11.534576099998958
739, 5.557144813751699, 75.7357238380449, 91.02223999801602, 0.09999999999999906, 180.0, 902, 528869, 739, 22.454249000000345
740, 4.08492251852555, 75.74946408248066, 91.03464460610157, 0.10000000000000075, 110.0, 402, 529271, 740, 10.296237099999416
741, 8.266337893186435, 75.83245360260455, 91.25702257962686, 0.10000000000000063, 30.0, 343, 529614, 741, 8.67756349999945
742, 5.73752837145123, 75.49555122989348, 90.75454744360913, 0.09999999999999923, 280.0, 870, 530484, 742, 21.98120949999975
743, 8.397695037181533, 75.16622749964397, 90.52389476412819, 0.10000000000000062, 55.0, 336, 530820, 743, 8.627886799999033
744, 5.041029610845208, 75.07393519460977, 90.24159622192383, 0.10000000000000066, 150.0, 674, 531494, 744, 17.1537204999986
745, 4.986006440205888, 74.96243115100232, 90.13304421561105, 0.10000000000000082, 115.0, 455, 531949, 745, 11.448468099999445
746, 4.6766373843445885, 75.0585755777883, 90.1808477129255, 0.10000000000000069, 10.0, 364, 532313, 746, 9.311588700000357
747, 5.360152473400804, 75.01370241072175, 90.16667831185032, 0.0999999999999994, 290.0, 841, 533154, 747, 21.251097800000935
748, 4.626074025875951, 75.044832802989, 90.19022184500665, 0.10000000000000059, 10.0, 326, 533480, 748, 8.312245699999039
749, 7.123717733955136, 75.03910346945332, 90.2893680078378, 0.09999999999999874, 440.0, 965, 534445, 749, 24.697011599999314
750, 6.23546764074556, 75.22367341726418, 90.41775925984662, 0.09999999999999842, 225.0, 1043, 535488, 750, 26.517211899999893
751, 7.0128643328163225, 75.02415144867098, 90.20727366723385, 0.10000000000000074, 50.0, 394, 535882, 751, 10.005355500001315
752, 9.303002445360784, 75.00393833336936, 90.24411825874682, 0.09999999999999862, 155.0, 994, 536876, 752, 26.19830019999972
753, 5.21452750948783, 75.05183303727411, 90.22397610885461, 0.10000000000000095, 35.0, 578, 537454, 753, 15.664417399999365
754, 5.324023048345842, 75.0251873322647, 90.20686066759764, 0.09999999999999822, 240.0, 1096, 538550, 754, 28.02931770000032
755, 5.655850036384797, 75.07918482930441, 90.2746814233495, 0.09999999999999855, 220.0, 1011, 539561, 755, 26.105403300000035
756, 5.472124770888822, 74.52960318938125, 89.60893552363827, 0.09999999999999866, 160.0, 985, 540546, 756, 25.411457399999563
757, 4.4854382136375595, 73.88398641238287, 88.80272022770689, 0.10000000000000037, 100.0, 707, 541253, 757, 18.182684100000188
758, 7.341688384401038, 73.93866692843704, 88.8767244054916, 0.1000000000000009, 95.0, 517, 541770, 758, 13.528237000000445
759, 4.352736476700583, 73.90815606651465, 88.81012763818765, 0.10000000000000087, 70.0, 482, 542252, 759, 12.498737600000823
760, 5.405655897605212, 73.82699874510249, 88.74847367170504, 0.10000000000000005, 290.0, 747, 542999, 760, 19.45297109999956
761, 4.479384282875061, 74.04165078125, 88.9641280883789, 0.10000000000000099, 145.0, 625, 543624, 761, 16.290647899999385
762, 3.9551536938279797, 73.93333012750259, 88.84540388009844, 0.09999999999999952, 135.0, 822, 544446, 762, 21.277710800000932
763, 5.547711736757338, 73.98781319750034, 88.9515579812895, 0.09999999999999866, 390.0, 984, 545430, 763, 25.37953059999927
764, 5.654045297207015, 74.0643806658082, 89.0611813903231, 0.09999999999999881, 280.0, 951, 546381, 764, 24.650821299999734
765, 7.415404620005091, 74.05681917892855, 89.07037397265674, 0.09999999999999862, 210.0, 994, 547375, 765, 26.022847600001114
766, 6.680408835703553, 74.05202785208206, 89.02754054581824, 0.09999999999999873, 210.0, 968, 548343, 766, 25.410227599999416
767, 5.270552358477313, 74.00091312724824, 88.9309267420446, 0.0999999999999984, 505.0, 1049, 549392, 767, 27.457739199999196
768, 7.560061291813449, 74.14533464836352, 89.23932531251918, 0.09999999999999912, 550.0, 891, 550283, 768, 23.5291457000003
769, 9.777548418920388, 74.32731896884994, 89.47657349892964, 0.10000000000000094, 25.0, 557, 550840, 769, 14.604165499998999
770, 5.886081742936251, 74.34534673885423, 89.34224671344367, 0.10000000000000087, 75.0, 490, 551330, 770, 13.082206900000529
771, 5.931868318722099, 74.42556789027465, 89.47771637489534, 0.0999999999999982, 125.0, 1101, 552431, 771, 28.954590299999836
772, 4.868264402499039, 74.3468535573859, 89.32811971904748, 0.10000000000000099, 70.0, 627, 553058, 772, 16.564131799999814
773, 7.375088609031918, 74.25770480656182, 89.30835304551452, 0.09999999999999898, 185.0, 917, 553975, 773, 24.234337400001095
774, 5.66912330607666, 74.43756532045168, 89.50697203306395, 0.09999999999999831, 570.0, 1070, 555045, 774, 28.548175100000662
775, 5.016402263893935, 74.51634720852823, 89.56129224112864, 0.10000000000000099, 145.0, 623, 555668, 775, 16.641995199999656
776, 6.964117549786263, 74.50040538543804, 89.57787209113707, 0.09999999999999912, 290.0, 891, 556559, 776, 23.984110899998996
777, 5.700198597915761, 74.36798732311695, 89.36073746619286, 0.10000000000000098, 170.0, 616, 557175, 777, 16.527545299999474
778, 5.692912796884153, 74.33976391861611, 89.38212498128664, 0.09999999999999788, 530.0, 1197, 558372, 778, 31.956228400000327
779, 5.851746371640755, 74.23942275854726, 89.24096474936975, 0.10000000000000099, 175.0, 626, 558998, 779, 16.851256800000556
780, 6.103396134011111, 74.16292269146022, 89.13895036706973, 0.10000000000000074, 85.0, 398, 559396, 780, 10.540105399999447
781, 6.47189490597551, 74.35984357127828, 89.37525153397196, 0.09999999999999905, 470.0, 905, 560301, 781, 24.30361819999962
782, 7.955839832054947, 74.5704323255372, 89.78060965653461, 0.10000000000000092, 75.0, 537, 560838, 782, 14.419734000000972
783, 6.415568012412029, 74.60524427416557, 89.68350312870062, 0.10000000000000019, 165.0, 729, 561567, 783, 19.67698670000027
784, 7.857834258160008, 74.4470531608485, 89.42604307987519, 0.10000000000000085, 35.0, 474, 562041, 784, 12.865099599999667
785, 6.2444951126289405, 74.6270473770779, 89.73649586545552, 0.09999999999999781, 270.0, 1221, 563262, 785, 32.90950899999916
786, 9.112810628462572, 74.5423986183829, 89.72825521047042, 0.10000000000000031, 170.0, 714, 563976, 786, 19.434971299999233
787, 6.134329482608468, 74.39441091718464, 89.42548101940294, 0.10000000000000056, 160.0, 685, 564661, 787, 19.114330499998687
788, 4.8277237835526465, 74.49394114903042, 89.44823356628417, 0.10000000000000042, 120.0, 700, 565361, 788, 18.88967709999997
789, 7.519782179037098, 74.65816359775914, 89.77955722998435, 0.10000000000000088, 50.0, 503, 565864, 789, 13.626625799999601
790, 4.559891108904729, 74.64037560275867, 89.65831641603314, 0.10000000000000077, 120.0, 418, 566282, 790, 11.489741900000809
791, 4.120824175648987, 74.50683327539157, 89.56462873492325, 0.1000000000000009, 65.0, 513, 566795, 791, 14.156153500000073
792, 5.207717657940342, 74.49887493060918, 89.54581798646845, 0.09999999999999819, 225.0, 1103, 567898, 792, 29.980825099999493
793, 7.451367914241142, 74.6849835979167, 89.82762219263766, 0.09999999999999878, 420.0, 958, 568856, 793, 26.078313399999388
794, 5.408700360512199, 74.70348857163715, 89.85028054801022, 0.10000000000000031, 190.0, 714, 569570, 794, 19.435533300000316
795, 6.052969819408024, 74.2987673228402, 89.30712771648088, 0.0999999999999971, 720.0, 1539, 571109, 795, 41.969529399999374
796, 9.51483659109122, 74.15000629787663, 89.2483824088093, 0.10000000000000091, 50.0, 526, 571635, 796, 14.522633500000666
797, 5.104124184894798, 74.27820437595183, 89.26333712271132, 0.09999999999999902, 160.0, 908, 572543, 797, 24.761496200000693
798, 5.341754791884907, 74.14323133303796, 89.11685838545377, 0.09999999999999838, 265.0, 1053, 573596, 798, 29.087547999999515
799, 4.465896300511596, 74.16245984274244, 89.12544604373777, 0.10000000000000095, 80.0, 567, 574163, 799, 15.64649350000036
800, 5.77732480432306, 74.13129518054781, 89.1511416335333, 0.10000000000000091, 35.0, 525, 574688, 800, 14.663831699999719
801, 7.273545196999404, 74.18434286688306, 89.2178147308715, 0.09999999999999896, 385.0, 919, 575607, 801, 25.5179834999999
802, 6.591821131590059, 74.1181435019283, 89.09457252631753, 0.09999999999999794, 220.0, 1180, 576787, 802, 32.62056389999998
803, 8.072636218244241, 74.02453848309992, 89.02140928633028, 0.10000000000000099, 55.0, 633, 577420, 803, 17.566716899998937
804, 5.882724407986177, 73.97678411303468, 88.91613074914733, 0.09999999999999963, 250.0, 804, 578224, 804, 22.397220099999686
805, 5.49329449966213, 74.26804430646455, 89.2569716405304, 0.09999999999999892, 155.0, 929, 579153, 805, 25.759679299999334
806, 5.955948529357556, 74.1809638440609, 89.19215315580368, 0.1000000000000009, 40.0, 512, 579665, 806, 14.304734199999075
807, 4.977435374004847, 73.13707112229389, 87.8957691192627, 0.10000000000000013, 120.0, 736, 580401, 807, 20.678803500000868
808, 6.45505146151551, 72.31490630436707, 86.940356988761, 0.09999999999999744, 460.0, 1373, 581774, 808, 38.27182489999905
809, 5.666335895402691, 72.29598515470263, 86.90045670292507, 0.09999999999999862, 405.0, 994, 582768, 809, 27.852783700000145
810, 10.463372179705429, 72.36196142958514, 87.21610409139574, 0.10000000000000066, 55.0, 353, 583121, 810, 9.868910400000459
811, 9.148153616271152, 72.27269714757016, 87.01121614296738, 0.10000000000000094, 125.0, 646, 583767, 811, 18.10314709999875
812, 6.720259930314542, 72.545287625543, 87.14496160610555, 0.09999999999999959, 350.0, 812, 584579, 812, 22.834554400000343
813, 9.864120095550456, 72.63401025076892, 87.42943371924285, 0.10000000000000092, 140.0, 535, 585114, 813, 15.247662700001456
814, 4.636054650218604, 72.17695412648125, 86.70147805620533, 0.10000000000000073, 45.0, 387, 585501, 814, 10.94403930000044
815, 7.805978485176907, 72.32215220405456, 87.01224321171561, 0.0999999999999989, 315.0, 935, 586436, 815, 26.254079100001036
816, 4.571570277106363, 72.30875358822762, 86.88634958241367, 0.09999999999999817, 275.0, 1107, 587543, 816, 31.074468400000114
817, 7.632042148760242, 72.37371433616704, 87.05175944271251, 0.09999999999999797, 425.0, 1170, 588713, 817, 32.958570200000395
818, 8.19220376128722, 72.37962362350518, 87.05126014383663, 0.09999999999999812, 320.0, 1124, 589837, 818, 32.0455751999998
819, 7.853805121905472, 71.87845586900094, 86.51932216283694, 0.10000000000000075, 50.0, 402, 590239, 819, 11.426904299998569
820, 6.816324139063842, 71.70792655652511, 86.22790975314904, 0.09999999999999841, 295.0, 1044, 591283, 820, 25.717905400000745
821, 6.645768484411723, 71.87318776830276, 86.44230608913286, 0.10000000000000091, 105.0, 533, 591816, 821, 13.206130500000654
822, 6.134549596988492, 71.73332951863607, 86.2362164815267, 0.10000000000000067, 25.0, 360, 592176, 822, 8.88615260000006
823, 4.163611387234809, 71.64991713509256, 86.05454320093735, 0.09999999999999899, 165.0, 914, 593090, 823, 22.746516100000008
824, 5.998729768793592, 71.83843308421764, 86.34358028973001, 0.10000000000000009, 195.0, 741, 593831, 824, 18.23591320000014
825, 4.308132828712679, 71.6964341453884, 86.15546874723573, 0.10000000000000094, 60.0, 552, 594383, 825, 13.674781600000642
826, 5.864295648668188, 71.83484798241716, 86.38103282780938, 0.10000000000000023, 310.0, 724, 595107, 826, 17.92744429999948
827, 5.423187155357522, 71.77590142125669, 86.30738040675287, 0.10000000000000069, 55.0, 368, 595475, 827, 9.184510400000363
828, 7.862202602378653, 71.85848992534281, 86.43471157217662, 0.09999999999999952, 240.0, 823, 596298, 828, 20.42005969999991
829, 7.134262606173179, 71.8597884795554, 86.3276191480232, 0.10000000000000067, 75.0, 363, 596661, 829, 9.031875600001513
830, 5.76819579777001, 71.58051674903473, 86.014663045806, 0.10000000000000049, 165.0, 692, 597353, 830, 17.1080194999995
831, 4.52188593694254, 71.79499303918136, 86.26911623101485, 0.09999999999999995, 240.0, 760, 598113, 831, 18.87475970000014
832, 4.807690409410234, 71.80335783864938, 86.25083673514573, 0.1000000000000009, 105.0, 510, 598623, 832, 12.791329899999255
833, 4.714925480958222, 71.76669996399508, 86.2314940969095, 0.10000000000000014, 200.0, 733, 599356, 833, 18.045387800000753
834, 8.547188019331884, 71.8317382865026, 86.4990583541266, 0.10000000000000096, 50.0, 581, 599937, 834, 14.614819299998999
835, 5.79092000485018, 71.52102498149952, 85.94869769251176, 0.09999999999999791, 595.0, 1189, 601126, 835, 29.709087799999907
836, 4.342949323833282, 71.44919580544158, 85.80144459390876, 0.10000000000000075, 75.0, 406, 601532, 836, 10.212086399998952
837, 7.775130043631976, 71.71591734851056, 86.27006175697113, 0.10000000000000062, 230.0, 679, 602211, 837, 16.926334899999347
838, 4.909382088017534, 71.50095540928076, 85.92681000601098, 0.10000000000000055, 45.0, 686, 602897, 838, 17.14787190000061
839, 6.767754724052981, 71.64666420422776, 86.15161455886265, 0.10000000000000088, 50.0, 503, 603400, 839, 12.725684400000318
840, 6.897643558271638, 71.53807821029272, 86.03063903361449, 0.09999999999999823, 450.0, 1092, 604492, 840, 27.581541300000026
841, 7.697385535716474, 71.63080063323746, 86.18023714811906, 0.10000000000000073, 90.0, 667, 605159, 841, 16.820927999999185
842, 5.057749567253519, 71.54790298306212, 85.96764770819216, 0.09999999999999916, 130.0, 882, 606041, 842, 22.342595199999778
843, 6.266105486951173, 71.5409158916981, 85.9523319200871, 0.09999999999999838, 370.0, 1052, 607093, 843, 26.617985000000772
844, 5.172800128884807, 71.5471068173093, 86.01534747722867, 0.09999999999999828, 220.0, 1076, 608169, 844, 27.404829500001142
845, 5.937939565288746, 71.55003990548305, 85.97319940626322, 0.0999999999999986, 200.0, 997, 609166, 845, 25.113458199999513
846, 5.454821226306451, 71.66246704533998, 86.1763641110316, 0.10000000000000009, 105.0, 741, 609907, 846, 18.81926299999941
847, 7.6351060885474515, 70.86183811486417, 85.20547558696585, 0.09999999999999855, 315.0, 1009, 610916, 847, 25.794442599999456
848, 3.847175535719882, 70.81078674972699, 85.01557192238428, 0.10000000000000084, 65.0, 465, 611381, 848, 11.960641800000303
849, 3.4635282193038828, 70.7906179451883, 85.00919374385082, 0.10000000000000074, 155.0, 401, 611782, 849, 10.264363300000696
850, 6.782839893072198, 70.93116838791791, 85.26221092861873, 0.10000000000000094, 195.0, 646, 612428, 850, 16.334189199998946
851, 7.593788847458108, 70.93345709098328, 85.32746753190064, 0.09999999999999969, 160.0, 797, 613225, 851, 20.280409699998927
852, 3.834096424727206, 70.82806809895347, 85.09492658770256, 0.09999999999999944, 285.0, 836, 614061, 852, 21.39664989999983
853, 4.9674614273581, 70.74715247423546, 85.062233756943, 0.10000000000000098, 135.0, 602, 614663, 853, 15.406206800000291
854, 6.232895238079139, 71.01056373459232, 85.389029320593, 0.09999999999999883, 230.0, 947, 615610, 854, 24.081887700000152
855, 5.061816100219646, 71.02627354357617, 85.33906448548099, 0.09999999999999946, 410.0, 830, 616440, 855, 21.086304200000086
856, 5.855440599462864, 70.88927276929219, 85.18756973382199, 0.09999999999999837, 515.0, 1056, 617496, 856, 27.681609999999637
857, 8.698528665304185, 70.94532563180634, 85.38034345838759, 0.10000000000000088, 60.0, 495, 617991, 857, 14.29124899999988
858, 5.704146496238388, 70.96531350161054, 85.27644160128902, 0.10000000000000087, 20.0, 491, 618482, 858, 12.629562699999951
859, 3.5464349365397676, 70.80178258190416, 85.03889465332031, 0.10000000000000069, 35.0, 365, 618847, 859, 9.440367600000172
860, 7.388054136457659, 70.79677134993003, 85.20648888509378, 0.10000000000000099, 165.0, 619, 619466, 860, 15.822265500000867
861, 6.948349245652626, 70.46801151411242, 84.7249331820693, 0.09999999999999763, 370.0, 1294, 620760, 861, 33.77930750000087
862, 6.069641783833504, 70.32677399456416, 84.47372166427806, 0.10000000000000035, 120.0, 709, 621469, 862, 18.351581499999156
863, 3.869605312801543, 70.28792377290272, 84.4198447672526, 0.10000000000000091, 55.0, 525, 621994, 863, 13.702004899998428
864, 5.048271632853205, 70.21387070875902, 84.40413096253302, 0.09999999999999895, 180.0, 923, 622917, 864, 23.753006999999343
865, 7.307208985320966, 70.28665553025209, 84.52498323756706, 0.09999999999999822, 315.0, 1098, 624015, 865, 28.240702899998723
866, 4.7191819125190975, 70.20987878053823, 84.3650721739364, 0.09999999999999812, 180.0, 1123, 625138, 866, 29.194949499998984
867, 5.3511960070462745, 70.27625751672295, 84.47875461330662, 0.10000000000000092, 65.0, 539, 625677, 867, 13.982597399999577
868, 7.508031276067098, 70.08104381306966, 84.31094822184245, 0.1000000000000007, 45.0, 375, 626052, 868, 9.771580200000244
869, 6.5685125632673245, 70.27020545291086, 84.45780398703029, 0.09999999999999888, 205.0, 936, 626988, 869, 24.295256499999596
870, 4.809729880787791, 70.11825335089536, 84.20233929475998, 0.1000000000000007, 5.0, 374, 627362, 870, 9.7340204000011
871, 7.18385871062795, 70.2947243450775, 84.51665733428723, 0.09999999999999896, 185.0, 919, 628281, 871, 24.03105979999964
872, 4.856956951077062, 70.38459979183614, 84.57601195058987, 0.10000000000000091, 75.0, 521, 628802, 872, 13.516149600000062
873, 6.966652408754293, 70.17128335487392, 84.36492588266064, 0.10000000000000096, 50.0, 582, 629384, 873, 15.246680999998716
874, 5.218138790222266, 70.45654624947055, 84.63511655287677, 0.09999999999999885, 150.0, 943, 630327, 874, 24.594459899999492
875, 5.714576228956381, 70.47183602072975, 84.71496822472774, 0.1000000000000008, 70.0, 660, 630987, 875, 17.250827500000014
876, 4.3352583853239866, 70.32977890329262, 84.53798367215187, 0.10000000000000087, 35.0, 485, 631472, 876, 12.831759100001364
877, 6.885746089403802, 70.529747750475, 84.7985464402431, 0.09999999999999985, 185.0, 772, 632244, 877, 20.30810250000104
878, 5.879842413441709, 70.48223468733997, 84.71665121869343, 0.09999999999999759, 660.0, 1312, 633556, 878, 34.460839499999565
879, 5.3700925638972805, 70.67251499952879, 84.98232360886223, 0.10000000000000081, 60.0, 658, 634214, 879, 17.256299699998635
880, 4.961168786666378, 70.36969943322258, 84.61654682690377, 0.10000000000000084, 35.0, 467, 634681, 880, 12.447286300000997
881, 6.939253827046358, 70.38333698773476, 84.62599052517571, 0.09999999999999845, 210.0, 1036, 635717, 881, 27.517704900001263
882, 6.711377058713006, 70.5100540548268, 84.80963961912853, 0.0999999999999996, 300.0, 808, 636525, 882, 21.277221700000155
883, 6.7380919358202895, 70.47650391177127, 84.70052224711368, 0.10000000000000098, 50.0, 608, 637133, 883, 16.063802999999098
884, 5.1588785841609495, 70.42965485158592, 84.63422221944789, 0.09999999999999863, 515.0, 990, 638123, 884, 26.21964669999943
885, 7.92400088780236, 70.51912567622712, 84.80401587126119, 0.10000000000000078, 90.0, 662, 638785, 885, 17.541402099999686
886, 5.656170389911104, 70.48858726596325, 84.71569285553683, 0.09999999999999812, 535.0, 1126, 639911, 886, 29.801608799998576
887, 4.9777112800535, 69.75388556570101, 83.78632974167016, 0.10000000000000091, 50.0, 521, 640432, 887, 13.934623199998896
888, 4.866879744595344, 69.62598862254292, 83.6855188912208, 0.09999999999999824, 320.0, 1090, 641522, 888, 29.0635628
889, 7.490166535323116, 69.68940049064439, 83.90725028794144, 0.09999999999999959, 115.0, 811, 642333, 889, 21.847575199999483
890, 8.36422495421451, 69.7050860737115, 83.83864367703151, 0.10000000000000071, 35.0, 669, 643002, 890, 17.910193300000174
891, 3.6201727186775394, 69.60206934264662, 83.61131476613798, 0.1000000000000009, 120.0, 514, 643516, 891, 13.829495800000586
892, 5.519697501852706, 69.68111669179555, 83.76068792944555, 0.09999999999999817, 230.0, 1110, 644626, 892, 29.484285500000624
893, 9.242658084292783, 69.76113693020868, 83.92049311644642, 0.10000000000000038, 215.0, 705, 645331, 893, 18.763547700000345
894, 8.460608586201685, 69.69016169504837, 83.75627310350797, 0.10000000000000095, 85.0, 574, 645905, 894, 15.289851999999883
895, 5.959151635971471, 69.60556934288972, 83.70398398404996, 0.10000000000000064, 190.0, 676, 646581, 895, 18.173564599999736
896, 8.562429992451642, 69.65941293789125, 83.78884354606947, 0.10000000000000094, 60.0, 551, 647132, 896, 14.862697600001411
897, 3.614837813650796, 69.62487437396967, 83.59400370186621, 0.10000000000000092, 130.0, 545, 647677, 897, 14.61405569999988
898, 7.97183647979059, 69.78801576036773, 83.93912348196658, 0.10000000000000084, 45.0, 459, 648136, 898, 12.367361900000105
899, 5.763537658839049, 69.6526044474128, 83.67675334671655, 0.09999999999999899, 330.0, 914, 649050, 899, 24.676894599999287
900, 5.167290428429971, 69.5498561414796, 83.57449072902834, 0.09999999999999801, 500.0, 1159, 650209, 900, 31.305483999998614
901, 4.867105952624617, 69.18711961249946, 83.12332636435578, 0.100000000000001, 120.0, 638, 650847, 901, 17.67478780000056
902, 7.483744297774283, 69.00757744757684, 82.97867424933465, 0.10000000000000082, 105.0, 455, 651302, 902, 12.587361699999747
903, 6.5324071190830235, 69.1461913696964, 83.09812171804818, 0.09999999999999958, 155.0, 814, 652116, 903, 22.114471400000184
904, 5.086917869056901, 69.18772702711189, 83.1859480754354, 0.09999999999999695, 685.0, 1631, 653747, 904, 44.724186699999336
905, 5.442264489367239, 69.15285141849931, 83.12692243127424, 0.10000000000000049, 165.0, 693, 654440, 905, 18.90407899999991
906, 3.970496099550627, 69.18604114307331, 83.13033129152217, 0.09999999999999787, 275.0, 1203, 655643, 906, 32.93165509999926
907, 7.716903740065355, 69.29118578667735, 83.35177509831448, 0.0999999999999985, 190.0, 1020, 656663, 907, 27.91528820000167
908, 5.094135465937973, 69.0956304102136, 83.00118391817848, 0.10000000000000006, 130.0, 745, 657408, 908, 20.532775699999547
909, 4.571152192865197, 69.2433349644493, 83.19437823718107, 0.09999999999999924, 50.0, 869, 658277, 909, 23.802062300001126
910, 6.878191569431495, 69.2344975297169, 83.23510424706244, 0.09999999999999891, 185.0, 930, 659207, 910, 25.559033399998953
911, 8.006822820121085, 69.02868178295113, 83.04648226464701, 0.10000000000000063, 30.0, 342, 659549, 911, 9.47978460000013
912, 5.692324423345087, 69.18504298505165, 83.12009154120796, 0.10000000000000094, 40.0, 556, 660105, 912, 15.14371570000003
913, 6.395422397972011, 69.07329037343855, 83.05755869913445, 0.10000000000000046, 250.0, 695, 660800, 913, 19.1483532000002
914, 7.774032404887647, 69.19326325209042, 83.16018768161317, 0.0999999999999978, 420.0, 1227, 662027, 914, 33.79927240000143
915, 4.116348900059834, 69.20463069499361, 83.10101257094476, 0.09999999999999969, 160.0, 797, 662824, 915, 22.08071999999993
916, 6.694395942919599, 69.24981221913627, 83.27201899578976, 0.10000000000000027, 105.0, 718, 663542, 916, 19.832119999999122
917, 8.412976708282576, 69.16526243106163, 83.23899012471169, 0.09999999999999751, 390.0, 1343, 664885, 917, 36.92214369999965
918, 4.592827166769749, 69.17326132456462, 83.10962565495417, 0.0999999999999998, 120.0, 780, 665665, 918, 21.707643600000665
919, 6.3251251110426185, 69.01055793869061, 82.91400979947643, 0.10000000000000067, 55.0, 357, 666022, 919, 9.807383899998968
920, 5.633289734664631, 68.97618419578276, 82.91559427330293, 0.10000000000000075, 150.0, 664, 666686, 920, 18.387628500000574
921, 5.618709231792547, 69.02760997778782, 82.98340463556234, 0.10000000000000096, 140.0, 581, 667267, 921, 16.230250700000397
922, 6.478353431028438, 69.14031274608105, 83.08674799454235, 0.09999999999999844, 190.0, 1038, 668305, 922, 28.961788700000398
923, 6.226590024098345, 69.22345248957227, 83.18581239124784, 0.09999999999999964, 175.0, 802, 669107, 923, 22.447653100000025
924, 5.735433061719789, 69.173725931268, 83.18175686745352, 0.1000000000000004, 170.0, 703, 669810, 924, 19.573141199998645
925, 8.125115247778963, 69.04988441844978, 83.06504170634959, 0.10000000000000088, 80.0, 505, 670315, 925, 14.225155899999663
926, 7.256487038092563, 68.83672466225532, 82.76644201077268, 0.09999999999999824, 365.0, 1089, 671404, 926, 30.417999999999665
927, 5.440455033061325, 68.87515204644973, 82.70285524757959, 0.10000000000000084, 100.0, 465, 671869, 927, 13.638723199999731
928, 5.351290722506387, 68.83730479213169, 82.7583840157645, 0.0999999999999992, 330.0, 875, 672744, 928, 25.35583410000072
929, 4.166122629422392, 68.6654084882972, 82.45890246010501, 0.10000000000000095, 115.0, 566, 673310, 929, 15.992200000000594
930, 6.57665891375781, 68.70393584409736, 82.64904193068104, 0.1000000000000009, 50.0, 518, 673828, 930, 14.581524799999897
931, 6.077509702724254, 69.06732923541954, 82.98466183325488, 0.10000000000000062, 35.0, 334, 674162, 931, 9.386117000000013
932, 7.122329997756475, 68.86554555522005, 82.790695075558, 0.09999999999999701, 710.0, 1594, 675756, 932, 44.65807510000013
933, 5.945707363314753, 68.92974483689596, 82.8794807057048, 0.10000000000000053, 65.0, 688, 676444, 933, 19.52516680000008
934, 5.291097840031346, 68.68078053677762, 82.56259858644044, 0.10000000000000074, 120.0, 666, 677110, 934, 18.809884399999646
935, 3.71347413884337, 68.85057719998004, 82.70900763582755, 0.10000000000000073, 75.0, 389, 677499, 935, 10.958556900000985
936, 5.563659936496892, 68.82504086838556, 82.66174390340589, 0.10000000000000087, 105.0, 485, 677984, 936, 13.84854710000036
937, 5.0176865954906935, 68.74370367828259, 82.61561486970646, 0.09999999999999741, 270.0, 1385, 679369, 937, 39.246468999999706
938, 4.7761183851131905, 68.80387668635016, 82.6847164291199, 0.1, 140.0, 751, 680120, 938, 21.354277599999477
939, 4.215907951768156, 68.54924171008365, 82.31922167633216, 0.10000000000000071, 75.0, 382, 680502, 939, 10.903356399998302
940, 6.876900773804419, 68.62947125203546, 82.50826004935729, 0.09999999999999766, 540.0, 1278, 681780, 940, 36.27219409999998
941, 5.241522279421776, 68.60559582513226, 82.40749059629835, 0.09999999999999873, 225.0, 968, 682748, 941, 27.605761299999358
942, 8.769702375118662, 68.56714715628789, 82.57909194119458, 0.10000000000000075, 50.0, 406, 683154, 942, 11.601697399999466
943, 6.488101086067949, 68.62417192552604, 82.51786788304646, 0.09999999999999956, 210.0, 816, 683970, 943, 23.48352640000121
944, 5.6008045762733305, 68.37838517474988, 82.18123163535994, 0.10000000000000063, 130.0, 677, 684647, 944, 19.50629200000003
945, 6.380587382812205, 68.5122634301989, 82.40749355327571, 0.09999999999999858, 400.0, 1003, 685650, 945, 28.616051200000584
946, 6.209384253494037, 68.62336272971575, 82.49970754726913, 0.09999999999999847, 275.0, 1032, 686682, 946, 29.72915020000073
947, 5.989921202173689, 68.5077569735881, 82.36651117952368, 0.10000000000000098, 95.0, 617, 687299, 947, 17.772039099998437
948, 4.448792767510039, 68.53271449798433, 82.35640522623297, 0.09999999999999853, 230.0, 1015, 688314, 948, 29.2093117000004
949, 5.535358558538594, 68.51680356762077, 82.33866691106482, 0.10000000000000074, 55.0, 395, 688709, 949, 11.492697699999553
950, 6.637896746165394, 68.63251778795312, 82.52144221963043, 0.09999999999999874, 225.0, 965, 689674, 950, 28.001286199998503
951, 4.737368253761051, 68.04492000297263, 81.81817708192048, 0.10000000000000092, 115.0, 648, 690322, 951, 18.828174299998864
952, 5.540351187384974, 67.46503779894411, 81.0975817382492, 0.10000000000000071, 105.0, 381, 690703, 952, 10.982423700001164
953, 3.83832994235526, 67.54861462060623, 81.12421882356493, 0.10000000000000096, 45.0, 643, 691346, 953, 18.609875000000102
954, 6.850562344740901, 67.51712024672348, 81.16772857960713, 0.09999999999999891, 210.0, 932, 692278, 954, 26.904501600000003
955, 7.256877023376533, 67.51262531734135, 81.23837891143418, 0.09999999999999916, 265.0, 883, 693161, 955, 25.654459900000802
956, 5.403649887862029, 67.49757520887587, 81.09482211642795, 0.10000000000000066, 160.0, 675, 693836, 956, 19.846451499999603
957, 6.946468087131056, 67.64561349509155, 81.36511931499035, 0.09999999999999942, 195.0, 838, 694674, 957, 24.496292099998755
958, 5.19386220390812, 67.42671509558296, 81.03602964434462, 0.09999999999999824, 175.0, 1091, 695765, 958, 32.35104870000032
959, 5.9711439051524255, 67.57335224729596, 81.17153931820032, 0.1000000000000008, 95.0, 660, 696425, 959, 19.621355100000073
960, 6.254643914905468, 67.54215011505637, 81.18340017459842, 0.09999999999999942, 80.0, 838, 697263, 960, 24.63636039999983
961, 9.46081882383616, 67.56011557477007, 81.2512798445371, 0.10000000000000042, 85.0, 701, 697964, 961, 20.868129200000112
962, 4.0354450029504445, 67.55096923695295, 81.1552991649142, 0.09999999999999896, 215.0, 919, 698883, 962, 27.09875060000013
963, 7.820271678814074, 67.68472917138077, 81.48882865595624, 0.10000000000000098, 60.0, 615, 699498, 963, 18.176028399999268
964, 4.93121250153093, 67.48874853101827, 81.08395125825527, 0.10000000000000096, 120.0, 590, 700088, 964, 17.523665099999562
965, 5.218155859453025, 67.38218582778418, 80.95885752028778, 0.09999999999999881, 75.0, 952, 701040, 965, 28.057850600000165
966, 4.095274359647368, 67.4021655973841, 80.97046374961978, 0.10000000000000098, 70.0, 610, 701650, 966, 18.07864669999981
967, 5.648496665939933, 67.42753077647725, 81.02234433283571, 0.10000000000000098, 110.0, 610, 702260, 967, 18.092052600000898
968, 6.905947776703999, 67.53504449349863, 81.21230943662758, 0.09999999999999978, 325.0, 783, 703043, 968, 23.27034569999887
969, 6.544195465190442, 67.37593102767478, 80.96466023640862, 0.09999999999999898, 280.0, 916, 703959, 969, 27.191261400001167
970, 8.228041158474513, 67.6919126618467, 81.38647163896452, 0.10000000000000099, 115.0, 619, 704578, 970, 18.30236679999871
971, 6.698050730859143, 67.59184582147572, 81.2398436626459, 0.09999999999999827, 170.0, 1083, 705661, 971, 32.180744599998434
972, 6.363613477513242, 67.46395706950396, 81.0927215378647, 0.09999999999999892, 390.0, 927, 706588, 972, 27.338820299999497
973, 7.8555942759928055, 67.50616833315057, 81.21313988421596, 0.10000000000000035, 190.0, 708, 707296, 973, 21.236925100000008
974, 5.937239591387057, 67.50224504924955, 81.11200040181478, 0.10000000000000078, 45.0, 420, 707716, 974, 12.577733199999784
975, 5.898822720871287, 67.52963085462929, 81.15955425836441, 0.09999999999999741, 455.0, 1389, 709105, 975, 41.30804220000027
976, 5.984050314425515, 67.5019419189639, 81.14823007801353, 0.10000000000000082, 85.0, 657, 709762, 976, 19.975691200001165
977, 3.4591295608658763, 67.04556631913519, 80.54296355872437, 0.10000000000000094, 120.0, 557, 710319, 977, 16.718525399999635
978, 5.27328851838517, 66.60570435534376, 80.06465956744026, 0.10000000000000084, 95.0, 459, 710778, 978, 13.75651050000124
979, 6.744492876745317, 66.53337283467137, 80.03698842839677, 0.10000000000000073, 105.0, 387, 711165, 979, 11.662717100000009
980, 4.772129965196477, 66.52395647909583, 79.92874436262177, 0.10000000000000084, 145.0, 656, 711821, 980, 19.642498299999716
981, 5.656997309890372, 66.56513532276104, 80.02508943119852, 0.099999999999998, 530.0, 1163, 712984, 981, 34.94297000000006
982, 4.939122281143298, 66.6207000556359, 80.02083482008715, 0.1000000000000009, 120.0, 650, 713634, 982, 19.636019899999155
983, 3.9404541021419894, 66.4995216369629, 79.9089099460178, 0.10000000000000067, 55.0, 360, 713994, 983, 10.826701100000719
984, 5.848256397009832, 66.48419056302637, 79.87744878732529, 0.09999999999999912, 230.0, 891, 714885, 984, 26.94253910000043
985, 5.529266118009885, 66.48499597821917, 79.87923060825892, 0.10000000000000078, 85.0, 420, 715305, 985, 12.791967799999838
986, 6.624021047430976, 66.52955060470396, 79.98186956963887, 0.10000000000000084, 115.0, 656, 715961, 986, 19.879142100000536
987, 6.219584835913011, 66.69635697444126, 80.147468404567, 0.1000000000000009, 85.0, 517, 716478, 987, 15.716928899999402
988, 7.797458022647571, 66.68030621227206, 80.19282998989283, 0.09999999999999874, 440.0, 965, 717443, 988, 29.465448499999184
989, 5.272574842452298, 66.6213470142974, 80.02802048180935, 0.09999999999999938, 265.0, 845, 718288, 989, 25.491627499999595
990, 3.518985935261013, 66.67710710838266, 80.09030559266687, 0.09999999999999926, 200.0, 866, 719154, 990, 26.37265110000044
991, 6.004602127125607, 66.76069001534685, 80.31572567005063, 0.09999999999999858, 100.0, 1005, 720159, 991, 30.592901699999857
992, 6.8417310636803395, 67.32255085855343, 80.89477100809111, 0.09999999999999705, 355.0, 1572, 721731, 992, 47.7326424999992
993, 3.7583497262331185, 67.29092550563242, 80.7884659567279, 0.10000000000000071, 120.0, 668, 722399, 993, 20.52719529999922
994, 6.346744977959565, 67.34898184640068, 80.88455444335938, 0.10000000000000064, 50.0, 350, 722749, 994, 10.80039029999898
995, 5.14304904404904, 67.16769664095476, 80.71042275089788, 0.09999999999999938, 215.0, 844, 723593, 995, 25.92227599999933
996, 8.122789702245168, 67.27485101772119, 81.01389586334673, 0.10000000000000063, 30.0, 343, 723936, 996, 10.586626000000251
997, 3.979597813105798, 67.27043597247149, 80.81579253050658, 0.10000000000000094, 160.0, 555, 724491, 997, 17.09040979999918
998, 8.05068273827353, 67.27839940625019, 80.89306418764804, 0.09999999999999763, 270.0, 1293, 725784, 998, 39.503691299998536
999, 7.372145365820572, 67.26239374032605, 80.90517945220505, 0.09999999999999995, 120.0, 759, 726543, 999, 23.421133300000292
1000, 8.51045539298732, 67.3870407998847, 81.03654344002025, 0.09999999999999944, 165.0, 836, 727379, 1000, 25.871945399998367
1001, 5.931345618950141, 67.22790197435316, 80.77744285667336, 0.09999999999999902, 195.0, 910, 728289, 1001, 27.936202999999296
1002, 6.067018328302932, 67.4366694434974, 80.9740748132378, 0.1000000000000006, 170.0, 681, 728970, 1002, 21.202524500000436
1003, 4.642787851582805, 67.24096630669125, 80.77654266357422, 0.09999999999999976, 80.0, 786, 729756, 1003, 24.546799900001133
1004, 4.545759233047709, 67.16887916343799, 80.67585070697582, 0.09999999999999948, 470.0, 828, 730584, 1004, 25.57590209999944
1005, 7.086070595857725, 67.31290517441214, 80.88441861818914, 0.09999999999999798, 550.0, 1168, 731752, 1005, 35.92388170000049
1006, 6.41092828533125, 67.19507658812122, 80.76012114632373, 0.10000000000000092, 70.0, 541, 732293, 1006, 16.775932900000043
1007, 6.3950292242227125, 67.19552573210912, 80.77235611120733, 0.09999999999999774, 470.0, 1249, 733542, 1007, 38.672728699999425
1008, 6.2951601572900735, 67.22829523791135, 80.78419940801615, 0.09999999999999877, 310.0, 961, 734503, 1008, 30.02089050000177
1009, 7.196468834983957, 67.233725837164, 80.81999516550029, 0.10000000000000071, 30.0, 379, 734882, 1009, 11.730830399999832
1010, 6.115134998533461, 67.27658225504557, 80.85572228325738, 0.09999999999999812, 275.0, 1125, 736007, 1010, 35.127598600000056
1011, 6.128094613878567, 67.12227302276659, 80.66046361072523, 0.100000000000001, 110.0, 639, 736646, 1011, 19.984856099999888
1012, 8.861379734082863, 67.28063693902432, 80.86905424656013, 0.0999999999999998, 145.0, 780, 737426, 1012, 24.430318400001852
1013, 5.414098192491663, 67.19978466908866, 80.70679626464843, 0.10000000000000092, 40.0, 545, 737971, 1013, 17.05958129999999
1014, 6.81549707999125, 67.32800593773858, 80.89279215297682, 0.09999999999999792, 385.0, 1187, 739158, 1014, 37.16912820000289
1015, 5.469202040289422, 67.3286465215319, 80.90737683536442, 0.10000000000000091, 110.0, 524, 739682, 1015, 16.5201562000002
1016, 4.362155541697425, 66.67761987934198, 80.06292898409035, 0.09999999999999815, 295.0, 1115, 740797, 1016, 35.01527999999962
1017, 6.273747940464776, 66.41299593330609, 79.83249523804919, 0.10000000000000088, 55.0, 505, 741302, 1017, 15.942984099998284
1018, 5.11070841520867, 66.26628510005891, 79.6095303409314, 0.09999999999999884, 335.0, 945, 742247, 1018, 29.65569360000154
1019, 5.042138700216235, 66.46279828579395, 79.82338938775001, 0.10000000000000098, 150.0, 616, 742863, 1019, 19.49446999999782
1020, 7.863225780469235, 66.41874689119999, 79.82811976637795, 0.10000000000000092, 60.0, 535, 743398, 1020, 16.860738200000924
1021, 5.623828956415487, 66.299460712699, 79.69029680296433, 0.09999999999999928, 250.0, 860, 744258, 1021, 27.23367169999983
1022, 6.762301472695641, 66.33284495528594, 79.73191015118134, 0.10000000000000095, 50.0, 578, 744836, 1022, 18.279595200001495
1023, 4.877023531384365, 66.35106468493672, 79.708984257805, 0.10000000000000088, 100.0, 651, 745487, 1023, 20.596835499996814
1024, 5.55240011833063, 66.5197797403103, 79.89262464569836, 0.1000000000000006, 50.0, 328, 745815, 1024, 10.557079999998678
1025, 5.890198908624545, 66.48626803486404, 79.86957597126762, 0.0999999999999982, 250.0, 1102, 746917, 1025, 34.88343629999872
1026, 7.345796700993743, 66.60058598474083, 80.0613292422457, 0.10000000000000094, 120.0, 646, 747563, 1026, 20.476324500003102
1027, 5.551867853202875, 66.40867135331438, 79.794568728296, 0.1000000000000009, 55.0, 518, 748081, 1027, 16.560348500002874
1028, 7.0957570402208425, 66.46864163327835, 79.90035050853452, 0.09999999999999788, 230.0, 1197, 749278, 1028, 38.121161900002335
1029, 9.546336617307029, 66.39727519974937, 79.82598306390778, 0.09999999999999958, 70.0, 813, 750091, 1029, 25.8599028000026
1030, 5.632313688298849, 65.55811277374508, 78.75605433907096, 0.10000000000000099, 125.0, 635, 750726, 1030, 20.258579600002122
1031, 5.575784031599092, 65.58771030443131, 78.77982192787888, 0.09999999999999815, 465.0, 1115, 751841, 1031, 35.76338599999872
1032, 4.180792624424341, 65.56161182376064, 78.74622596402861, 0.09999999999999871, 115.0, 971, 752812, 1032, 31.088989500000025
1033, 4.49533734492913, 65.57562505984734, 78.76667038694828, 0.10000000000000071, 155.0, 668, 753480, 1033, 21.39760060000117
1034, 4.973568777425355, 65.61774718751946, 78.79745656047685, 0.09999999999999773, 425.0, 1255, 754735, 1034, 40.05612829999882
1035, 7.030782129367193, 65.62527574206156, 78.93219596015082, 0.10000000000000099, 165.0, 630, 755365, 1035, 20.047123000000283
1036, 7.501434408695925, 65.83923015140351, 79.1293951851981, 0.09999999999999941, 300.0, 840, 756205, 1036, 26.919009600002028
1037, 6.606441343761981, 65.56179502606392, 78.79644719362258, 0.100000000000001, 135.0, 640, 756845, 1037, 20.49864080000043
1038, 6.1407011153041, 65.71601152972752, 79.01301957382668, 0.09999999999999883, 245.0, 949, 757794, 1038, 30.34895019999749
1039, 4.810181501287692, 65.63518004721783, 78.8537332871381, 0.09999999999999967, 90.0, 799, 758593, 1039, 25.621349199998804
1040, 4.625623003517149, 65.70640771549077, 78.993618375421, 0.10000000000000095, 140.0, 566, 759159, 1040, 18.106825700000627
1041, 7.118564158078436, 65.88242521351332, 79.17493547805368, 0.09999999999999798, 305.0, 1168, 760327, 1041, 37.69632920000004
1042, 5.070840404003481, 66.15536860833332, 79.47492042803636, 0.09999999999999819, 580.0, 1106, 761433, 1042, 35.73915639999905
1043, 5.697713260013196, 66.1499353281657, 79.47209537082249, 0.0999999999999967, 545.0, 1800, 763233, 1043, 58.00213359999907
1044, 3.968478754852222, 66.06316812958502, 79.3376919879773, 0.09999999999999881, 300.0, 951, 764184, 1044, 30.80647179999869
1045, 6.128665696585097, 65.97659058528829, 79.30590464622804, 0.0999999999999985, 415.0, 1021, 765205, 1045, 33.207616199997574
1046, 3.734385019430969, 66.17569650264677, 79.49566213178817, 0.09999999999999976, 260.0, 787, 765992, 1046, 25.76039039999887
1047, 5.603308812227773, 65.98976632514257, 79.26291142184863, 0.10000000000000092, 75.0, 537, 766529, 1047, 17.786869000003207
1048, 8.314095288443964, 66.10688512251315, 79.51910291139151, 0.09999999999999942, 280.0, 838, 767367, 1048, 27.407807700001285
1049, 4.7562777126797275, 66.11900687308597, 79.42217756802124, 0.09999999999999976, 320.0, 787, 768154, 1049, 25.531317000000854
1050, 5.82708360550958, 66.11406435787174, 79.45174537945599, 0.0999999999999976, 335.0, 1303, 769457, 1050, 42.35754380000071
1051, 3.934370575028676, 65.90202079395023, 79.14019471868274, 0.10000000000000094, 155.0, 646, 770103, 1051, 21.05794909999895
1052, 5.684619249429317, 66.1650785368991, 79.43125147295825, 0.09999999999999926, 345.0, 865, 770968, 1052, 28.38041769999836
1053, 4.903213354069948, 66.03811464936021, 79.29419137229115, 0.09999999999999962, 195.0, 807, 771775, 1053, 26.610674600000493
1054, 3.788168141245842, 66.2199537198219, 79.52322677522017, 0.09999999999999938, 215.0, 845, 772620, 1054, 28.139774700001
1055, 4.687522997613996, 66.12399442791938, 79.49346836805344, 0.100000000000001, 80.0, 640, 773260, 1055, 21.50062710000202
1056, 4.716878125008116, 66.2987132956554, 79.71792703414036, 0.10000000000000081, 150.0, 658, 773918, 1056, 21.819325200001913
1057, 5.778288136478491, 66.23944184050738, 79.61105346679688, 0.09999999999999949, 195.0, 827, 774745, 1057, 27.32838549999724
1058, 5.438049376395165, 66.20285820072907, 79.56434884932116, 0.0999999999999984, 310.0, 1047, 775792, 1058, 34.573714400001336
1059, 6.477904905246012, 66.13739019286311, 79.48577561460357, 0.09999999999999781, 285.0, 1223, 777015, 1059, 40.472092500000144
1060, 5.786932605450285, 66.24837660732406, 79.60466919797759, 0.09999999999999773, 410.0, 1253, 778268, 1060, 41.067845800000214
1061, 6.515336386171844, 66.28898023873703, 79.67026061550031, 0.10000000000000078, 180.0, 661, 778929, 1061, 22.123063199996977
1062, 6.506332796078462, 66.06292791122046, 79.3680983166817, 0.0999999999999987, 155.0, 975, 779904, 1062, 32.911324100001366
1063, 4.4066413881326705, 65.83252213933379, 79.07135639303091, 0.09999999999999852, 365.0, 1018, 780922, 1063, 34.605410199998005
1064, 5.505887888494532, 65.71377146440189, 78.92311292854045, 0.09999999999999823, 410.0, 1094, 782016, 1064, 37.970195499998226
1065, 6.501643800319847, 65.58887308788754, 78.90031149572502, 0.0999999999999977, 590.0, 1262, 783278, 1065, 42.060989900001005
1066, 5.700002717477505, 65.68037818220492, 78.89057204563795, 0.09999999999999847, 340.0, 1031, 784309, 1066, 34.22254260000045
1067, 5.499703782021138, 65.6561169523551, 78.85861075362055, 0.09999999999999908, 410.0, 899, 785208, 1067, 30.16055409999899
1068, 3.9808009195267204, 65.75913125579346, 78.99473356958397, 0.10000000000000052, 150.0, 689, 785897, 1068, 23.203923199998826
1069, 8.187383096363094, 65.65411674224579, 78.98093452109947, 0.10000000000000074, 170.0, 666, 786563, 1069, 22.342050700000982
1070, 5.1850477249726, 65.81017188403918, 79.02953328257021, 0.10000000000000069, 150.0, 368, 786931, 1070, 12.382517100002588
1071, 5.690492325060945, 65.74709449070458, 78.98472422473836, 0.10000000000000052, 110.0, 689, 787620, 1071, 23.2234712999998
1072, 3.626698258811805, 65.53776780949083, 78.69927308232901, 0.10000000000000073, 45.0, 387, 788007, 1072, 12.951416899999458
1073, 5.158849073527102, 65.63397155578978, 78.86557189575926, 0.09999999999999944, 205.0, 835, 788842, 1073, 28.319919200002914
1074, 4.5004213275073095, 65.85226470620202, 79.12919582105921, 0.09999999999999784, 400.0, 1213, 790055, 1074, 40.83318919999874
1075, 5.766769209982933, 65.30301876469059, 78.41976113075967, 0.10000000000000074, 120.0, 666, 790721, 1075, 22.585633999999118
1076, 7.508515639572397, 65.10502301028704, 78.26551263003603, 0.09999999999999896, 245.0, 921, 791642, 1076, 31.190898500000912
1077, 6.421601741355467, 65.27747925796078, 78.45265345744045, 0.09999999999999834, 260.0, 1062, 792704, 1077, 36.017930400001205
1078, 8.060971959804496, 65.2189616117722, 78.38116407394409, 0.10000000000000099, 100.0, 624, 793328, 1078, 21.0610708000022
1079, 5.9804838658002195, 65.23895340320264, 78.38360433545262, 0.09999999999999928, 110.0, 861, 794189, 1079, 29.355442200001562
1080, 5.850955439260701, 65.43803122803405, 78.60501253735889, 0.10000000000000019, 215.0, 728, 794917, 1080, 24.60140660000252
1081, 7.129754980767934, 65.2257406220454, 78.39290345295538, 0.09999999999999833, 260.0, 1068, 795985, 1081, 36.49404990000039
1082, 6.296920185937156, 65.2496389394871, 78.43466514330756, 0.09999999999999759, 490.0, 1308, 797293, 1082, 44.54168429999845
1083, 5.985920512484848, 65.1997483542206, 78.31089705720954, 0.1000000000000008, 50.0, 436, 797729, 1083, 15.00602230000004
1084, 7.06185299040354, 65.31448365740208, 78.58108685547823, 0.09999999999999985, 360.0, 772, 798501, 1084, 26.67820849999771
1085, 5.214813100120851, 65.20215674264091, 78.31970041547503, 0.10000000000000042, 105.0, 700, 799201, 1085, 23.954860000001645
1086, 6.391571375349877, 65.18993824703593, 78.3971708485778, 0.10000000000000066, 40.0, 355, 799556, 1086, 12.267826700001024
1087, 6.568053460884385, 65.31228766557646, 78.44783721551663, 0.09999999999999953, 260.0, 820, 800376, 1087, 28.187330900000234
1088, 5.480989532053294, 65.19558932024223, 78.28636299231404, 0.09999999999999855, 130.0, 1011, 801387, 1088, 34.75931900000069
1089, 7.2301051278625215, 65.2664805167062, 78.40286369105748, 0.0999999999999992, 140.0, 875, 802262, 1089, 30.50743750000038
1090, 5.263118519089352, 65.29718270028796, 78.49245627615328, 0.1, 80.0, 751, 803013, 1090, 26.278170400000818
1091, 4.4734181733914165, 65.43899894622434, 78.60181295249357, 0.10000000000000088, 100.0, 498, 803511, 1091, 17.1186624999973
1092, 6.380205688006188, 65.60522190231875, 78.83290127673781, 0.09999999999999946, 215.0, 830, 804341, 1092, 28.741241300002002
1093, 6.7048759819803445, 65.35538538781609, 78.56477385613977, 0.09999999999999759, 305.0, 1312, 805653, 1093, 45.65408100000059
1094, 5.552642117094928, 65.2866696380559, 78.43943998080371, 0.09999999999999826, 205.0, 1086, 806739, 1094, 37.632915800000774
1095, 5.217650194670383, 65.36104133552324, 78.54932804476398, 0.09999999999999808, 270.0, 1138, 807877, 1095, 39.53504210000028
1096, 3.669418632595097, 65.38310042498317, 78.47485807732565, 0.10000000000000071, 50.0, 383, 808260, 1096, 13.360796799999662
1097, 3.5338231704374117, 65.60406288453315, 78.77980591462173, 0.10000000000000091, 50.0, 523, 808783, 1097, 18.24084109999967
1098, 5.09747721036864, 65.34217686406969, 78.51433491752435, 0.09999999999999841, 275.0, 1046, 809829, 1098, 36.80462040000202
1099, 4.164549167243598, 65.52589345602465, 78.64610060846618, 0.10000000000000071, 45.0, 382, 810211, 1099, 13.255236699998932
1100, 5.85772275144796, 65.33207904035952, 78.54123022007789, 0.09999999999999824, 485.0, 1091, 811302, 1100, 37.85071529999914
1101, 5.850959582969414, 65.33030287282807, 78.54831236600876, 0.09999999999999909, 145.0, 896, 812198, 1101, 31.36746040000071
1102, 5.492971006314313, 65.36949370154437, 78.55975427645751, 0.09999999999999705, 300.0, 1573, 813771, 1102, 55.2362890000004
1103, 6.089316801503166, 65.37312434163705, 78.55255287680876, 0.09999999999999819, 320.0, 1106, 814877, 1103, 38.9922387000006
1104, 5.423343693763018, 65.3550208391462, 78.48610670907156, 0.10000000000000042, 145.0, 700, 815577, 1104, 24.644508599998517
1105, 7.680519045810022, 65.48481647220589, 78.66295971390764, 0.10000000000000064, 150.0, 676, 816253, 1105, 23.91557280000052
1106, 5.327192230502877, 65.37895262963843, 78.52383758805014, 0.09999999999999837, 225.0, 1056, 817309, 1106, 37.13847159999932
1107, 7.3941910530462165, 65.38216046954311, 78.66932888918144, 0.10000000000000053, 170.0, 688, 817997, 1107, 24.253627300000517
1108, 5.800994557108033, 65.24673039331874, 78.38343612212596, 0.09999999999999809, 325.0, 1132, 819129, 1108, 39.725880800000596
1109, 5.856437709637653, 65.37602723414795, 78.54377402813982, 0.09999999999999766, 190.0, 1285, 820414, 1109, 45.52289110000129
1110, 5.684455195528882, 65.32381577536324, 78.50068615351881, 0.09999999999999831, 170.0, 1070, 821484, 1110, 38.03873790000216
1111, 6.0416677340343306, 65.37881699795852, 78.53811655601174, 0.09999999999999766, 370.0, 1285, 822769, 1111, 45.78496760000053
1112, 5.403509067451016, 65.38422746122554, 78.51139471504126, 0.10000000000000081, 40.0, 445, 823214, 1112, 15.976731099999597
1113, 5.360421076680009, 65.22578315027815, 78.35445392605276, 0.09999999999999809, 205.0, 1133, 824347, 1113, 40.412264499998855
1114, 4.61722808056518, 65.40715509625957, 78.61101908242395, 0.10000000000000081, 125.0, 659, 825006, 1114, 23.564884499999607
1115, 6.947147545193424, 65.29772627373704, 78.47637188053932, 0.10000000000000096, 115.0, 595, 825601, 1115, 21.428405400001793
1116, 7.036636625024133, 65.32377893819749, 78.49966076784914, 0.10000000000000099, 160.0, 636, 826237, 1116, 23.00720949999959
1117, 5.618680562948781, 65.16737029426976, 78.25623080604954, 0.09999999999999944, 115.0, 836, 827073, 1117, 29.827704299998004
1118, 6.6392595374572005, 65.44618369416469, 78.64489184420533, 0.10000000000000087, 110.0, 489, 827562, 1118, 17.4669533999986
1119, 5.751300467259039, 65.35017099128198, 78.49437004775598, 0.09999999999999884, 180.0, 945, 828507, 1119, 34.30421479999859
1120, 4.87884326580291, 65.27766296863555, 78.451349401474, 0.10000000000000085, 50.0, 480, 828987, 1120, 17.215182700001606
1121, 5.064562588210919, 65.19284292943158, 78.33372331852287, 0.10000000000000077, 100.0, 663, 829650, 1121, 24.13260249999803
1122, 5.215807435027968, 65.32202534523472, 78.46909633590312, 0.09999999999999902, 235.0, 909, 830559, 1122, 32.70317680000153
1123, 5.665202655170882, 65.19146713994084, 78.32247645544273, 0.10000000000000057, 180.0, 683, 831242, 1123, 24.34473579999758
1124, 5.766154597371312, 65.20982010620462, 78.37174288431804, 0.10000000000000035, 110.0, 708, 831950, 1124, 25.699244600000384
1125, 5.645156866450754, 65.00940295321983, 78.05849331875675, 0.10000000000000099, 100.0, 623, 832573, 1125, 22.446625999997195
1126, 5.66772667175276, 65.2220802967833, 78.3858091411747, 0.09999999999999822, 230.0, 1097, 833670, 1126, 39.5065926999996
1127, 4.501870825466203, 65.09600984070198, 78.16143411273605, 0.09999999999999956, 200.0, 815, 834485, 1127, 29.419617700001254
1128, 6.4232125680863374, 65.24041958165363, 78.41906102498372, 0.10000000000000087, 85.0, 492, 834977, 1128, 17.860688500000833
1129, 6.040098898777091, 65.25545893644272, 78.40254492949393, 0.10000000000000019, 85.0, 729, 835706, 1129, 26.290443399997457
1130, 5.574503590422775, 65.21708149212623, 78.36977189708604, 0.09999999999999855, 280.0, 1012, 836718, 1130, 37.742240200001106
1131, 6.560130442012248, 65.1234393730212, 78.23588400527703, 0.09999999999999974, 145.0, 789, 837507, 1131, 31.37516930000129
1132, 7.983781859923258, 65.03172549764619, 78.14123513801711, 0.10000000000000073, 45.0, 393, 837900, 1132, 13.913138899999467
1133, 4.749896798929919, 65.2740214960571, 78.40733886770214, 0.10000000000000096, 45.0, 593, 838493, 1133, 21.274167200001102
1134, 3.6378596075771825, 65.21827764726052, 78.2894097505798, 0.0999999999999994, 275.0, 843, 839336, 1134, 30.02219039999909
1135, 7.360613195120616, 65.41607231103279, 78.69456405762504, 0.10000000000000099, 105.0, 621, 839957, 1135, 22.42506190000131
1136, 5.935725567186669, 64.08618469117944, 77.02646378237367, 0.10000000000000099, 85.0, 634, 840591, 1136, 22.693836999998894
1137, 5.925368682912756, 64.27702125261129, 77.15069847031094, 0.10000000000000088, 15.0, 503, 841094, 1137, 18.303136800001084
1138, 5.743868585968955, 64.15522361069583, 77.09428112158615, 0.10000000000000066, 45.0, 356, 841450, 1138, 13.054943200000707
1139, 5.863919373194607, 64.12768922262634, 77.07061800419889, 0.09999999999999785, 175.0, 1208, 842658, 1139, 44.33073030000014
1140, 5.058275030267359, 64.10638571267177, 77.00572206516459, 0.10000000000000074, 15.0, 396, 843054, 1140, 14.829135299998597
1141, 4.7492054428154304, 64.02132231319061, 76.86592251824139, 0.09999999999999995, 225.0, 759, 843813, 1141, 27.765092699999514
1142, 4.017162364704879, 64.13680907320385, 76.97640587672714, 0.10000000000000067, 55.0, 363, 844176, 1142, 13.253089900001214
1143, 5.975757348043421, 64.13375468079009, 77.0879386671161, 0.09999999999999894, 350.0, 926, 845102, 1143, 34.19919680000021
1144, 8.966226761346256, 64.25207612559221, 77.32808944019577, 0.10000000000000049, 300.0, 693, 845795, 1144, 25.378775200002565
1145, 5.564353493978258, 64.09092802775471, 76.9949390668227, 0.10000000000000074, 85.0, 401, 846196, 1145, 15.165127099997335
1146, 5.832497113101833, 64.16836185283489, 77.0720637782558, 0.10000000000000074, 135.0, 666, 846862, 1146, 24.51183840000158
1147, 5.509102861662013, 63.987500498613976, 76.8526826907867, 0.09999999999999913, 220.0, 889, 847751, 1147, 32.64730419999978
1148, 5.18869876020584, 63.99856758117676, 76.8773762003035, 0.09999999999999891, 335.0, 932, 848683, 1148, 34.399500100000296
1149, 6.817366718940847, 64.04606720931886, 77.00898259681041, 0.10000000000000099, 140.0, 635, 849318, 1149, 23.57293319999735
1150, 4.560046964265147, 64.16293443492893, 77.03038996866304, 0.09999999999999883, 200.0, 949, 850267, 1150, 35.27400409999973
1151, 5.362817999111709, 64.66035104156822, 77.66017321514828, 0.09999999999999891, 155.0, 930, 851197, 1151, 34.73534389999986
1152, 7.143768169724641, 64.51671256698481, 77.56257360762909, 0.09999999999999791, 455.0, 1190, 852387, 1152, 44.23460609999893
1153, 6.878659940837956, 64.70350485053851, 77.72103601908512, 0.10000000000000046, 140.0, 695, 853082, 1153, 26.117749500001082
1154, 6.042748388751309, 64.43644682881069, 77.41757972641747, 0.10000000000000098, 95.0, 606, 853688, 1154, 22.59591950000322
1155, 7.0369484044248996, 64.69408368909681, 77.7530269231023, 0.09999999999999894, 450.0, 925, 854613, 1155, 35.245210200002475
1156, 6.653580103232036, 64.49655808616724, 77.45999851750634, 0.09999999999999777, 555.0, 1238, 855851, 1156, 46.10672070000146
1157, 4.615262985380227, 64.63866545285792, 77.65538550250103, 0.10000000000000049, 50.0, 692, 856543, 1157, 25.807945500000642
1158, 6.015875067017482, 64.68925190791701, 77.80091713629342, 0.10000000000000064, 10.0, 349, 856892, 1158, 13.098493500001496
1159, 3.98174195881348, 64.5528250134681, 77.46379488164729, 0.10000000000000087, 65.0, 484, 857376, 1159, 18.030981099997007
1160, 5.542253937277277, 64.6296856676029, 77.70248489156147, 0.10000000000000059, 135.0, 682, 858058, 1160, 26.05790159999742
1161, 6.734950547150913, 64.76289144178637, 77.91360379562897, 0.09999999999999795, 600.0, 1176, 859234, 1161, 43.899680499998794
1162, 6.781229301741937, 64.68404335704277, 77.73340586013587, 0.10000000000000012, 225.0, 738, 859972, 1162, 27.438021099998878
1163, 5.032321942941204, 64.43041155128282, 77.40412386958464, 0.10000000000000073, 30.0, 386, 860358, 1163, 14.631241999999475
1164, 7.309758968460828, 64.4234245300293, 77.52519189361342, 0.10000000000000074, 110.0, 665, 861023, 1164, 25.34447630000068
1165, 6.537937417414181, 64.26869038086903, 77.28132456767408, 0.10000000000000099, 120.0, 632, 861655, 1165, 23.798030000001745
1166, 7.511190938146886, 64.39128316097751, 77.43390019370355, 0.10000000000000064, 75.0, 349, 862004, 1166, 13.06966669999747
1167, 5.436592874588168, 64.3557677584456, 77.31426386960106, 0.09999999999999758, 440.0, 1315, 863319, 1167, 49.46826080000028
1168, 4.874410058898474, 64.31698370766992, 77.26909589063179, 0.09999999999999803, 405.0, 1151, 864470, 1168, 43.28802759999962
1169, 6.3581430643305845, 64.45343434405498, 77.47367580739895, 0.09999999999999871, 280.0, 971, 865441, 1169, 36.587834800000564
1170, 6.1378670583239625, 64.4350250680106, 77.42816779000418, 0.10000000000000042, 100.0, 700, 866141, 1170, 26.494669700001396
1171, 5.816094859076795, 64.21603118097049, 77.17356352925572, 0.10000000000000081, 110.0, 439, 866580, 1171, 16.580537499998172
1172, 4.6726203307388925, 64.3185619960898, 77.27488535069605, 0.09999999999999816, 350.0, 1113, 867693, 1172, 42.601312300001155
1173, 4.2954938241248, 64.23024131685844, 77.13345653964387, 0.09999999999999766, 795.0, 1285, 868978, 1173, 49.055265599999984
1174, 7.257592171357543, 64.33643300860535, 77.2711197722192, 0.09999999999999956, 175.0, 816, 869794, 1174, 31.327489100000093
1175, 4.681151248131166, 64.19225927661446, 77.12824584456051, 0.10000000000000092, 30.0, 544, 870338, 1175, 20.744096700000227
1176, 6.167151658828328, 64.39237154829249, 77.38030413391657, 0.09999999999999726, 375.0, 1459, 871797, 1176, 55.860892000000604
1177, 4.942509101718202, 64.319860816926, 77.28266472040221, 0.09999999999999847, 225.0, 1032, 872829, 1177, 39.961987699996826
1178, 6.098996426824099, 64.2776581540753, 77.21277687651883, 0.10000000000000098, 65.0, 606, 873435, 1178, 27.388491800000338
1179, 4.574102203290265, 64.3118647525185, 77.23638755396793, 0.10000000000000074, 25.0, 665, 874100, 1179, 33.64453809999759
1180, 4.885676197482596, 64.40726244733898, 77.37100690347401, 0.10000000000000099, 105.0, 629, 874729, 1180, 29.103270799998427
1181, 5.483437562557133, 64.28019859268143, 77.23112400730808, 0.10000000000000074, 150.0, 666, 875395, 1181, 25.297369700001582
1182, 5.34514110117731, 64.56106565233688, 77.63257405455683, 0.10000000000000066, 50.0, 355, 875750, 1182, 13.678466299999855
1183, 5.092937490736059, 64.32367494102515, 77.2991818822507, 0.10000000000000099, 75.0, 631, 876381, 1183, 24.603566199999477
1184, 6.034724785682613, 64.31594469660433, 77.27531438100162, 0.10000000000000098, 110.0, 611, 876992, 1184, 23.86307450000095
1185, 6.097141188535105, 64.41520763639622, 77.3879488686654, 0.0999999999999979, 185.0, 1196, 878188, 1185, 46.09778919999735
1186, 5.224571320118771, 64.24928200977905, 77.16695305290345, 0.09999999999999892, 285.0, 927, 879115, 1186, 35.67372470000191
1187, 5.814078045402758, 64.3476290204351, 77.30131855048607, 0.09999999999999853, 460.0, 1014, 880129, 1187, 39.2116242000011
1188, 7.273698916736489, 63.63117656678284, 76.52363632414404, 0.10000000000000092, 195.0, 647, 880776, 1188, 25.070834699999978
1189, 5.551269290994291, 63.68707973210905, 76.51758774816676, 0.09999999999999883, 255.0, 949, 881725, 1189, 37.05519339999955
1190, 5.1427569320901885, 63.769695659016456, 76.67640144880428, 0.10000000000000063, 35.0, 344, 882069, 1190, 13.615751699999237
1191, 5.543601732458821, 63.66200124609868, 76.46880271522777, 0.09999999999999808, 215.0, 1138, 883207, 1191, 44.048826199999894
1192, 6.946259559239402, 63.573259607950845, 76.40649108886718, 0.1000000000000008, 55.0, 660, 883867, 1192, 25.92845070000112
1193, 6.867413329603269, 63.70377648168062, 76.59150299042435, 0.09999999999999849, 490.0, 1023, 884890, 1193, 39.63652169999841
1194, 7.571119492988528, 63.68834365444419, 76.54868539174397, 0.10000000000000092, 150.0, 648, 885538, 1194, 25.490862099999504
1195, 3.970731386300828, 63.65023764369676, 76.44632168764568, 0.10000000000000092, 35.0, 543, 886081, 1195, 21.209521999997378
1196, 5.115225217483017, 63.75024456638522, 76.57264112836859, 0.09999999999999754, 610.0, 1335, 887416, 1196, 52.24269110000023
1197, 6.263130465382139, 63.707598955117675, 76.57166771295817, 0.09999999999999806, 505.0, 1142, 888558, 1197, 44.20377510000253
1198, 5.423802418768511, 63.64375092652225, 76.46178967252976, 0.09999999999999808, 240.0, 1138, 889696, 1198, 44.65858339999977
1199, 6.248835123419635, 63.41669358529569, 76.18523498405708, 0.09999999999999885, 425.0, 943, 890639, 1199, 36.9867407999991
1200, 5.948222286539026, 63.15180592540654, 75.83158892407093, 0.09999999999999766, 425.0, 1279, 891918, 1200, 49.88477700000294
1201, 5.242089617758427, 63.32012555824136, 76.08885315229308, 0.10000000000000091, 30.0, 530, 892448, 1201, 20.94662459999745
1202, 7.736721069391107, 63.33457470782017, 76.11403630029359, 0.09999999999999702, 540.0, 1586, 894034, 1202, 62.36556620000192
1203, 6.109716452192992, 63.153082329272735, 75.8986173803511, 0.09999999999999869, 100.0, 977, 895011, 1203, 38.850318299999344
1204, 4.900302554627153, 63.14027438240255, 75.84980880002925, 0.0999999999999989, 235.0, 935, 895946, 1204, 37.111978299999464
1205, 3.9210270144245816, 63.0925247850974, 75.7437927006606, 0.09999999999999912, 105.0, 892, 896838, 1205, 35.34865639999771
1206, 4.577221858994281, 63.25651200153719, 76.00327838724117, 0.09999999999999906, 250.0, 901, 897739, 1206, 35.92069380000248
1207, 4.436723488098696, 63.22895050622467, 75.98568459417586, 0.10000000000000074, 110.0, 665, 898404, 1207, 26.620916400002898
1208, 5.467845509708791, 63.24945243614307, 75.99155475782311, 0.10000000000000052, 150.0, 690, 899094, 1208, 27.37376040000163
1209, 6.92092744207808, 63.24359636890645, 76.0249828416474, 0.10000000000000073, 30.0, 392, 899486, 1209, 15.909859600000345
1210, 3.8331053303411373, 63.0961137844966, 75.74590750474196, 0.10000000000000091, 50.0, 520, 900006, 1210, 20.797787899999093
1211, 7.3198099407001775, 62.977706818757234, 75.76563852945964, 0.0999999999999975, 700.0, 1350, 901356, 1211, 53.21709710000141
1212, 4.6871918734633224, 63.04816866383969, 75.75196555054303, 0.10000000000000077, 110.0, 412, 901768, 1212, 16.572898200000054
1213, 3.7660412749675105, 63.031837411517465, 75.64006612956344, 0.10000000000000078, 170.0, 662, 902430, 1213, 26.283112199998868
1214, 6.4367367180014465, 63.00296446064673, 75.7265241302713, 0.09999999999999952, 110.0, 822, 903252, 1214, 32.8628443000016
1215, 5.097664808469381, 63.07037788729938, 75.78799757438999, 0.10000000000000087, 110.0, 653, 903905, 1215, 26.090176199999405
1216, 8.745801989149754, 62.90813726468253, 75.60873804738634, 0.10000000000000087, 80.0, 487, 904392, 1216, 19.968033599998307
1217, 5.8924164772663765, 62.81944369261663, 75.48022477873788, 0.09999999999999884, 375.0, 946, 905338, 1217, 37.87145050000254
1218, 3.2584403247288423, 63.034822710737856, 75.71403968097806, 0.09999999999999835, 320.0, 1059, 906397, 1218, 42.34129659999962
1219, 3.620649518829877, 62.86933918311948, 75.51867109830262, 0.10000000000000098, 40.0, 610, 907007, 1219, 24.42783269999927
1220, 6.386860700672835, 63.03248513850555, 75.7637604750429, 0.09999999999999792, 260.0, 1186, 908193, 1220, 47.605591899999126
1221, 5.141392557102828, 62.793908413804346, 75.45665658990397, 0.09999999999999953, 155.0, 819, 909012, 1221, 32.96103729999959
1222, 5.902970771205857, 62.84077926398559, 75.4970973751088, 0.09999999999999874, 185.0, 965, 909977, 1222, 39.07226989999981
1223, 6.155843768014961, 62.65606960290585, 75.23375727295308, 0.10000000000000099, 70.0, 631, 910608, 1223, 25.75497819999873
1224, 4.228193556161853, 62.594111684615235, 75.17773466545918, 0.09999999999999974, 240.0, 788, 911396, 1224, 31.642469399997935
1225, 5.270090389309362, 62.71444134485154, 75.3357389313834, 0.10000000000000069, 100.0, 672, 912068, 1225, 27.3786147000028
1226, 7.151453134129482, 62.68651725929762, 75.3549510667463, 0.09999999999999962, 315.0, 807, 912875, 1226, 32.56348429999707
1227, 5.948965093885886, 62.61694491194976, 75.22725477271317, 0.09999999999999826, 625.0, 1086, 913961, 1227, 43.78659920000064
1228, 3.5010547772079645, 62.495253146051645, 75.03079761192946, 0.10000000000000088, 110.0, 501, 914462, 1228, 20.27622160000101
1229, 7.3808252016525255, 62.62754743842668, 75.2752210555538, 0.09999999999999942, 230.0, 837, 915299, 1229, 33.65753350000159
1230, 3.6962826961083888, 62.655833995171605, 75.22501165003864, 0.09999999999999869, 295.0, 978, 916277, 1230, 39.58694839999953
1231, 4.241323051029613, 62.635028396172544, 75.26946690636224, 0.09999999999999938, 240.0, 844, 917121, 1231, 34.51354100000026
1232, 4.973638477691773, 62.64405754275061, 75.24588587608105, 0.09999999999999866, 230.0, 986, 918107, 1232, 40.19176530000186
1233, 5.972573078685362, 62.58209130236211, 75.14645733724113, 0.10000000000000091, 45.0, 524, 918631, 1233, 21.50586470000053
1234, 5.737513163573165, 62.781213664911135, 75.45780607385217, 0.09999999999999869, 325.0, 979, 919610, 1234, 40.753830099998595
1235, 5.823760638907218, 63.33813710063028, 76.09383253773231, 0.09999999999999912, 240.0, 892, 920502, 1235, 36.50201630000083
1236, 3.457488436305646, 63.936026748185306, 76.7649738587055, 0.10000000000000087, 80.0, 485, 920987, 1236, 19.878143800000544
1237, 5.08464654318311, 64.156925956649, 77.06686442982067, 0.10000000000000088, 20.0, 495, 921482, 1237, 20.403824900000473
1238, 5.968441636634433, 63.948876246648574, 76.84409427298536, 0.10000000000000094, 95.0, 554, 922036, 1238, 22.958677300001
1239, 4.894994145268173, 64.13098756342984, 77.04097379109506, 0.09999999999999841, 310.0, 1045, 923081, 1239, 42.64559880000161
1240, 5.856127531871051, 64.06256884197856, 76.94706328129055, 0.09999999999999905, 335.0, 903, 923984, 1240, 37.16520909999963
1241, 5.599472884064587, 64.10856730944586, 77.05832455045542, 0.09999999999999828, 280.0, 1079, 925063, 1241, 44.301434699998936
1242, 4.755116932853392, 64.09204464404193, 76.95391460183826, 0.09999999999999885, 305.0, 942, 926005, 1242, 39.194687900002464
1243, 6.556756492300983, 64.03227791228852, 76.9812182224158, 0.09999999999999895, 215.0, 924, 926929, 1243, 37.818804399998044
1244, 5.438635756368216, 63.90484375028468, 76.78316346922917, 0.09999999999999698, 605.0, 1608, 928537, 1244, 66.22891490000256
1245, 7.70286486136701, 64.07627894860188, 77.03307782238676, 0.09999999999999976, 120.0, 786, 929323, 1245, 32.94530100000338
1246, 5.7801682582717016, 63.941210690771214, 76.84799719790044, 0.0999999999999983, 475.0, 1073, 930396, 1246, 44.47942949999924
1247, 4.9223057722326615, 64.11965833391461, 76.99154213057136, 0.10000000000000088, 130.0, 651, 931047, 1247, 27.511599900000874
1248, 8.21050013936023, 64.00853331598528, 76.98871955435972, 0.0999999999999978, 340.0, 1226, 932273, 1248, 51.085360500001116
1249, 6.333088082455025, 63.94462711976306, 76.84105620053735, 0.0999999999999996, 140.0, 808, 933081, 1249, 33.7900922000008
1250, 5.502698989474233, 63.98698566317896, 76.86696376206179, 0.10000000000000038, 90.0, 706, 933787, 1250, 29.534665300001507
1251, 5.8418649604558945, 63.93696160888672, 76.81422312011719, 0.10000000000000099, 75.0, 625, 934412, 1251, 26.215580600000976
1252, 4.9599403188379245, 64.05065139238611, 76.9511399695037, 0.09999999999999898, 300.0, 918, 935330, 1252, 38.579636700000265
1253, 4.869255324505796, 64.15408299323629, 77.01263676542912, 0.10000000000000049, 80.0, 693, 936023, 1253, 29.027616399998806
1254, 4.368859776372357, 63.9835040785445, 76.87184686807076, 0.10000000000000028, 155.0, 717, 936740, 1254, 30.025161800000205
1255, 6.700339982740399, 64.06859016999965, 77.01031188267034, 0.10000000000000084, 140.0, 656, 937396, 1255, 27.821869800001878
1256, 6.283564059561588, 64.06556302959676, 76.9357059435683, 0.09999999999999969, 170.0, 797, 938193, 1256, 33.580338399999164
1257, 4.884487003450016, 63.99153695659577, 76.8611775162078, 0.09999999999999767, 395.0, 1276, 939469, 1257, 53.28167580000081
1258, 7.720950816925077, 63.830209021287104, 76.71741801492841, 0.09999999999999969, 150.0, 797, 940266, 1258, 33.67036240000016
1259, 3.605336917508947, 63.36211108531889, 76.07922455815985, 0.09999999999999784, 290.0, 1212, 941478, 1259, 51.48448300000018
1260, 5.708091197285072, 63.40728916793904, 76.19143415178571, 0.09999999999999884, 230.0, 945, 942423, 1260, 40.43978200000129
1261, 10.83477446906911, 63.48511130582547, 76.34835771569325, 0.10000000000000078, 95.0, 661, 943084, 1261, 28.385979200000293
1262, 8.279077554262376, 63.41058041215572, 76.24989947702846, 0.10000000000000095, 130.0, 569, 943653, 1262, 24.375604299999395
1263, 6.3784725382414384, 63.27143275761748, 75.99900613704197, 0.10000000000000088, 30.0, 497, 944150, 1263, 21.498476100001426
1264, 7.410559929907322, 63.51378144609167, 76.37629007496008, 0.10000000000000081, 85.0, 658, 944808, 1264, 27.97286399999939
1265, 5.578166428815685, 63.440247923538855, 76.20027632580027, 0.09999999999999817, 490.0, 1109, 945917, 1265, 47.870533199999045
1266, 5.002151821614547, 63.38862667048871, 76.12360079879807, 0.09999999999999692, 470.0, 1641, 947558, 1266, 70.3569533000009
1267, 8.740204202712222, 63.47678128109183, 76.51165670989663, 0.1000000000000007, 35.0, 372, 947930, 1267, 15.954511199997796
1268, 4.626227212809463, 63.37407633073702, 76.1240044087306, 0.09999999999999817, 260.0, 1109, 949039, 1268, 47.57784619999802
1269, 5.225293600455874, 63.476444359046184, 76.25587440446623, 0.09999999999999926, 265.0, 865, 949904, 1269, 37.303504300001805
1270, 7.764687104059047, 63.35966405191057, 76.18026964781714, 0.10000000000000069, 30.0, 366, 950270, 1270, 15.856160100000125
1271, 8.417850187173537, 62.96124618995089, 75.6697299219981, 0.09999999999999881, 160.0, 952, 951222, 1271, 40.7477558999999
1272, 5.042327165625746, 62.989968902633166, 75.66257176837864, 0.10000000000000066, 145.0, 674, 951896, 1272, 29.270789400001377
1273, 3.960638738688404, 63.09388323339529, 75.72976812429411, 0.10000000000000092, 15.0, 543, 952439, 1273, 23.46465790000002
1274, 8.628557522853303, 63.0814503801818, 75.83888703058174, 0.09999999999999898, 160.0, 917, 953356, 1274, 39.84970389999944
1275, 4.40510821652727, 62.88691752816925, 75.49310430263844, 0.10000000000000063, 55.0, 341, 953697, 1275, 14.951232100000198
1276, 5.968661133420723, 62.853264249438446, 75.47931973239663, 0.09999999999999971, 170.0, 793, 954490, 1276, 34.54726370000208
1277, 6.956760129415583, 62.86979342835606, 75.51608689724476, 0.10000000000000094, 70.0, 646, 955136, 1277, 27.92935149999903
1278, 5.446398357941076, 63.019201464901606, 75.69934217986338, 0.09999999999999837, 465.0, 1055, 956191, 1278, 46.37786150000102
1279, 5.631327597300212, 63.03917186373756, 75.68774294172015, 0.10000000000000078, 80.0, 420, 956611, 1279, 19.763515499998903
1280, 4.877575900138725, 62.85687163165797, 75.47141818465474, 0.10000000000000098, 160.0, 642, 957253, 1280, 28.689418300000398
1281, 6.0575719177072225, 62.93584585398045, 75.6417002448869, 0.10000000000000055, 325.0, 687, 957940, 1281, 29.70616280000104
1282, 5.379993484095788, 63.07398376464844, 75.75593478780397, 0.10000000000000034, 200.0, 710, 958650, 1282, 31.250626299999567
1283, 10.833240654835901, 63.123089724248, 76.02318244405312, 0.10000000000000075, 30.0, 404, 959054, 1283, 17.827203400000144
1284, 5.629407552931505, 62.992868423461914, 75.7371197108981, 0.10000000000000099, 110.0, 632, 959686, 1284, 27.443228199997975
1285, 4.660869514730213, 62.57344394305657, 75.16869834784804, 0.09999999999999892, 290.0, 928, 960614, 1285, 40.381799700000556
1286, 7.9303063262526585, 62.504835857608455, 75.1063718222021, 0.10000000000000098, 160.0, 615, 961229, 1286, 27.612079800001084
1287, 6.1610196399909976, 62.59688847888307, 75.21214995582675, 0.09999999999999913, 215.0, 889, 962118, 1287, 38.78762749999805
1288, 5.359249190495373, 62.660881514343174, 75.22065774658931, 0.10000000000000069, 120.0, 671, 962789, 1288, 29.074126800001977
1289, 5.028131140434585, 62.50794198418741, 75.05953880353162, 0.10000000000000091, 75.0, 531, 963320, 1289, 23.145015899997816
1290, 7.011675932213792, 62.49011525944767, 75.11364454285712, 0.09999999999999888, 260.0, 936, 964256, 1290, 41.554912700001296
1291, 6.181387640991989, 62.47954989303038, 75.07200683641658, 0.10000000000000099, 105.0, 637, 964893, 1291, 27.646795900000143
1292, 8.60369947051099, 62.640819255299185, 75.33380406233907, 0.10000000000000031, 80.0, 713, 965606, 1292, 30.9701696000011
1293, 5.421105122244036, 62.54582131875528, 75.10297286832655, 0.10000000000000096, 70.0, 592, 966198, 1293, 26.06869580000057
1294, 5.939101183588716, 62.57633348204743, 75.17620357759353, 0.10000000000000073, 115.0, 667, 966865, 1294, 29.344040899999527
1295, 7.132231048451413, 62.54447777025045, 75.11209620036166, 0.0999999999999997, 85.0, 794, 967659, 1295, 34.703008899999986
1296, 7.946929856936137, 62.670879102434434, 75.33110562279111, 0.10000000000000091, 75.0, 525, 968184, 1296, 22.973571900001843
1297, 4.6690679917810485, 62.5328685939312, 75.08959951996803, 0.1000000000000009, 30.0, 512, 968696, 1297, 22.580279800000426
1298, 5.605864675703996, 62.44431083987218, 75.0544339825648, 0.09999999999999765, 680.0, 1288, 969984, 1298, 56.34887009999875
1299, 10.439762636606872, 63.614135606486805, 76.53728780633377, 0.09999999999999995, 180.0, 759, 970743, 1299, 33.67446840000048
1300, 6.6871746284385285, 63.255435549570414, 76.00033399159322, 0.10000000000000071, 95.0, 668, 971411, 1300, 29.289601500000572
1301, 5.369005380732404, 63.44435749854241, 76.17343672505625, 0.09999999999999805, 340.0, 1144, 972555, 1301, 49.822140399999626
1302, 6.558407817636767, 63.39425880678238, 76.17824512912381, 0.09999999999999863, 300.0, 992, 973547, 1302, 43.55348790000062
1303, 5.1417436686062254, 63.531288777816044, 76.25900649601029, 0.09999999999999906, 470.0, 901, 974448, 1303, 39.877333099997486
1304, 7.404674558556585, 63.430175322958796, 76.27442806181253, 0.09999999999999801, 540.0, 1157, 975605, 1304, 50.76705669999865
1305, 5.999747766166612, 63.542534982866, 76.34861875554088, 0.09999999999999931, 210.0, 857, 976462, 1305, 38.11968699999852
1306, 5.085815747253823, 63.327821044921876, 76.06598353530421, 0.0999999999999995, 210.0, 825, 977287, 1306, 36.51310739999826
1307, 5.504010627248201, 63.597489655735984, 76.35685686318271, 0.1000000000000006, 15.0, 332, 977619, 1307, 14.800695900001301
1308, 6.080528200693962, 63.33108137255517, 76.09944558069343, 0.10000000000000098, 155.0, 642, 978261, 1308, 28.62781769999856
1309, 6.095210392070267, 63.39740302607698, 76.20724641332086, 0.10000000000000091, 130.0, 530, 978791, 1309, 23.49113170000055
1310, 7.127412786892413, 63.45718990426518, 76.27670119403584, 0.10000000000000088, 20.0, 493, 979284, 1310, 21.94406650000019
1311, 6.807817291131866, 63.432819541773966, 76.25068416081594, 0.10000000000000099, 210.0, 631, 979915, 1311, 28.016800299999886
1312, 6.517699929255607, 62.95028087920845, 75.64975123563472, 0.09999999999999848, 245.0, 1026, 980941, 1312, 45.750296599999274
1313, 9.91185455814842, 63.00344728315955, 75.70392925756776, 0.10000000000000075, 50.0, 409, 981350, 1313, 18.35139170000184
1314, 5.18233456079788, 63.01332853625826, 75.68048549118106, 0.0999999999999979, 300.0, 1193, 982543, 1314, 53.27838349999729
1315, 5.04025697486446, 62.94255153818152, 75.62028525606364, 0.0999999999999991, 255.0, 894, 983437, 1315, 40.004211500003294
1316, 5.275875087476546, 62.82413163215883, 75.48666380851499, 0.09999999999999984, 235.0, 775, 984212, 1316, 34.77705600000263
1317, 5.459172700222431, 62.936200512314514, 75.6150195183779, 0.09999999999999808, 225.0, 1138, 985350, 1317, 50.95974390000265
1318, 7.7349795096680385, 63.02302764019757, 75.81372223056252, 0.09999999999999869, 280.0, 979, 986329, 1318, 44.10365240000101
1319, 6.508182746027404, 62.90399200395919, 75.61076689106592, 0.10000000000000042, 120.0, 701, 987030, 1319, 31.53355620000002
1320, 6.311723950745191, 62.95424549458391, 75.65466696529064, 0.10000000000000085, 75.0, 472, 987502, 1320, 21.40932669999893
1321, 5.745752190527152, 62.88548555276922, 75.54632867100727, 0.09999999999999828, 395.0, 1079, 988581, 1321, 48.30022850000023
1322, 6.855132327115132, 62.898242756471795, 75.5618070020514, 0.10000000000000085, 100.0, 472, 989053, 1322, 21.519117600000754
1323, 7.649967299579582, 62.81123618479684, 75.53312427616031, 0.09999999999999827, 255.0, 1081, 990134, 1323, 48.68752619999941
1324, 4.822640557066063, 62.01035919189453, 74.47615856802537, 0.09999999999999956, 80.0, 815, 990949, 1324, 36.29501060000257
1325, 7.072964705421396, 62.219583250441644, 74.73253188942964, 0.09999999999999935, 315.0, 848, 991797, 1325, 38.40360289999808
1326, 5.032743094181335, 62.19226397265185, 74.70297022409983, 0.10000000000000074, 50.0, 666, 992463, 1326, 30.25447020000138
1327, 5.524273891331151, 62.18849258866421, 74.69746334164641, 0.09999999999999928, 205.0, 860, 993323, 1327, 38.84513800000059
1328, 7.591333497825255, 62.20575051090245, 74.78758969514266, 0.09999999999999885, 320.0, 943, 994266, 1328, 42.82989830000224
1329, 8.849002685244624, 62.16178073477238, 74.77186183253079, 0.09999999999999735, 340.0, 1410, 995676, 1329, 63.94223290000082
1330, 9.743006152462433, 62.169886516122254, 74.80994666604435, 0.1000000000000006, 125.0, 680, 996356, 1330, 30.820215399999142
1331, 5.980480638211188, 62.21255321088044, 74.7282098562821, 0.09999999999999896, 170.0, 920, 997276, 1331, 42.00296149999849
1332, 5.920723136676014, 61.9487125043433, 74.38516885594215, 0.09999999999999933, 245.0, 853, 998129, 1332, 38.87376990000121
1333, 8.164678898745809, 62.16545380787416, 74.73486864566803, 0.1000000000000004, 90.0, 704, 998833, 1333, 31.899360100000195
1334, 7.099221616747422, 62.012264907629785, 74.5212851908412, 0.09999999999999916, 190.0, 884, 999717, 1334, 40.417060100000526
