,loss,mae,mean_q,mean_eps,episode_reward,nb_episode_steps,nb_steps,episode,duration
0,0,0,0,0,185.0,682,682,0,1.5010274
1, 0, 0, 0, 0, 75.0, 398, 1080, 1, 0.7796545000000012
2, 0, 0, 0, 0, 105.0, 524, 1604, 2, 1.058781699999999
3, 0, 0, 0, 0, 105.0, 633, 2237, 3, 1.2419437999999996
4, 0, 0, 0, 0, 210.0, 724, 2961, 4, 1.4203942000000005
5, 0, 0, 0, 0, 35.0, 506, 3467, 5, 1.0210743999999998
6, 0, 0, 0, 0, 285.0, 922, 4389, 6, 1.7770736000000014
7, 0, 0, 0, 0, 105.0, 691, 5080, 7, 1.343838899999998
8, 0, 0, 0, 0, 50.0, 374, 5454, 8, 0.7386470999999979
9, 0, 0, 0, 0, 15.0, 506, 5960, 9, 0.9770706999999987
10, 0, 0, 0, 0, 135.0, 639, 6599, 10, 1.3129723999999996
11, 0, 0, 0, 0, 315.0, 781, 7380, 11, 1.6348847999999983
12, 0, 0, 0, 0, 75.0, 542, 7922, 12, 1.061399399999999
13, 0, 0, 0, 0, 170.0, 681, 8603, 13, 1.398682400000002
14, 0, 0, 0, 0, 155.0, 746, 9349, 14, 1.5019151000000015
15, 0, 0, 0, 0, 210.0, 593, 9942, 15, 1.1888393000000015
16, 0, 0, 0, 0, 110.0, 766, 10708, 16, 1.5004714000000021
17, 0, 0, 0, 0, 105.0, 613, 11321, 17, 1.2080085999999994
18, 0, 0, 0, 0, 150.0, 582, 11903, 18, 1.1699008000000006
19, 0, 0, 0, 0, 155.0, 724, 12627, 19, 1.3921175999999988
20, 0, 0, 0, 0, 115.0, 660, 13287, 20, 1.3136239000000032
21, 0, 0, 0, 0, 120.0, 675, 13962, 21, 1.3248435
22, 0, 0, 0, 0, 60.0, 706, 14668, 22, 1.4056746000000047
23, 0, 0, 0, 0, 210.0, 789, 15457, 23, 1.6124481999999958
24, 0, 0, 0, 0, 155.0, 664, 16121, 24, 1.3245436999999995
25, 0, 0, 0, 0, 240.0, 1115, 17236, 25, 2.1248957999999973
26, 0, 0, 0, 0, 625.0, 1378, 18614, 26, 2.6126026999999965
27, 0, 0, 0, 0, 30.0, 444, 19058, 27, 0.8912295999999955
28, 0, 0, 0, 0, 65.0, 449, 19507, 28, 0.9061385000000044
29, 0, 0, 0, 0, 120.0, 696, 20203, 29, 1.3832572999999968
30, 0, 0, 0, 0, 110.0, 639, 20842, 30, 1.2810744999999955
31, 0, 0, 0, 0, 80.0, 405, 21247, 31, 0.8036677999999995
32, 0, 0, 0, 0, 120.0, 796, 22043, 32, 1.5483820999999978
33, 0, 0, 0, 0, 225.0, 906, 22949, 33, 1.7911704000000057
34, 0, 0, 0, 0, 165.0, 785, 23734, 34, 1.5721782000000033
35, 0, 0, 0, 0, 110.0, 631, 24365, 35, 1.233500399999997
36, 0, 0, 0, 0, 210.0, 856, 25221, 36, 1.6418272000000016
37, 0, 0, 0, 0, 215.0, 824, 26045, 37, 1.5780657000000033
38, 0, 0, 0, 0, 180.0, 613, 26658, 38, 1.2075458999999995
39, 0, 0, 0, 0, 410.0, 790, 27448, 39, 1.5330407000000008
40, 0, 0, 0, 0, 30.0, 569, 28017, 40, 1.1222440000000091
41, 0, 0, 0, 0, 410.0, 981, 28998, 41, 1.9321041999999977
42, 0, 0, 0, 0, 105.0, 641, 29639, 42, 1.3182381999999961
43, 0, 0, 0, 0, 110.0, 692, 30331, 43, 1.407821300000009
44, 0, 0, 0, 0, 210.0, 886, 31217, 44, 1.7406404000000038
45, 0, 0, 0, 0, 20.0, 569, 31786, 45, 1.1229326999999927
46, 0, 0, 0, 0, 110.0, 645, 32431, 46, 1.2756561000000062
47, 0, 0, 0, 0, 155.0, 733, 33164, 47, 1.439934000000008
48, 0, 0, 0, 0, 130.0, 795, 33959, 48, 1.559309600000006
49, 0, 0, 0, 0, 245.0, 930, 34889, 49, 1.814161200000001
50, 0, 0, 0, 0, 50.0, 416, 35305, 50, 0.8343638999999996
51, 0, 0, 0, 0, 65.0, 379, 35684, 51, 0.7605871000000093
52, 0, 0, 0, 0, 155.0, 772, 36456, 52, 1.5210110999999955
53, 0, 0, 0, 0, 330.0, 1304, 37760, 53, 2.5036137000000025
54, 0, 0, 0, 0, 410.0, 822, 38582, 54, 1.5928085000000038
55, 0, 0, 0, 0, 150.0, 908, 39490, 55, 1.748249599999994
56, 0, 0, 0, 0, 135.0, 733, 40223, 56, 1.4037527999999924
57, 0, 0, 0, 0, 75.0, 393, 40616, 57, 0.7767400000000038
58, 0, 0, 0, 0, 380.0, 985, 41601, 58, 1.9971536000000043
59, 0, 0, 0, 0, 60.0, 587, 42188, 59, 1.213633999999999
60, 0, 0, 0, 0, 210.0, 801, 42989, 60, 1.6139162999999996
61, 0, 0, 0, 0, 215.0, 784, 43773, 61, 1.5555520000000058
62, 0, 0, 0, 0, 150.0, 853, 44626, 62, 1.6482562000000058
63, 0, 0, 0, 0, 105.0, 654, 45280, 63, 1.3164891999999924
64, 0, 0, 0, 0, 75.0, 461, 45741, 64, 0.891823599999995
65, 0, 0, 0, 0, 210.0, 837, 46578, 65, 1.6307077999999962
66, 0, 0, 0, 0, 160.0, 777, 47355, 66, 2.0005432999999897
67, 0, 0, 0, 0, 210.0, 790, 48145, 67, 1.6102765999999917
68, 0, 0, 0, 0, 320.0, 763, 48908, 68, 1.557844700000004
69, 0, 0, 0, 0, 155.0, 790, 49698, 69, 1.729031500000005
70, 0, 0, 0, 0, 80.0, 671, 50369, 70, 1.4940856999999994
71, 0, 0, 0, 0, 470.0, 974, 51343, 71, 1.9941355999999928
72, 0, 0, 0, 0, 155.0, 850, 52193, 72, 1.7288449999999926
73, 0, 0, 0, 0, 210.0, 786, 52979, 73, 1.613594699999993
74, 0, 0, 0, 0, 210.0, 807, 53786, 74, 1.709587600000006
75, 0, 0, 0, 0, 180.0, 784, 54570, 75, 1.611772000000002
76, 0, 0, 0, 0, 160.0, 873, 55443, 76, 1.8024317999999937
77, 0, 0, 0, 0, 185.0, 829, 56272, 77, 1.6250177000000008
78, 0, 0, 0, 0, 380.0, 787, 57059, 78, 1.6098111000000017
79, 0, 0, 0, 0, 90.0, 466, 57525, 79, 0.9460629999999952
80, 0, 0, 0, 0, 195.0, 1124, 58649, 80, 2.5497139000000004
81, 0, 0, 0, 0, 210.0, 761, 59410, 81, 1.586035200000012
82, 0, 0, 0, 0, 120.0, 813, 60223, 82, 1.7097669000000053
83, 0, 0, 0, 0, 110.0, 653, 60876, 83, 1.288533699999988
84, 0, 0, 0, 0, 135.0, 773, 61649, 84, 1.5388764999999864
85, 0, 0, 0, 0, 50.0, 570, 62219, 85, 1.1228179000000011
86, 0, 0, 0, 0, 110.0, 724, 62943, 86, 1.429822999999999
87, 0, 0, 0, 0, 105.0, 652, 63595, 87, 1.2319253000000003
88, 0, 0, 0, 0, 180.0, 828, 64423, 88, 1.6615234000000214
89, 0, 0, 0, 0, 105.0, 637, 65060, 89, 1.350307000000015
90, 0, 0, 0, 0, 105.0, 658, 65718, 90, 1.391055399999999
91, 0, 0, 0, 0, 65.0, 581, 66299, 91, 1.2282287999999824
92, 0, 0, 0, 0, 210.0, 819, 67118, 92, 1.656385599999993
93, 0, 0, 0, 0, 105.0, 542, 67660, 93, 1.115344399999998
94, 0, 0, 0, 0, 335.0, 799, 68459, 94, 1.6913988000000018
95, 0, 0, 0, 0, 120.0, 814, 69273, 95, 1.625676800000008
96, 0, 0, 0, 0, 105.0, 646, 69919, 96, 1.2705087999999876
97, 0, 0, 0, 0, 105.0, 690, 70609, 97, 1.3203068999999914
98, 0, 0, 0, 0, 120.0, 776, 71385, 98, 1.5236192999999787
99, 0, 0, 0, 0, 80.0, 466, 71851, 99, 0.9786711999999795
100, 0, 0, 0, 0, 105.0, 418, 72269, 100, 0.8241239999999834
101, 0, 0, 0, 0, 110.0, 636, 72905, 101, 1.2815663000000086
102, 0, 0, 0, 0, 240.0, 958, 73863, 102, 1.8618016000000068
103, 0, 0, 0, 0, 75.0, 512, 74375, 103, 1.2111915000000124
104, 0, 0, 0, 0, 35.0, 555, 74930, 104, 1.0834802999999908
105, 0, 0, 0, 0, 160.0, 768, 75698, 105, 1.4919802000000004
106, 0, 0, 0, 0, 260.0, 1009, 76707, 106, 2.116595600000011
107, 0, 0, 0, 0, 230.0, 1109, 77816, 107, 2.257807499999984
108, 0, 0, 0, 0, 285.0, 1372, 79188, 108, 2.658274900000009
109, 0, 0, 0, 0, 30.0, 426, 79614, 109, 0.8237321000000009
110, 0, 0, 0, 0, 50.0, 381, 79995, 110, 0.7757418999999857
111, 0, 0, 0, 0, 210.0, 817, 80812, 111, 1.6995082999999909
112, 0, 0, 0, 0, 120.0, 755, 81567, 112, 1.5268190000000175
113, 0, 0, 0, 0, 120.0, 775, 82342, 113, 1.4547905999999955
114, 0, 0, 0, 0, 155.0, 815, 83157, 114, 1.5357424999999978
115, 0, 0, 0, 0, 75.0, 424, 83581, 115, 0.8567229999999881
116, 0, 0, 0, 0, 135.0, 847, 84428, 116, 1.6165004000000067
117, 0, 0, 0, 0, 85.0, 702, 85130, 117, 1.4012899999999888
118, 0, 0, 0, 0, 210.0, 824, 85954, 118, 1.6650914999999884
119, 0, 0, 0, 0, 135.0, 784, 86738, 119, 1.6159827999999834
120, 0, 0, 0, 0, 410.0, 847, 87585, 120, 1.9563481000000138
121, 0, 0, 0, 0, 180.0, 836, 88421, 121, 1.735601900000006
122, 0, 0, 0, 0, 30.0, 367, 88788, 122, 0.7862518999999963
123, 0, 0, 0, 0, 80.0, 395, 89183, 123, 0.8637603999999897
124, 0, 0, 0, 0, 410.0, 840, 90023, 124, 1.7143555000000106
125, 0, 0, 0, 0, 105.0, 497, 90520, 125, 1.0049074000000076
126, 0, 0, 0, 0, 450.0, 963, 91483, 126, 1.8664679999999976
127, 0, 0, 0, 0, 180.0, 785, 92268, 127, 1.54380119999999
128, 0, 0, 0, 0, 50.0, 393, 92661, 128, 0.8299999000000184
129, 0, 0, 0, 0, 110.0, 706, 93367, 129, 1.3346136000000115
130, 0, 0, 0, 0, 170.0, 782, 94149, 130, 1.4416774999999973
131, 0, 0, 0, 0, 240.0, 974, 95123, 131, 1.847586199999995
132, 0, 0, 0, 0, 180.0, 807, 95930, 132, 1.5732856999999854
133, 0, 0, 0, 0, 155.0, 804, 96734, 133, 1.5763790000000029
134, 0, 0, 0, 0, 180.0, 809, 97543, 134, 1.5574511000000086
135, 0, 0, 0, 0, 530.0, 1422, 98965, 135, 2.625574300000011
136, 0, 0, 0, 0, 180.0, 828, 99793, 136, 1.5773843999999997
137, 153.33349534589337, 105.38009754790505, 131.04421332169207, 0.8194528000000001, 180.0, 815, 100608, 137, 31.98287450000001
138, 51.43368630631026, 105.09809240075045, 126.34668762739315, 0.8182873, 200.0, 688, 101296, 138, 35.44050580000001
139, 47.014863039048855, 105.12061244386261, 126.02556161456963, 0.8170803999999995, 180.0, 653, 101949, 139, 33.34410389999999
140, 46.74657605489095, 105.13669373688874, 126.0204261723271, 0.8158852000000001, 130.0, 675, 102624, 140, 34.80721089999997
141, 45.32905541447339, 105.29061098032724, 126.1952907211349, 0.8143677999999995, 365.0, 1011, 103635, 141, 52.67421939999997
142, 46.07613719124759, 105.33086217181982, 126.39931469291669, 0.8130915999999999, 35.0, 407, 104042, 142, 21.279229999999984
143, 45.210111477998815, 105.29747683851524, 126.22593534325617, 0.8118549999999999, 270.0, 967, 105009, 143, 50.39005689999999
144, 45.23143567347, 105.25115521548298, 126.25671070231247, 0.8104141, 165.0, 634, 105643, 144, 33.30591049999998
145, 45.11835272153565, 105.14570447948793, 126.10692274453466, 0.8090182000000001, 365.0, 917, 106560, 145, 48.285191199999986
146, 44.5119601719816, 105.12412115822376, 126.07467045313875, 0.8078734000000001, 85.0, 355, 106915, 146, 18.93376569999998
147, 45.05746558955842, 105.19101975329815, 126.17598161755895, 0.8068203999999999, 210.0, 815, 107730, 147, 43.05846819999999
148, 44.28158517832596, 105.2424245336567, 126.24248447467498, 0.8053902999999996, 230.0, 774, 108504, 148, 41.052875900000004
149, 43.78308346267108, 105.11232295009874, 126.05109396351023, 0.8037198999999999, 195.0, 1082, 109586, 149, 57.018517900000006
150, 43.64099199619251, 104.07206790073555, 125.04470504356536, 0.8019307000000006, 250.0, 906, 110492, 150, 49.42608029999997
151, 30.271361703921922, 102.92466326137418, 124.16044327806483, 0.8005924, 150.0, 581, 111073, 151, 30.951517800000033
152, 28.040456196681205, 102.96888972465239, 124.19874764872338, 0.7992010000000008, 290.0, 965, 112038, 152, 52.05159649999996
153, 27.602949262175514, 103.00333977017695, 124.2404668266525, 0.7977015999999998, 190.0, 701, 112739, 153, 38.04210770000009
154, 26.64530103592276, 102.96425634095046, 124.17187407640087, 0.7961860000000006, 440.0, 983, 113722, 154, 52.992009900000085
155, 27.764350921204947, 102.84452404096288, 124.07385297423427, 0.7945596999999996, 245.0, 824, 114546, 155, 44.764715799999976
156, 26.656144421799738, 102.78334944110765, 123.99118129950119, 0.7934589999999999, 115.0, 399, 114945, 156, 21.973995700000046
157, 26.614377081769067, 102.79796186083267, 123.98362732733321, 0.7922413, 275.0, 954, 115899, 157, 52.294897999999876
158, 26.250301046077222, 102.87670541199063, 124.17236991370005, 0.7908868000000001, 90.0, 551, 116450, 158, 30.55387420000011
159, 26.224092900046248, 102.93545634755975, 124.27984399003945, 0.7899355000000005, 65.0, 506, 116956, 159, 28.354156600000124
160, 27.28415326450182, 102.90116609845843, 124.17447088964238, 0.7889004999999998, 85.0, 644, 117600, 160, 35.48127139999997
161, 26.47611490762797, 102.90041589690956, 124.1741890314115, 0.7873876000000003, 400.0, 1037, 118637, 161, 57.42021409999984
162, 25.869996503351853, 102.74399761946673, 124.01274417035869, 0.7854381999999999, 395.0, 1129, 119766, 162, 62.84856650000006
163, 44.665342058755655, 103.18072353633104, 124.13653282570628, 0.7836084999999998, 405.0, 904, 120670, 163, 50.435871099999986
164, 45.38083833798393, 103.31038485991937, 124.00997721429074, 0.7821837999999999, 140.0, 679, 121349, 164, 38.27640180000003
165, 44.615289290746055, 103.2424829059177, 123.96167278289795, 0.7812487, 60.0, 360, 121709, 165, 20.41399790000014
166, 44.16007118384931, 103.2241710684153, 123.93817130147411, 0.7802802999999998, 105.0, 716, 122425, 166, 41.82024239999987
167, 44.46168984057226, 103.08511882804478, 123.74372002489946, 0.7785676, 345.0, 1187, 123612, 167, 67.72847479999996
168, 43.029918182373045, 102.99180740356445, 123.60741024780273, 0.7770493000000002, 45.0, 500, 124112, 168, 28.790845799999943
169, 43.222716312519985, 103.00102912947449, 123.67333948681926, 0.7758298000000001, 180.0, 855, 124967, 169, 48.76296449999995
170, 43.31470589590545, 102.99579410741825, 123.686395833988, 0.7746966999999999, 95.0, 404, 125371, 170, 23.393755199999987
171, 43.03197018163966, 102.97725550710977, 123.6611959908294, 0.7734232000000003, 305.0, 1011, 126382, 171, 58.458253199999945
172, 43.06106023178544, 102.97198604982952, 123.62435828807742, 0.7718940999999997, 180.0, 688, 127070, 172, 39.85781159999988
173, 43.65524121241871, 103.04407978498696, 123.75312358462388, 0.7706907999999996, 80.0, 649, 127719, 173, 37.865398700000014
174, 43.556564956825234, 102.94723514747119, 123.53117604893963, 0.7697637999999999, 30.0, 381, 128100, 174, 22.430708700000196
175, 42.695803884949, 102.99876659257072, 123.71592421191079, 0.7690176999999998, 60.0, 448, 128548, 175, 26.212611599999946
176, 43.73823081347959, 102.93155423969242, 123.60047978881403, 0.7681069, 80.0, 564, 129112, 176, 33.25414960000012
177, 43.455413174916465, 102.88841712413269, 123.5622868365552, 0.7670764000000001, 95.0, 581, 129693, 177, 34.22983999999997
178, 38.477033396617905, 102.02689201104249, 123.02683136272879, 0.7655950000000005, 195.0, 1065, 130758, 178, 62.6117263000001
179, 34.97927235382531, 101.60117120852415, 122.7798360188802, 0.7640884, 75.0, 609, 131367, 179, 36.006087899999784
180, 34.87411500503915, 101.57906964340309, 122.80119038491786, 0.7628446000000002, 105.0, 773, 132140, 180, 45.753081000000066
181, 35.18922732225278, 101.53919144374568, 122.74186867039379, 0.7615585000000001, 280.0, 656, 132796, 181, 39.71090849999996
182, 35.78450528066093, 101.52500727942231, 122.71584924820367, 0.7604776000000001, 105.0, 545, 133341, 182, 33.342795600000045
183, 34.22808136370938, 101.65082759621703, 122.8787887793019, 0.7591123, 180.0, 972, 134313, 183, 58.78230739999981
184, 34.62976656940049, 101.72371698441661, 122.98123237781955, 0.7578783999999998, 40.0, 399, 134712, 184, 24.001695599999948
185, 34.31198439426729, 101.73176302431241, 122.96878102809524, 0.7567930000000002, 155.0, 807, 135519, 185, 48.54303560000017
186, 34.61185985511106, 101.73238327875002, 123.02617943949892, 0.7552413999999996, 255.0, 917, 136436, 186, 55.749601099999836
187, 34.33652718022184, 101.63604544873508, 122.83180058317365, 0.7539390999999999, 55.0, 530, 136966, 187, 32.4213850000001
188, 35.29290312689704, 101.67279411764706, 122.89299535220681, 0.752896, 180.0, 629, 137595, 188, 39.49499000000014
189, 34.24135971069336, 101.72805516560872, 122.99166034274631, 0.7519249000000002, 30.0, 450, 138045, 189, 28.016783300000043
190, 34.05876304961297, 101.70845791090245, 122.96479995871039, 0.7509456999999998, 105.0, 638, 138683, 190, 39.640581799999836
191, 34.62192197089648, 101.68753992902101, 122.94656332159855, 0.7496316999999998, 180.0, 822, 139505, 191, 50.831451300000026
192, 28.53970997133493, 101.8921221346001, 122.88178678759101, 0.7480981000000001, 230.0, 882, 140387, 192, 55.34094269999969
193, 20.79952504536877, 102.34071299147932, 123.10687330324356, 0.7467786999999997, 100.0, 584, 140971, 193, 36.62148819999993
194, 20.48393974523435, 102.36212846602517, 123.10305172273482, 0.7454701000000001, 175.0, 870, 141841, 194, 54.725636099999974
195, 20.753915751077294, 102.36904696332729, 123.07606744533632, 0.7441336, 120.0, 615, 142456, 195, 38.98777790000031
196, 20.637017288986517, 102.45777227141232, 123.22965905205983, 0.7430067999999999, 105.0, 637, 143093, 196, 39.7851897999999
197, 20.76446396601438, 102.38566423572617, 123.08899105097396, 0.7420276000000002, 55.0, 451, 143544, 197, 28.428924800000004
198, 20.965169232066085, 102.50616801868786, 123.23748503556008, 0.7412157999999999, 95.0, 451, 143995, 198, 28.94181729999991
199, 21.154600023012204, 102.49513045312358, 123.22451458890829, 0.7395697000000003, 320.0, 1378, 145373, 199, 88.45636430000013
200, 20.9475689544595, 102.61115902882078, 123.39392085706335, 0.7374997000000005, 165.0, 922, 146295, 200, 59.19783729999972
201, 20.724697259825508, 102.65957299395481, 123.41373030074483, 0.7357167999999997, 405.0, 1059, 147354, 201, 68.26503700000012
202, 20.55107545803042, 102.7106954235192, 123.47729712098247, 0.7338988, 320.0, 961, 148315, 202, 62.27149299999974
203, 20.052205192978317, 102.70183603647592, 123.44566877210463, 0.7322013999999997, 180.0, 925, 149240, 203, 60.504097399999864
204, 20.5719089334976, 102.71289408661276, 123.45038642121746, 0.7308730000000003, 85.0, 551, 149791, 204, 36.14902140000004
205, 17.924755295943083, 102.42980138625872, 123.07514942293705, 0.7297704999999998, 155.0, 674, 150465, 205, 44.54111739999962
206, 16.331092642185702, 102.3103235875935, 122.92083354625737, 0.7281685, 240.0, 1106, 151571, 206, 74.98588380000001
207, 16.644385766031473, 102.37299911938855, 122.96616867640594, 0.7267672000000001, 95.0, 451, 152022, 207, 29.41506440000012
208, 16.85830274029313, 102.31495744936934, 122.93549008235753, 0.7257834999999998, 85.0, 642, 152664, 208, 41.78165799999988
209, 15.658869390719248, 102.39011992734525, 122.98725987112286, 0.7247980000000002, 75.0, 453, 153117, 209, 29.968178499999794
210, 15.709260757666753, 102.32783496275466, 122.8934485574111, 0.7238764, 30.0, 571, 153688, 210, 37.93599029999996
211, 15.375818986991018, 102.38975423439261, 123.00244757268847, 0.7224895, 470.0, 970, 154658, 211, 64.61861259999978
212, 16.476668268743186, 102.31057974304815, 122.86721339370266, 0.7212600999999998, 30.0, 396, 155054, 212, 27.73023880000028
213, 16.541314818443507, 102.36081508904786, 122.95622588224732, 0.7197265000000002, 400.0, 1308, 156362, 213, 110.7048319999999
214, 15.603037561785182, 102.43444461580393, 123.02038238482348, 0.7179112000000001, 190.0, 709, 157071, 214, 50.40376719999995
215, 16.19906873297883, 102.44075748868433, 123.02470298968555, 0.7164892000000002, 220.0, 871, 157942, 215, 67.26355770000009
216, 16.237028309793182, 102.45288589939926, 123.02903886274858, 0.7152598, 90.0, 495, 158437, 216, 41.46862359999977
217, 16.22971634042674, 102.47047797893656, 123.07035829390603, 0.7144227999999998, 35.0, 435, 158872, 217, 37.439073400000325
218, 15.695194359628188, 102.36896263316653, 122.96174624568096, 0.7131114999999996, 155.0, 1022, 159894, 218, 90.9155539999997
219, 13.960533043136172, 101.21168534005253, 121.56242017825666, 0.7115454999999998, 100.0, 718, 160612, 219, 61.738158399999975
220, 13.469497404749387, 101.04444473221324, 121.38517568797668, 0.7102926999999997, 165.0, 674, 161286, 220, 59.0277787
221, 13.632747543542406, 101.04541513494854, 121.4041380637362, 0.7093881999999998, 10.0, 331, 161617, 221, 29.69765640000014
222, 13.127397112612766, 101.09960154772492, 121.41511795087919, 0.7087779999999998, 20.0, 347, 161964, 222, 30.438517300000058
223, 13.3816696117906, 101.05028159197639, 121.35974004408892, 0.7078536999999999, 170.0, 680, 162644, 223, 59.591398700000354
224, 13.507481744035177, 101.1267402714886, 121.44596723177247, 0.7066171000000001, 80.0, 694, 163338, 224, 61.086345499999425
225, 12.173884686470032, 101.12902279663086, 121.49266213989257, 0.7055425000000004, 100.0, 500, 163838, 225, 44.42336040000009
226, 12.676864432602478, 101.1121336243993, 121.41899024359614, 0.7044669999999996, 100.0, 695, 164533, 226, 59.866011699999945
227, 14.340907376972053, 101.04903076255256, 121.34771701416683, 0.7035121, 50.0, 366, 164899, 227, 29.46248209999976
228, 13.04510508198892, 101.0843680474066, 121.39934259230091, 0.7026247000000004, 85.0, 620, 165519, 228, 59.3869923000002
229, 12.597114313283615, 101.08549036782169, 121.4309658298831, 0.7014582999999999, 190.0, 676, 166195, 229, 63.256643599999734
230, 13.158117381671003, 101.07654471361, 121.39719866104709, 0.7002603999999997, 160.0, 655, 166850, 230, 59.89830559999973
231, 13.65734826417073, 101.14829968369526, 121.47744051269864, 0.6990084999999998, 90.0, 736, 167586, 231, 67.07719810000071
232, 13.355297524933357, 101.10457460013694, 121.44473888128188, 0.6973507000000001, 160.0, 1106, 168692, 232, 100.35667920000014
233, 13.625462788423395, 101.17004677976249, 121.50640895123084, 0.6954832, 85.0, 969, 169661, 233, 87.98150299999998
234, 13.426930681762533, 101.24409104208661, 121.55082577925462, 0.6937687, 255.0, 936, 170597, 234, 85.63607460000003
235, 12.29348236374841, 101.28852902409618, 121.57668486788126, 0.6923124999999999, 190.0, 682, 171279, 235, 63.57230830000026
236, 12.266688147118172, 101.25249240487655, 121.54320292209347, 0.6911938000000001, 80.0, 561, 171840, 236, 51.655945900000006
237, 12.489269253176058, 101.26480685127498, 121.55092655826776, 0.6900607000000001, 135.0, 698, 172538, 237, 67.97187819999999
238, 12.256521680672181, 101.27788793629614, 121.55664639402492, 0.6890670999999998, 80.0, 406, 172944, 238, 38.5818991999995
239, 12.73636413566391, 101.23821497550578, 121.51901891163044, 0.6880438, 205.0, 731, 173675, 239, 68.50865489999978
240, 12.378513219385495, 101.33475934542142, 121.62948997590223, 0.6869413000000002, 115.0, 494, 174169, 240, 46.65457620000052
241, 11.98326563433959, 101.24504217734703, 121.54797753920921, 0.6861222999999999, 80.0, 416, 174585, 241, 38.904720599999564
242, 11.822573981634001, 101.19816492326584, 121.45774915741711, 0.6852313, 65.0, 574, 175159, 242, 54.82116330000008
243, 12.254278978073236, 101.27689410122959, 121.59579739426121, 0.6841207, 130.0, 660, 175819, 243, 63.358717299999626
244, 12.91917726620525, 101.21494422964498, 121.47576581215372, 0.6829975000000003, 110.0, 588, 176407, 244, 56.99071069999991
245, 12.14130763019747, 101.26190132863077, 121.55634655184149, 0.6821163999999998, 15.0, 391, 176798, 245, 37.953625699999975
246, 12.665983656956175, 101.33572186226452, 121.65131889001975, 0.6811408, 165.0, 693, 177491, 246, 67.18382889999975
247, 12.268203726544543, 101.25273557074152, 121.558063134669, 0.680176, 35.0, 379, 177870, 247, 36.57868589999998
248, 13.05640091204234, 101.3146459070643, 121.60663261949179, 0.6792579999999997, 210.0, 641, 178511, 248, 57.041388700000425
249, 12.816867304212265, 101.37988733189707, 121.7054660476801, 0.6780915999999999, 260.0, 655, 179166, 249, 48.388431800000035
250, 12.58124792098999, 101.32721394042969, 121.63551893310547, 0.6769396000000001, 220.0, 625, 179791, 250, 50.93902869999965
251, 12.034889497069466, 101.1752470231541, 121.44387538155434, 0.6758902000000003, 170.0, 541, 180332, 251, 42.21196730000065
252, 11.566161266072381, 101.05239179381822, 121.3063477291503, 0.6748569999999999, 110.0, 607, 180939, 252, 46.99436960000003
253, 11.105543228910133, 101.02215174157199, 121.27266384385732, 0.6736923999999997, 180.0, 687, 181626, 253, 53.27803809999932
254, 11.887918775923112, 101.01543240266687, 121.27709996840534, 0.6727681000000002, 45.0, 340, 181966, 254, 25.427013999999872
255, 11.690348137679853, 100.92516927217183, 121.17172941910593, 0.6721200999999999, 25.0, 380, 182346, 255, 28.434191600000304
256, 11.652729467484585, 100.97706621369751, 121.21773416753604, 0.671185, 65.0, 659, 183005, 256, 49.434503000000404
257, 10.728234954989782, 100.89959571385148, 121.1339638209579, 0.6702282999999999, 120.0, 404, 183409, 257, 30.29577479999989
258, 12.208895042110672, 100.96071761208476, 121.18681292621025, 0.6691753, 120.0, 766, 184175, 258, 57.64792070000021
259, 11.063722071193514, 101.02941841549344, 121.295823581635, 0.6680322999999998, 85.0, 504, 184679, 259, 38.42676019999999
260, 11.037633000515363, 101.04447195691728, 121.31687581903627, 0.6663718000000002, 305.0, 1341, 186020, 260, 102.29221549999966
261, 11.362407792698253, 100.94865799720841, 121.15939457440616, 0.6647194000000002, 60.0, 495, 186515, 261, 40.93872830000055
262, 11.181991150197776, 100.98947630757871, 121.2361251167629, 0.6639426999999999, 25.0, 368, 186883, 262, 30.679978400000437
263, 11.015136186586043, 100.9605710152804, 121.20213353462766, 0.6628591, 250.0, 836, 187719, 263, 70.22150390000024
264, 11.561873350466524, 101.0389304205636, 121.30038887986512, 0.6613363, 200.0, 856, 188575, 264, 71.63563599999998
265, 10.67579381465912, 100.98222171559053, 121.22813442454618, 0.6602599, 55.0, 340, 188915, 265, 26.022298700000647
266, 11.447888399894696, 101.04789288680155, 121.29701502126946, 0.6592320999999999, 485.0, 802, 189717, 266, 61.665792599999804
267, 11.365766358203095, 101.38295806553653, 121.72286784497997, 0.6575149000000001, 575.0, 1106, 190823, 267, 89.08150810000006
268, 11.029708116085498, 101.52461684586166, 121.91266223857929, 0.6561729999999999, 80.0, 385, 191208, 268, 31.515145700000176
269, 11.866994493269507, 101.51058847504544, 121.86598716030231, 0.6552036999999999, 365.0, 692, 191900, 269, 56.40281959999993
270, 11.638549612141862, 101.50235089652146, 121.8451645863207, 0.6542253999999998, 60.0, 395, 192295, 270, 32.46323250000023
271, 11.170017997003761, 101.54301096168179, 121.90084275937231, 0.6534442000000001, 65.0, 473, 192768, 271, 38.93938650000018
272, 11.57741399937794, 101.54202885737851, 121.88560862566608, 0.6525117999999996, 135.0, 563, 193331, 272, 46.58022189999974
273, 11.114256913519444, 101.51551663548187, 121.85370833192003, 0.6514479999999999, 160.0, 619, 193950, 273, 50.85144440000022
274, 11.068253478378926, 101.59160392724195, 121.95433551825366, 0.6501492999999999, 185.0, 824, 194774, 274, 68.53960720000032
275, 11.19767664356755, 101.68440603464366, 122.05684961782723, 0.6479973999999997, 575.0, 1567, 196341, 275, 130.16887570000017
276, 10.967516759790067, 101.63231715563981, 122.00486029497524, 0.6459201999999999, 115.0, 741, 197082, 276, 64.83629649999966
277, 11.982172106409957, 101.59960233743034, 121.9535067013102, 0.6447196000000002, 50.0, 593, 197675, 277, 50.31678919999922
278, 11.286357365032234, 101.65288422839477, 122.0357602865389, 0.6437314000000001, 70.0, 505, 198180, 278, 42.92865079999956
279, 11.682950175538355, 101.59449953351702, 121.97568572686643, 0.6428358999999998, 85.0, 490, 198670, 279, 41.088972399999875
280, 11.746094360675263, 101.624480563729, 121.99540726385291, 0.6420502, 105.0, 383, 199053, 280, 34.52052670000012
281, 11.223797690948384, 101.52711561915592, 121.86483298692127, 0.6409009000000001, 155.0, 894, 199947, 281, 76.84701459999997
282, 11.521323674106455, 99.89831029780777, 119.89814582676453, 0.6394942, 100.0, 669, 200616, 282, 55.955599699999766
283, 10.671093526639437, 99.74282648820956, 119.70765960777895, 0.6382423, 180.0, 722, 201338, 283, 61.70578729999943
284, 11.496825179775941, 99.65755404870487, 119.61618914557891, 0.6371289999999997, 160.0, 515, 201853, 284, 42.634095600000364
285, 10.781739154635513, 99.6989801865094, 119.64798283821749, 0.6362272, 85.0, 487, 202340, 285, 41.326866499999596
286, 10.906209963360471, 99.71850259224193, 119.71425789280941, 0.6354127, 25.0, 418, 202758, 286, 35.77745750000031
287, 10.667940235035504, 99.76118746223818, 119.7409679277627, 0.6341985999999995, 245.0, 931, 203689, 287, 79.22638939999979
288, 10.317006598830343, 99.67023325303929, 119.61755354122397, 0.6324706000000001, 105.0, 989, 204678, 288, 83.77959490000012
289, 10.693559031989706, 99.77316941687809, 119.72072603235293, 0.6312223000000001, 20.0, 398, 205076, 289, 34.00659379999979
290, 10.404407158115793, 99.73021535340905, 119.69192998663424, 0.6305095000000001, 45.0, 394, 205470, 290, 33.30882389999988
291, 12.13578515177731, 99.78427797009331, 119.76059844504277, 0.6297427000000002, 105.0, 458, 205928, 291, 38.54108180000003
292, 11.173738297525343, 99.80110028025868, 119.81078313471197, 0.6290029000000001, 65.0, 364, 206292, 292, 30.91901760000019
293, 11.738875898672509, 99.75799797730124, 119.74604243935698, 0.6283279, 40.0, 386, 206678, 293, 32.690363899999284
294, 10.872901335427928, 99.81456085914789, 119.7484175926031, 0.6275934999999999, 30.0, 430, 207108, 294, 36.37884959999974
295, 11.395962872881318, 99.79977143265819, 119.77389464244891, 0.6268528000000001, 55.0, 393, 207501, 295, 33.47749329999988
296, 10.629464608878038, 99.78359382535204, 119.74654013116589, 0.6255513999999994, 375.0, 1053, 208554, 296, 92.80648669999937
297, 11.778088129316554, 99.745214018913, 119.73699962995002, 0.6236164, 345.0, 1097, 209651, 297, 97.22647920000054
298, 10.831585192042876, 99.23467415386342, 119.09198563519647, 0.6217876, 230.0, 935, 210586, 298, 77.95205010000063
299, 11.577753290337434, 99.00587038628973, 118.84815141582237, 0.6206050000000001, 75.0, 379, 210965, 299, 30.856953200001044
300, 10.489055428672675, 98.94543531791649, 118.75251881201663, 0.6199057000000001, 60.0, 398, 211363, 300, 34.55006150000008
301, 10.900040639990609, 98.94277969702077, 118.72962001514527, 0.6186231999999999, 180.0, 1027, 212390, 301, 86.9829479
302, 10.81477082261933, 98.98958863021417, 118.78679772979397, 0.6169708, 220.0, 809, 213199, 302, 73.74002460000156
303, 10.287840937803647, 99.05075194028193, 118.86742752778507, 0.6157936, 45.0, 499, 213698, 303, 42.95592029999898
304, 11.59988060593605, 98.91823756694794, 118.69304411751884, 0.6145380999999998, 175.0, 896, 214594, 304, 75.48748180000075
305, 10.353773239710907, 98.91701494035065, 118.69724373489684, 0.6133257999999998, 70.0, 451, 215045, 305, 41.88890689999971
306, 11.144537749203417, 98.9024598777415, 118.66661714008323, 0.6124762, 65.0, 493, 215538, 306, 45.675469099998736
307, 11.025678555710408, 98.94018004179405, 118.72008444457386, 0.6115023999999999, 45.0, 589, 216127, 307, 52.26191330000074
308, 9.884671336147303, 98.89894683435682, 118.71354545832074, 0.6104259999999999, 155.0, 607, 216734, 308, 57.21091139999953
309, 10.46000576046504, 98.82429930281965, 118.58546689003026, 0.6090912999999999, 330.0, 876, 217610, 309, 75.68035280000004
310, 10.899676863882277, 98.79423833211263, 118.53103205362956, 0.6074928999999999, 185.0, 900, 218510, 310, 77.79781920000096
311, 9.909046208496438, 98.7892628638629, 118.54037741627816, 0.6058827999999997, 205.0, 889, 219399, 311, 74.03715910000028
312, 10.275509888759712, 98.38514143697331, 118.0493623921636, 0.6043618, 185.0, 801, 220200, 312, 66.07913830000143
313, 9.485451047024672, 97.10077645143487, 116.50881140572685, 0.6031746999999996, 100.0, 518, 220718, 313, 42.47729620000064
314, 8.967184527889712, 97.11680604704134, 116.51580314217033, 0.6022990000000001, 90.0, 455, 221173, 314, 40.47962370000096
315, 9.605641247745176, 97.06299468152582, 116.46920074330014, 0.6012694000000002, 195.0, 689, 221862, 315, 57.552599500000724
316, 10.086636744293513, 97.15432400173611, 116.5785742533233, 0.6002362, 20.0, 459, 222321, 316, 38.110060399998474
317, 9.891048807274634, 97.0996834903017, 116.51296281348611, 0.5989941999999999, 260.0, 921, 223242, 317, 76.23597759999939
318, 9.80776247802556, 97.15489732137374, 116.60298031295406, 0.5971636, 260.0, 1113, 224355, 318, 92.5189305999993
319, 9.421011960946748, 97.20115399654195, 116.64356642904426, 0.595504, 150.0, 731, 225086, 319, 59.91725749999932
320, 9.20671470936187, 97.15653426728086, 116.57462380841345, 0.5943952000000001, 50.0, 501, 225587, 320, 41.39386629999899
321, 9.216002706312583, 97.20585271859042, 116.65696789485735, 0.5934375999999996, 105.0, 563, 226150, 321, 46.92654349999975
322, 9.775584034554592, 97.14785833616514, 116.56399652979395, 0.5925313000000002, 70.0, 444, 226594, 322, 36.70626609999999
323, 9.61919009009022, 97.15095711924548, 116.5877415124624, 0.5915449000000003, 125.0, 652, 227246, 323, 53.592602999999144
324, 9.364830690791145, 97.24034527547998, 116.6605228598601, 0.5905449999999999, 115.0, 459, 227705, 324, 38.287922999999864
325, 9.751949501248587, 97.07799735955433, 116.46956161904124, 0.5897251, 10.0, 452, 228157, 325, 37.27934210000058
326, 9.987860831893792, 97.16598824893727, 116.61358059955245, 0.5884615000000003, 375.0, 952, 229109, 326, 78.23640840000007
327, 9.866046216613368, 97.2231101320501, 116.68840843334533, 0.5870917, 90.0, 570, 229679, 327, 47.56233910000083
328, 9.970703140719907, 96.85852107073487, 116.22066794834107, 0.5860054000000003, 145.0, 637, 230316, 328, 53.17253999999957
329, 9.096813539521424, 96.59910205857483, 115.9107261230819, 0.5848047999999999, 175.0, 697, 231013, 329, 57.56769499999973
330, 10.21020616910454, 96.54759494500914, 115.8492621838207, 0.5836023999999996, 180.0, 639, 231652, 330, 53.55306989999917
331, 9.709542237633375, 96.60247275581949, 115.89936048831898, 0.5826196, 40.0, 453, 232105, 331, 37.32565149999937
332, 9.21489748366803, 96.46692276000977, 115.76532555143362, 0.5815477000000002, 85.0, 738, 232843, 332, 60.45190139999977
333, 9.328746120813417, 96.48096112507146, 115.76721554267698, 0.5805144999999999, 95.0, 410, 233253, 333, 34.34703530000115
334, 9.39552600051488, 96.46840600571015, 115.75614197349392, 0.5790412000000001, 255.0, 1227, 234480, 334, 101.51408139999876
335, 9.270995895301594, 96.45696355034323, 115.73983484155991, 0.5776309000000001, 20.0, 340, 234820, 335, 28.84981809999954
336, 9.243481599737745, 96.420791695971, 115.70569567199146, 0.5768344, 100.0, 545, 235365, 336, 45.32279549999839
337, 9.507643105449057, 96.36788441129397, 115.64542537414809, 0.5757057999999999, 170.0, 709, 236074, 337, 58.36999449999894
338, 9.752130391853632, 96.35415214005687, 115.61147816542669, 0.5745394, 95.0, 587, 236661, 338, 48.82567419999941
339, 9.591032502118965, 96.37750004992937, 115.64556722611827, 0.5734225000000002, 90.0, 654, 237315, 339, 53.99320709999847
340, 8.933226982752482, 96.40997654249688, 115.67172018954066, 0.5725125999999998, 50.0, 357, 237672, 340, 29.434919499999523
341, 9.738570047052283, 96.39542645619328, 115.68546342491207, 0.5717125, 125.0, 532, 238204, 341, 44.215935599999284
342, 9.361092155545602, 96.37670255727805, 115.64811941065213, 0.5707711, 55.0, 514, 238718, 342, 43.80940139999984
343, 8.356988572482521, 96.37915797943765, 115.6608692331517, 0.5698008999999999, 105.0, 564, 239282, 343, 47.00614449999921
344, 8.792150204658508, 96.41260917663574, 115.69422842407226, 0.5688433, 65.0, 500, 239782, 344, 41.680461100000684
345, 9.396831656631983, 96.36237437945054, 115.62588363038631, 0.5676715000000003, 140.0, 802, 240584, 345, 66.48412800000006
346, 9.033487455980914, 96.30695902048288, 115.55283539001648, 0.5663503000000004, 150.0, 666, 241250, 346, 55.942074100001264
347, 8.956161018513592, 96.34518061430984, 115.60956595032756, 0.5650498, 145.0, 779, 242029, 347, 66.56583809999938
348, 9.035253441098348, 96.3233783934232, 115.5575286618683, 0.5638473999999997, 60.0, 557, 242586, 348, 47.664878399999
349, 9.281953185162646, 96.41282596993953, 115.70438169114134, 0.5629231000000001, 25.0, 470, 243056, 349, 40.329568400000426
350, 8.967966927931858, 96.43400089557355, 115.6889228454003, 0.5621257, 20.0, 416, 243472, 350, 36.09347460000026
351, 8.815894580700181, 96.41625213623047, 115.68576489072858, 0.5612760999999997, 50.0, 528, 244000, 351, 45.30227999999988
352, 9.115831503537622, 96.38135773309386, 115.65125193076558, 0.5603464, 80.0, 505, 244505, 352, 46.348082800001066
353, 9.022221173180474, 96.30164311726888, 115.54202297351978, 0.5594059000000002, 155.0, 540, 245045, 353, 49.09752720000142
354, 8.620434638719923, 96.27821216544875, 115.4926801869567, 0.5584725999999998, 45.0, 497, 245542, 354, 43.39112290000048
355, 9.349037171606737, 96.33959667057435, 115.58631814647947, 0.5573079999999999, 165.0, 797, 246339, 355, 69.55931030000102
356, 8.428939020620554, 96.3558393518349, 115.60954627864547, 0.5557743999999998, 125.0, 907, 247246, 356, 78.75694579999981
357, 9.055062495788501, 96.28653697200983, 115.5129180168711, 0.5541966999999999, 255.0, 846, 248092, 357, 73.62657770000078
358, 9.239953061029421, 96.30800687100025, 115.54996909283577, 0.5528007999999998, 325.0, 705, 248797, 358, 61.7256823000007
359, 9.140778168864633, 96.24674082350457, 115.46686105618532, 0.5515399, 110.0, 696, 249493, 359, 60.4596087000009
360, 8.46822726726532, 96.22853952543741, 115.4755933232038, 0.5501808999999998, 265.0, 814, 250307, 360, 70.74690270000065
361, 8.968453444982234, 95.70233134695664, 114.82158351792648, 0.5489929000000001, 105.0, 506, 250813, 361, 44.100935799999206
362, 8.99200911712965, 95.76064161705055, 114.89144767544704, 0.5474592999999998, 510.0, 1198, 252011, 362, 100.23708850000003
363, 8.591738128788256, 95.78205541916836, 114.95616875165774, 0.5453605, 385.0, 1134, 253145, 363, 92.7354518000011
364, 8.524563381017423, 95.70366225897097, 114.8052588967716, 0.5438809, 120.0, 510, 253655, 364, 43.43311860000176
365, 8.280782616477671, 95.7523900163852, 114.87150370590086, 0.5429790999999997, 80.0, 492, 254147, 365, 43.711419499999465
366, 9.220075124236661, 95.69489338723929, 114.82649584885932, 0.5419503999999999, 130.0, 651, 254798, 366, 58.00166030000037
367, 8.475856919556248, 95.70838450217734, 114.83444255128198, 0.5404825, 395.0, 980, 255778, 367, 87.24168850000024
368, 9.476147665948925, 95.67854479639354, 114.80595557846709, 0.5391495999999999, 70.0, 501, 256279, 368, 44.65546640000139
369, 7.8957497531717475, 95.65267547453293, 114.76421425559305, 0.5383423, 95.0, 396, 256675, 369, 35.24359760000152
370, 8.288966190421357, 95.71667007230363, 114.82853952443824, 0.5376043000000001, 45.0, 424, 257099, 370, 37.702260599999136
371, 8.689989840920596, 95.69098028907163, 114.78857600370193, 0.5365495, 130.0, 748, 257847, 371, 66.34637629999997
372, 9.151950085470636, 95.7205310989403, 114.8394589807629, 0.5352832000000001, 155.0, 659, 258506, 372, 58.47030750000158
373, 8.777153206063684, 95.66109420107003, 114.7678607062986, 0.5336848000000001, 355.0, 1117, 259623, 373, 98.50512329999947
374, 8.875577831712569, 95.45840919447241, 114.53959329735419, 0.5319549999999998, 220.0, 805, 260428, 374, 71.32264179999947
375, 8.518345495184885, 95.26462267793994, 114.29707468950849, 0.5304843999999999, 250.0, 829, 261257, 375, 73.25932920000014
376, 8.198482076863986, 95.24372447933163, 114.26631748783696, 0.5291389, 195.0, 666, 261923, 376, 59.09416810000039
377, 8.560366865377578, 95.18458055768694, 114.20159638419985, 0.5279725000000001, 180.0, 630, 262553, 377, 55.920863200000895
378, 8.528797974509578, 95.25035875928872, 114.28652043496409, 0.5269033000000001, 210.0, 558, 263111, 378, 49.49148520000017
379, 8.95425784782223, 95.19337956801705, 114.19540050755377, 0.5260699, 35.0, 368, 263479, 379, 32.52640419999989
380, 8.442973271755987, 95.31264129187396, 114.3403862478993, 0.5247648999999999, 210.0, 1082, 264561, 380, 95.5500164999994
381, 8.961654395631511, 95.31293383669023, 114.34107200172413, 0.5231961999999998, 110.0, 661, 265222, 381, 58.50606560000051
382, 8.748611736843603, 95.3417808008558, 114.3528797178778, 0.5220117999999998, 175.0, 655, 265877, 382, 57.92601420000028
383, 8.406804638408627, 95.31809002824376, 114.3514811301212, 0.5203144000000001, 305.0, 1231, 267108, 383, 108.75639840000076
384, 7.547612295889682, 95.34038639761346, 114.38156368080121, 0.5188347999999999, 80.0, 413, 267521, 384, 36.56721959999959
385, 8.235236108964294, 95.32098261716816, 114.36234761040109, 0.5178952000000001, 170.0, 631, 268152, 385, 55.902785199999926
386, 8.186593183778353, 95.3130286451101, 114.33218153845951, 0.516745, 140.0, 647, 268799, 386, 57.50631489999978
387, 8.616003824507489, 95.31663796480964, 114.34089669059304, 0.5156731, 50.0, 544, 269343, 387, 48.458573899999465
388, 8.634596572664684, 95.32874697839429, 114.36948205182652, 0.5148829, 30.0, 334, 269677, 388, 29.625600699999268
389, 8.687897301339484, 95.21330967551039, 114.22531580173018, 0.5136120999999997, 395.0, 1078, 270755, 389, 95.53345620000073
390, 8.756681763506554, 95.00001742623068, 113.97688372723468, 0.5120874999999998, 135.0, 616, 271371, 390, 54.52712760000031
391, 8.558777108263516, 95.08088033826047, 114.07105518744244, 0.5108689, 195.0, 738, 272109, 391, 65.47877460000018
392, 8.855018426518921, 94.98220449558457, 113.93375725702408, 0.5096160999999999, 150.0, 654, 272763, 392, 58.424236900000324
393, 8.63086324535117, 95.04038757412165, 114.00010021550511, 0.5087152, 35.0, 347, 273110, 393, 31.350281399998494
394, 8.547374548132128, 95.01884425698353, 113.99467092320539, 0.5079682, 55.0, 483, 273593, 394, 42.85060539999904
395, 8.974034847349536, 94.98263341553357, 113.94976353158756, 0.5071806999999999, 125.0, 392, 273985, 395, 34.91359420000117
396, 8.304253271995018, 94.99814283429293, 113.9468165534809, 0.5060332000000001, 465.0, 883, 274868, 396, 78.27454170000055
397, 9.048117038549512, 95.00261302759264, 113.98049683120476, 0.5046381999999999, 120.0, 667, 275535, 397, 59.25837049999973
398, 9.131750962282592, 94.96561108111635, 113.93632246289134, 0.5034249999999999, 200.0, 681, 276216, 398, 60.53143040000032
399, 8.676183634830846, 95.00816768010458, 113.99260327021281, 0.5021640999999998, 165.0, 720, 276936, 399, 63.75671770000008
400, 8.405366221499492, 94.98092352691093, 113.9313479379031, 0.5010724, 10.0, 493, 277429, 400, 43.8742958999992
401, 9.016663332780203, 94.9123684276234, 113.85444636778398, 0.5001534999999999, 85.0, 528, 277957, 401, 46.79164200000014
402, 9.239234000829455, 94.79125015495359, 113.72025286258037, 0.49898170000000025, 125.0, 774, 278731, 402, 68.82491360000131
403, 8.59341055763665, 94.85686419087071, 113.77895264984458, 0.4976155, 105.0, 744, 279475, 403, 65.93478849999883
404, 8.903672522704937, 94.52092898112443, 113.39151361283673, 0.4963131999999999, 190.0, 703, 280178, 404, 62.382977799999935
405, 8.327822711308798, 93.5324091796875, 112.20579930623373, 0.4950054999999998, 150.0, 750, 280928, 405, 66.56863750000048
406, 8.995836864434446, 93.57478125380827, 112.25520589741647, 0.49379679999999976, 180.0, 593, 281521, 406, 52.73249349999969
407, 9.491289607139484, 93.59195072748889, 112.27566924421754, 0.4926060999999999, 85.0, 730, 282251, 407, 64.89132179999979
408, 9.118983038474193, 93.58011773803617, 112.25339024842106, 0.4907781999999995, 330.0, 1301, 283552, 408, 115.71302000000105
409, 8.607489937208069, 93.65791465866734, 112.34536024550317, 0.4890961000000001, 135.0, 568, 284120, 409, 50.334720099999686
410, 8.840598540008068, 93.63888233502706, 112.33488368988037, 0.48815289999999995, 20.0, 480, 284600, 410, 42.86777979999897
411, 8.129728215994295, 93.57398216011597, 112.23238020434822, 0.48728439999999995, 85.0, 485, 285085, 411, 43.0130764000005
412, 8.425703309677743, 93.65801152784643, 112.34958988598973, 0.485749, 300.0, 1221, 286306, 412, 108.65581680000105
413, 8.444962047204092, 93.68738779316534, 112.36696328739819, 0.4834206999999999, 720.0, 1366, 287672, 413, 121.28863730000012
414, 8.533928963234786, 93.5407245641093, 112.19807353396332, 0.481519, 320.0, 747, 288419, 414, 66.294284900001
415, 9.202697386159166, 93.66860805535168, 112.35850099994036, 0.4804119999999999, 35.0, 483, 288902, 415, 42.98284199999944
416, 8.969974165646041, 93.60988382013832, 112.3037010518516, 0.47938689999999995, 170.0, 656, 289558, 416, 58.44415519999893
417, 8.144792274826939, 93.33722064564529, 111.94813793886055, 0.4783329999999998, 165.0, 515, 290073, 417, 45.72933009999906
418, 8.534784543617018, 92.40927907790261, 110.85632620186641, 0.4772431, 135.0, 696, 290769, 418, 61.76333119999981
419, 8.696139086723328, 92.35727299499511, 110.79865133666992, 0.4761666999999999, 90.0, 500, 291269, 419, 44.35815159999947
420, 8.976048375539598, 92.41222665875995, 110.87420261588005, 0.4751973999999999, 55.0, 577, 291846, 420, 51.432759199999055
421, 7.810865931399166, 92.33791171312332, 110.7665230512619, 0.4741020999999998, 105.0, 640, 292486, 421, 56.870010399999956
422, 8.457658340892639, 92.4049037795469, 110.84316114249478, 0.47307790000000005, 95.0, 498, 292984, 422, 44.51849659999971
423, 8.036593556830622, 92.40278382548706, 110.84831569446435, 0.47212659999999995, 125.0, 559, 293543, 423, 49.71342430000004
424, 8.5338682843809, 92.31869084852602, 110.74116529751527, 0.4707676000000001, 110.0, 951, 294494, 424, 89.59880410000005
425, 8.808163933709679, 92.33356227815705, 110.76544378416457, 0.46933030000000014, 90.0, 646, 295140, 425, 63.29227449999962
426, 7.877356428016976, 92.26048035737945, 110.66143373163735, 0.46815850000000003, 180.0, 656, 295796, 426, 58.54229029999988
427, 8.741984434878628, 92.2752516098444, 110.69211528490042, 0.4665907, 355.0, 1086, 296882, 427, 105.12198620000163
428, 9.005590161421683, 92.28881309864913, 110.72627927969712, 0.4645899999999999, 305.0, 1137, 298019, 428, 120.32331669999985
429, 8.466176994769803, 92.24073846878544, 110.64411299920852, 0.46300869999999994, 120.0, 620, 298639, 429, 105.78691380000055
430, 8.565683898414195, 92.32522447099569, 110.7374255840595, 0.4620061, 10.0, 494, 299133, 430, 150.2926077000011
431, 8.235083544504612, 92.32817430070692, 110.74576987118859, 0.4608757000000001, 210.0, 762, 299895, 431, 215.5886946999999
432, 8.21342739107412, 92.06669516373847, 110.45390623133481, 0.45960130000000027, 120.0, 654, 300549, 432, 69.65056130000085
433, 8.649390014516054, 91.98880026475439, 110.35962891899993, 0.4583449, 185.0, 742, 301291, 433, 80.32408789999863
434, 8.439095566566403, 91.8171845119532, 110.13620880700353, 0.45724599999999993, 15.0, 479, 301770, 434, 57.12056710000252
435, 8.673302197814884, 91.8820464915799, 110.22117535870774, 0.4563361, 125.0, 532, 302302, 435, 57.957502000001114
436, 8.541376504266687, 91.9172011665676, 110.25851346946988, 0.4554019, 110.0, 506, 302808, 436, 56.720224299999245
437, 8.526119884651196, 91.89713899923642, 110.26436141696615, 0.4543893999999999, 135.0, 619, 303427, 437, 64.87383000000045
438, 8.623984486163259, 91.8403833117896, 110.15559324520623, 0.4533832, 100.0, 499, 303926, 438, 54.33952830000271
439, 8.655837744202357, 91.87207216761419, 110.21485206319089, 0.45184959999999974, 365.0, 1205, 305131, 439, 135.67608299999847
440, 8.735574186454386, 91.94083047640525, 110.27893950898769, 0.4502340999999999, 30.0, 590, 305721, 440, 60.17311239999981
441, 8.41663232110194, 91.96944219071344, 110.3166901291601, 0.44915949999999993, 90.0, 604, 306325, 441, 54.47868329999983
442, 8.63446183087025, 91.90756940751193, 110.24283753310029, 0.4481415999999998, 125.0, 527, 306852, 442, 56.76963769999929
443, 8.547414097622688, 91.94019121262372, 110.29442042471246, 0.44690500000000016, 145.0, 847, 307699, 443, 97.32391339999958
444, 8.967353901078429, 91.89166684693927, 110.23071511184114, 0.44578719999999994, 90.0, 395, 308094, 444, 43.4709225000006
445, 8.51290583672785, 91.91113974469138, 110.26347948676924, 0.445087, 80.0, 383, 308477, 445, 41.406998999998905
446, 8.791590773574706, 91.98465593539602, 110.36481149564914, 0.44418880000000005, 110.0, 615, 309092, 446, 64.172885699998
447, 7.9935258675209235, 91.97664536220927, 110.3398848788839, 0.44312409999999985, 135.0, 568, 309660, 447, 53.54551650000212
448, 8.044475399277692, 91.76948150681572, 110.07775176814728, 0.44202610000000003, 135.0, 652, 310312, 448, 69.98436220000076
449, 8.642159165289158, 91.40808384235089, 109.6599842951848, 0.44087769999999993, 90.0, 624, 310936, 449, 66.06865109999853
450, 8.829054476170057, 91.34169825619718, 109.56886106585998, 0.4397553999999999, 155.0, 623, 311559, 450, 70.13425490000009
451, 8.727294425390385, 91.45213012695312, 109.69753148114239, 0.43870869999999995, 45.0, 540, 312099, 451, 60.56916070000079
452, 8.699467681909537, 91.37466826996246, 109.6152678650695, 0.4378762, 100.0, 385, 312484, 452, 39.55019860000175
453, 8.59262093591296, 91.29061953962342, 109.49799761811563, 0.43698519999999996, 85.0, 605, 313089, 453, 59.22909929999878
454, 8.433259950505981, 91.27189277361282, 109.46927267516323, 0.4359393999999999, 90.0, 557, 313646, 454, 47.754001599998446
455, 8.285894896509038, 91.39919107675108, 109.65690206460225, 0.4349548, 80.0, 537, 314183, 455, 45.242947700000514
456, 8.585860042529303, 91.37907572849868, 109.60963177654271, 0.43366779999999994, 270.0, 893, 315076, 456, 77.01900829999795
457, 8.704185086830073, 91.3206848077312, 109.54337700663159, 0.4318425999999999, 375.0, 1135, 316211, 457, 104.67743940000219
458, 7.895595344863986, 91.32244405786031, 109.5323971823538, 0.4297366000000001, 185.0, 1205, 317416, 458, 110.8573006000006
459, 8.6175740363151, 91.26232887011824, 109.4845857795889, 0.4278213999999998, 145.0, 923, 318339, 459, 84.44371609999871
460, 8.328834907695798, 91.26246584524023, 109.47807695369909, 0.42626349999999974, 165.0, 808, 319147, 460, 74.11066070000015
461, 8.12668374331459, 91.30894880377114, 109.51876668306814, 0.4248063999999997, 140.0, 811, 319958, 461, 75.69451950000075
462, 8.260298790890946, 90.91722466884515, 109.0454113560864, 0.42354999999999987, 90.0, 585, 320543, 462, 54.5583278999984
463, 8.066470036174394, 90.88850592489297, 109.01982049169737, 0.4225456, 65.0, 531, 321074, 463, 49.3826575000021
464, 8.379499029083506, 90.81325847841181, 108.92485498827557, 0.4215258999999999, 115.0, 602, 321676, 464, 56.008081899999524
465, 8.35508541782697, 90.86046087476942, 108.99133615281846, 0.42017410000000016, 345.0, 900, 322576, 465, 83.9913134999988
466, 8.171455651115902, 90.85043302642777, 108.95579229865601, 0.4187692, 200.0, 661, 323237, 466, 61.41726429999835
467, 7.529369192282842, 90.85246749924309, 108.97311018737979, 0.4178781999999999, 5.0, 329, 323566, 467, 30.48058790000141
468, 8.005870832098744, 90.87313282691827, 109.00671773845866, 0.41673249999999984, 140.0, 944, 324510, 468, 87.68796090000251
469, 8.25610296388495, 90.9114008257466, 109.03867507014334, 0.41524119999999987, 155.0, 713, 325223, 469, 66.1468109999987
470, 8.920753858196058, 90.92746156211791, 109.08756342942152, 0.41415669999999993, 80.0, 492, 325715, 470, 45.19099130000177
471, 9.489903137514855, 90.97018876802149, 109.13134581506881, 0.4131172, 115.0, 663, 326378, 471, 61.17633439999918
472, 7.907204744675155, 90.89586792915564, 109.01724251243603, 0.41192559999999995, 55.0, 661, 327039, 472, 60.48376039999857
473, 7.776487857142821, 90.91508147384947, 109.04627173215349, 0.4106512, 210.0, 755, 327794, 473, 68.92367159999776
474, 8.525361056861403, 90.8936733157766, 109.03175759188447, 0.40946499999999986, 110.0, 563, 328357, 474, 51.527196600000025
475, 8.321723991279327, 90.91769620118065, 109.05581166457445, 0.40845700000000007, 130.0, 557, 328914, 475, 50.926921300000686
476, 8.045337069034577, 90.9944390978132, 109.14564970833915, 0.40732569999999985, 165.0, 700, 329614, 476, 64.19783749999988
477, 8.800321897343984, 90.76057140410893, 108.89720034220862, 0.4062421, 90.0, 504, 330118, 477, 46.21814340000128
478, 8.259789853468645, 89.99306040872885, 107.9387085137595, 0.4051665999999999, 165.0, 691, 330809, 478, 63.13393399999768
479, 7.653741671078241, 90.0212622685219, 107.97808695551174, 0.40406229999999993, 105.0, 536, 331345, 479, 48.887843199998315
480, 7.637877778110341, 90.14627429494831, 108.11032417492989, 0.40326400000000007, 45.0, 351, 331696, 480, 32.59464870000011
481, 8.235900129302074, 90.05539852665459, 108.01817231259103, 0.4023639999999998, 225.0, 649, 332345, 481, 63.987654600001406
482, 7.905947198603777, 90.12105395809915, 108.10466433531487, 0.4007070999999999, 535.0, 1192, 333537, 482, 106.30344319999858
483, 8.308571308045774, 90.11155500669737, 108.10763652904613, 0.39930129999999997, 100.0, 370, 333907, 483, 33.55520279999837
484, 8.174886856942978, 90.11430204298271, 108.1044005347378, 0.3982131999999997, 170.0, 839, 334746, 484, 73.98453750000044
485, 8.220244550282636, 90.05623669708793, 108.02729755592038, 0.3968991999999999, 65.0, 621, 335367, 485, 55.9576175000002
486, 7.899566675199044, 90.07622741493019, 108.04387911203746, 0.39567429999999987, 145.0, 740, 336107, 486, 65.42603809999855
487, 8.352966851007285, 90.06451440533527, 108.04834119944582, 0.39453219999999994, 80.0, 529, 336636, 487, 46.34164559999772
488, 7.721642843565453, 90.09824585542728, 108.04608902691555, 0.3935367999999999, 85.0, 577, 337213, 488, 50.80922389999978
489, 8.100803324053228, 90.07798054030533, 108.05729763716857, 0.39241179999999987, 105.0, 673, 337886, 489, 59.04754410000169
490, 7.736384572431463, 90.13408193553066, 108.13114667378669, 0.3910743999999999, 115.0, 813, 338699, 490, 71.27556080000068
491, 8.63934317701261, 90.07830815220318, 108.04027088860458, 0.38975499999999996, 155.0, 653, 339352, 491, 57.7062685000019
492, 8.135360920143128, 90.03317248535156, 108.01605681152344, 0.3886048, 30.0, 625, 339977, 492, 54.89799370000037
493, 7.919409984311915, 88.83369843607541, 106.56108278687046, 0.3872016999999998, 215.0, 934, 340911, 493, 84.95737899999949
494, 8.124227073497888, 88.76194665490127, 106.47276666687756, 0.3857707, 110.0, 656, 341567, 494, 57.79411049999908
495, 7.971607731868986, 88.7733880809096, 106.47126387768104, 0.38430189999999975, 225.0, 976, 342543, 495, 85.38339909999922
496, 8.117605596036604, 88.712426374982, 106.4229092229419, 0.38266659999999975, 180.0, 841, 343384, 496, 82.64764819999982
497, 7.913509203500046, 88.73851125477712, 106.45966892325, 0.3814939, 75.0, 462, 343846, 497, 42.775002599999425
498, 8.144342384078133, 88.70030368213922, 106.42075394912504, 0.3800556999999998, 360.0, 1136, 344982, 498, 99.14462529999946
499, 8.221246709988035, 88.6299789954876, 106.32091750572468, 0.37838079999999974, 105.0, 725, 345707, 499, 65.0035699
500, 8.264621414511327, 88.59383898427286, 106.27118346985593, 0.3772764999999999, 115.0, 502, 346209, 500, 45.558650700000726
501, 7.483187263355967, 88.58994290133417, 106.27601300190484, 0.3759327999999999, 185.0, 991, 347200, 501, 82.76319669999793
502, 8.033957618124346, 88.58612367517807, 106.27673640531653, 0.3742758999999998, 165.0, 850, 348050, 502, 71.17701469999884
503, 8.123092115038059, 88.57646147470167, 106.2582635284597, 0.3730347999999999, 95.0, 529, 348579, 503, 47.212036299999454
504, 8.244021225466781, 88.53163853084607, 106.1933400899219, 0.37199079999999995, 210.0, 631, 349210, 504, 53.013160399998014
505, 7.597695609807512, 88.5221991894578, 106.19135548462147, 0.37095219999999995, 60.0, 523, 349733, 505, 44.40830950000236
506, 8.210034148864063, 88.3318058485054, 105.94906849500192, 0.36957790000000007, 275.0, 1004, 350737, 506, 85.43212270000004
507, 7.836821789883856, 88.17129906042298, 105.75443879312543, 0.36807129999999993, 210.0, 670, 351407, 507, 55.85923190000176
508, 7.9069278872664714, 88.29613672728708, 105.92255651835843, 0.3669085, 95.0, 622, 352029, 508, 51.621675099999266
509, 7.903244741777755, 88.29450632795259, 105.91652777576807, 0.36563500000000004, 235.0, 793, 352822, 509, 66.19063679999817
510, 8.439887685981798, 88.24668773133078, 105.87394854698653, 0.36419229999999997, 155.0, 810, 353632, 510, 67.76365810000061
511, 7.910274700214874, 88.32411515222837, 105.94192395144945, 0.3626749000000002, 285.0, 876, 354508, 511, 72.38805090000096
512, 8.123574135923487, 88.24100675038505, 105.84044298813157, 0.3610351, 405.0, 946, 355454, 512, 80.79979920000187
513, 8.160290156273131, 88.22593297349646, 105.83864569156728, 0.3598453, 100.0, 376, 355830, 513, 33.252566999999544
514, 7.819391419788628, 88.17409999994761, 105.75375820263602, 0.3588777999999999, 110.0, 699, 356529, 514, 60.36889209999936
515, 8.017194015256475, 88.04246127892459, 105.61868055903892, 0.35768799999999995, 105.0, 623, 357152, 515, 50.98101289999977
516, 7.963640129479178, 88.07692207559182, 105.63067635306477, 0.35663409999999984, 125.0, 548, 357700, 516, 44.91882110000006
517, 7.984046162343493, 88.07164276721431, 105.65186338237687, 0.35568190000000005, 50.0, 510, 358210, 517, 41.83605460000035
518, 7.757234242673103, 88.2063171680157, 105.80302237241696, 0.35466129999999985, 150.0, 624, 358834, 518, 52.58312609999848
519, 8.341216029130925, 88.21896167479993, 105.8136659440009, 0.3531762999999999, 520.0, 1026, 359860, 519, 90.74700909999956
520, 8.484801543313404, 88.02500380018044, 105.57067723506097, 0.3514015000000001, 270.0, 946, 360806, 520, 84.48756599999979
521, 8.282137212333621, 87.98607973553162, 105.53512080052192, 0.34995699999999996, 110.0, 659, 361465, 521, 58.749852500001
522, 8.181083458697511, 87.88706849870228, 105.39983134042649, 0.34875909999999993, 155.0, 672, 362137, 522, 59.82629690000249
523, 8.405484215112834, 87.88690021221454, 105.41507701384715, 0.3474522999999998, 155.0, 780, 362917, 523, 69.70528950000153
524, 8.180081071161696, 87.91347198004978, 105.45464328561296, 0.3461796999999999, 210.0, 634, 363551, 524, 56.52721459999884
525, 8.182443417709985, 87.83916388007758, 105.36612555048734, 0.3444832, 420.0, 1251, 364802, 525, 111.20316780000212
526, 8.513805116192575, 87.78580945758728, 105.28319678542337, 0.34279299999999985, 155.0, 627, 365429, 526, 56.00983069999711
527, 8.829802225234914, 87.86453835045492, 105.38668797057058, 0.34165179999999995, 165.0, 641, 366070, 527, 57.12743549999868
528, 8.392529305424238, 87.8823827522256, 105.39313679710673, 0.3401362000000001, 375.0, 1043, 367113, 528, 93.34536970000045
529, 8.086629843663097, 87.78394507971765, 105.30783893920649, 0.33875740000000004, 45.0, 489, 367602, 529, 43.73600979999901
530, 7.92220858777507, 87.78635685095627, 105.28942984677433, 0.33799689999999993, 65.0, 356, 367958, 530, 31.8224412999989
531, 8.610338733803411, 87.83921869250311, 105.37776315187568, 0.33724179999999987, 50.0, 483, 368441, 531, 43.032101100001455
532, 8.271290845038907, 87.81385219497169, 105.32839154749108, 0.3361365999999999, 140.0, 745, 369186, 532, 66.1230402000001
533, 8.784413700422663, 87.84218017189366, 105.35854420267093, 0.3347595999999999, 145.0, 785, 369971, 533, 69.98158780000085
534, 8.865191737025704, 85.66365126635891, 102.76797416942098, 0.3334609, 135.0, 658, 370629, 534, 58.5364178000018
535, 8.287322801147099, 85.60717083973746, 102.67643034237985, 0.33218649999999994, 195.0, 758, 371387, 535, 67.45661000000109
536, 8.367773140230144, 85.63428207076024, 102.72791859415236, 0.33077799999999985, 130.0, 807, 372194, 536, 71.7209720000028
537, 7.697549010918326, 85.597692341313, 102.6632190311149, 0.32955399999999996, 160.0, 553, 372747, 537, 49.1290001999987
538, 7.822269756862925, 85.63255670045245, 102.71005161929892, 0.32846499999999995, 225.0, 657, 373404, 538, 58.46085429999948
539, 8.643502745863277, 85.63419036545343, 102.70816587052255, 0.3270151, 290.0, 954, 374358, 539, 84.76998079999976
540, 7.899039772578648, 85.62747517994472, 102.71191144670759, 0.32565249999999996, 115.0, 560, 374918, 540, 49.737681200000225
541, 8.321619424245341, 85.5739670348682, 102.62816969782328, 0.3246481, 90.0, 556, 375474, 541, 49.77125220000016
542, 8.065559690847447, 85.6938322177108, 102.76152575827393, 0.3238038999999999, 50.0, 382, 375856, 542, 34.20046070000171
543, 8.29410703222383, 85.63368144480776, 102.7284827005991, 0.32287239999999995, 170.0, 653, 376509, 543, 58.14906680000058
544, 7.826677516051229, 85.65160728903378, 102.7337206474225, 0.32124429999999987, 290.0, 1156, 377665, 544, 103.15181830000074
545, 8.392447044386119, 85.64213439796774, 102.72537476598369, 0.3192544, 205.0, 1055, 378720, 545, 95.19898269999976
546, 8.496407527498963, 85.68740168088323, 102.79608637216432, 0.317557, 205.0, 831, 379551, 546, 74.45827500000087
547, 7.649907665609627, 85.71693943192085, 102.80320382438558, 0.3163402, 25.0, 521, 380072, 547, 46.55510560000039
548, 8.476347276142665, 85.79194921708034, 102.8998621251687, 0.31498300000000007, 295.0, 987, 381059, 548, 87.9297314999967
549, 8.15481726537986, 85.77751730723553, 102.86929949794907, 0.3134971, 105.0, 664, 381723, 549, 59.294003599999996
550, 8.484863406257407, 85.7762279584714, 102.88765577026842, 0.31243689999999996, 105.0, 514, 382237, 550, 45.77440990000105
551, 8.38363979200692, 85.81457358683616, 102.94294410010009, 0.3107107, 395.0, 1404, 383641, 551, 124.969031800003
552, 7.984764035901237, 85.76049537718018, 102.85580132278277, 0.30886839999999993, 110.0, 643, 384284, 552, 58.97598350000044
553, 8.887103146865588, 85.79657948918704, 102.90960278230556, 0.30786129999999995, 20.0, 476, 384760, 553, 45.51785329999984
554, 7.73873623191853, 85.67646844185832, 102.74453257294871, 0.30708099999999994, 80.0, 391, 385151, 554, 38.29861759999767
555, 8.067025735996388, 85.78049093740958, 102.8649570606373, 0.30612159999999994, 190.0, 675, 385826, 555, 62.24831909999921
556, 8.204590502366498, 85.74616845923276, 102.83498337019735, 0.30479049999999996, 325.0, 804, 386630, 556, 68.36009120000017
557, 8.6063739944072, 85.78209432874407, 102.89341882069905, 0.3033109, 210.0, 840, 387470, 557, 69.37246709999818
558, 8.671210931345474, 85.81628503134084, 102.95238157760265, 0.3021679, 130.0, 430, 387900, 558, 35.74986949999948
559, 8.576824025007395, 85.75926577054537, 102.85675568800706, 0.30119589999999996, 110.0, 650, 388550, 559, 52.75563630000033
560, 7.758436618691281, 85.77861063468023, 102.88258325250655, 0.2999160999999999, 165.0, 772, 389322, 560, 62.83106460000272
561, 7.870861368212767, 85.79141764363688, 102.89013466233003, 0.29832309999999995, 290.0, 998, 390320, 561, 82.06073079999987
562, 7.684240376313158, 85.6519373121505, 102.71403974280832, 0.29664909999999994, 225.0, 862, 391182, 562, 69.99683999999979
563, 7.922525741514134, 85.63791658953252, 102.71162311882861, 0.2947563999999999, 525.0, 1241, 392423, 563, 100.746295500001
564, 7.841922899895308, 85.56485496411483, 102.6395820635928, 0.2928870999999999, 225.0, 836, 393259, 564, 68.81888439999966
565, 8.42317755201498, 85.61262112413431, 102.68758905402437, 0.29172249999999994, 120.0, 458, 393717, 565, 37.09934670000075
566, 7.61620993903189, 85.61535286951546, 102.67551152393071, 0.2908647999999999, 50.0, 495, 394212, 566, 40.33668089999992
567, 8.339556568908947, 85.53548064244656, 102.57374029696467, 0.28974789999999995, 110.0, 746, 394958, 567, 64.03645439999673
568, 8.322161497217643, 85.51868433117721, 102.55670152942, 0.28834119999999996, 335.0, 817, 395775, 568, 66.3665863999995
569, 8.21143729460519, 85.5978376717964, 102.66676698208872, 0.28676169999999995, 210.0, 938, 396713, 569, 75.74306199999774
570, 7.8713874983664, 85.61704248220809, 102.71536365568329, 0.2855700999999999, 60.0, 386, 397099, 570, 31.548365300001024
571, 8.794434416882254, 85.5806033321523, 102.64398817666027, 0.2844747999999999, 110.0, 831, 397930, 571, 67.84545520000029
572, 8.199303357361707, 85.57224906688174, 102.6269303922917, 0.2831085999999999, 115.0, 687, 398617, 572, 55.907233999998425
573, 8.485922716567234, 85.65097845800175, 102.7300215916604, 0.28176579999999996, 185.0, 805, 399422, 573, 65.2000500000031
574, 8.499294746331065, 85.26870578247225, 102.25966487239852, 0.28033299999999994, 120.0, 787, 400209, 574, 63.83041690000027
575, 8.233211182617211, 84.27755117559576, 101.09558136398728, 0.27902530000000003, 85.0, 666, 400875, 575, 54.09209190000183
576, 7.8921391808401395, 84.23775892233047, 101.02989632461114, 0.2777292999999999, 200.0, 774, 401649, 576, 62.59191400000054
577, 7.949974866901956, 84.22480662276105, 100.99961934903773, 0.27666369999999996, 80.0, 410, 402059, 577, 33.319000499999675
578, 8.105672536542018, 84.21037947336832, 101.00103468894959, 0.27586269999999996, 130.0, 480, 402539, 578, 38.900620500000514
579, 7.78310242732693, 84.30703137767985, 101.1168012789084, 0.2747745999999999, 110.0, 729, 403268, 579, 60.3228343999981
580, 8.271811453444002, 84.42532254986814, 101.24538591019943, 0.27361989999999997, 45.0, 554, 403822, 580, 45.57162489999973
581, 8.56876930145838, 84.3929020633862, 101.23400476589184, 0.2721825999999999, 460.0, 1043, 404865, 581, 85.35710900000049
582, 7.948177373734657, 84.32003159440185, 101.13889833360393, 0.2708811999999999, 50.0, 403, 405268, 582, 32.870372000001225
583, 8.10333209829368, 84.35472297668457, 101.1618807796433, 0.2696076999999999, 185.0, 1012, 406280, 583, 89.10934970000017
584, 8.414204337578694, 84.23477289330869, 101.04128911841006, 0.2681073999999999, 160.0, 655, 406935, 584, 60.68304710000302
585, 8.032713235026659, 84.31934135770959, 101.13270904078628, 0.26698329999999987, 135.0, 594, 407529, 585, 49.75339099999837
586, 8.331692851236406, 84.30098073887375, 101.12396170958033, 0.26568549999999996, 370.0, 848, 408377, 586, 82.10709919999863
587, 8.453133129859959, 84.34479860175497, 101.16314694702558, 0.2641186, 185.0, 893, 409270, 587, 85.88168339999902
588, 8.329085204560878, 84.29220495154725, 101.10137940376781, 0.26257149999999996, 110.0, 826, 410096, 588, 77.71752240000205
589, 8.291275082536005, 84.16032274919957, 100.94228423768608, 0.26146630000000004, 45.0, 402, 410498, 589, 38.29209289999926
590, 8.272457426191826, 84.21960124984952, 101.00781790183409, 0.2599948, 285.0, 1233, 411731, 590, 116.29886570000235
591, 7.883683821875533, 84.2214831397647, 101.0044794746371, 0.25839369999999984, 135.0, 546, 412277, 591, 51.69233460000032
592, 8.6490629032034, 84.2342027936663, 101.00807731139837, 0.2571714999999999, 205.0, 812, 413089, 592, 75.60384909999993
593, 8.435887717569708, 84.23576177586229, 101.0321959728104, 0.2559645999999999, 135.0, 529, 413618, 593, 49.34167279999747
594, 8.739173048086512, 84.26233525062675, 101.05301942804984, 0.2546442999999999, 195.0, 938, 414556, 594, 87.70688950000113
595, 8.35419700931045, 84.34149215066222, 101.16117657241972, 0.2533437999999999, 55.0, 507, 415063, 595, 48.567893899999035
596, 8.75845957242719, 84.33735889243576, 101.13597301191264, 0.2522052999999999, 125.0, 758, 415821, 596, 71.64250600000014
597, 8.336468539333769, 84.34699293545314, 101.16385461602893, 0.25071669999999996, 355.0, 896, 416717, 597, 82.24704310000016
598, 8.627358965056853, 84.37228751647439, 101.19304096997614, 0.24926409999999993, 135.0, 718, 417435, 598, 64.56514659999812
599, 8.864452656702417, 84.37126930245303, 101.20590579973843, 0.2478088, 290.0, 899, 418334, 599, 84.68756690000009
600, 8.182374022486135, 84.37206120525664, 101.16678967602894, 0.24625629999999998, 355.0, 826, 419160, 600, 77.93289920000097
601, 8.491439842669847, 84.38024427919349, 101.19758558209821, 0.24483699999999994, 215.0, 751, 419911, 601, 70.91406590000042
602, 8.783899687712116, 82.94422040282629, 99.48889520557731, 0.24339519999999992, 205.0, 851, 420762, 602, 80.07964520000314
603, 8.754985526819079, 82.87554171123202, 99.38419590299091, 0.24206230000000006, 55.0, 630, 421392, 603, 58.48012130000279
604, 9.056104872066513, 82.7951648018577, 99.29981754891016, 0.24058449999999995, 145.0, 1012, 422404, 604, 84.26373380000223
605, 8.71273656215163, 82.79785065821044, 99.29248631590391, 0.2388915999999999, 140.0, 869, 423273, 605, 81.29652270000224
606, 8.62866560350626, 82.80443771068866, 99.31301909226637, 0.23754789999999992, 120.0, 624, 423897, 606, 58.14938280000206
607, 8.78866488961246, 82.79702911598416, 99.29677748991547, 0.23636619999999997, 150.0, 689, 424586, 607, 65.14259839999795
608, 8.57122268118489, 82.78210962322396, 99.28079734050053, 0.23523489999999989, 20.0, 568, 425154, 608, 50.48232299999654
609, 9.087273560790502, 82.87743240253693, 99.41376888390744, 0.23418909999999993, 70.0, 594, 425748, 609, 51.16647660000308
610, 8.873538646282125, 82.90936898570821, 99.4265838713783, 0.23274639999999988, 395.0, 1009, 426757, 610, 92.55507370000123
611, 8.630884296195521, 82.85498516625407, 99.36915735783344, 0.23099049999999996, 215.0, 942, 427699, 611, 78.513390600001
612, 8.589595555723143, 82.90196426995367, 99.44927058460044, 0.22914189999999995, 215.0, 1112, 428811, 612, 93.91311300000234
613, 9.393370301076295, 82.83701494004991, 99.33658727546617, 0.22750119999999988, 285.0, 711, 429522, 613, 63.999027800000476
614, 8.83525573239249, 82.55552842390233, 99.00901626268285, 0.2260854999999999, 170.0, 862, 430384, 614, 77.67337000000043
615, 9.368458848148382, 82.07394777709465, 98.43570902810168, 0.2246463999999999, 380.0, 737, 431121, 615, 66.22933140000168
616, 9.465622697806939, 82.00629752554545, 98.34936021013958, 0.22361409999999995, 50.0, 410, 431531, 616, 36.947068800000125
617, 9.559167321324349, 82.09261526107788, 98.45524005889892, 0.22288509999999992, 20.0, 400, 431931, 617, 36.1909029999988
618, 8.27551658410794, 82.0353590550756, 98.4026159385055, 0.22193289999999988, 110.0, 658, 432589, 618, 59.34678110000095
619, 9.221780198735841, 82.06340838091782, 98.42818281888727, 0.22043079999999993, 220.0, 1011, 433600, 619, 92.74421730000176
620, 8.955883845963886, 82.07839988509961, 98.45409267099373, 0.21903669999999992, 15.0, 538, 434138, 620, 51.63433839999925
621, 8.93970705091682, 82.1506908688813, 98.53533244386247, 0.21795939999999994, 105.0, 659, 434797, 621, 62.32713849999709
622, 9.350752122025295, 82.16313983788498, 98.54608758685856, 0.21635289999999996, 515.0, 1126, 435923, 622, 97.3350019999998
623, 9.45525072407632, 82.10307332266748, 98.48180075933598, 0.2146276, 140.0, 791, 436714, 623, 65.202217500002
624, 8.658275750192447, 82.20065216205087, 98.58304985034667, 0.21332979999999993, 110.0, 651, 437365, 624, 53.70967540000129
625, 8.647084551622562, 82.24091702755366, 98.64063189259942, 0.21216609999999994, 155.0, 642, 438007, 625, 57.339576899998065
626, 9.471935478700773, 82.19603928551697, 98.61880480469563, 0.21104739999999989, 90.0, 601, 438608, 626, 54.02319129999887
627, 9.126199947611967, 82.18151228734467, 98.56875699885032, 0.20978559999999996, 200.0, 801, 439409, 627, 72.0239040000015
628, 9.438626882722945, 81.908060105748, 98.22009910149718, 0.20798830000000001, 545.0, 1196, 440605, 628, 106.7250368999994
629, 9.920176361752794, 81.5044811892819, 97.77108756721793, 0.20656539999999995, 80.0, 385, 440990, 629, 34.31630009999935
630, 9.0678923094138, 81.40704058523907, 97.62844034958364, 0.2055016, 185.0, 797, 441787, 630, 70.87269620000006
631, 9.34064608035996, 81.44537201584733, 97.65911260795798, 0.20394819999999997, 415.0, 929, 442716, 631, 82.63772339999923
632, 9.617497890153517, 81.43178663043193, 97.65503504900526, 0.20254149999999993, 185.0, 634, 443350, 632, 56.28996069999994
633, 9.082347588832151, 81.46689445879207, 97.67915265386996, 0.2016486999999999, 30.0, 358, 443708, 633, 32.28336430000127
634, 9.240472731807015, 81.53892739035867, 97.78932670824456, 0.20073249999999992, 120.0, 660, 444368, 634, 58.62494409999999
635, 8.907924769070227, 81.50305705898805, 97.74016228378845, 0.1995634, 105.0, 639, 445007, 635, 56.891352200000256
636, 9.660996420042855, 81.55031402444166, 97.8025848412626, 0.19841499999999995, 70.0, 637, 445644, 636, 56.74247370000012
637, 9.731870966468538, 81.58889906747001, 97.84863221304757, 0.19721169999999988, 105.0, 700, 446344, 637, 62.24139769999965
638, 9.448351962874536, 81.58096118330144, 97.85362138813045, 0.19592019999999985, 115.0, 735, 447079, 638, 65.27074189999985
639, 8.907471527709044, 81.55964562727168, 97.80478229624703, 0.19492209999999985, 40.0, 374, 447453, 639, 33.38177630000064
640, 9.16457737595161, 81.70184704474, 97.98770578730573, 0.1938267999999999, 160.0, 843, 448296, 640, 74.95735839999907
641, 9.214175018965436, 81.61070280733621, 97.88756129077024, 0.19236429999999993, 120.0, 782, 449078, 641, 69.64437539999926
642, 8.270186937784022, 81.62795372545186, 97.90266179733959, 0.1909557999999999, 155.0, 783, 449861, 642, 69.67811020000227
643, 8.514143580448128, 80.54757086474025, 96.59573517759404, 0.18949960000000002, 190.0, 835, 450696, 643, 72.73551869999937
644, 9.605110482888275, 80.38077473729737, 96.39530448342084, 0.18778689999999995, 230.0, 1068, 451764, 644, 88.32882210000025
645, 9.563604280327548, 80.37288927350725, 96.37044796983734, 0.18629019999999996, 75.0, 595, 452359, 645, 55.83271910000258
646, 8.972743271622594, 80.42421827165643, 96.44675173012048, 0.18501399999999993, 180.0, 823, 453182, 646, 74.1205265000026
647, 9.346113370910546, 80.46482238076474, 96.50647416212269, 0.18308439999999992, 470.0, 1321, 454503, 647, 125.50429950000034
648, 9.364189285345384, 80.42539454245312, 96.44856732337779, 0.18114039999999992, 180.0, 839, 455342, 648, 78.45728760000202
649, 9.07670176125342, 80.45549276567274, 96.48533228904971, 0.17949249999999997, 465.0, 992, 456334, 649, 84.74992500000008
650, 9.021452015700657, 80.57277378166455, 96.61862737321134, 0.17782479999999987, 210.0, 861, 457195, 650, 70.93093650000083
651, 8.674646890805867, 80.53843283510494, 96.59954164699167, 0.17644869999999999, 110.0, 668, 457863, 651, 55.13224919999993
652, 9.565203190788509, 80.5511039193221, 96.59479113000585, 0.17527599999999996, 90.0, 635, 458498, 652, 52.05502459999843
653, 8.900158478166052, 80.5412661119568, 96.6100992544219, 0.1742068, 80.0, 553, 459051, 653, 46.148708000000624
654, 9.889062686172943, 80.4327395135464, 96.49064812047521, 0.17306469999999993, 140.0, 716, 459767, 654, 59.76283840000178
655, 9.093395945031633, 79.97670781062199, 95.92308714708336, 0.17130879999999993, 210.0, 1235, 461002, 655, 103.84578489999694
656, 10.028304549178692, 79.86232963716141, 95.76070301942151, 0.16984089999999993, 50.0, 396, 461398, 656, 32.409086900002876
657, 9.269060858615914, 79.80795805591004, 95.70479176585513, 0.1687626999999999, 155.0, 802, 462200, 657, 65.82674960000077
658, 9.470773014182193, 79.81427878481578, 95.73858366178224, 0.1676781999999999, 80.0, 403, 462603, 658, 32.99691800000073
659, 9.100742804448222, 79.89218136485994, 95.78921713557268, 0.16644699999999993, 225.0, 965, 463568, 659, 82.15084019999995
660, 9.296973221858503, 79.87028840370101, 95.78305538799202, 0.1646838999999999, 260.0, 994, 464562, 660, 84.63582440000027
661, 9.247044559887478, 79.86601593274028, 95.7503389759224, 0.16325379999999992, 120.0, 595, 465157, 661, 49.81055310000011
662, 9.3111988846853, 79.89984516890773, 95.8304943033398, 0.1615140999999999, 315.0, 1338, 466495, 662, 110.0567646999989
663, 9.331326039425264, 79.94761339920768, 95.89537669907668, 0.15972219999999995, 310.0, 653, 467148, 663, 53.985947999997734
664, 9.416382802082943, 79.96408880380484, 95.89725555419922, 0.15854949999999993, 110.0, 650, 467798, 664, 53.67985620000036
665, 9.840620117836163, 80.02637682637327, 95.98778770214915, 0.15734259999999992, 155.0, 691, 468489, 665, 61.77803240000139
666, 9.105704550657954, 79.97166871570406, 95.9130839756557, 0.15596469999999996, 285.0, 840, 469329, 666, 77.10351609999998
667, 9.752595614085605, 79.61011444626091, 95.49011558902006, 0.1543348, 200.0, 971, 470300, 667, 88.75751279999895
668, 9.21578125715565, 78.68749189562371, 94.36765337794363, 0.15276699999999988, 110.0, 771, 471071, 668, 67.86596469999859
669, 9.36504803958692, 78.82215760883533, 94.51853488549254, 0.15147459999999996, 105.0, 665, 471736, 669, 58.3063699000013
670, 9.583766628221701, 78.80683499401762, 94.52635183552749, 0.15028659999999988, 105.0, 655, 472391, 670, 53.916554799998266
671, 9.537720619721643, 78.85733031330041, 94.56717449685802, 0.1489311999999999, 210.0, 851, 473242, 671, 73.29936879999877
672, 9.836265035593732, 78.94516734247622, 94.66726353805258, 0.14744079999999987, 155.0, 805, 474047, 672, 67.20388110000204
673, 9.258676753456431, 78.86715981237273, 94.57180058567745, 0.14599809999999988, 210.0, 798, 474845, 673, 65.92505630000232
674, 9.529209511113061, 78.9298813844047, 94.66710311503063, 0.14467599999999994, 305.0, 671, 475516, 674, 55.43003669999962
675, 10.221341025253588, 78.88362969051708, 94.60576216741042, 0.14343849999999994, 155.0, 704, 476220, 675, 57.742635300000984
676, 9.589474965941232, 78.89612349709839, 94.64067892672666, 0.1418032, 260.0, 1113, 477333, 676, 91.4531195999989
677, 9.01309028619115, 79.06444824886206, 94.82653087370306, 0.1400607999999999, 355.0, 823, 478156, 677, 67.05616870000085
678, 9.426336855290224, 79.0202796461993, 94.78365427891507, 0.13855239999999994, 215.0, 853, 479009, 678, 69.54088939999929
679, 9.391189053466482, 79.08074197867708, 94.84808462605, 0.13700079999999992, 195.0, 871, 479880, 679, 71.58599350000077
680, 10.556165232760632, 79.5854904739945, 95.44054381610357, 0.13575519999999994, 50.0, 513, 480393, 680, 42.1312646999977
681, 9.573981601249129, 79.66302092809642, 95.54098262714342, 0.13482009999999994, 120.0, 526, 480919, 681, 43.03063570000086
682, 9.706608216611691, 79.75178042164555, 95.64694382231913, 0.13318029999999995, 470.0, 1296, 482215, 682, 106.10759250000046
683, 9.774255909853512, 79.82213170187813, 95.75189036414737, 0.13110669999999996, 485.0, 1008, 483223, 683, 83.03592920000301
684, 9.708582628174721, 79.79776245608686, 95.69035810747049, 0.1295848, 145.0, 683, 483906, 684, 61.38829800000167
685, 9.753928355548693, 79.83580092909914, 95.76835013442899, 0.12824559999999996, 155.0, 805, 484711, 685, 67.74858659999882
686, 9.253000145333207, 79.76627355731324, 95.67248892526965, 0.1269369999999999, 105.0, 649, 485360, 686, 53.78011310000147
687, 9.239037114972124, 79.78106178389316, 95.69203872599414, 0.12550779999999995, 260.0, 939, 486299, 687, 76.68237539999973
688, 9.011404803918193, 79.78490492620755, 95.69228973606343, 0.1240317999999999, 120.0, 701, 487000, 688, 57.25957560000097
689, 9.44774691074162, 79.8617536959045, 95.7902143838013, 0.12264669999999991, 215.0, 838, 487838, 689, 70.19611360000272
690, 9.431008484796129, 79.93827841553507, 95.88189568499473, 0.12103929999999997, 255.0, 948, 488786, 690, 80.47807009999815
691, 9.225685958309585, 79.90153498921272, 95.83572458143553, 0.11972799999999996, 120.0, 509, 489295, 691, 43.42864510000072
692, 9.369011502584083, 79.91269534266564, 95.85232467274297, 0.11817729999999994, 330.0, 1214, 490509, 692, 114.45723450000514
693, 9.192378588563846, 79.75425724663471, 95.66662510908033, 0.11646729999999991, 110.0, 686, 491195, 693, 58.27993250000145
694, 10.042652863558098, 79.86379628544965, 95.79155658499542, 0.11504709999999993, 385.0, 892, 492087, 694, 73.07499649999954
695, 8.641919219243507, 79.89462839844539, 95.8387712962408, 0.11368719999999988, 110.0, 619, 492706, 695, 50.69831690000137
696, 9.497092900700169, 79.88399474948972, 95.82785858451666, 0.11239119999999994, 180.0, 821, 493527, 696, 67.20466030000534
697, 9.902447088666502, 80.03030563337367, 95.98995745623553, 0.11085039999999995, 180.0, 891, 494418, 697, 75.125369399997
698, 9.257569777858631, 80.06096041897487, 96.03408978552027, 0.10924569999999996, 190.0, 892, 495310, 698, 73.550957499996
699, 9.42675098048801, 80.08504940497144, 96.05383080205891, 0.1074591999999999, 315.0, 1093, 496403, 699, 89.31291290000081
700, 9.691807385603292, 80.10456378043362, 96.08666578810454, 0.10550709999999994, 235.0, 1076, 497479, 700, 87.69085060000361
701, 8.913640383611689, 80.10074024496919, 96.09675567508361, 0.10384389999999992, 155.0, 772, 498251, 701, 63.377037900005234
702, 9.164406647329374, 80.10676048689359, 96.07966610348278, 0.10234629999999993, 180.0, 892, 499143, 702, 72.87212179999915
703, 9.78568227320361, 80.14891499712424, 96.13213695689944, 0.10080999999999991, 170.0, 815, 499958, 703, 67.24778569999762
704, 9.346922978167068, 80.96527195091569, 97.09714556715835, 0.10000195595667816, 345.0, 831, 500789, 704, 68.19105509999645
705, 9.69444022297714, 81.11100562742654, 97.29587577234378, 0.09999999999999952, 155.0, 821, 501610, 705, 68.48662039999908
706, 9.50472954824972, 81.12172754293482, 97.3057709892711, 0.09999999999999862, 460.0, 993, 502603, 706, 83.9102567000009
707, 9.782079351860434, 81.13922518258417, 97.33006819456922, 0.09999999999999812, 345.0, 1124, 503727, 707, 91.88338780000049
708, 9.919255635351591, 81.08670881700863, 97.2729039596299, 0.09999999999999949, 355.0, 826, 504553, 708, 67.93377419999888
709, 9.478701295773627, 81.17758317810396, 97.39908934254234, 0.10000000000000092, 80.0, 543, 505096, 709, 44.49495800000295
710, 9.66211715904442, 81.07657980968452, 97.25817591930873, 0.09999999999999876, 240.0, 962, 506058, 710, 78.7898478000061
711, 10.26920641096766, 81.13209450544711, 97.31509460631959, 0.09999999999999944, 180.0, 835, 506893, 711, 70.36865989999933
712, 9.911583544784932, 81.22822988579613, 97.42738937575164, 0.09999999999999934, 155.0, 851, 507744, 712, 69.83616690000053
713, 9.702768748065075, 81.32219179452184, 97.53764798267778, 0.09999999999999946, 210.0, 830, 508574, 713, 67.60381860000052
714, 9.627400407288086, 81.26437445948063, 97.48015466381146, 0.10000000000000067, 305.0, 673, 509247, 714, 55.758256499997515
715, 10.223574376019775, 81.2041576897507, 97.41179094233853, 0.09999999999999949, 355.0, 827, 510074, 715, 67.97935040000448
716, 10.1226786383622, 80.49461537642445, 96.55642691962153, 0.09999999999999945, 180.0, 834, 510908, 716, 69.152511399996
717, 10.2127701489906, 80.54836869544407, 96.63913370591007, 0.09999999999999928, 210.0, 861, 511769, 717, 71.94653620000463
718, 9.700284182643768, 80.63547788417293, 96.73525491047761, 0.0999999999999998, 120.0, 781, 512550, 718, 64.6612146999978
719, 10.396397377727036, 80.7113943276834, 96.82023466058533, 0.10000000000000042, 100.0, 701, 513251, 719, 59.368074300000444
720, 10.552100537437024, 80.68187500226615, 96.78818001133381, 0.0999999999999996, 185.0, 808, 514059, 720, 66.46183649999875
721, 10.201393957627882, 80.77516514239925, 96.88029555519029, 0.0999999999999996, 160.0, 808, 514867, 721, 68.36080780000339
722, 10.618030928057532, 80.86564852912556, 96.99328041531875, 0.09999999999999942, 215.0, 838, 515705, 722, 68.57498120000673
723, 10.082387522453779, 80.99466315450123, 97.14564337709402, 0.10000000000000082, 55.0, 454, 516159, 723, 37.25166639999952
724, 9.883084803484799, 80.87620628252161, 97.02445537171857, 0.09999999999999966, 105.0, 801, 516960, 724, 68.93813399999635
725, 9.687789407397803, 80.92956281451261, 97.05313412933782, 0.10000000000000038, 160.0, 706, 517666, 725, 58.53692900000169
726, 10.460436220826773, 80.90139755637928, 97.05319894450358, 0.10000000000000073, 120.0, 667, 518333, 726, 54.80459819999669
727, 9.913518304011973, 80.95022548203852, 97.0680991238048, 0.09999999999999945, 180.0, 833, 519166, 727, 67.7498431999993
728, 10.330455552713543, 80.91001562978707, 97.05914680630553, 0.09999999999999956, 130.0, 816, 519982, 728, 67.02405620000354
729, 10.464737440437771, 81.33749480580174, 97.56693089285562, 0.10000000000000053, 120.0, 688, 520670, 729, 56.29694079999899
730, 10.216244430361467, 81.40905540605749, 97.66045185417792, 0.0999999999999999, 110.0, 766, 521436, 730, 62.58562640000309
731, 10.195928956083169, 81.45841879029464, 97.71702852628829, 0.09999999999999933, 210.0, 854, 522290, 731, 70.02388240000437
732, 10.13859538747146, 81.47537009765264, 97.75283477018013, 0.10000000000000063, 110.0, 678, 522968, 732, 55.26390760000504
733, 10.297682417750115, 81.55236249251666, 97.85185209068408, 0.09999999999999867, 505.0, 982, 523950, 733, 80.33939999999711
734, 10.177077023506165, 81.49983767089844, 97.76377418212891, 0.10000000000000099, 110.0, 625, 524575, 734, 50.847743499994976
735, 9.80196493281129, 81.53659348616098, 97.82804124454414, 0.09999999999999955, 180.0, 818, 525393, 735, 67.34157009999763
736, 10.339445253797606, 81.6075543048335, 97.92077356226304, 0.10000000000000075, 65.0, 408, 525801, 736, 33.80974090000382
737, 10.37174811966448, 81.56669027489352, 97.83352445119834, 0.09999999999999946, 170.0, 830, 526631, 737, 67.6364407000001
738, 9.991084026449208, 81.5890385518689, 97.86301399843536, 0.09999999999999952, 185.0, 822, 527453, 738, 66.98805329999595
739, 9.60392543221965, 81.63887397303726, 97.94592977581603, 0.1000000000000008, 110.0, 660, 528113, 739, 54.100261200001114
740, 10.014657363351786, 81.74784530543681, 98.03951889134053, 0.0999999999999997, 210.0, 795, 528908, 740, 65.15703070000018
741, 9.860520335870195, 81.65214517282885, 97.98206692481226, 0.10000000000000095, 125.0, 645, 529553, 741, 53.0202344000063
742, 10.481663142545072, 81.86090042452403, 98.20014568973446, 0.10000000000000024, 110.0, 722, 530275, 742, 58.79771569999866
743, 11.128955779404476, 82.1274137074137, 98.53336338926418, 0.09999999999999959, 155.0, 812, 531087, 743, 66.41476699999475
744, 10.655406003420515, 82.1673391865369, 98.56464184455152, 0.10000000000000052, 105.0, 689, 531776, 744, 55.919735900002706
745, 11.072782320126217, 82.17214832608661, 98.57852689861815, 0.09999999999999953, 210.0, 819, 532595, 745, 66.4189303000021
746, 10.803111440879254, 82.28746774036178, 98.69830786154431, 0.09999999999999937, 210.0, 847, 533442, 746, 69.11495870000363
747, 10.740452123061353, 82.22752898041249, 98.6457628057488, 0.1000000000000004, 125.0, 703, 534145, 747, 57.805043399996066
748, 10.13145430146912, 82.23044215072821, 98.64372265662676, 0.0999999999999996, 210.0, 810, 534955, 748, 66.01465650000318
749, 10.780619481427088, 82.27305166291686, 98.70066009449593, 0.09999999999999935, 160.0, 849, 535804, 749, 69.16070469999977
750, 10.76218408339072, 82.32556865269294, 98.76723576615053, 0.09999999999999941, 210.0, 839, 536643, 750, 68.00253049999446
751, 10.798945931298881, 82.32750447286944, 98.77374103308864, 0.09999999999999944, 230.0, 836, 537479, 751, 67.92365620000055
752, 10.199112855706897, 82.32213777814593, 98.7407313319615, 0.10000000000000042, 110.0, 700, 538179, 752, 57.36596580000332
753, 9.888940093589552, 82.35948577880859, 98.79873056122752, 0.0999999999999995, 210.0, 825, 539004, 753, 68.34301640000194
754, 10.932915449735537, 82.40621401658699, 98.84287539050354, 0.10000000000000075, 75.0, 402, 539406, 754, 32.84389509999892
755, 10.222503826167383, 82.41988943891916, 98.87944859138474, 0.1000000000000009, 80.0, 513, 539919, 755, 42.0203790999949
756, 10.604647201368179, 81.60382961404734, 97.87929762917004, 0.10000000000000046, 105.0, 696, 540615, 756, 58.30119760000525
757, 10.431669129400838, 81.5124931724704, 97.7647310860303, 0.09999999999999977, 120.0, 784, 541399, 757, 64.48642820000532
758, 10.533682358009735, 81.46216442096488, 97.71887477676438, 0.10000000000000085, 185.0, 654, 542053, 758, 56.247326099997736
759, 9.834875457874675, 81.45348060235511, 97.6913671672568, 0.09999999999999967, 110.0, 799, 542852, 759, 65.02316070000234
760, 10.172220194010679, 81.5035614665873, 97.77457474855473, 0.09999999999999812, 545.0, 1123, 543975, 760, 91.42305779999879
761, 10.72037372813923, 81.58252217219426, 97.86615858243654, 0.09999999999999962, 160.0, 806, 544781, 761, 70.38177300000098
762, 10.18180502178628, 81.6204580452284, 97.91240156956329, 0.09999999999999958, 155.0, 814, 545595, 762, 72.07043610000255
763, 10.24039813661311, 81.58649969189092, 97.86182128567792, 0.10000000000000092, 65.0, 541, 546136, 763, 47.59416179999971
764, 11.05227524273264, 81.5625290293531, 97.82227519984531, 0.09999999999999934, 225.0, 851, 546987, 764, 75.00857810000161
765, 10.51782783621757, 81.64133181074251, 97.9339539841503, 0.09999999999999912, 180.0, 891, 547878, 765, 73.42943500000547
766, 10.760484887369902, 81.68562509862824, 97.97136613189197, 0.09999999999999933, 195.0, 854, 548732, 766, 70.35889469999529
767, 10.99327259907988, 81.721496541557, 98.01954256255051, 0.09999999999999999, 105.0, 754, 549486, 767, 61.93850220000604
768, 9.986249800523122, 81.70700444115533, 98.01516585879855, 0.10000000000000067, 75.0, 360, 549846, 768, 29.639807599996857
769, 10.790624441766795, 81.75655339649423, 98.06153692243221, 0.0999999999999994, 355.0, 843, 550689, 769, 72.24224420000246
770, 10.63838583782381, 81.78132487113605, 98.1105291223736, 0.1000000000000006, 115.0, 681, 551370, 770, 59.953583799993794
771, 10.591720411667279, 81.75449133731443, 98.0565987468636, 0.09999999999999952, 180.0, 822, 552192, 771, 72.38548849999643
772, 10.014834502786712, 81.74175417297234, 98.066016344389, 0.09999999999999884, 215.0, 946, 553138, 772, 82.99732409999706
773, 10.827912389186391, 81.78494392720081, 98.09162414283084, 0.09999999999999967, 385.0, 798, 553936, 773, 70.64048899999761
774, 10.781358407309027, 81.80079802524897, 98.12450222439236, 0.0999999999999996, 210.0, 810, 554746, 774, 71.39079889999994
775, 10.061260125026328, 81.86975896299766, 98.20827680503206, 0.09999999999999959, 355.0, 812, 555558, 775, 71.6358368000001
776, 11.34304159925417, 81.91586939819024, 98.27971557461088, 0.09999999999999978, 160.0, 782, 556340, 776, 69.46760599999834
777, 11.497633751009552, 82.00243811092466, 98.35515408224903, 0.10000000000000078, 75.0, 426, 556766, 777, 37.723873200004164
778, 11.183629922276177, 81.97860285594744, 98.35814614886604, 0.10000000000000078, 110.0, 662, 557428, 778, 58.60055850000208
779, 10.773614818125242, 81.99592390159194, 98.3583252778399, 0.09999999999999924, 180.0, 869, 558297, 779, 76.73455449999892
780, 10.094098756342758, 81.9234559172956, 98.27591592294199, 0.10000000000000087, 30.0, 486, 558783, 780, 42.950436900006025
781, 10.529867280816807, 81.94433534052077, 98.33715617339563, 0.100000000000001, 105.0, 639, 559422, 781, 56.584676200000104
782, 10.597096997001072, 81.84858027807634, 98.17792520840747, 0.09999999999999723, 290.0, 1471, 560893, 782, 130.0901651000022
783, 10.725669811926302, 81.73674140026813, 98.07396170290805, 0.09999999999999933, 210.0, 853, 561746, 783, 75.32587340000464
784, 10.342363507343489, 81.76843954652873, 98.09337477142667, 0.10000000000000096, 110.0, 643, 562389, 784, 56.887353899997834
785, 11.03083144004284, 81.78225605548685, 98.12116928185263, 0.09999999999999906, 210.0, 901, 563290, 785, 79.58140949999506
786, 10.24243305296171, 81.82595167583635, 98.16221951121757, 0.09999999999999945, 210.0, 833, 564123, 786, 73.5109558999975
787, 10.105943903678984, 81.820061751238, 98.16762703422486, 0.1000000000000009, 110.0, 508, 564631, 787, 44.756031499993696
788, 10.49478495933457, 81.82170449106815, 98.14859195033266, 0.09999999999999962, 180.0, 807, 565438, 788, 71.24536130000342
789, 10.430975814837785, 81.8647639864967, 98.21373212905158, 0.10000000000000069, 105.0, 672, 566110, 789, 59.54451870000048
790, 10.782828657598381, 81.79138544840986, 98.1576693982963, 0.09999999999999946, 145.0, 830, 566940, 790, 73.34013210000558
791, 10.30825939611416, 81.84130967552983, 98.19755510548454, 0.09999999999999963, 215.0, 804, 567744, 791, 70.94557660000282
792, 10.388246819916843, 81.8950959150342, 98.24231440088023, 0.09999999999999819, 320.0, 1104, 568848, 792, 97.29812690000108
793, 9.657656769598685, 81.91117610884068, 98.29156448705025, 0.10000000000000075, 105.0, 403, 569251, 793, 35.727115000001504
794, 11.017292133424686, 81.90660052200454, 98.24337488961149, 0.10000000000000066, 175.0, 674, 569925, 794, 59.33683429999655
795, 11.005089192413816, 82.07553689620075, 98.4510106011933, 0.09999999999999956, 135.0, 816, 570741, 795, 71.86878779999824
796, 10.469196999271297, 82.15848004347073, 98.56950487069429, 0.09999999999999876, 240.0, 962, 571703, 796, 84.5721143999981
797, 10.718618349122853, 82.19744218646056, 98.60936088997751, 0.09999999999999876, 260.0, 963, 572666, 797, 84.79863409999962
798, 11.182109125564633, 82.2220395294686, 98.64628639268935, 0.09999999999999967, 360.0, 799, 573465, 798, 70.36136879999685
799, 10.981666700813042, 82.21852364299966, 98.6361664382919, 0.09999999999999871, 225.0, 973, 574438, 799, 85.47541400000046
800, 10.876765232187367, 82.1989577518534, 98.62135169234136, 0.09999999999999999, 120.0, 754, 575192, 800, 66.3526720000009
801, 10.578046446996378, 82.20512512784195, 98.62894153820426, 0.09999999999999937, 215.0, 846, 576038, 801, 74.58560600000055
802, 10.83390275482646, 82.2169369908864, 98.63464304073128, 0.10000000000000071, 110.0, 668, 576706, 802, 58.76578009999503
803, 10.88741423206955, 82.25729005595876, 98.70255755661125, 0.09999999999999724, 390.0, 1463, 578169, 803, 128.74502799999755
804, 10.90704629243898, 82.32092897669624, 98.76197967168994, 0.09999999999999937, 195.0, 847, 579016, 804, 74.65568329999951
805, 10.598712524135806, 82.42136529172294, 98.89068485838588, 0.09999999999999981, 135.0, 778, 579794, 805, 68.43440640000335
806, 10.58539331791981, 81.87820681482033, 98.25022237153769, 0.0999999999999993, 230.0, 859, 580653, 806, 75.43807050000032
807, 10.848513797849934, 81.8102046881361, 98.16805762392711, 0.09999999999999962, 380.0, 806, 581459, 807, 70.69750080000085
808, 10.629642427575831, 81.85416622551121, 98.1859849813033, 0.10000000000000073, 105.0, 392, 581851, 808, 34.78048580000177
809, 10.485230057274254, 81.77737305465254, 98.11018960452775, 0.0999999999999995, 165.0, 824, 582675, 809, 72.37711489999492
810, 10.283932847615956, 81.82085894861966, 98.18396793302351, 0.10000000000000078, 110.0, 423, 583098, 810, 37.83733499999653
811, 11.079916137926684, 81.86051777430943, 98.21598625183105, 0.09999999999999959, 245.0, 812, 583910, 811, 71.35712739999872
812, 11.210405555066712, 81.88447156958624, 98.25932195645953, 0.09999999999999921, 175.0, 872, 584782, 812, 76.62157300000399
813, 11.382759730379952, 81.89020970605029, 98.24536379088667, 0.10000000000000081, 75.0, 443, 585225, 813, 39.025069399998756
814, 10.248392207016254, 81.92565038386448, 98.32408355141578, 0.10000000000000099, 170.0, 641, 585866, 814, 56.39458420000301
815, 12.039442000133452, 81.90710013507407, 98.27045844373725, 0.1000000000000008, 75.0, 429, 586295, 815, 37.76291610000044
816, 10.813476200640713, 81.92741537852854, 98.28952506356023, 0.09999999999999955, 220.0, 817, 587112, 816, 72.01244869999937
817, 10.036494607636422, 81.95856305902655, 98.33738855304141, 0.1000000000000008, 110.0, 660, 587772, 817, 58.01837620000151
818, 11.14720521126903, 81.96085452433653, 98.34969580548365, 0.10000000000000099, 55.0, 636, 588408, 818, 55.7065389000054
819, 10.529360482330722, 81.93395887444781, 98.30543744152129, 0.0999999999999988, 225.0, 955, 589363, 819, 83.84574859999702
820, 10.21954112205811, 81.85374934592085, 98.22166467334083, 0.0999999999999986, 285.0, 998, 590361, 820, 87.4861871999965
821, 10.433850446936802, 81.73109086994623, 98.06646172098932, 0.0999999999999991, 210.0, 894, 591255, 821, 78.36475600000267
822, 10.42387774974406, 81.75655281002288, 98.11126671982693, 0.09999999999999762, 265.0, 1299, 592554, 822, 114.3051040000064
823, 11.20308167155565, 81.77617734915782, 98.11912510621983, 0.09999999999999934, 125.0, 851, 593405, 823, 69.98555009999836
824, 10.5159611567449, 81.77121034021043, 98.10463094154684, 0.1000000000000009, 55.0, 514, 593919, 824, 40.99961619999522
825, 10.17118500500882, 81.77120855560484, 98.09426548761647, 0.0999999999999994, 210.0, 841, 594760, 825, 67.1860885999995
826, 9.428302554996467, 81.76167492076664, 98.09568156610969, 0.09999999999999956, 200.0, 815, 595575, 826, 64.7517061000035
827, 10.21849671266973, 81.76351162195206, 98.12022012472153, 0.100000000000001, 120.0, 640, 596215, 827, 51.02782049999951
828, 10.26872731420988, 81.8044881004576, 98.15753111337975, 0.09999999999999955, 210.0, 818, 597033, 828, 65.38308220000181
829, 10.081871284994968, 81.83601181562557, 98.19646943558094, 0.09999999999999928, 210.0, 860, 597893, 829, 68.93409310000425
830, 10.06020639580982, 81.85732991011346, 98.24554470836186, 0.09999999999999945, 135.0, 833, 598726, 830, 66.3408094999977
831, 10.280670030603131, 81.86045831053333, 98.23712765591816, 0.10000000000000024, 110.0, 721, 599447, 831, 57.7832963999972
832, 9.413893331327369, 81.73391835168187, 98.07374890489133, 0.09999999999999958, 185.0, 814, 600261, 832, 64.78083000000333
833, 10.905333418904998, 81.38538209891614, 97.64204022913803, 0.10000000000000092, 150.0, 648, 600909, 833, 51.655475799998385
834, 10.226557277311567, 81.41831999558669, 97.71274526086867, 0.09999999999999916, 215.0, 884, 601793, 834, 70.4241148000001
835, 10.114617678902366, 81.41440748041326, 97.67586264870384, 0.0999999999999982, 310.0, 1100, 602893, 835, 87.54764479999722
836, 10.035195766493331, 81.30961011546526, 97.564599609375, 0.10000000000000095, 160.0, 645, 603538, 836, 51.85434379999788
837, 10.182160230821877, 81.39723994172452, 97.6743482007411, 0.09999999999999791, 310.0, 1189, 604727, 837, 94.60657369999535
838, 9.37955141809664, 81.3995513223334, 97.64464559196344, 0.09999999999999987, 140.0, 771, 605498, 838, 61.39695539999957
839, 9.965706349914914, 81.42193926113612, 97.6994287450161, 0.09999999999999969, 165.0, 797, 606295, 839, 63.40384880000056
840, 10.208182602389458, 81.36938746867736, 97.62836470340659, 0.10000000000000088, 120.0, 652, 606947, 840, 52.07550110000011
841, 9.35398956532535, 81.37803045280366, 97.6392546340882, 0.1000000000000009, 105.0, 506, 607453, 841, 40.465672799997265
842, 9.258104202797615, 81.41125388317798, 97.68130997577346, 0.10000000000000075, 110.0, 664, 608117, 842, 53.069418300001416
843, 10.323101278801007, 81.42501173465449, 97.70507371558378, 0.09999999999999908, 445.0, 898, 609015, 843, 72.07845559999987
844, 9.383981449127198, 81.468404296875, 97.76356892903645, 0.1000000000000007, 30.0, 375, 609390, 844, 29.957815599998867
845, 9.35351004774553, 81.395247677991, 97.69310838462663, 0.10000000000000056, 155.0, 685, 610075, 845, 54.82306519999838
846, 9.88865141719944, 80.95751295579383, 97.16190632864432, 0.09999999999999955, 180.0, 818, 610893, 846, 65.49507380000432
847, 10.143650433226446, 80.91302677135371, 97.09351986257275, 0.09999999999999969, 180.0, 796, 611689, 847, 63.84872220000398
848, 8.753594029247761, 80.94468727111817, 97.14011401176452, 0.09999999999999966, 355.0, 800, 612489, 848, 63.97000349999871
849, 9.637082740826452, 80.96644973754883, 97.18648746739264, 0.10000000000000013, 105.0, 736, 613225, 849, 58.87395619999734
850, 10.491850025259177, 81.00363064028508, 97.23453836592417, 0.09999999999999916, 180.0, 882, 614107, 850, 70.58153260000108
851, 9.55084349133863, 80.99727540442534, 97.22342056164639, 0.09999999999999871, 260.0, 973, 615080, 851, 77.63165760000265
852, 9.586208911557351, 81.03853517593876, 97.24096802742251, 0.09999999999999984, 150.0, 775, 615855, 852, 61.95037449999654
853, 8.976933661047543, 81.00787331233515, 97.21659761945779, 0.09999999999999931, 180.0, 856, 616711, 853, 68.48994249999669
854, 9.857807918339018, 81.04971164047339, 97.24919808746144, 0.10000000000000099, 110.0, 628, 617339, 854, 50.211894899999606
855, 9.270498711412603, 80.99154572457978, 97.19276603929924, 0.0999999999999995, 210.0, 825, 618164, 855, 65.98368430000119
856, 9.73931706144442, 81.02554647720868, 97.2381957419476, 0.09999999999999963, 225.0, 804, 618968, 856, 64.29288339999766
857, 9.265482832457273, 81.03710395871228, 97.22833072574994, 0.10000000000000085, 105.0, 655, 619623, 857, 52.328790200001094
858, 9.636392215957418, 80.4269406235009, 96.50370737711589, 0.09999999999999931, 210.0, 855, 620478, 858, 68.39241680000123
859, 9.492807123855668, 79.93832652033592, 95.92151419191944, 0.09999999999999869, 240.0, 980, 621458, 859, 78.12340350000159
860, 9.898058748407612, 79.9430115404248, 95.93058300559557, 0.09999999999999917, 210.0, 881, 622339, 860, 70.45736420000321
861, 9.468118855275808, 79.94520699218504, 95.94667552334715, 0.09999999999999865, 265.0, 989, 623328, 861, 78.8948251000038
862, 9.053578507631345, 79.92442340133782, 95.91290485697581, 0.09999999999999755, 325.0, 1330, 624658, 862, 106.21102950000204
863, 9.493732841940545, 79.95117754793806, 95.9510609619895, 0.09999999999999871, 260.0, 971, 625629, 863, 77.49690469999769
864, 8.211653733833808, 79.88330899097373, 95.86698395146801, 0.09999999999999866, 260.0, 986, 626615, 864, 78.87384290000045
865, 9.589415452710472, 79.96027175978858, 95.9645917155955, 0.0999999999999996, 355.0, 808, 627423, 865, 64.78010150000046
866, 9.33373878783775, 79.92563038951945, 95.95512030259619, 0.09999999999999935, 210.0, 848, 628271, 866, 67.62358819999645
867, 10.187651573964791, 79.93469131824583, 95.9504220178885, 0.10000000000000095, 120.0, 645, 628916, 867, 51.82319510000525
868, 9.791317346778582, 79.99289682735554, 96.01587356426471, 0.09999999999999715, 240.0, 1516, 630432, 868, 120.875386599997
869, 8.738259651022165, 80.1102454640041, 96.14773990951966, 0.10000000000000098, 120.0, 642, 631074, 869, 51.273033500001475
870, 9.316067594493234, 80.16163354577066, 96.23314004119217, 0.09999999999999973, 135.0, 791, 631865, 870, 63.3896603999965
871, 9.186139645237178, 80.24473938220945, 96.32619468562939, 0.09999999999999976, 135.0, 787, 632652, 871, 62.889844899997115
872, 9.11439247448426, 80.20281690709731, 96.28514227903712, 0.09999999999999978, 155.0, 782, 633434, 872, 62.417632999997295
873, 8.809468687749376, 80.24173892713061, 96.33372844434253, 0.09999999999999956, 155.0, 816, 634250, 873, 65.29617520000465
874, 8.981319248602073, 80.25765018296865, 96.33234419769249, 0.09999999999999964, 210.0, 803, 635053, 874, 64.37733050000679
875, 8.5756788694142, 80.28897563329811, 96.35924745987022, 0.09999999999999899, 120.0, 915, 635968, 875, 73.21833949999564
876, 8.717571035729653, 80.3261055272287, 96.39388183274194, 0.10000000000000071, 45.0, 382, 636350, 876, 30.602959299998474
877, 8.87434806816687, 80.26123756848199, 96.3239630244155, 0.10000000000000063, 135.0, 677, 637027, 877, 54.10203220000403
878, 8.923910121593613, 80.24125859175112, 96.3463465084622, 0.09999999999999871, 380.0, 971, 637998, 878, 78.13834260000294
879, 8.613842680262422, 80.29604059855143, 96.40552308532013, 0.09999999999999923, 210.0, 870, 638868, 879, 69.62485960000049
880, 9.341857454727187, 80.30106422986786, 96.40559069916522, 0.10000000000000091, 55.0, 529, 639397, 880, 42.15869279999606
881, 8.475430327118735, 80.29195516249713, 96.37158433424061, 0.10000000000000094, 110.0, 646, 640043, 881, 51.613197900005616
882, 8.853723443806443, 79.98744114566611, 95.98886505545002, 0.10000000000000082, 110.0, 657, 640700, 882, 52.47166210000432
883, 8.803602014375718, 80.00574152520362, 96.047891781536, 0.09999999999999967, 135.0, 799, 641499, 883, 63.90911240000423
884, 10.253395706302715, 80.04921224342202, 96.06488404663854, 0.0999999999999997, 135.0, 795, 642294, 884, 63.880427700001746
885, 8.548014839977819, 80.03855824226738, 96.06812987688373, 0.09999999999999869, 425.0, 978, 643272, 885, 78.19536890000018
886, 8.494109589663733, 80.04079845259614, 96.09939094136831, 0.09999999999999817, 320.0, 1107, 644379, 886, 88.30182610000338
887, 8.760424954381156, 80.0865832845963, 96.14464679167638, 0.09999999999999963, 155.0, 804, 645183, 887, 65.05685479999374
888, 8.73155781564444, 80.01101912551312, 96.05686180814627, 0.0999999999999982, 260.0, 1101, 646284, 888, 86.93437209999684
889, 8.58467301928011, 80.01472514446516, 96.05449226780942, 0.10000000000000074, 110.0, 665, 646949, 889, 53.0987277000022
890, 8.055942975312659, 79.99415362855923, 96.01832970433266, 0.10000000000000099, 110.0, 636, 647585, 890, 50.88289149999764
891, 9.177199808844165, 80.02176140803917, 96.06175384334489, 0.09999999999999956, 150.0, 816, 648401, 891, 65.36591079999926
892, 8.432531293424859, 79.99567190644704, 96.00943970075113, 0.09999999999999974, 140.0, 788, 649189, 892, 63.11836699999549
893, 8.939613981885946, 79.97150462617162, 95.99656757301688, 0.09999999999999973, 140.0, 791, 649980, 893, 63.38888769999903
894, 8.575285444881391, 79.14289440021868, 95.00838972557742, 0.0999999999999987, 440.0, 974, 650954, 894, 77.91250350000337
895, 8.00264507708726, 79.05601731053105, 94.88738622312192, 0.09999999999999827, 290.0, 1080, 652034, 895, 86.24859670000296
896, 9.289038539390125, 79.04351260290122, 94.86969173655791, 0.09999999999999978, 365.0, 782, 652816, 896, 62.7378624999983
897, 8.38479440813666, 79.05569865061595, 94.88463729995865, 0.0999999999999986, 240.0, 999, 653815, 897, 80.23125730000174
898, 8.260286083243184, 79.03878833766402, 94.87945091221461, 0.09999999999999919, 210.0, 877, 654692, 898, 70.06293880000158
899, 8.86490887287751, 79.12308309199098, 94.9801956555347, 0.09999999999999663, 305.0, 1854, 656546, 899, 148.0933256999997
900, 8.667810547068006, 79.09995851970854, 94.95520409175327, 0.09999999999999941, 410.0, 840, 657386, 900, 67.12371480000002
901, 8.726541629983767, 79.14602148453712, 95.00536926999035, 0.09999999999999999, 110.0, 753, 658139, 901, 60.25559760000033
902, 8.628294833516794, 79.15327314215699, 94.99934405193817, 0.1000000000000009, 135.0, 509, 658648, 902, 40.94939790000353
903, 11.750335858506459, 79.16954950925683, 95.02099223783752, 0.09999999999999945, 165.0, 833, 659481, 903, 66.66555339999468
904, 11.336448920873734, 78.95306259571963, 94.6675157187354, 0.09999999999999988, 135.0, 769, 660250, 904, 61.437616099996376
905, 9.85800856870932, 78.34661478036875, 94.03289231308946, 0.10000000000000074, 150.0, 666, 660916, 905, 53.42765949999739
906, 9.88720895725138, 78.39034457936006, 94.08959407133214, 0.09999999999999935, 360.0, 850, 661766, 906, 67.84413510000013
907, 10.51684491444325, 78.41951679837877, 94.10762552823421, 0.10000000000000077, 80.0, 414, 662180, 907, 33.216252500002156
908, 9.134408138630803, 78.4297873363022, 94.13807548964319, 0.09999999999999873, 290.0, 968, 663148, 908, 77.29541039999458
909, 10.152142149548592, 78.4017483125722, 94.09650939168544, 0.09999999999999726, 350.0, 1461, 664609, 909, 116.74318109999876
910, 9.137925843231747, 78.37909485259982, 94.06499259474107, 0.09999999999999828, 260.0, 1077, 665686, 910, 86.09907500000554
911, 9.014280225824102, 78.37095134635491, 94.02483619889173, 0.10000000000000088, 120.0, 651, 666337, 911, 52.16962300000159
912, 9.595565655163357, 78.39884813581195, 94.07765076555525, 0.0999999999999992, 215.0, 875, 667212, 912, 70.04784249999648
913, 9.338387872772964, 78.36596157676296, 94.04203504097798, 0.09999999999999955, 325.0, 817, 668029, 913, 65.30451469999389
914, 9.111779998252347, 78.34973816355323, 94.04904245267248, 0.10000000000000099, 110.0, 628, 668657, 914, 50.4798568000042
915, 9.454994893678583, 78.42012186549167, 94.12003793126996, 0.0999999999999977, 345.0, 1262, 669919, 915, 101.05802790000598
916, 9.19904492859635, 78.53241715134617, 94.2293209641744, 0.10000000000000077, 75.0, 418, 670337, 916, 33.581506000002264
917, 10.771676167002264, 78.563547468571, 94.31748522324061, 0.1000000000000007, 75.0, 371, 670708, 917, 29.778698299996904
918, 9.345856408501385, 78.5747282525871, 94.31353473068027, 0.09999999999999966, 180.0, 801, 671509, 918, 64.0201642999964
919, 9.596111721855834, 78.5854581834838, 94.29900907518432, 0.09999999999999869, 290.0, 977, 672486, 919, 78.18990060000215
920, 9.397264866121844, 78.55200793696385, 94.28873959709617, 0.09999999999999956, 355.0, 816, 673302, 920, 65.23254910000105
921, 9.83768489827459, 78.61456446578633, 94.34440877271635, 0.09999999999999727, 375.0, 1451, 674753, 921, 116.40588260000368
922, 8.851934091657656, 78.63634934384599, 94.3687550688741, 0.10000000000000066, 75.0, 351, 675104, 922, 28.185885099999723
923, 10.068936554143127, 78.66269900899538, 94.4239634124326, 0.10000000000000066, 75.0, 355, 675459, 923, 28.48411119999946
924, 10.357341308645742, 78.67004857999142, 94.43387444516951, 0.10000000000000098, 105.0, 642, 676101, 924, 51.626372300001094
925, 9.88035308431292, 78.63744992939355, 94.39046139032166, 0.09999999999999823, 230.0, 1093, 677194, 925, 87.86437599999772
926, 9.939619429894952, 78.60630892896788, 94.35772404116882, 0.09999999999999735, 365.0, 1412, 678606, 926, 113.18020719999913
927, 9.754493035366723, 78.55955746601636, 94.28220514850305, 0.09999999999999969, 110.0, 797, 679403, 927, 63.824550700002874
928, 9.548409098193568, 78.56993112186281, 94.2978449039528, 0.09999999999999945, 180.0, 833, 680236, 928, 66.59556599999632
929, 10.099958756886997, 78.41534711788862, 94.11523128411709, 0.0999999999999987, 460.0, 975, 681211, 929, 78.1012492000009
930, 9.372619159557416, 78.3707733076998, 94.06975617258986, 0.09999999999999865, 460.0, 987, 682198, 930, 79.1178607000038
931, 9.49359085902174, 78.3313188274146, 94.0127704819094, 0.09999999999999976, 145.0, 787, 682985, 931, 63.075472999997146
932, 9.013586886743507, 78.40789314307789, 94.08648928085177, 0.0999999999999996, 135.0, 808, 683793, 932, 68.28434070000367
933, 10.232462434384324, 78.44162145529747, 94.15549792490718, 0.09999999999999791, 255.0, 1191, 684984, 933, 95.3315447000059
934, 9.747579321626235, 78.36012060919103, 94.04667896216574, 0.09999999999999788, 425.0, 1197, 686181, 934, 95.8484638000009
935, 9.410713817785664, 78.3851990124553, 94.08540874941373, 0.09999999999999913, 180.0, 887, 687068, 935, 71.8406984999965
936, 9.906758336737605, 78.47745081457761, 94.1872913813827, 0.0999999999999996, 160.0, 808, 687876, 936, 65.07450330000574
937, 10.526061124481231, 78.46453315624292, 94.19108026677912, 0.09999999999999995, 135.0, 759, 688635, 937, 60.94278209999902
938, 9.503444750807178, 78.41835202269293, 94.10388540391305, 0.09999999999999963, 155.0, 804, 689439, 938, 64.44391069999983
939, 9.465265405120666, 78.44876734211586, 94.18032625054471, 0.10000000000000099, 75.0, 623, 690062, 939, 50.001010300002235
940, 10.35420258312617, 78.58804211608984, 94.29649460296872, 0.10000000000000099, 120.0, 633, 690695, 940, 50.83042269999714
941, 9.40496549767723, 78.64310783331864, 94.38609812321968, 0.0999999999999994, 210.0, 842, 691537, 941, 67.31453599999804
942, 10.042033655589082, 78.66548182383305, 94.39586070634309, 0.09999999999999945, 160.0, 833, 692370, 942, 66.79772340000636
943, 9.928667554910156, 78.56345044911897, 94.28559105728169, 0.09999999999999978, 135.0, 783, 693153, 943, 62.7540544999938
944, 9.816516882254302, 78.60988282279735, 94.32383355918837, 0.10000000000000088, 120.0, 652, 693805, 944, 52.36885140000231
945, 9.799769716133683, 78.649534663561, 94.39309424550507, 0.0999999999999986, 225.0, 997, 694802, 945, 79.63133499999822
946, 9.949707909853217, 78.64344238836956, 94.37524294817031, 0.10000000000000081, 105.0, 659, 695461, 946, 52.86481030000141
947, 10.638182957866904, 78.64496202697369, 94.40461164284474, 0.09999999999999971, 155.0, 793, 696254, 947, 63.49824269999954
948, 9.941151629959311, 78.64940509617885, 94.40768464703426, 0.09999999999999931, 215.0, 856, 697110, 948, 68.74074239999754
949, 10.06401686837354, 78.66676445908433, 94.41230266901452, 0.10000000000000099, 125.0, 635, 697745, 949, 50.94687910000357
950, 10.341434070655891, 78.6794852408561, 94.43188727057135, 0.0999999999999986, 240.0, 999, 698744, 950, 81.51198210000439
951, 10.124585973142384, 78.68306237412772, 94.43263719026186, 0.09999999999999908, 180.0, 899, 699643, 951, 72.02887190000183
952, 10.094717698332705, 77.95424884210819, 93.54583889592892, 0.09999999999999809, 530.0, 1134, 700777, 952, 90.8555084000036
953, 10.143684381468695, 77.60900676916845, 93.12418758202784, 0.09999999999999765, 260.0, 1288, 702065, 953, 103.50099259999843
954, 10.642463567711058, 77.72342190288362, 93.26125552540734, 0.10000000000000069, 105.0, 672, 702737, 954, 53.891095900005894
955, 10.43517491055019, 77.69156887809638, 93.21109172414403, 0.09999999999999974, 170.0, 788, 703525, 955, 63.4955895000021
956, 10.470104911765764, 77.68734495225421, 93.2240676111178, 0.10000000000000074, 35.0, 397, 703922, 956, 31.868602700000338
957, 9.941036182709716, 77.69816025820646, 93.21232678673483, 0.1000000000000004, 120.0, 704, 704626, 957, 56.50159530000383
958, 10.434920096157954, 77.71950735696932, 93.23383829343952, 0.10000000000000045, 110.0, 697, 705323, 958, 55.97351389999676
959, 9.867496764993547, 77.66767324200113, 93.17652066063334, 0.10000000000000073, 50.0, 393, 705716, 959, 31.65968490000523
960, 9.155829453286325, 77.68297322591145, 93.1884217589866, 0.10000000000000073, 35.0, 393, 706109, 960, 31.548537900001975
961, 9.708229998586848, 77.63835809644235, 93.15468628258718, 0.09999999999999816, 355.0, 1113, 707222, 961, 89.1825020000033
962, 10.137942767005436, 77.66437441434475, 93.19410285729204, 0.09999999999999926, 125.0, 865, 708087, 962, 69.52255539999896
963, 9.730144200844395, 77.6802049108618, 93.19125047067088, 0.09999999999999927, 180.0, 863, 708950, 963, 69.15846469999815
964, 9.582215573320436, 77.75522013525269, 93.32631917215473, 0.10000000000000074, 30.0, 398, 709348, 964, 31.913474800006952
965, 10.055520803149383, 77.69565959968189, 93.22155299422765, 0.10000000000000088, 60.0, 505, 709853, 965, 40.51919999999518
966, 9.627128238358148, 77.2614775556859, 92.75231747510956, 0.09999999999999866, 285.0, 984, 710837, 966, 78.80329379999603
967, 9.504291679441314, 77.16338685615776, 92.61452586380477, 0.09999999999999983, 135.0, 776, 711613, 967, 62.169608600001084
968, 8.863623233055801, 77.21846502068337, 92.67749391191461, 0.09999999999999912, 215.0, 890, 712503, 968, 71.24878519999766
969, 9.330587352620823, 77.12913895718879, 92.57782277581413, 0.10000000000000028, 105.0, 716, 713219, 969, 57.39903119999508
970, 9.472545038723776, 77.16882856569846, 92.62995735830253, 0.09999999999999666, 225.0, 1833, 715052, 970, 146.2066932000016
971, 10.154637582388967, 77.08639119414666, 92.53279542343819, 0.09999999999999865, 460.0, 988, 716040, 971, 78.95639220000157
972, 9.395246068781072, 77.08298904418945, 92.5131527709961, 0.10000000000000094, 50.0, 550, 716590, 972, 43.91764730000432
973, 10.377529592404354, 77.09377523426859, 92.53734719782129, 0.09999999999999949, 120.0, 826, 717416, 973, 66.05944140000065
974, 9.399060829966245, 77.12833107162812, 92.57045053241248, 0.0999999999999986, 285.0, 998, 718414, 974, 79.64314119999472
975, 9.576132805518414, 77.05582482689589, 92.48618596236898, 0.09999999999999674, 330.0, 1771, 720185, 975, 141.5223868999965
976, 9.520061828611842, 76.39691762794736, 91.70208879473702, 0.10000000000000077, 110.0, 663, 720848, 976, 53.28440060000139
977, 8.875797209910827, 76.39084749882764, 91.69661263192054, 0.0999999999999996, 180.0, 808, 721656, 977, 64.63770180000574
978, 9.395061026317904, 76.40100150830818, 91.7124338477549, 0.09999999999999863, 260.0, 990, 722646, 978, 79.25238089999766
979, 8.96532264608254, 76.42332714602709, 91.73574257704031, 0.09999999999999734, 565.0, 1418, 724064, 979, 113.50349070000084
980, 9.520412047551229, 76.37300998981182, 91.68049282660851, 0.10000000000000091, 60.0, 520, 724584, 980, 41.664384299998346
981, 9.134478173133457, 76.36238368785975, 91.66049695206301, 0.10000000000000099, 75.0, 623, 725207, 981, 50.02040660000057
982, 9.292249351031039, 76.41054608286845, 91.70666360312681, 0.09999999999999874, 180.0, 967, 726174, 982, 77.36721740000212
983, 9.473477513320328, 76.40280944856376, 91.70376636758368, 0.09999999999999883, 265.0, 949, 727123, 983, 76.150736399999
984, 8.800585308738151, 76.39769713454406, 91.668945573334, 0.09999999999999765, 300.0, 1287, 728410, 984, 103.00653159999638
985, 8.99289555039139, 76.38418508562148, 91.6879888010141, 0.10000000000000077, 80.0, 411, 728821, 985, 33.05225470000005
986, 8.833635312172062, 76.44239655077666, 91.76420443893737, 0.09999999999999933, 185.0, 853, 729674, 986, 68.24893400000292
987, 8.946526971317473, 76.34247404734293, 91.62765066964286, 0.09999999999999941, 210.0, 840, 730514, 987, 67.82357110000157
988, 8.695905596624591, 76.22750342820218, 91.49260618472528, 0.09999999999999944, 180.0, 835, 731349, 988, 66.98494850000134
989, 9.073516465723515, 76.20207200050353, 91.47844866514205, 0.100000000000001, 105.0, 640, 731989, 989, 51.48027650000586
990, 9.268048955856242, 76.29422068373066, 91.59377566899094, 0.10000000000000003, 105.0, 749, 732738, 990, 60.39566580000246
991, 8.717057033240867, 76.2666008814684, 91.56280080429464, 0.09999999999999948, 210.0, 829, 733567, 991, 66.5635867000019
992, 8.358288084356614, 76.26298867300555, 91.52556728170737, 0.09999999999999933, 180.0, 853, 734420, 992, 68.31578050000098
993, 9.093480915163529, 76.33178462769462, 91.61642519869326, 0.10000000000000092, 80.0, 538, 734958, 993, 43.20260229999985
994, 9.284428321346377, 76.28355182337677, 91.57027997128112, 0.09999999999999735, 545.0, 1415, 736373, 994, 113.16793959999632
995, 9.141425786695667, 76.25878790017529, 91.53247432118839, 0.09999999999999921, 180.0, 873, 737246, 995, 69.85655260000203
996, 9.547207833340595, 76.26350470771284, 91.51952116928376, 0.09999999999999946, 210.0, 831, 738077, 996, 66.4650363000037
997, 8.968668576607035, 76.22657112247688, 91.50520907157708, 0.09999999999999873, 240.0, 968, 739045, 997, 77.47082129999762
998, 8.919146073265361, 76.20084962571691, 91.45813603953437, 0.09999999999999964, 155.0, 803, 739848, 998, 64.18505659999937
999, 8.384320890152214, 75.18930593483796, 90.25616370710266, 0.0999999999999994, 210.0, 841, 740689, 999, 67.27832100000523
1000, 9.425621749511059, 74.98792266087314, 90.03246241393194, 0.09999999999999856, 465.0, 1006, 741695, 1000, 80.42509209999844
1001, 8.862366841060375, 74.96399292310909, 89.99894533082649, 0.09999999999999712, 645.0, 1532, 743227, 1001, 122.89099389999319
1002, 8.849678183472479, 74.97718346441873, 90.01294253543634, 0.09999999999999935, 210.0, 849, 744076, 1002, 68.26451890000317
1003, 28.4034424870392, 75.49650976045535, 90.3543718265054, 0.10000000000000069, 15.0, 366, 744442, 1003, 29.32758979999926
1004, 31.370775156108078, 75.51010628094427, 90.32726236824568, 0.10000000000000081, 125.0, 658, 745100, 1004, 52.792061499996635
1005, 30.186490175265916, 75.49658837659496, 90.24167483250858, 0.10000000000000031, 160.0, 713, 745813, 1005, 57.17258339999535
1006, 30.004078908197222, 75.49684975039382, 90.24248855757453, 0.10000000000000099, 85.0, 641, 746454, 1006, 51.54436459999852
1007, 29.62453460779743, 75.50955330116162, 90.32422626191291, 0.09999999999999819, 225.0, 1104, 747558, 1007, 88.4754338000057
1008, 28.822095385699317, 75.49432843036632, 90.2872269756464, 0.09999999999999877, 185.0, 961, 748519, 1008, 77.01076499999908
1009, 29.01638767727462, 75.51842451587166, 90.30847011972538, 0.099999999999998, 220.0, 1164, 749683, 1009, 93.06803539999964
1010, 15.616973379416446, 74.26002207161493, 89.00773837676108, 0.09999999999999878, 210.0, 956, 750639, 1010, 76.53904959999636
1011, 9.036118088643763, 73.6954045452649, 88.46954964746402, 0.09999999999999973, 155.0, 790, 751429, 1011, 63.33503409999685
1012, 8.746143621093822, 73.7267200182069, 88.50399739487366, 0.10000000000000099, 120.0, 636, 752065, 1012, 50.94151769999735
1013, 9.0617336920576, 73.73838481281865, 88.53136500230889, 0.09999999999999948, 145.0, 829, 752894, 1013, 66.50492520000262
1014, 8.582148097039479, 73.74125309280937, 88.51107484071993, 0.10000000000000074, 20.0, 394, 753288, 1014, 31.690707100002328
1015, 8.71821848656794, 73.74024668606845, 88.51528389285309, 0.09999999999999971, 155.0, 792, 754080, 1015, 63.54113650000363
1016, 8.76171367353831, 73.72309104205627, 88.5055025826103, 0.09999999999999952, 155.0, 823, 754903, 1016, 66.02882110000064
1017, 8.566897913102359, 73.72084980654911, 88.49007535674659, 0.0999999999999993, 215.0, 859, 755762, 1017, 69.0202863999948
1018, 8.91211109232276, 73.73636664130711, 88.51263838223237, 0.10000000000000023, 105.0, 723, 756485, 1018, 57.85656259999814
1019, 9.20440454525177, 73.74498897128635, 88.5661287018747, 0.10000000000000074, 95.0, 396, 756881, 1019, 31.957499000003736
1020, 8.815580160268851, 73.69748058061025, 88.46760525298734, 0.09999999999999958, 180.0, 813, 757694, 1020, 65.13679219999904
1021, 8.874266523365922, 73.70328276531659, 88.49600079209901, 0.0999999999999996, 195.0, 809, 758503, 1021, 64.83876980000059
1022, 8.387146559254877, 73.68274957782423, 88.43318573285046, 0.100000000000001, 75.0, 638, 759141, 1022, 51.218704799997795
1023, 8.434790970905718, 73.66821349729975, 88.436012176146, 0.09999999999999946, 180.0, 830, 759971, 1023, 66.32341989999986
1024, 9.01202209300256, 74.37384208339871, 89.2670885302244, 0.10000000000000045, 310.0, 697, 760668, 1024, 55.949514400002954
1025, 8.96903670765729, 74.40133270616987, 89.3431912876245, 0.1000000000000005, 120.0, 691, 761359, 1025, 55.32811770000262
1026, 9.223426349498899, 74.40201153246885, 89.34005286124757, 0.09999999999999974, 105.0, 788, 762147, 1026, 63.10780320000049
1027, 8.376493890508474, 74.35147035722252, 89.25007936765822, 0.10000000000000094, 75.0, 556, 762703, 1027, 44.66475979999814
1028, 8.050206294155572, 74.34278367315342, 89.26023822360568, 0.09999999999999937, 160.0, 846, 763549, 1028, 67.97295470000245
1029, 7.977318747368084, 74.46006910335383, 89.39645512146357, 0.09999999999999938, 185.0, 845, 764394, 1029, 67.77754989999812
1030, 8.318465948773738, 74.48348164736778, 89.41732076516473, 0.09999999999999964, 155.0, 802, 765196, 1030, 64.25816320000013
1031, 8.808074882810498, 74.47827334933811, 89.43924601048599, 0.0999999999999996, 140.0, 810, 766006, 1031, 65.14210729999468
1032, 8.517112372686833, 74.50837180997118, 89.45169758737823, 0.0999999999999996, 150.0, 810, 766816, 1032, 65.03396339999745
1033, 8.66202380902627, 74.50963179270427, 89.45537243637384, 0.10000000000000075, 85.0, 408, 767224, 1033, 32.65653620000376
1034, 8.392777046627469, 74.55160511158131, 89.50334181043837, 0.10000000000000066, 80.0, 675, 767899, 1034, 54.13580070000171
1035, 9.175576573523923, 74.6015307329703, 89.57564068117003, 0.10000000000000052, 105.0, 690, 768589, 1035, 55.25767140000244
1036, 7.876415651211139, 74.60420080667227, 89.54807915499734, 0.09999999999999976, 155.0, 787, 769376, 1036, 63.27375449999818
1037, 8.371127900850377, 74.60629120334038, 89.55619019684114, 0.09999999999999756, 320.0, 1324, 770700, 1037, 106.10167889999866
1038, 8.544976251350084, 74.611707993221, 89.56024507276055, 0.09999999999999848, 280.0, 1029, 771729, 1038, 82.189544199995
1039, 9.246142833145118, 74.62317318126468, 89.58204848634685, 0.10000000000000088, 135.0, 652, 772381, 1039, 52.191249499999685
1040, 8.404916741065126, 74.59566831446406, 89.5576475798194, 0.1000000000000007, 105.0, 670, 773051, 1040, 53.6660303000026
1041, 8.935922140673716, 74.7016766606545, 89.69158370154244, 0.09999999999999977, 305.0, 784, 773835, 1041, 62.90412389999983
1042, 8.70842303986452, 74.70464375554299, 89.69221100320621, 0.09999999999999869, 240.0, 980, 774815, 1042, 78.16844120000314
1043, 8.348862800020271, 74.73505705158885, 89.73087470124408, 0.10000000000000084, 105.0, 656, 775471, 1043, 52.6624026999998
1044, 8.296175403204577, 74.71868025350292, 89.6807436134383, 0.10000000000000057, 105.0, 684, 776155, 1044, 54.81820689999586
1045, 8.849046328459014, 74.6892191176662, 89.69540470545957, 0.10000000000000031, 75.0, 713, 776868, 1045, 57.34651990000566
1046, 9.229641939507557, 74.64906289073194, 89.63333149935039, 0.09999999999999967, 135.0, 799, 777667, 1046, 64.24703760000557
1047, 8.180684143694762, 74.6268146431706, 89.5660325047383, 0.10000000000000098, 105.0, 642, 778309, 1047, 51.39795050000248
1048, 8.988834106162482, 74.6029509189082, 89.58054104973289, 0.10000000000000075, 80.0, 408, 778717, 1048, 32.6890454999957
1049, 8.435632701607437, 74.63293859808294, 89.60353602503871, 0.09999999999999817, 325.0, 1110, 779827, 1049, 88.62173069999699
1050, 8.67832296412924, 73.87464312124943, 88.70656094758407, 0.10000000000000052, 105.0, 690, 780517, 1050, 55.20490830000199
1051, 8.221736828592372, 73.65929579437311, 88.44345102973163, 0.09999999999999813, 215.0, 1122, 781639, 1051, 89.66862309999851
1052, 8.60876388952424, 73.68987678535593, 88.47269545251453, 0.09999999999999867, 240.0, 983, 782622, 1052, 78.51156150000315
1053, 7.968597474645396, 73.70832914044203, 88.49067430697224, 0.09999999999999933, 180.0, 854, 783476, 1053, 68.53790010000375
1054, 8.303398969651413, 73.67959678988782, 88.46963391985211, 0.09999999999999945, 155.0, 833, 784309, 1054, 66.56901819999621
1055, 8.328974016377183, 73.72061706292824, 88.52738298509942, 0.10000000000000098, 85.0, 610, 784919, 1055, 48.683160900000075
1056, 8.642689186308353, 73.72488597136062, 88.54026533398509, 0.09999999999999747, 630.0, 1362, 786281, 1056, 108.57108970000263
1057, 8.41309701277886, 73.69468602309992, 88.48262692675178, 0.0999999999999996, 115.0, 810, 787091, 1057, 64.87772759999643
1058, 8.75027152596006, 73.70115270918342, 88.49345308534659, 0.09999999999999977, 135.0, 785, 787876, 1058, 62.601203400001395
1059, 8.762625736280606, 73.69875885417656, 88.50237555984738, 0.09999999999999952, 155.0, 823, 788699, 1059, 65.90239660000225
1060, 8.577983778511056, 73.69287287724482, 88.49206064667865, 0.09999999999999937, 180.0, 847, 789546, 1060, 67.61427209999965
1061, 8.831732515557011, 73.53814278418461, 88.28665493132402, 0.10000000000000048, 80.0, 694, 790240, 1061, 55.319443400003365
1062, 8.039044158249956, 73.22815384403351, 87.92468606272051, 0.09999999999999924, 210.0, 868, 791108, 1062, 69.10100529999909
1063, 8.071012459094487, 73.30269841994009, 88.01066181736607, 0.09999999999999863, 285.0, 992, 792100, 1063, 79.11629410000023
1064, 8.359344060996639, 73.31204616706181, 88.00106242219758, 0.09999999999999838, 255.0, 1052, 793152, 1064, 83.54271850000077
1065, 7.947156145483183, 73.31874370805865, 88.03553466242681, 0.09999999999999949, 230.0, 826, 793978, 1065, 65.8150886999938
1066, 8.115803263190541, 73.36168041053801, 88.06951125316645, 0.09999999999999994, 135.0, 761, 794739, 1066, 60.700330500003474
1067, 8.019886460848541, 73.35367112834163, 88.08188330979264, 0.09999999999999962, 310.0, 806, 795545, 1067, 64.06758059999993
1068, 8.61803707889901, 73.38786568408086, 88.12032183210768, 0.09999999999999942, 210.0, 837, 796382, 1068, 66.5532869000017
1069, 7.668182541359038, 73.38550375075567, 88.0972436087472, 0.09999999999999941, 410.0, 840, 797222, 1069, 66.81338390000019
1070, 8.510262944122061, 73.39107820773012, 88.12013977737789, 0.09999999999999938, 180.0, 844, 798066, 1070, 67.3102035999982
1071, 9.16329032083802, 73.42068427360616, 88.14468346965438, 0.10000000000000077, 110.0, 663, 798729, 1071, 52.865774099998816
1072, 8.584868875355406, 73.45791710747613, 88.18846892445536, 0.09999999999999916, 180.0, 882, 799611, 1072, 70.30060190000222
1073, 8.27731532847277, 72.98207537391768, 87.62826576057118, 0.09999999999999826, 240.0, 1085, 800696, 1073, 86.5917191999979
1074, 7.678722114112246, 72.67609464351217, 87.23651861314157, 0.10000000000000075, 55.0, 402, 801098, 1074, 32.18389829999796
1075, 7.895408428102624, 72.65667454688558, 87.22566388402174, 0.09999999999999946, 210.0, 831, 801929, 1075, 66.43939120000141
1076, 8.57747608961181, 72.69008261890617, 87.27845088440014, 0.09999999999999946, 210.0, 831, 802760, 1076, 66.2732279999982
1077, 8.130765827635663, 72.75853223953358, 87.35383977987186, 0.10000000000000055, 75.0, 687, 803447, 1077, 54.88406870000472
1078, 8.033684647535976, 72.75044681211061, 87.33196689267702, 0.10000000000000074, 50.0, 395, 803842, 1078, 31.714122700002918
1079, 8.02639840584767, 72.78648522292511, 87.37553916641428, 0.09999999999999973, 135.0, 790, 804632, 1079, 62.93947879999905
1080, 8.133653643596098, 72.82922580167183, 87.44610527566394, 0.0999999999999997, 135.0, 795, 805427, 1080, 63.37302830000408
1081, 8.203555102867213, 72.84721072485031, 87.43022842836649, 0.10000000000000091, 105.0, 533, 805960, 1081, 42.51080219999858
1082, 7.959393934905529, 72.83652641296386, 87.44842868804932, 0.10000000000000074, 50.0, 400, 806360, 1082, 31.907551599993894
1083, 7.922818121202605, 72.85690786179933, 87.46951323395328, 0.09999999999999948, 180.0, 829, 807189, 1083, 66.27535329999955
1084, 7.974955833225633, 72.89084782876259, 87.50859583254547, 0.09999999999999937, 185.0, 847, 808036, 1084, 67.68330440000136
1085, 8.659612420119775, 72.88070466525649, 87.51796994890485, 0.10000000000000081, 120.0, 658, 808694, 1085, 52.67213990000164
1086, 8.275802427964495, 72.87011699662479, 87.49636692611324, 0.09999999999999748, 160.0, 1359, 810053, 1086, 108.73035299999901
1087, 8.563901478767395, 72.74869742257255, 87.35751305280412, 0.0999999999999992, 155.0, 875, 810928, 1087, 69.96853310000006
1088, 7.092454192747597, 72.63428840928405, 87.19125699341753, 0.10000000000000085, 105.0, 655, 811583, 1088, 52.58259900000121
1089, 7.72305902590616, 72.65929819635646, 87.26315068042945, 0.09999999999999883, 260.0, 949, 812532, 1089, 76.16513890000351
1090, 8.043797487318516, 72.64487975120545, 87.2326307296753, 0.09999999999999966, 135.0, 800, 813332, 1090, 64.12728490000154
1091, 7.982036643407562, 72.58366614640362, 87.15131087254996, 0.09999999999999971, 335.0, 792, 814124, 1091, 63.32532410000567
1092, 7.5986477348948265, 72.54157893754657, 87.09196904999678, 0.09999999999999733, 210.0, 1426, 815550, 1092, 114.00139300000592
1093, 7.552256367264724, 72.56782151198969, 87.13384559445265, 0.09999999999999953, 180.0, 820, 816370, 1093, 65.71956439999485
1094, 7.740322527846054, 72.59763875183339, 87.1616629633243, 0.09999999999999976, 160.0, 787, 817157, 1094, 63.22563130000344
1095, 7.862467285684476, 72.60916426426785, 87.17694446496796, 0.09999999999999967, 155.0, 798, 817955, 1095, 63.96916240000428
1096, 7.708529326412603, 72.59246326693528, 87.15634851432819, 0.09999999999999945, 180.0, 834, 818789, 1096, 66.83670040000288
1097, 8.075570487108322, 72.57901692902558, 87.13909498774636, 0.09999999999999942, 210.0, 838, 819627, 1097, 67.10797029999958
1098, 8.103584450034, 72.19991705082033, 86.67469968789415, 0.09999999999999717, 685.0, 1499, 821126, 1098, 120.18682849999459
1099, 8.020895716942768, 71.97499394836068, 86.3998243325201, 0.09999999999999933, 210.0, 853, 821979, 1099, 68.67693110000255
1100, 7.6671722373126245, 72.0180513734501, 86.44935680226692, 0.09999999999999938, 180.0, 844, 822823, 1100, 67.71018280000135
1101, 7.840549271377372, 72.03038687741355, 86.47894858552331, 0.09999999999999676, 565.0, 1753, 824576, 1101, 140.31325440000364
1102, 8.51867630950406, 71.99956287481847, 86.45196175643181, 0.10000000000000041, 105.0, 702, 825278, 1102, 56.616461500001606
1103, 7.770073848541337, 72.04965106887046, 86.50818996236782, 0.09999999999999971, 155.0, 792, 826070, 1103, 63.658350199999404
1104, 7.974652022335001, 72.06157219951803, 86.51494035395709, 0.09999999999999737, 210.0, 1408, 827478, 1104, 112.85664219999308
1105, 7.320700533773707, 72.02121417166173, 86.4558842976888, 0.09999999999999923, 410.0, 870, 828348, 1105, 69.86014740000246
1106, 7.685685549056932, 72.02967223692477, 86.47321467453175, 0.10000000000000032, 115.0, 712, 829060, 1106, 56.97687429999496
1107, 7.801458713054005, 71.95790528990531, 86.37778595887899, 0.09999999999999724, 435.0, 1464, 830524, 1107, 117.46269159999792
1108, 7.928365605618015, 71.82896252256451, 86.24535208037405, 0.09999999999999863, 230.0, 990, 831514, 1108, 79.18038350000279
1109, 8.294448360508563, 71.80884879962352, 86.20591847461453, 0.10000000000000077, 130.0, 663, 832177, 1109, 53.377800000002026
1110, 7.592529300181267, 71.79674197345375, 86.17952910483527, 0.10000000000000091, 105.0, 649, 832826, 1110, 52.200191999996605
1111, 7.503691218621803, 71.80966049656723, 86.18599386504202, 0.0999999999999995, 170.0, 825, 833651, 1111, 66.50560150000092
1112, 7.833336081262541, 71.79557669390987, 86.19345623684913, 0.09999999999999748, 410.0, 1358, 835009, 1112, 109.22691170000326
1113, 6.8899375434432715, 71.77957978702727, 86.15131898153396, 0.10000000000000069, 120.0, 672, 835681, 1113, 54.17266319999908
1114, 8.046611871764974, 71.79766213569333, 86.19823154901388, 0.09999999999999748, 715.0, 1359, 837040, 1114, 108.97873660000187
1115, 7.856661667426427, 71.73772076765697, 86.12544111410777, 0.10000000000000071, 30.0, 384, 837424, 1115, 30.866331099998206
1116, 7.18720303892706, 71.74314740539747, 86.14841886808635, 0.10000000000000099, 60.0, 622, 838046, 1116, 49.91994340000383
1117, 8.33293090702488, 71.75428828367336, 86.14965846898563, 0.09999999999999883, 210.0, 947, 838993, 1117, 76.0285922999974
1118, 7.887241897954009, 71.76492961151897, 86.16011222222745, 0.09999999999999948, 355.0, 829, 839822, 1118, 66.40509800000291
1119, 7.8423502138432335, 71.07164323096181, 85.32331945381912, 0.09999999999999956, 140.0, 816, 840638, 1119, 65.37137030000304
1120, 7.259135266805344, 70.85972813032905, 85.06602747706849, 0.10000000000000078, 120.0, 662, 841300, 1120, 53.20147559999896
1121, 7.8656162175805395, 70.90338575654312, 85.13233228784483, 0.10000000000000098, 105.0, 642, 841942, 1121, 51.540566099996795
1122, 7.650846819296205, 70.91431747623749, 85.13438346488344, 0.10000000000000088, 110.0, 652, 842594, 1122, 52.07965279999917
1123, 7.865859495715404, 70.84962613871333, 85.04717486092214, 0.09999999999999966, 185.0, 801, 843395, 1123, 64.287244799998
1124, 7.938452503195515, 70.84810515980662, 85.05235480084832, 0.10000000000000092, 110.0, 648, 844043, 1124, 52.10571560000244
1125, 7.138184062662841, 70.90099741544337, 85.09808226127845, 0.10000000000000049, 120.0, 692, 844735, 1125, 55.602480500005186
1126, 7.755534504858312, 70.87069963861205, 85.0656676825484, 0.10000000000000087, 120.0, 653, 845388, 1126, 52.29259969999839
1127, 7.691861594208765, 70.91052948964666, 85.11054383705104, 0.09999999999999819, 350.0, 1105, 846493, 1127, 88.42198400000052
1128, 8.43839211975827, 70.94463846543256, 85.16581933414234, 0.09999999999999935, 210.0, 850, 847343, 1128, 67.99300719999883
1129, 7.7547067016510685, 70.90770049142365, 85.11763021261385, 0.09999999999999697, 230.0, 1616, 848959, 1129, 129.22634180000023
1130, 7.509025084233099, 70.8609886110291, 85.05137356307155, 0.10000000000000095, 110.0, 645, 849604, 1130, 51.863293800000974
1131, 7.9736656278664775, 70.54461151750307, 84.68515759179164, 0.09999999999999813, 425.0, 1119, 850723, 1131, 89.71218719999888
1132, 7.714660017140362, 70.38375666282094, 84.51529050934903, 0.09999999999999946, 180.0, 831, 851554, 1132, 66.65780369999993
1133, 7.585085623874897, 70.42594676134063, 84.55156037865615, 0.09999999999999953, 210.0, 820, 852374, 1133, 65.73474540000461
1134, 7.977232968134265, 70.39318084716797, 84.508050041814, 0.10000000000000088, 75.0, 496, 852870, 1134, 39.864072600001236
1135, 7.16295861488638, 70.36425526325519, 84.47650809471423, 0.09999999999999945, 210.0, 832, 853702, 1135, 66.77044999999634
1136, 8.495203570248206, 70.43757899803451, 84.55100471400007, 0.09999999999999973, 120.0, 790, 854492, 1136, 63.429631900005916
1137, 7.590000816738848, 70.43182852840508, 84.55732812197257, 0.0999999999999981, 415.0, 1129, 855621, 1137, 90.64342219999526
1138, 7.446423094977373, 70.44583104824703, 84.5812329892759, 0.09999999999999731, 775.0, 1431, 857052, 1138, 114.95477449999453
1139, 7.964220374470344, 70.42850924552755, 84.5539067676445, 0.09999999999999937, 135.0, 846, 857898, 1139, 67.80040600000211
1140, 7.732998214419324, 70.45627607379043, 84.58826530666877, 0.09999999999999967, 180.0, 798, 858696, 1140, 64.13562459999957
1141, 7.891992733693949, 70.48986982591082, 84.61710301956327, 0.0999999999999996, 180.0, 808, 859504, 1141, 65.02353029999358
1142, 7.758267719762117, 70.28807226963306, 84.36399834276894, 0.09999999999999924, 215.0, 868, 860372, 1142, 69.6452769000025
1143, 8.273197665723444, 70.01779190420407, 84.09091361270778, 0.09999999999999848, 475.0, 1026, 861398, 1143, 82.4125936000055
1144, 7.405244098910734, 69.97979219714601, 83.98734617952127, 0.09999999999999969, 120.0, 796, 862194, 1144, 63.78744529999676
1145, 7.356669677165447, 69.95492858344345, 84.00499656641088, 0.09999999999999938, 210.0, 844, 863038, 1145, 67.69904189999943
1146, 8.084996727772944, 69.9907439394936, 84.03464712824847, 0.09999999999999874, 425.0, 965, 864003, 1146, 77.24042770000233
1147, 7.34087177175675, 69.92818094518063, 83.93166722578434, 0.10000000000000077, 45.0, 411, 864414, 1147, 33.07167430000118
1148, 7.6858112721486425, 69.97463303015977, 84.0226795430086, 0.09999999999999756, 255.0, 1323, 865737, 1148, 106.25713430000178
1149, 7.910682813845827, 69.92119642010648, 83.94745661803415, 0.09999999999999931, 150.0, 857, 866594, 1149, 67.90041660000134
1150, 7.955965717124124, 69.96038998769559, 83.99194877168053, 0.10000000000000041, 125.0, 702, 867296, 1150, 56.002850300006685
1151, 8.223331746808604, 69.93533712424744, 83.9676650309812, 0.09999999999999928, 140.0, 861, 868157, 1151, 69.06871990000218
1152, 7.5497363874929375, 69.95930748350882, 84.00012546521054, 0.09999999999999944, 180.0, 836, 868993, 1152, 67.48552539999946
1153, 8.316972353070186, 69.94338559939754, 83.99242584614814, 0.09999999999999924, 210.0, 869, 869862, 1153, 69.65023619999556
1154, 7.13232584830977, 69.31887309003177, 83.21683361597367, 0.09999999999999847, 245.0, 1031, 870893, 1154, 82.61276969999744
1155, 7.653100629764034, 69.19925575211627, 83.0874491486991, 0.09999999999999933, 380.0, 853, 871746, 1155, 68.30093299999862
1156, 7.369615675405014, 69.23324733845988, 83.10829132512076, 0.09999999999999865, 240.0, 989, 872735, 1156, 79.20352810000622
1157, 7.316494000931912, 69.24507977922818, 83.13661087659412, 0.10000000000000078, 120.0, 661, 873396, 1157, 53.05554090000078
1158, 7.628558404252579, 69.25915341996877, 83.16495065635208, 0.10000000000000091, 75.0, 531, 873927, 1158, 42.560479899999336
1159, 7.254809383640147, 69.29689072191525, 83.18615229467487, 0.09999999999999887, 210.0, 939, 874866, 1159, 75.15977340000245
1160, 7.6055035990781015, 69.31301448765461, 83.22498844404393, 0.10000000000000098, 55.0, 607, 875473, 1160, 48.84816080000019
1161, 7.679191725274313, 69.32264965946234, 83.21981368944483, 0.0999999999999995, 180.0, 824, 876297, 1161, 65.98078530000203
1162, 7.695207609833971, 69.32409073996679, 83.24136680128885, 0.09999999999999915, 185.0, 885, 877182, 1162, 71.13928609999857
1163, 7.807359616535937, 69.33318547155126, 83.22880948164101, 0.09999999999999844, 460.0, 1038, 878220, 1163, 83.33988710000267
1164, 7.637313107559584, 69.33151046039472, 83.21896267944152, 0.10000000000000077, 120.0, 663, 878883, 1164, 53.39794919999986
1165, 7.447031845762746, 69.32101088639527, 83.2276317151242, 0.09999999999999921, 190.0, 874, 879757, 1165, 70.0646465999962
1166, 7.1280668984219115, 68.86616614226416, 82.66132851159504, 0.10000000000000091, 75.0, 521, 880278, 1166, 41.72581550000177
1167, 7.937552049252894, 68.5298220944095, 82.28344177642425, 0.10000000000000071, 35.0, 385, 880663, 1167, 30.69263630000205
1168, 7.034678839416706, 68.54225588307797, 82.28350064445152, 0.09999999999999809, 215.0, 1133, 881796, 1168, 89.92949300000328
1169, 7.176293595728195, 68.56277864655034, 82.29785654233241, 0.09999999999999747, 265.0, 1362, 883158, 1169, 109.66017599999759
1170, 7.3190467377001625, 68.51682566104526, 82.27744866106055, 0.09999999999999946, 180.0, 831, 883989, 1170, 71.31772769999952
1171, 7.394059448475605, 68.51051296420864, 82.26902774197238, 0.1000000000000003, 105.0, 715, 884704, 1171, 62.75648910000018
1172, 6.900909849423535, 68.49091035492566, 82.20116967571025, 0.10000000000000073, 65.0, 392, 885096, 1172, 34.547213000005286
1173, 6.168508166993009, 68.4934379021436, 82.22200399448651, 0.1000000000000002, 135.0, 727, 885823, 1173, 68.69518359999347
1174, 6.920107288064116, 68.53974074526772, 82.28496142372566, 0.10000000000000073, 60.0, 386, 886209, 1174, 41.436934099998325
1175, 7.321591836030667, 68.52657338069035, 82.25928511399489, 0.1000000000000009, 120.0, 650, 886859, 1175, 58.657506799994735
1176, 7.024443083396642, 68.49057842481254, 82.24128784519611, 0.0999999999999996, 140.0, 808, 887667, 1176, 73.14168939999945
1177, 7.050594730045072, 68.52137997755364, 82.26842308993363, 0.09999999999999858, 260.0, 1005, 888672, 1177, 97.19426239999302
1178, 7.853472519382258, 68.50382455547204, 82.25035536214803, 0.09999999999999966, 120.0, 801, 889473, 1178, 80.03661110000394
1179, 7.236164559868618, 68.43951095128351, 82.16584740550522, 0.10000000000000095, 30.0, 573, 890046, 1179, 56.93389549999847
1180, 7.235069907651159, 67.91791078915149, 81.53639409859193, 0.09999999999999853, 210.0, 1015, 891061, 1180, 100.17144669999834
1181, 7.007617370164172, 67.92828268679033, 81.56753596904115, 0.09999999999999963, 170.0, 805, 891866, 1181, 79.95832130000053
1182, 7.275193677890073, 67.99900627379205, 81.62077004985444, 0.09999999999999977, 135.0, 785, 892651, 1182, 77.96939050000219
1183, 6.783654553352406, 67.9804181178651, 81.60370164239275, 0.09999999999999862, 405.0, 993, 893644, 1183, 99.79539089999162
1184, 7.199817906647617, 67.94108913593764, 81.56657489626689, 0.10000000000000055, 105.0, 687, 894331, 1184, 68.85923499999626
1185, 6.952670526885709, 67.93953530732975, 81.55612680523895, 0.10000000000000053, 105.0, 688, 895019, 1185, 68.98708140000235
1186, 6.75355718731433, 67.94780995625798, 81.57231118959855, 0.09999999999999754, 440.0, 1333, 896352, 1186, 133.94814019999467
1187, 6.817668839371035, 67.89769565286983, 81.5293648525437, 0.10000000000000099, 145.0, 633, 896985, 1187, 67.48702459999186
1188, 7.455708661003804, 67.93513918192983, 81.58019397428865, 0.09999999999999916, 185.0, 883, 897868, 1188, 95.59933119999187
1189, 7.1083386577878676, 67.90818965366908, 81.53499605451312, 0.10000000000000064, 50.0, 350, 898218, 1189, 32.60755619998963
1190, 6.898827810073546, 67.93187840629497, 81.56134281811495, 0.09999999999999937, 155.0, 847, 899065, 1190, 78.90713389999291
1191, 6.936325198529355, 67.94256789825192, 81.57636976186812, 0.09999999999999927, 185.0, 863, 899928, 1191, 79.27805429999717
1192, 8.185469630305752, 67.96863270390985, 81.60813388941479, 0.10000000000000087, 30.0, 489, 900417, 1192, 45.365355599991744
1193, 7.471032699813014, 67.94897093037842, 81.59777325415328, 0.1000000000000009, 105.0, 506, 900923, 1193, 50.54412710000179
1194, 7.682223234076062, 67.95603752609517, 81.5777336290989, 0.09999999999999962, 320.0, 806, 901729, 1194, 69.50666349999665
1195, 6.9499591163226535, 67.91882167997814, 81.5385117667062, 0.10000000000000099, 110.0, 630, 902359, 1195, 58.08987660000275
1196, 6.488800680941647, 67.89327694775464, 81.51853497250302, 0.10000000000000074, 105.0, 666, 903025, 1196, 61.55466619999788
1197, 7.3151652872498385, 67.89998593929631, 81.52276215517432, 0.09999999999999891, 265.0, 931, 903956, 1197, 101.4899155000021
1198, 7.283274920733361, 67.86359979164943, 81.47977867645864, 0.10000000000000078, 105.0, 661, 904617, 1198, 63.58841830000165
1199, 8.286931984489796, 67.86840736851822, 81.50638097701827, 0.0999999999999994, 210.0, 841, 905458, 1199, 105.72399250000308
1200, 7.892686219920827, 67.88504930322388, 81.50543106212449, 0.09999999999999966, 375.0, 801, 906259, 1200, 98.58415339999192
1201, 7.51794274899527, 67.87409173721335, 81.50241258409288, 0.10000000000000034, 110.0, 711, 906970, 1201, 158.44454959999712
1202, 7.023140851959225, 67.86165950682516, 81.47653381819231, 0.09999999999999903, 240.0, 906, 907876, 1202, 215.13862189999782
1203, 7.708064427357594, 67.87379464302354, 81.50919995295789, 0.09999999999999976, 175.0, 786, 908662, 1203, 169.47955750000256
1204, 7.023962636414696, 67.86517513499541, 81.49173767089843, 0.10000000000000078, 90.0, 425, 909087, 1204, 37.46658360000583
1205, 8.07664276381389, 67.8443928136799, 81.44339519490107, 0.10000000000000027, 120.0, 718, 909805, 1205, 62.161482700001216
1206, 6.809051606414382, 67.19535667994887, 80.69029102186217, 0.09999999999999952, 155.0, 822, 910627, 1206, 76.75346050001099
1207, 7.623855554896234, 67.10631597877868, 80.58756905493554, 0.09999999999999958, 160.0, 813, 911440, 1207, 80.03736979998939
1208, 6.750208625852158, 67.07170568812977, 80.53146342075232, 0.10000000000000091, 65.0, 528, 911968, 1208, 56.52601410000352
1209, 6.691159390150718, 67.08673818563207, 80.57331045125707, 0.10000000000000091, 110.0, 533, 912501, 1209, 55.08897069998784
1210, 6.068992086552453, 67.09799080791423, 80.5622876518389, 0.10000000000000071, 90.0, 383, 912884, 1210, 53.58160000000498
1211, 7.445679021650277, 67.03240135174308, 80.49666245546364, 0.09999999999999952, 210.0, 822, 913706, 1211, 143.64299549999123
1212, 6.690988293603048, 67.04266284316566, 80.49282551492269, 0.09999999999999867, 225.0, 981, 914687, 1212, 220.57147590001114
1213, 6.831810729945053, 67.10780708961774, 80.59970588807269, 0.09999999999999892, 215.0, 929, 915616, 1213, 204.92414740000095
1214, 7.120996822143686, 67.14327012891405, 80.6246007940426, 0.09999999999999958, 155.0, 813, 916429, 1214, 184.78283540000848
1215, 7.17735725442809, 67.16665930205338, 80.66707454986202, 0.09999999999999691, 605.0, 1652, 918081, 1215, 378.6593564000068
1216, 7.452998254067606, 67.11478753398649, 80.60786138301273, 0.0999999999999974, 385.0, 1390, 919471, 1216, 308.18221020000055
1217, 6.951638553154635, 67.09077678917328, 80.57161630454021, 0.09999999999999974, 380.0, 789, 920260, 1217, 169.50152730000264
1218, 7.334212341041209, 67.07916967308324, 80.5574142763205, 0.0999999999999974, 345.0, 1391, 921651, 1218, 295.5016470999981
1219, 7.187542530956511, 67.04405310646287, 80.50502398285124, 0.09999999999999928, 210.0, 862, 922513, 1219, 197.51469290000387
1220, 7.286850824627178, 67.04547993787723, 80.50363345755224, 0.10000000000000098, 120.0, 642, 923155, 1220, 144.14468209999905
1221, 7.832183167121153, 67.0554032840117, 80.52960763380757, 0.10000000000000063, 55.0, 343, 923498, 1221, 72.74945649999427
1222, 6.732589888457375, 67.04542294263551, 80.51322850293087, 0.09999999999999949, 180.0, 827, 924325, 1222, 178.18623339998885
1223, 7.667032771047793, 67.0809159610146, 80.57512367650082, 0.09999999999999881, 235.0, 950, 925275, 1223, 156.51521990000037
1224, 6.489555883371359, 67.08485974946645, 80.5606037244246, 0.10000000000000081, 105.0, 658, 925933, 1224, 56.72792499999923
1225, 7.383851871849635, 67.04306278473291, 80.508547660632, 0.10000000000000099, 135.0, 624, 926557, 1225, 52.60710320000362
1226, 7.112402974360088, 67.02467566495817, 80.47901071401743, 0.09999999999999938, 155.0, 845, 927402, 1226, 71.47252049999952
1227, 7.747226430436592, 67.00829914247791, 80.47539401907909, 0.10000000000000078, 75.0, 419, 927821, 1227, 39.893926099990495
1228, 7.108278798729683, 67.09545221320289, 80.56419619213067, 0.0999999999999981, 235.0, 1129, 928950, 1228, 96.11235650000162
1229, 6.631432143338208, 66.98261971309267, 80.44932941380392, 0.10000000000000075, 90.0, 406, 929356, 1229, 35.77924109999731
1230, 7.201270233766706, 67.0545129589006, 80.53819508646049, 0.10000000000000075, 75.0, 408, 929764, 1230, 34.41445609999937
1231, 6.778273526923585, 66.96867217583473, 80.42017314579884, 0.1000000000000004, 105.0, 703, 930467, 1231, 59.25421149999602
1232, 7.010399565705252, 66.93567672037567, 80.37959276804776, 0.09999999999999942, 205.0, 838, 931305, 1232, 71.09285790000285
1233, 6.931951125584741, 66.92476695398123, 80.35854512782184, 0.09999999999999869, 260.0, 978, 932283, 1233, 84.38862560001144
1234, 7.898224795423616, 66.82315311827458, 80.25212386796021, 0.09999999999999817, 170.0, 1109, 933392, 1234, 96.36004259999027
1235, 6.833409325320405, 66.81592354942498, 80.21546688520169, 0.09999999999999952, 180.0, 823, 934215, 1235, 71.03586650000943
1236, 7.212651108183078, 66.79304522288633, 80.22811230820125, 0.09999999999999888, 420.0, 938, 935153, 1236, 90.12499830000161
1237, 7.190011229187776, 66.79654486053236, 80.2192653396568, 0.0999999999999997, 155.0, 794, 935947, 1237, 75.60473649999767
1238, 6.919522555540506, 66.82974867054598, 80.25493923708689, 0.10000000000000077, 75.0, 417, 936364, 1238, 39.90904490000685
1239, 6.929260038395001, 66.73452055659395, 80.14917138065024, 0.10000000000000091, 145.0, 523, 936887, 1239, 49.783547500002896
1240, 6.782982012721954, 66.80148609561441, 80.23000281600163, 0.10000000000000063, 110.0, 677, 937564, 1240, 64.56214559999353
1241, 6.760136192453277, 66.78275105387894, 80.20701074108635, 0.09999999999999983, 135.0, 776, 938340, 1241, 73.6550916999986
1242, 7.556592996423668, 66.83712357843379, 80.26047630177142, 0.10000000000000095, 60.0, 574, 938914, 1242, 54.54426130000502
1243, 7.288097192170256, 66.81092215392549, 80.22832539121984, 0.10000000000000085, 120.0, 472, 939386, 1243, 44.766952100006165
1244, 7.361233237357634, 66.52483032334526, 79.89025381376159, 0.09999999999999935, 415.0, 848, 940234, 1244, 80.59435330000997
1245, 7.495406454269981, 65.8819692564644, 79.14493485510462, 0.10000000000000091, 110.0, 527, 940761, 1245, 50.0108462000062
1246, 7.000818664707789, 65.8488986364225, 79.08981561428163, 0.09999999999999953, 180.0, 820, 941581, 1246, 77.65470689999347
1247, 6.992888442054098, 65.82711646356455, 79.06033231101445, 0.09999999999999767, 410.0, 1273, 942854, 1247, 120.5868688000046
1248, 6.866022328562546, 65.87047090086077, 79.0983534561147, 0.09999999999999722, 720.0, 1481, 944335, 1248, 140.14042660000268
1249, 7.615581529460988, 65.85690622959497, 79.09825356501453, 0.09999999999999935, 370.0, 848, 945183, 1249, 80.14729660000012
1250, 7.323513996867707, 65.81712142651836, 79.03414228396674, 0.10000000000000099, 135.0, 626, 945809, 1250, 59.34138540001004
1251, 7.580862962463988, 65.82947576498684, 79.07201816462263, 0.10000000000000099, 135.0, 632, 946441, 1251, 60.34786580000946
1252, 7.231296790574125, 65.78381491107142, 79.00949278505976, 0.09999999999999944, 140.0, 835, 947276, 1252, 79.71160870000313
1253, 7.612504901282705, 65.74855597146085, 78.98142610010312, 0.09999999999999831, 250.0, 1071, 948347, 1253, 101.55399749999924
1254, 7.002219376806727, 65.68279268641672, 78.88840979159235, 0.10000000000000071, 105.0, 668, 949015, 1254, 63.237298600011854
1255, 7.074837114351491, 65.76790789763133, 79.0011224548022, 0.10000000000000071, 90.0, 384, 949399, 1255, 36.574523899995256
1256, 7.348852880430222, 65.62456863708496, 78.82889218139648, 0.09999999999999774, 315.0, 1250, 950649, 1256, 119.02066749999358
1257, 7.295263487699694, 65.5209675842493, 78.70477609455688, 0.10000000000000096, 115.0, 587, 951236, 1257, 55.77613910000946
1258, 7.031801678874027, 65.49390089100805, 78.66625776619746, 0.09999999999999923, 360.0, 870, 952106, 1258, 82.49090509999951
1259, 6.926745005884716, 65.46291465700318, 78.62691590959174, 0.10000000000000092, 165.0, 647, 952753, 1259, 61.40286799999012
1260, 7.329586848244071, 65.46509254932404, 78.62093117713928, 0.09999999999999966, 170.0, 800, 953553, 1260, 75.96298019999813
1261, 7.18348485802951, 65.50282875043617, 78.67352841869337, 0.0999999999999992, 250.0, 876, 954429, 1261, 83.19117190000543
1262, 6.784268291062699, 65.47757614651117, 78.64601517183789, 0.09999999999999948, 195.0, 829, 955258, 1262, 78.44883000000846
1263, 7.904291357989459, 65.61139452734659, 78.8159394227257, 0.1000000000000009, 105.0, 516, 955774, 1263, 49.3384425000113
1264, 7.061660906103731, 65.54989852322876, 78.74622723528446, 0.10000000000000085, 125.0, 655, 956429, 1264, 62.12712199999078
1265, 7.254079774946706, 65.6018062387882, 78.80225808279855, 0.10000000000000049, 110.0, 693, 957122, 1265, 66.38863270000729
1266, 7.256890167889895, 65.58106381609723, 78.77626479355605, 0.1000000000000003, 210.0, 715, 957837, 1266, 67.9516583999939
1267, 7.324954914990987, 65.54655872136155, 78.7273400463313, 0.09999999999999717, 355.0, 1498, 959335, 1267, 142.43481489999976
1268, 7.558052672399437, 65.52874258887358, 78.69996285321474, 0.09999999999999781, 230.0, 1222, 960557, 1268, 116.39629829999467
1269, 7.084078552938948, 65.54794209115457, 78.75259279938085, 0.0999999999999991, 245.0, 894, 961451, 1269, 84.66265630000271
1270, 7.050926698176633, 65.57510322389149, 78.7550379162743, 0.09999999999999941, 225.0, 840, 962291, 1270, 79.67221459999564
1271, 7.438159176504425, 65.55248503160726, 78.74828582284339, 0.10000000000000071, 30.0, 382, 962673, 1271, 36.25496389999171
1272, 6.418020783669678, 65.53394847378048, 78.70157336026449, 0.09999999999999706, 280.0, 1559, 964232, 1272, 149.52914680000686
1273, 6.743798156855522, 65.51758164472936, 78.69947504065122, 0.09999999999999803, 225.0, 1151, 965383, 1273, 109.43626919999951
1274, 7.069299187437333, 65.52620795360706, 78.71777252975335, 0.10000000000000038, 110.0, 706, 966089, 1274, 67.06817410000076
1275, 6.767900892789813, 65.52210158472475, 78.68917128521463, 0.09999999999999742, 530.0, 1380, 967469, 1275, 130.77586380000866
1276, 7.096294999849506, 65.43688410730543, 78.60633024096812, 0.10000000000000012, 135.0, 738, 968207, 1276, 70.18535519999568
1277, 7.042810648178854, 65.45644188461517, 78.61638296218146, 0.09999999999999733, 565.0, 1428, 969635, 1277, 135.33054529999208
1278, 7.033461566070594, 65.09693821845177, 78.1638510341014, 0.09999999999999955, 210.0, 817, 970452, 1278, 77.6217689000041
1279, 7.557399661976164, 64.80489417208524, 77.86747389390204, 0.10000000000000099, 115.0, 641, 971093, 1279, 61.08255890000146
1280, 7.178409446801808, 64.77905283682342, 77.79563655521821, 0.09999999999999769, 425.0, 1266, 972359, 1280, 120.21634710000944
1281, 7.701831889204869, 64.76184366353911, 77.7923111397401, 0.099999999999999, 300.0, 911, 973270, 1281, 87.06113729999925
1282, 7.182624416046233, 64.77828782881606, 77.79064474060637, 0.09999999999999938, 195.0, 844, 974114, 1282, 73.59284519999346
1283, 6.649451652880973, 64.7492858528961, 77.75643340165898, 0.09999999999999898, 245.0, 917, 975031, 1283, 76.71129490000021
1284, 7.474978171810339, 64.74462595265821, 77.7636787121775, 0.09999999999999915, 310.0, 886, 975917, 1284, 74.05445769999642
1285, 7.624907795678485, 64.7166943766854, 77.7232628735629, 0.10000000000000066, 50.0, 352, 976269, 1285, 29.42852760000096
1286, 7.631827034332134, 64.75973701194481, 77.7934905327691, 0.10000000000000066, 145.0, 675, 976944, 1286, 56.41891730000498
1287, 6.995466137858963, 64.72937473017717, 77.74603700281436, 0.10000000000000071, 110.0, 669, 977613, 1287, 55.98532310000155
1288, 7.322690827417324, 64.74663305530687, 77.7582180567016, 0.09999999999999877, 245.0, 961, 978574, 1288, 80.75983980001183
1289, 6.901826970431269, 64.67959635209064, 77.66461625391123, 0.10000000000000087, 150.0, 490, 979064, 1289, 41.057388100001845
1290, 7.752157112035148, 64.70961223611576, 77.71257964828008, 0.09999999999999952, 140.0, 822, 979886, 1290, 68.4196443999972
1291, 7.604739752102855, 64.48296237231098, 77.45563256381746, 0.0999999999999979, 285.0, 1196, 981082, 1291, 99.42118799999298
1292, 6.5774995391104625, 64.4154381451739, 77.3780930756922, 0.0999999999999997, 380.0, 794, 981876, 1292, 66.09731810000085
1293, 7.094719029548584, 64.39502519906966, 77.35340730457283, 0.0999999999999996, 155.0, 809, 982685, 1293, 67.42409430000407
1294, 7.467479561167635, 64.42559571951325, 77.34524418757512, 0.10000000000000052, 320.0, 689, 983374, 1294, 57.52196689999255
1295, 7.751000130303362, 64.39897526274336, 77.33798337084181, 0.09999999999999887, 230.0, 940, 984314, 1295, 78.19644069999049
1296, 7.414213725459263, 64.4164359197366, 77.36463014346187, 0.10000000000000092, 120.0, 647, 984961, 1296, 53.902355199999874
1297, 7.128339752089864, 64.39371493584103, 77.35175643361893, 0.10000000000000012, 105.0, 737, 985698, 1297, 61.47931690000405
1298, 7.806139054752531, 64.42636921796849, 77.37444091473938, 0.10000000000000071, 105.0, 378, 986076, 1298, 31.586243099998683
1299, 7.305610049215162, 64.43059830280565, 77.39622335493195, 0.09999999999999963, 140.0, 805, 986881, 1299, 67.04736860000412
1300, 7.046790177941323, 64.45793995666504, 77.41128871154785, 0.10000000000000088, 30.0, 500, 987381, 1300, 41.55023819999769
1301, 6.9596178042507875, 64.41652626018852, 77.36026299029076, 0.10000000000000075, 115.0, 407, 987788, 1301, 33.95943570000236
1302, 7.319250668622809, 64.43447178506742, 77.37934322924582, 0.09999999999999921, 225.0, 874, 988662, 1302, 72.81307489999745
1303, 6.978911218864002, 64.49411421335385, 77.46387800615332, 0.09999999999999967, 135.0, 799, 989461, 1303, 66.58264009999402
1304, 7.332545728191362, 64.37333991162717, 77.3256789726719, 0.09999999999999737, 535.0, 1405, 990866, 1304, 117.15220130000671
1305, 7.964999851915572, 64.32445333826611, 77.25568196257653, 0.09999999999999931, 210.0, 855, 991721, 1305, 71.38731190000544
1306, 7.5657177470105, 64.28894002876719, 77.21378187483232, 0.09999999999999877, 260.0, 961, 992682, 1306, 80.01230899999791
1307, 7.233415621915099, 64.27145751615195, 77.1803366873902, 0.10000000000000096, 110.0, 587, 993269, 1307, 48.82718880000175
1308, 7.928490605735779, 64.27620928955078, 77.1987053100586, 0.10000000000000099, 105.0, 625, 993894, 1308, 52.025834200001555
1309, 7.351938807888274, 64.24259704151793, 77.15207344797429, 0.10000000000000099, 155.0, 627, 994521, 1309, 52.3989631000004
1310, 7.101103711766591, 64.23355150044632, 77.12800139240726, 0.09999999999999964, 155.0, 803, 995324, 1310, 66.89732439999352
1311, 8.064490582776624, 64.24276295151822, 77.15833865616673, 0.10000000000000095, 145.0, 645, 995969, 1311, 53.795847300003516
1312, 7.525686183872149, 64.24054555375447, 77.15140558582868, 0.1000000000000009, 85.0, 516, 996485, 1312, 43.09256190000451
1313, 7.947682315330668, 64.21603702620811, 77.15481997481824, 0.10000000000000038, 95.0, 706, 997191, 1313, 58.81195289999596
1314, 7.748713661085422, 64.16748396633307, 77.06752133544325, 0.09999999999999955, 180.0, 818, 998009, 1314, 68.22592090000398
1315, 7.568693986751255, 64.16117590079035, 77.05980177370378, 0.09999999999999985, 185.0, 772, 998781, 1315, 64.34871629999543
1316, 7.728978853714227, 64.13194113478629, 77.01029801740412, 0.09999999999999908, 180.0, 898, 999679, 1316, 74.93097830000625
