,loss,mae,mean_q,mean_eps,episode_reward,nb_episode_steps,nb_steps,episode,duration
0,0,0,0,0,50.0,387,387,0,0.8261292000000005
1, 0, 0, 0, 0, 285.0, 1402, 1789, 1, 2.793507
2, 0, 0, 0, 0, 30.0, 449, 2238, 2, 0.9126972000000002
3, 0, 0, 0, 0, 220.0, 946, 3184, 3, 1.952876999999999
4, 0, 0, 0, 0, 110.0, 494, 3678, 4, 1.0609239000000006
5, 0, 0, 0, 0, 255.0, 934, 4612, 5, 1.9160416999999974
6, 0, 0, 0, 0, 85.0, 662, 5274, 6, 1.3983111999999984
7, 0, 0, 0, 0, 215.0, 730, 6004, 7, 1.4964134000000016
8, 0, 0, 0, 0, 50.0, 514, 6518, 8, 1.0872385000000016
9, 0, 0, 0, 0, 90.0, 459, 6977, 9, 0.9841461000000002
10, 0, 0, 0, 0, 35.0, 480, 7457, 10, 1.0150571
11, 0, 0, 0, 0, 310.0, 1113, 8570, 11, 2.3242297999999977
12, 0, 0, 0, 0, 110.0, 606, 9176, 12, 1.2731084999999993
13, 0, 0, 0, 0, 210.0, 824, 10000, 13, 1.7665203999999974
14, 0, 0, 0, 0, 120.0, 612, 10612, 14, 1.2794346999999995
15, 0, 0, 0, 0, 320.0, 760, 11372, 15, 1.5888664999999982
16, 0, 0, 0, 0, 180.0, 759, 12131, 16, 1.6006056000000015
17, 0, 0, 0, 0, 105.0, 621, 12752, 17, 1.288367700000002
18, 0, 0, 0, 0, 105.0, 637, 13389, 18, 1.306984100000001
19, 0, 0, 0, 0, 20.0, 494, 13883, 19, 1.0623328
20, 0, 0, 0, 0, 410.0, 902, 14785, 20, 1.7946605000000062
21, 0, 0, 0, 0, 155.0, 980, 15765, 21, 1.9351034999999968
22, 0, 0, 0, 0, 90.0, 481, 16246, 22, 1.011135699999997
23, 0, 0, 0, 0, 135.0, 690, 16936, 23, 1.4580921000000018
24, 0, 0, 0, 0, 15.0, 478, 17414, 24, 0.9798298999999986
25, 0, 0, 0, 0, 145.0, 864, 18278, 25, 1.7991481999999976
26, 0, 0, 0, 0, 105.0, 501, 18779, 26, 1.0579217999999955
27, 0, 0, 0, 0, 120.0, 650, 19429, 27, 1.392901699999996
28, 0, 0, 0, 0, 65.0, 601, 20030, 28, 1.2473257999999987
29, 0, 0, 0, 0, 155.0, 775, 20805, 29, 1.5452841000000035
30, 0, 0, 0, 0, 0.0, 585, 21390, 30, 1.2161666999999952
31, 0, 0, 0, 0, 180.0, 622, 22012, 31, 1.2900069999999957
32, 0, 0, 0, 0, 95.0, 664, 22676, 32, 1.4221906000000004
33, 0, 0, 0, 0, 30.0, 395, 23071, 33, 0.8188789000000014
34, 0, 0, 0, 0, 110.0, 558, 23629, 34, 1.1202419999999975
35, 0, 0, 0, 0, 155.0, 811, 24440, 35, 1.6729550999999958
36, 0, 0, 0, 0, 80.0, 501, 24941, 36, 1.0453237000000044
37, 0, 0, 0, 0, 105.0, 497, 25438, 37, 1.0239461000000034
38, 0, 0, 0, 0, 180.0, 772, 26210, 38, 1.5533138999999991
39, 0, 0, 0, 0, 150.0, 709, 26919, 39, 1.4822058000000027
40, 0, 0, 0, 0, 135.0, 715, 27634, 40, 1.4451554999999985
41, 0, 0, 0, 0, 160.0, 590, 28224, 41, 1.2043895000000049
42, 0, 0, 0, 0, 105.0, 433, 28657, 42, 0.9081113999999957
43, 0, 0, 0, 0, 185.0, 804, 29461, 43, 1.599445000000003
44, 0, 0, 0, 0, 160.0, 810, 30271, 44, 1.65845019999999
45, 0, 0, 0, 0, 240.0, 874, 31145, 45, 1.7466295000000116
46, 0, 0, 0, 0, 105.0, 608, 31753, 46, 1.2276801000000006
47, 0, 0, 0, 0, 155.0, 741, 32494, 47, 1.5284452000000073
48, 0, 0, 0, 0, 220.0, 1085, 33579, 48, 2.1316744000000085
49, 0, 0, 0, 0, 155.0, 623, 34202, 49, 1.2800238999999891
50, 0, 0, 0, 0, 80.0, 586, 34788, 50, 1.2346872000000104
51, 0, 0, 0, 0, 165.0, 584, 35372, 51, 1.2621460999999954
52, 0, 0, 0, 0, 225.0, 947, 36319, 52, 1.928711199999995
53, 0, 0, 0, 0, 180.0, 651, 36970, 53, 1.3196030000000007
54, 0, 0, 0, 0, 55.0, 587, 37557, 54, 1.193473400000002
55, 0, 0, 0, 0, 125.0, 600, 38157, 55, 1.2128817000000112
56, 0, 0, 0, 0, 210.0, 701, 38858, 56, 1.4332548000000003
57, 0, 0, 0, 0, 120.0, 683, 39541, 57, 1.3889276000000024
58, 0, 0, 0, 0, 415.0, 1190, 40731, 58, 2.363841199999996
59, 0, 0, 0, 0, 180.0, 694, 41425, 59, 1.3954233999999985
60, 0, 0, 0, 0, 120.0, 598, 42023, 60, 1.2393074000000013
61, 0, 0, 0, 0, 60.0, 393, 42416, 61, 0.8129567000000009
62, 0, 0, 0, 0, 55.0, 592, 43008, 62, 1.2301281000000017
63, 0, 0, 0, 0, 265.0, 957, 43965, 63, 1.9531233999999955
64, 0, 0, 0, 0, 110.0, 571, 44536, 64, 1.180017499999991
65, 0, 0, 0, 0, 120.0, 792, 45328, 65, 1.6407700999999975
66, 0, 0, 0, 0, 130.0, 657, 45985, 66, 1.3667023
67, 0, 0, 0, 0, 105.0, 389, 46374, 67, 0.8057297999999946
68, 0, 0, 0, 0, 200.0, 828, 47202, 68, 1.6721260999999998
69, 0, 0, 0, 0, 260.0, 1020, 48222, 69, 2.0507948999999996
70, 0, 0, 0, 0, 155.0, 733, 48955, 70, 1.5235843000000102
71, 0, 0, 0, 0, 75.0, 514, 49469, 71, 1.0989167999999978
72, 0, 0, 0, 0, 360.0, 832, 50301, 72, 1.7422355000000067
73, 0, 0, 0, 0, 210.0, 812, 51113, 73, 1.6459820999999977
74, 0, 0, 0, 0, 75.0, 794, 51907, 74, 1.6036392999999975
75, 0, 0, 0, 0, 180.0, 709, 52616, 75, 1.4653641000000022
76, 0, 0, 0, 0, 225.0, 858, 53474, 76, 1.7599139999999949
77, 0, 0, 0, 0, 45.0, 506, 53980, 77, 1.0241565999999978
78, 0, 0, 0, 0, 110.0, 469, 54449, 78, 1.0092108000000053
79, 0, 0, 0, 0, 210.0, 810, 55259, 79, 1.6148589999999956
80, 0, 0, 0, 0, 110.0, 608, 55867, 80, 1.2460446999999988
81, 0, 0, 0, 0, 90.0, 618, 56485, 81, 1.2781599999999997
82, 0, 0, 0, 0, 80.0, 387, 56872, 82, 0.8012448000000063
83, 0, 0, 0, 0, 90.0, 615, 57487, 83, 1.2485941999999994
84, 0, 0, 0, 0, 155.0, 663, 58150, 84, 1.3467497999999978
85, 0, 0, 0, 0, 140.0, 630, 58780, 85, 1.304651199999995
86, 0, 0, 0, 0, 210.0, 831, 59611, 86, 1.7642178000000115
87, 0, 0, 0, 0, 145.0, 790, 60401, 87, 1.6457009000000085
88, 0, 0, 0, 0, 300.0, 976, 61377, 88, 1.9742228000000068
89, 0, 0, 0, 0, 210.0, 864, 62241, 89, 1.7382077999999979
90, 0, 0, 0, 0, 85.0, 488, 62729, 90, 1.019124000000005
91, 0, 0, 0, 0, 95.0, 424, 63153, 91, 0.8677419999999927
92, 0, 0, 0, 0, 110.0, 751, 63904, 92, 1.5287563999999918
93, 0, 0, 0, 0, 145.0, 645, 64549, 93, 1.3070985999999891
94, 0, 0, 0, 0, 105.0, 684, 65233, 94, 1.4015064999999822
95, 0, 0, 0, 0, 125.0, 623, 65856, 95, 1.2696808000000033
96, 0, 0, 0, 0, 120.0, 706, 66562, 96, 1.425416399999989
97, 0, 0, 0, 0, 45.0, 490, 67052, 97, 1.044156799999996
98, 0, 0, 0, 0, 55.0, 515, 67567, 98, 1.080398400000007
99, 0, 0, 0, 0, 140.0, 706, 68273, 99, 1.471402299999994
100, 0, 0, 0, 0, 240.0, 796, 69069, 100, 1.6192206000000056
101, 0, 0, 0, 0, 170.0, 637, 69706, 101, 1.3032341000000258
102, 0, 0, 0, 0, 110.0, 649, 70355, 102, 1.3201024000000245
103, 0, 0, 0, 0, 50.0, 590, 70945, 103, 1.2258462000000065
104, 0, 0, 0, 0, 15.0, 510, 71455, 104, 1.042683299999993
105, 0, 0, 0, 0, 135.0, 761, 72216, 105, 1.5133325000000184
106, 0, 0, 0, 0, 320.0, 757, 72973, 106, 1.5641868999999815
107, 0, 0, 0, 0, 305.0, 1085, 74058, 107, 2.1565923
108, 0, 0, 0, 0, 60.0, 646, 74704, 108, 1.3478933999999754
109, 0, 0, 0, 0, 30.0, 439, 75143, 109, 0.8985582999999906
110, 0, 0, 0, 0, 100.0, 587, 75730, 110, 1.2092477999999858
111, 0, 0, 0, 0, 360.0, 1010, 76740, 111, 2.024635399999994
112, 0, 0, 0, 0, 135.0, 838, 77578, 112, 1.7221941000000243
113, 0, 0, 0, 0, 120.0, 688, 78266, 113, 1.4115112000000067
114, 0, 0, 0, 0, 245.0, 1007, 79273, 114, 2.049431499999997
115, 0, 0, 0, 0, 30.0, 351, 79624, 115, 0.7448161999999741
116, 0, 0, 0, 0, 200.0, 815, 80439, 116, 1.6808917999999835
117, 0, 0, 0, 0, 380.0, 966, 81405, 117, 1.962498299999993
118, 0, 0, 0, 0, 405.0, 1261, 82666, 118, 2.495399099999986
119, 0, 0, 0, 0, 80.0, 453, 83119, 119, 0.9469260999999847
120, 0, 0, 0, 0, 110.0, 520, 83639, 120, 1.0876376999999877
121, 0, 0, 0, 0, 500.0, 1260, 84899, 121, 2.5503336999999817
122, 0, 0, 0, 0, 180.0, 824, 85723, 122, 1.7527947000000097
123, 0, 0, 0, 0, 135.0, 648, 86371, 123, 1.315604900000011
124, 0, 0, 0, 0, 125.0, 804, 87175, 124, 1.620443899999998
125, 0, 0, 0, 0, 225.0, 861, 88036, 125, 1.724189899999999
126, 0, 0, 0, 0, 110.0, 602, 88638, 126, 1.268400100000008
127, 0, 0, 0, 0, 80.0, 529, 89167, 127, 1.0754109000000085
128, 0, 0, 0, 0, 30.0, 625, 89792, 128, 1.2946951000000126
129, 0, 0, 0, 0, 140.0, 478, 90270, 129, 0.9807478000000174
130, 0, 0, 0, 0, 135.0, 595, 90865, 130, 1.2415893000000153
131, 0, 0, 0, 0, 105.0, 655, 91520, 131, 1.374057300000004
132, 0, 0, 0, 0, 45.0, 619, 92139, 132, 1.267800099999988
133, 0, 0, 0, 0, 275.0, 1104, 93243, 133, 2.239952399999993
134, 0, 0, 0, 0, 325.0, 848, 94091, 134, 1.755189300000012
135, 0, 0, 0, 0, 105.0, 645, 94736, 135, 1.2982312000000036
136, 0, 0, 0, 0, 130.0, 658, 95394, 136, 1.3848628000000076
137, 0, 0, 0, 0, 210.0, 838, 96232, 137, 1.6977441999999883
138, 0, 0, 0, 0, 80.0, 568, 96800, 138, 1.1824320999999998
139, 0, 0, 0, 0, 125.0, 825, 97625, 139, 1.6625295999999992
140, 0, 0, 0, 0, 325.0, 1039, 98664, 140, 2.026533600000022
141, 0, 0, 0, 0, 215.0, 739, 99403, 141, 1.4998254999999858
142, 0, 0, 0, 0, 150.0, 480, 99883, 142, 0.9987265000000036
143, 23.812663113228, 26.739207450789635, 34.8424975703461, 0.9098213499999999, 110.0, 514, 100397, 143, 4.013866900000011
144, 15.401152837346173, 26.583531036711577, 33.20876006912767, 0.9093353499999998, 120.0, 684, 101081, 144, 6.065202900000003
145, 12.369152916210323, 26.57928974357619, 32.72146218227053, 0.9087859000000001, 110.0, 537, 101618, 145, 4.838012599999985
146, 13.002614017243081, 26.55997700522132, 32.69449582201369, 0.9082269999999998, 155.0, 705, 102323, 146, 6.22152490000002
147, 10.825736585181303, 26.537913718920077, 32.41452882530984, 0.9076694500000002, 45.0, 534, 102857, 147, 4.831416399999995
148, 12.859139503030987, 26.59211540222168, 32.688711719198544, 0.9071015499999999, 135.0, 728, 103585, 148, 6.520184599999993
149, 12.79479498280153, 26.552990723295228, 32.4934345801272, 0.9065053000000002, 80.0, 597, 104182, 149, 5.506678800000003
150, 11.237944275652191, 26.575656111266422, 32.420100127293054, 0.9059482000000004, 125.0, 641, 104823, 150, 5.825332899999978
151, 9.898161854273008, 26.470009395615065, 32.13776321175658, 0.9054410499999995, 35.0, 486, 105309, 151, 4.523814300000026
152, 9.378777959990122, 26.45829645035759, 32.17939449491955, 0.9049955500000003, 80.0, 504, 105813, 152, 4.780667499999993
153, 11.304938920964933, 26.4345367575345, 32.09999108967716, 0.90450595, 180.0, 584, 106397, 153, 5.3259616999999935
154, 13.228880316870553, 26.550990333877692, 32.2926929249483, 0.9039753999999997, 95.0, 595, 106992, 154, 5.591123799999991
155, 10.73736777778208, 26.46684148890027, 32.057448680584244, 0.9034034499999999, 135.0, 676, 107668, 155, 6.705149699999993
156, 9.31004529175935, 26.515722158926504, 32.07455540692365, 0.9027955000000002, 65.0, 675, 108343, 156, 6.357492799999989
157, 11.060649134618853, 26.484490762891063, 32.06852253379724, 0.9023158000000003, 55.0, 391, 108734, 157, 3.7263710999999944
158, 9.697413222254994, 26.440947855744408, 32.00954497640378, 0.9017546500000001, 210.0, 856, 109590, 158, 7.846267000000012
159, 11.423247277338415, 26.703753150651078, 32.34975115174971, 0.9011673999999996, 30.0, 449, 110039, 159, 4.2398408000000245
160, 5.641619319934769, 28.11322104503434, 34.06760518199419, 0.9005135499999998, 290.0, 1004, 111043, 160, 9.365958999999975
161, 4.758567048394812, 28.083470534574502, 33.946880942341146, 0.8998178499999996, 105.0, 542, 111585, 161, 5.1245600999999965
162, 4.614556704404367, 28.080383408875964, 34.012986523141805, 0.8993278000000003, 30.0, 547, 112132, 162, 5.184223900000006
163, 6.724520065451181, 28.146404717558173, 34.21033443601328, 0.89883055, 115.0, 558, 112690, 163, 5.222628600000007
164, 4.17600987187571, 28.115160324306984, 34.02775437908552, 0.8982855999999995, 180.0, 653, 113343, 164, 6.173167799999987
165, 6.284948950522654, 28.116976341041358, 34.124700659674566, 0.8978252500000001, 50.0, 370, 113713, 165, 3.5785655999999904
166, 5.1824975557949235, 28.128890825354535, 34.025200484455496, 0.8973482500000003, 135.0, 690, 114403, 166, 6.439141600000028
167, 6.790235101793533, 28.14596842756175, 34.15901446627082, 0.8965477000000003, 310.0, 1089, 115492, 167, 10.242581500000028
168, 6.978502842282632, 28.131487714164578, 34.09547296513471, 0.8955707499999994, 200.0, 1082, 116574, 168, 10.359394000000009
169, 3.9604149143605962, 28.003334802428792, 33.80279885268793, 0.8946779500000007, 475.0, 902, 117476, 169, 8.750185299999998
170, 4.1300063890904, 28.075406428272967, 33.93332585440282, 0.8938571500000003, 425.0, 922, 118398, 170, 9.24500599999999
171, 5.608318175481453, 28.03822710923071, 34.01010356089061, 0.89322715, 105.0, 478, 118876, 171, 4.720032300000014
172, 5.373699083297736, 28.13433985736296, 34.03426206613154, 0.8927658999999994, 120.0, 547, 119423, 172, 5.391676999999959
173, 5.384455096069724, 28.143933281302452, 34.01502253115177, 0.8922317500000002, 115.0, 640, 120063, 173, 6.192866399999957
174, 11.428474835836356, 28.59254713884489, 34.750408578106736, 0.8917723, 80.0, 381, 120444, 174, 3.72811310000003
175, 4.673256318491349, 28.551130029344066, 34.571469978778225, 0.8913389499999997, 75.0, 582, 121026, 175, 5.854749000000027
176, 8.686972797977543, 28.519173571223465, 34.68564653226913, 0.8906977000000004, 210.0, 843, 121869, 176, 8.102393099999972
177, 9.418861203537082, 28.55243615598868, 34.71383045840737, 0.8900465499999995, 30.0, 604, 122473, 177, 5.911749900000018
178, 6.058421189188957, 28.434141159057617, 34.489133281707765, 0.8895947500000001, 90.0, 400, 122873, 178, 3.7019553000000087
179, 6.523790905282304, 28.531175314413534, 34.611355173265615, 0.8892482500000002, 40.0, 370, 123243, 179, 3.5438431999999693
180, 4.650777412636179, 28.50630785982374, 34.55857632059447, 0.8887622500000001, 140.0, 710, 123953, 180, 6.66359239999997
181, 5.881059513262057, 28.510375903811227, 34.61174128897748, 0.8881714000000005, 105.0, 603, 124556, 181, 5.374359599999991
182, 6.979178681255372, 28.462221798226853, 34.59530714366062, 0.8876278000000002, 50.0, 605, 125161, 182, 5.746808699999974
183, 6.040037365910941, 28.51723289816347, 34.64114310970045, 0.8870927499999995, 100.0, 584, 125745, 183, 5.500344200000029
184, 5.808784435934095, 28.487838369341038, 34.597405755341946, 0.8865284499999999, 135.0, 670, 126415, 184, 6.288569399999972
185, 4.317316644512147, 28.462902871987566, 34.55242367318496, 0.8859992499999998, 110.0, 506, 126921, 185, 4.655999000000008
186, 6.6036444875247335, 28.472242307662963, 34.59856935388902, 0.8854655500000004, 155.0, 680, 127601, 186, 6.474975400000005
187, 6.09234661438192, 28.40281641980012, 34.501370310783386, 0.88498675, 130.0, 384, 127985, 187, 3.7274431000000163
188, 7.203667164756981, 28.44767939020722, 34.520209293946664, 0.8844890499999997, 180.0, 722, 128707, 188, 6.821734499999991
189, 5.481625349353679, 28.471272593101684, 34.585284170825865, 0.8839022500000004, 55.0, 582, 129289, 189, 5.639646499999969
190, 5.653933210256859, 28.47167101351291, 34.674069990734544, 0.8834185000000001, 155.0, 493, 129782, 190, 4.637813499999993
191, 5.291546002573644, 28.696637858947117, 34.70855639626583, 0.8828510499999999, 170.0, 768, 130550, 191, 7.278696099999991
192, 4.64769362108289, 28.872311270668646, 34.838981554036685, 0.8823438999999997, 75.0, 359, 130909, 192, 3.49438889999999
193, 4.79738455289119, 28.776904997954496, 34.7421283433244, 0.8817660999999998, 230.0, 925, 131834, 193, 8.897926900000016
194, 4.429025818251378, 28.8412911836885, 34.82432316971503, 0.8810965000000004, 55.0, 563, 132397, 194, 5.561752200000001
195, 3.9728612757722535, 28.77248191197713, 34.74183625857035, 0.8805731500000001, 80.0, 600, 132997, 195, 5.766723299999967
196, 4.801539479425825, 28.779013337122713, 34.75409820321373, 0.8797924, 545.0, 1135, 134132, 196, 10.71529750000002
197, 4.390068382915409, 28.87943737863124, 34.88085866467706, 0.8790859, 80.0, 435, 134567, 197, 4.3012932999999975
198, 4.4045455042156965, 28.794205960587473, 34.746588115411186, 0.8786151999999994, 55.0, 611, 135178, 198, 5.979028099999937
199, 6.969232958663876, 28.807750289638836, 34.83086282263199, 0.8779946499999998, 180.0, 768, 135946, 199, 7.55259239999998
200, 5.639362285107509, 28.811835849986355, 34.8365473402032, 0.8772512500000001, 305.0, 884, 136830, 200, 8.746493900000019
201, 6.023650031420732, 28.739634621920057, 34.77099908445104, 0.8765357500000002, 210.0, 706, 137536, 201, 6.962283800000023
202, 6.9688044915875444, 28.784755943444843, 34.84758023497273, 0.8759133999999995, 135.0, 677, 138213, 202, 6.682705100000021
203, 4.105446054176851, 28.768511357933583, 34.658786918177746, 0.8754305499999999, 105.0, 396, 138609, 203, 3.929086200000029
204, 6.821516799941828, 28.772331307721046, 34.774444621070444, 0.8748964000000007, 200.0, 791, 139400, 204, 7.83390159999999
205, 4.773890195700985, 28.80634073416392, 34.78244041479551, 0.8742596500000002, 110.0, 624, 140024, 205, 6.018344500000012
206, 3.5871885888207187, 29.21752367749739, 35.25897737439169, 0.8736026500000001, 200.0, 836, 140860, 206, 8.076750699999934
207, 2.706428865926253, 29.2173134897657, 35.21192429102764, 0.8730527499999998, 85.0, 386, 141246, 207, 3.8089983999999504
208, 2.567779506153011, 29.185614589131326, 35.149530938054106, 0.8726153500000003, 35.0, 586, 141832, 208, 5.746075700000006
209, 4.976948593106114, 29.21155081181168, 35.28333748650229, 0.8718845500000006, 285.0, 1038, 142870, 209, 10.097107999999935
210, 2.647393728763553, 29.177775069621273, 35.13171191579707, 0.8711641000000003, 55.0, 563, 143433, 210, 5.552010099999961
211, 6.695930169916064, 29.218446132418833, 35.38918231056525, 0.87066865, 80.0, 538, 143971, 211, 5.2759569999999485
212, 6.427860608555616, 29.230398545205343, 35.33642524389376, 0.869781249999999, 625.0, 1434, 145405, 212, 13.905990100000054
213, 3.1149813361095195, 29.229529507852863, 35.20637900718334, 0.8685752500000002, 395.0, 1246, 146651, 213, 12.132390900000019
214, 5.3174162756710155, 29.281283799016663, 35.37020219333509, 0.8675847999999996, 200.0, 955, 147606, 214, 9.41450020000002
215, 2.847897086668797, 29.195328640215326, 35.208889330276335, 0.8669768499999999, 45.0, 396, 148002, 215, 3.9502902000000404
216, 4.05663819601551, 29.271853376882145, 35.35561087184821, 0.8665169500000002, 120.0, 626, 148628, 216, 6.207679000000098
217, 5.08173909534315, 29.273902036451382, 35.364693115405345, 0.8657533000000002, 285.0, 1071, 149699, 217, 10.585924400000067
218, 2.644979916698873, 29.39219887746273, 35.44241007184342, 0.8650368999999999, 35.0, 521, 150220, 218, 5.201126400000021
219, 3.655536138598066, 29.766235265244532, 35.960320507522916, 0.8644941999999994, 110.0, 685, 150905, 219, 6.912408300000038
220, 2.5775877403410252, 29.64488223493953, 35.73317920990865, 0.8638718500000001, 135.0, 698, 151603, 220, 7.0257881
221, 3.7061578119256358, 29.86995754953388, 36.09478298004313, 0.8633043999999995, 85.0, 563, 152166, 221, 5.777164599999992
222, 4.045680176070828, 29.787840809419304, 35.89066754374907, 0.8628859000000002, 75.0, 367, 152533, 222, 3.6806285999999773
223, 6.807802852178285, 29.77910571480462, 36.18265318787472, 0.8624624500000002, 105.0, 574, 153107, 223, 5.816867500000058
224, 7.9700110183707595, 29.782977768470502, 36.06661141494225, 0.8619431499999997, 45.0, 580, 153687, 224, 5.9492475000000695
225, 3.774004957530514, 29.70110306833851, 35.84779891521936, 0.8610660999999997, 260.0, 1369, 155056, 225, 13.883022600000004
226, 2.175807918968836, 29.63725698016598, 35.712189572389754, 0.8602102000000001, 50.0, 533, 155589, 226, 5.5073486
227, 4.453479665478269, 29.668430397957316, 35.84856657088297, 0.859699, 60.0, 603, 156192, 227, 6.084812199999988
228, 4.689085111861497, 29.726977760882924, 35.941508080158194, 0.8592039999999996, 80.0, 497, 156689, 228, 5.181425099999956
229, 2.390740441131592, 29.746122305297853, 35.85785048217773, 0.8586991, 150.0, 625, 157314, 229, 6.595753599999966
230, 5.747989435857675, 29.753180739635557, 36.05087159524752, 0.8581321000000002, 115.0, 635, 157949, 230, 6.611267200000043
231, 4.658928607719313, 29.754102009468504, 35.894732573832165, 0.8575632999999995, 105.0, 629, 158578, 231, 6.495791900000086
232, 2.2249969709468513, 29.72429579684609, 35.80059285414846, 0.8571092499999999, 80.0, 380, 158958, 232, 4.001344099999983
233, 4.14397703076696, 29.767982169104727, 35.95714140551256, 0.8567632000000001, 135.0, 389, 159347, 233, 4.621508399999925
234, 2.289893756225172, 29.761747125889613, 35.875970932410254, 0.8562987999999995, 210.0, 643, 159990, 234, 6.34552240000005
235, 3.373299119614662, 29.205059735753064, 35.273329723523574, 0.8556669999999998, 170.0, 761, 160751, 235, 7.779363399999966
236, 4.993200118314324, 29.130872007969028, 35.2265697876153, 0.8548574500000005, 510.0, 1038, 161789, 236, 10.7693759
237, 3.2568610598624663, 29.129449121217995, 35.16181551712463, 0.8540366500000001, 215.0, 786, 162575, 237, 7.922480300000075
238, 7.026049197873407, 29.198802395007533, 35.46625877774025, 0.8533166499999992, 230.0, 814, 163389, 238, 8.605919900000004
239, 5.156292389907422, 29.24134382778716, 35.31239981461738, 0.8526560500000002, 135.0, 654, 164043, 239, 6.900991900000008
240, 7.243064040702145, 29.16501371938599, 35.37610029025804, 0.8518946500000002, 270.0, 1038, 165081, 240, 10.730920099999935
241, 3.349766040175164, 29.13864150054183, 35.14966759124359, 0.8511157, 180.0, 693, 165774, 241, 7.33799769999996
242, 2.8649859768894568, 29.127336761977645, 35.144423836229485, 0.850189599999999, 235.0, 1365, 167139, 242, 14.31990350000001
243, 2.3209270388352166, 29.1170754388114, 35.13531269834049, 0.8492864499999997, 100.0, 642, 167781, 243, 6.765311100000076
244, 3.1783643867614, 29.171789968621706, 35.234741111552374, 0.8485916500000004, 265.0, 902, 168683, 244, 9.618805299999963
245, 3.4427447875091466, 29.114125329094964, 35.15835824988523, 0.8479526499999998, 65.0, 518, 169201, 245, 5.4445766999999705
246, 3.3303545181912586, 29.170296948655206, 35.22463957707685, 0.8474203, 85.0, 665, 169866, 246, 7.051790099999948
247, 4.2196632717405596, 29.181802939809312, 35.23819221709131, 0.8468141500000002, 170.0, 682, 170548, 247, 7.271629100000041
248, 3.568821566659964, 29.13870723817757, 35.18728649908091, 0.8462682999999996, 125.0, 531, 171079, 248, 5.655545800000027
249, 8.490257975661148, 29.309483167141845, 35.49806429616925, 0.8457904, 50.0, 531, 171610, 249, 5.6284184999999525
250, 4.086128754015459, 29.246443908180346, 35.32562948528089, 0.84536335, 45.0, 418, 172028, 250, 4.497587900000099
251, 6.216281550134247, 29.207682520420708, 35.319968337629305, 0.8447274999999992, 210.0, 995, 173023, 251, 10.609577700000045
252, 2.010991328579937, 29.170953998070754, 35.12260598432042, 0.8440543, 110.0, 501, 173524, 252, 5.456826299999989
253, 3.8885005602362352, 29.226222411944317, 35.24484916833731, 0.84345445, 260.0, 832, 174356, 253, 8.926479900000004
254, 3.8819222065535457, 29.155465133468827, 35.21811010187322, 0.8429068000000002, 45.0, 385, 174741, 254, 4.130960699999946
255, 3.340017698017828, 29.195478696995945, 35.22728506776411, 0.8424604, 75.0, 607, 175348, 255, 6.448867099999916
256, 4.039229206082654, 29.134417292415986, 35.19037133618131, 0.8416931499999991, 180.0, 1098, 176446, 256, 11.771524200000044
257, 2.2839192077643364, 29.110908443863327, 35.091533135723424, 0.8409326499999997, 105.0, 592, 177038, 257, 6.46358500000008
258, 4.051842167449733, 29.240869727333102, 35.315779684605864, 0.8403526000000006, 155.0, 697, 177735, 258, 7.908556100000055
259, 5.01725894325812, 29.244968654853956, 35.36185104506357, 0.8396357499999999, 315.0, 896, 178631, 259, 9.667148200000042
260, 3.547310792876564, 29.167525103203992, 35.21868182216632, 0.8388198999999995, 225.0, 917, 179548, 260, 10.14743580000004
261, 2.4648911341753874, 29.36836453524503, 35.41938626838453, 0.8380360000000002, 175.0, 825, 180373, 261, 8.856279599999993
262, 2.2585007745371417, 29.594432613666243, 35.68800655071552, 0.8373722500000002, 80.0, 650, 181023, 262, 6.927055799999948
263, 3.86491434832491, 29.626746796206294, 35.79071276317271, 0.8367314499999997, 210.0, 774, 181797, 263, 8.1612654999999
264, 4.964779578096726, 29.678413869072408, 35.89947599747602, 0.8360006499999998, 155.0, 850, 182647, 264, 9.070424900000035
265, 5.836329597851326, 29.684012572392227, 35.84365609975961, 0.8354485, 35.0, 377, 183024, 265, 4.045494100000042
266, 6.806284379742363, 29.582530618147416, 35.74558984929865, 0.8350313499999998, 75.0, 550, 183574, 266, 6.034505299999864
267, 2.920125535679941, 29.59504923553686, 35.69203272508925, 0.8344702000000003, 180.0, 697, 184271, 267, 7.679081799999949
268, 6.2177293001569325, 29.66085970718249, 35.8728288175484, 0.8338005999999996, 215.0, 791, 185062, 268, 8.728739599999926
269, 3.236771871033427, 29.55025423435643, 35.63709541419884, 0.8332021000000003, 55.0, 539, 185601, 269, 6.030202899999949
270, 3.813697063544793, 29.581126516731224, 35.71538341579153, 0.8327786500000001, 110.0, 402, 186003, 270, 4.4822518000000855
271, 3.069441987964131, 29.58638479672289, 35.72688184648552, 0.83219545, 215.0, 894, 186897, 271, 9.927960600000006
272, 3.407459531597898, 29.592759959390186, 35.70951658982122, 0.8310884500000002, 610.0, 1566, 188463, 272, 17.00322149999988
273, 3.1076056088044166, 29.618207074893864, 35.72451880570183, 0.8300521000000005, 225.0, 737, 189200, 273, 8.269354399999884
274, 3.5725258331518788, 29.58604709241889, 35.70385277133797, 0.8294472999999994, 95.0, 607, 189807, 274, 6.823702499999854
275, 3.0741377090336757, 29.646949833631517, 35.760338419675826, 0.8288861500000001, 150.0, 640, 190447, 275, 7.085313899999846
276, 3.907021315492009, 29.712803029254616, 35.9110698811866, 0.8280612999999993, 380.0, 1193, 191640, 276, 13.33391370000004
277, 3.0694773207678168, 29.677303361111, 35.770973496358906, 0.8272499500000001, 50.0, 610, 192250, 277, 6.761986500000148
278, 3.9254503075409617, 29.736803864452646, 35.890474437069315, 0.8264719000000001, 300.0, 1119, 193369, 278, 12.41900499999997
279, 3.1536653515007833, 29.67791102381815, 35.79982334908298, 0.8256412000000001, 165.0, 727, 194096, 279, 8.113714399999935
280, 3.709500283503409, 29.71349896571433, 35.83616274456645, 0.8251398999999998, 40.0, 387, 194483, 280, 4.3205365999999685
281, 5.439702780528605, 29.768213478853387, 35.94077370289541, 0.8247997, 45.0, 369, 194852, 281, 4.179249100000106
282, 6.198748946078539, 29.69320687499468, 35.92184057033819, 0.8242723000000005, 240.0, 803, 195655, 282, 8.93023119999998
283, 2.087634240123066, 29.650336751164616, 35.70901161193848, 0.8234947000000004, 285.0, 925, 196580, 283, 10.391726199999994
284, 2.221488374378978, 29.64151471425472, 35.70518268238414, 0.8227022499999997, 260.0, 836, 197416, 284, 9.481453000000101
285, 2.8268313347767573, 29.646531373163832, 35.754719802536805, 0.8219178999999996, 215.0, 907, 198323, 285, 10.03675659999999
286, 4.966561542636337, 29.710929825936883, 35.94805059499986, 0.8213176, 130.0, 427, 198750, 286, 4.867483900000025
287, 2.020906488461928, 29.65761226692585, 35.74679899890013, 0.8209027, 80.0, 495, 199245, 287, 6.004248299999972
288, 4.311693054658395, 29.747530923373457, 35.9147296819518, 0.8204005000000002, 55.0, 621, 199866, 288, 7.392335199999934
289, 3.1152364033173603, 29.838953106258664, 35.99802943207029, 0.8197799499999995, 180.0, 758, 200624, 289, 9.109236699999883
290, 2.736630793616079, 29.8360749790781, 35.96104941778333, 0.8189523999999998, 405.0, 1081, 201705, 290, 13.900145199999997
291, 3.091784235046644, 29.717054372000355, 35.828322892972444, 0.8181180999999997, 195.0, 773, 202478, 291, 9.140833499999871
292, 3.5833387214753056, 29.804314859774934, 35.97883269366096, 0.8173418500000001, 230.0, 952, 203430, 292, 11.260569100000112
293, 7.163423123630694, 29.839382356212987, 36.061128683720135, 0.8166204999999997, 115.0, 651, 204081, 293, 7.942899200000056
294, 5.516775334943776, 29.836997727994564, 36.030935255686444, 0.8160845500000001, 85.0, 540, 204621, 294, 6.519363099999964
295, 3.6732796162281556, 29.860686935541285, 36.03308232139995, 0.8156057499999998, 120.0, 524, 205145, 295, 6.339967500000057
296, 3.946395956530519, 29.766788441201914, 35.906863502834156, 0.8150594500000005, 180.0, 690, 205835, 296, 8.405021799999986
297, 3.763943623676896, 29.721661905561174, 35.83245474679129, 0.8144339500000001, 150.0, 700, 206535, 297, 8.552148699999861
298, 2.7468360507374197, 29.83155177555941, 35.95078894540593, 0.8135780499999992, 445.0, 1202, 207737, 298, 14.413592199999812
299, 3.2260628235648734, 29.83401126950012, 35.97733662117393, 0.8127459999999997, 130.0, 647, 208384, 299, 7.935139899999967
300, 1.8017136325649286, 29.767869613130213, 35.83995751203117, 0.8121893500000004, 110.0, 590, 208974, 300, 7.641217200000028
301, 4.000289665747818, 29.84103141189618, 36.00487243099797, 0.8116007499999999, 150.0, 718, 209692, 301, 8.822724499999822
302, 3.08850635606142, 30.568292808114435, 36.86684044620447, 0.8108672499999995, 160.0, 912, 210604, 302, 11.288121300000057
303, 3.029675338179254, 31.046190962623864, 37.41102466034813, 0.8101751500000001, 180.0, 626, 211230, 303, 7.624315900000056
304, 2.1285224619011083, 30.973761273853814, 37.33643584939378, 0.8097125500000001, 35.0, 402, 211632, 304, 4.889911400000074
305, 2.2037847651865894, 30.906093794540322, 37.27137933763046, 0.8092094500000002, 140.0, 716, 212348, 305, 8.883342599999878
306, 3.3175541805777766, 31.017597922606946, 37.379068348505726, 0.8086572999999998, 80.0, 511, 212859, 306, 6.577459900000122
307, 5.475406139593706, 31.030907490907282, 37.510578863508485, 0.8082649, 50.0, 361, 213220, 307, 4.706718499999852
308, 2.084833014392998, 31.00165803258012, 37.33896203545051, 0.8078810500000002, 45.0, 492, 213712, 308, 6.692489099999875
309, 2.2597755838396414, 30.98118174570911, 37.35333798966318, 0.8074211499999999, 90.0, 530, 214242, 309, 6.833772700000054
310, 7.371932109989344, 31.026237881372847, 37.55882456340487, 0.8068991499999998, 210.0, 630, 214872, 310, 7.998165399999834
311, 1.9595309921248247, 30.987270185933312, 37.32383081334582, 0.8063114500000003, 85.0, 676, 215548, 311, 8.393550599999799
312, 3.6052010149185025, 31.00706419417668, 37.4211607935496, 0.8056571499999995, 125.0, 778, 216326, 312, 11.228249199999937
313, 5.25433531395573, 30.926068877153856, 37.36130739915817, 0.80513875, 35.0, 374, 216700, 313, 4.930630699999938
314, 2.3140519452018617, 30.95485045115153, 37.27287413768279, 0.8047949500000001, 135.0, 390, 217090, 314, 5.061056999999892
315, 2.8063385541211154, 31.027502378575942, 37.419808883666995, 0.8042369500000001, 180.0, 850, 217940, 315, 10.708466199999975
316, 2.02072888300842, 30.943605807592284, 37.279794180168295, 0.8034728500000001, 240.0, 848, 218788, 316, 10.653205999999955
317, 4.335360096362266, 31.01014857658973, 37.437589351947494, 0.8026817499999993, 225.0, 910, 219698, 317, 11.564272699999947
318, 3.356616912121625, 30.908010341211693, 37.24531392362929, 0.8020540000000003, 30.0, 485, 220183, 318, 6.088962400000128
319, 4.132565623461293, 30.639779613707876, 36.97687549881524, 0.8016584499999998, 65.0, 394, 220577, 319, 4.970638200000167
320, 3.6992717160430457, 30.58803220630921, 36.83958820460998, 0.80130655, 60.0, 388, 220965, 320, 4.977886699999999
321, 2.101977173177019, 30.687276392458987, 36.9466734161659, 0.8008885000000001, 20.0, 541, 221506, 321, 6.983490400000164
322, 2.1017108971259715, 30.712210091211464, 36.97505496308795, 0.8003939499999999, 110.0, 558, 222064, 322, 7.703846399999975
323, 4.264732817958297, 30.662103801799592, 37.05070165168482, 0.7997391999999993, 180.0, 897, 222961, 323, 11.692220000000134
324, 4.28089036075442, 30.721672302866953, 37.05603386725245, 0.7990480000000001, 155.0, 639, 223600, 324, 7.920508100000006
325, 2.8993945435966766, 30.56107896532331, 36.81682796478272, 0.7984454499999998, 155.0, 700, 224300, 325, 8.963779599999953
326, 2.8265944287946434, 30.64573709312448, 36.93021559629816, 0.7977538, 65.0, 837, 225137, 326, 10.596995800000059
327, 3.040491510612896, 30.65506630175744, 36.95253895118969, 0.7970810499999995, 155.0, 658, 225795, 327, 8.730582299999924
328, 3.2972110745080094, 30.583431946183847, 36.87981386064984, 0.79656985, 20.0, 478, 226273, 328, 6.618874000000005
329, 2.0625827268887593, 30.692365605344055, 36.945363182149904, 0.7961455000000001, 65.0, 465, 226738, 329, 6.331137699999999
330, 2.8926415729873067, 30.632100729534, 36.90393494383171, 0.7956261999999998, 135.0, 689, 227427, 330, 9.314794699999993
331, 3.981286862608335, 30.651791962167074, 36.922565316795406, 0.7951366, 55.0, 399, 227826, 331, 5.216049800000064
332, 3.2384997019519712, 30.616649471949444, 36.93175358893685, 0.7944444999999996, 275.0, 1139, 228965, 332, 14.736792499999865
333, 2.3225658788196926, 30.569379165498585, 36.78380750627848, 0.7936588000000002, 110.0, 607, 229572, 333, 8.15837590000001
334, 3.1334555709868837, 30.59037904510216, 36.86812513284454, 0.7931421999999997, 155.0, 541, 230113, 334, 7.417720500000087
335, 4.042080563922424, 30.43883505532908, 36.689455259351824, 0.7925698000000005, 135.0, 731, 230844, 335, 10.792559400000073
336, 3.105635289647176, 30.480298446720855, 36.73506340529652, 0.79192675, 120.0, 698, 231542, 336, 10.309227199999896
337, 1.9661742008048546, 30.46383651816715, 36.66640085586334, 0.7913241999999999, 180.0, 641, 232183, 337, 9.534459200000128
338, 2.0724385536433236, 30.518997833345185, 36.77791324312478, 0.7908148, 105.0, 491, 232674, 338, 6.921803599999976
339, 1.9041410280152773, 30.449590179247735, 36.64962553366637, 0.7904183499999998, 90.0, 390, 233064, 339, 5.570506000000023
340, 2.2771215131939497, 30.46531782039376, 36.738310741823774, 0.7899332499999999, 145.0, 688, 233752, 340, 9.172577300000057
341, 2.2653227175904225, 30.498315452451518, 36.727347134250415, 0.7893748000000002, 180.0, 553, 234305, 341, 7.0858943999999155
342, 1.905632257517253, 30.42469802927748, 36.65803216239002, 0.7888851999999997, 75.0, 535, 234840, 342, 6.586242700000184
343, 2.820766666380262, 30.510295680625166, 36.76046241755157, 0.7879707999999995, 615.0, 1497, 236337, 343, 19.717627900000025
344, 1.9209145971929984, 30.408947015509884, 36.639184678302094, 0.7870523500000003, 80.0, 544, 236881, 344, 6.88538850000009
345, 2.6320789585065354, 30.539965402592987, 36.78555924939008, 0.78630085, 215.0, 1126, 238007, 345, 14.390221899999915
346, 3.208520690356594, 30.529841997376344, 36.80179527204355, 0.7853121999999998, 500.0, 1071, 239078, 346, 13.280970799999977
347, 2.778871745526515, 30.580237717540175, 36.83076137525064, 0.7844414499999999, 210.0, 864, 239942, 347, 11.195062600000028
348, 2.970054589405907, 30.477821046323907, 36.700250897254186, 0.7837588, 90.0, 653, 240595, 348, 8.296283099999982
349, 3.70761532353452, 30.581359403063082, 36.88533249105909, 0.7831292499999993, 145.0, 746, 241341, 349, 9.287931999999955
350, 2.7957852357665582, 30.577462989435237, 36.855421390279886, 0.7824889, 150.0, 677, 242018, 350, 8.53318830000012
351, 2.6553237066318256, 30.620286317371885, 36.870936036683595, 0.7817167000000004, 265.0, 1039, 243057, 351, 13.599263399999927
352, 4.592284932723338, 30.682299112267884, 36.99553274339245, 0.7808864499999999, 300.0, 806, 243863, 352, 10.411252299999887
353, 4.898422652908133, 30.612381285866775, 36.94763471312442, 0.7802051499999993, 155.0, 708, 244571, 353, 10.280563499999971
354, 2.5331464215348585, 30.552956758803017, 36.79462608316801, 0.7793866000000005, 300.0, 1111, 245682, 354, 15.958342499999844
355, 4.723085489964231, 30.598227298006098, 36.89125325629052, 0.7786751500000002, 110.0, 470, 246152, 355, 6.232425400000011
356, 3.367179332828637, 30.601108164234734, 36.88116464492077, 0.77804425, 340.0, 932, 247084, 356, 12.49414129999991
357, 5.0307190529822154, 30.6908302537485, 37.01166784129857, 0.7774385500000001, 50.0, 414, 247498, 357, 5.516360999999961
358, 2.760530844558153, 30.570357909224963, 36.8516121358379, 0.7768688499999997, 260.0, 852, 248350, 358, 11.403645200000028
359, 1.918022890299011, 30.63042686242131, 36.877734717421646, 0.776314, 40.0, 381, 248731, 359, 5.177397599999949
360, 4.1794656926581455, 30.65549534863538, 36.957105212741425, 0.7758428500000002, 165.0, 666, 249397, 360, 8.95471090000001
361, 3.9064475547750543, 31.190120225631063, 37.59100703064155, 0.7751098000000001, 220.0, 963, 250360, 361, 13.111092899999903
362, 7.459628307129726, 32.0592377875462, 38.738015277326596, 0.7744586499999997, 125.0, 484, 250844, 362, 6.418347900000072
363, 1.9532768165071805, 31.91938862443781, 38.397792151833876, 0.7739100999999998, 185.0, 735, 251579, 363, 9.914417199999889
364, 1.9095611261915786, 31.910120140195517, 38.408759299872436, 0.7731496000000001, 440.0, 955, 252534, 364, 13.067580399999997
365, 2.9047666454851377, 31.99162419637044, 38.556354171561395, 0.7723972000000002, 180.0, 717, 253251, 365, 9.88508499999989
366, 2.3508852276136167, 31.990302208811045, 38.544834949076176, 0.7718441499999996, 150.0, 512, 253763, 366, 7.136301799999956
367, 3.0771948327768053, 31.963186778813927, 38.52167344948803, 0.7713253000000002, 180.0, 641, 254404, 367, 8.813944400000082
368, 3.8633529703225453, 31.96078466744947, 38.51068446773509, 0.7708649500000001, 45.0, 382, 254786, 368, 5.397628300000179
369, 1.987349194150192, 31.973821737514896, 38.464298705323436, 0.7704113499999995, 145.0, 626, 255412, 369, 8.549455099999932
370, 5.232319166481784, 32.03517001775743, 38.651119303105816, 0.7695730000000001, 185.0, 1237, 256649, 370, 16.774149800000032
371, 5.499053953942677, 31.98858412324566, 38.624437214577036, 0.7687535500000001, 115.0, 584, 257233, 371, 8.001658599999928
372, 4.497628579359679, 31.949548456403946, 38.5135611276778, 0.7681505500000005, 75.0, 756, 257989, 372, 10.964437699999962
373, 3.30651834644719, 31.981676202301585, 38.49094828334423, 0.7676141499999998, 30.0, 436, 258425, 373, 6.009172400000125
374, 3.945359270163633, 32.03449639647898, 38.59628507344409, 0.7670615500000003, 155.0, 792, 259217, 374, 10.283091000000013
375, 2.9640596861662303, 32.050222377416176, 38.59837080887485, 0.7663959999999996, 105.0, 687, 259904, 375, 8.882047199999988
376, 3.1709818305084254, 31.585100144874758, 38.03939878068319, 0.7657916500000004, 180.0, 656, 260560, 376, 8.688556500000004
377, 2.2322738360447487, 31.445606677142425, 37.83878067243378, 0.7652845, 110.0, 471, 261031, 377, 6.305017399999997
378, 4.481593208971099, 31.541736026642248, 38.070218306321365, 0.7648326999999996, 50.0, 533, 261564, 378, 7.00703580000004
379, 2.848718590791938, 31.477156263836743, 37.89811376424936, 0.7642886500000003, 105.0, 676, 262240, 379, 8.842330199999878
380, 4.278347081971254, 31.574548683914482, 38.061968934302236, 0.7637319999999999, 90.0, 561, 262801, 380, 7.452478699999801
381, 5.72344499344843, 31.500209366065867, 38.016965937959974, 0.7633243000000002, 60.0, 345, 263146, 381, 4.531470199999603
382, 2.197077853840658, 31.431786855061848, 37.77549323816409, 0.76301245, 60.0, 348, 263494, 382, 4.7927215999998225
383, 2.0121603691661862, 31.493920718448262, 37.93121474360076, 0.7625363500000002, 180.0, 710, 264204, 383, 9.760986799999955
384, 3.1069623641234045, 31.573427903024776, 38.036678492674355, 0.7619090499999998, 105.0, 684, 264888, 384, 9.23240910000004
385, 4.729083473151318, 31.618063235602005, 38.143141365415964, 0.7613658999999999, 75.0, 523, 265411, 385, 6.9012752000003275
386, 3.3736775688215825, 31.48805479839955, 37.951531395362544, 0.7606971999999996, 225.0, 963, 266374, 386, 12.708665200000269
387, 2.4597330506631745, 31.496950973957887, 37.93288384741479, 0.7596496000000006, 430.0, 1365, 267739, 387, 17.830795299999863
388, 4.882859014939321, 31.577790589583547, 38.08422586942974, 0.7586078500000004, 265.0, 950, 268689, 388, 12.65966810000009
389, 6.477723780663768, 31.518876248268626, 38.055276199800886, 0.7580012499999997, 30.0, 398, 269087, 389, 5.256574600000022
390, 2.607600624925724, 31.43137801142022, 37.819114994766686, 0.7573676499999994, 260.0, 1010, 270097, 390, 13.49424560000034
391, 4.04407735994229, 31.280799971360427, 37.74135150615986, 0.7566206499999999, 150.0, 650, 270747, 391, 8.926551600000039
392, 3.4036294360569603, 31.31147670960641, 37.7726525701918, 0.7559285500000005, 210.0, 888, 271635, 392, 11.99731789999987
393, 4.071562013694591, 31.368884901993905, 37.814451940408645, 0.7551999999999996, 180.0, 731, 272366, 393, 9.816273700000238
394, 2.8201420287547445, 31.32282679421561, 37.72656078439541, 0.7545308500000001, 125.0, 756, 273122, 394, 10.494976399999814
395, 3.966479706126869, 31.358041589910332, 37.81677141488043, 0.7538887, 105.0, 671, 273793, 395, 9.348550200000318
396, 3.2990957799692815, 31.359749114365947, 37.771695758590916, 0.7531138000000004, 210.0, 1051, 274844, 396, 14.919714500000282
397, 3.43324282086981, 31.35495313211752, 37.77138184536253, 0.7522182999999996, 455.0, 939, 275783, 397, 12.811111999999866
398, 1.8821952734561114, 31.324932036774882, 37.685150033972235, 0.7514753500000002, 155.0, 712, 276495, 398, 10.9411726000003
399, 5.070697155482364, 31.387567256231726, 37.85625963990793, 0.7508687499999995, 180.0, 636, 277131, 399, 8.751196100000016
400, 2.151045078746231, 31.42138394019556, 37.7864858453924, 0.7503796000000001, 80.0, 451, 277582, 400, 6.122280399999909
401, 4.7243275521415296, 31.406123986574684, 37.87904596612005, 0.7499494000000002, 65.0, 505, 278087, 401, 6.901037500000257
402, 4.939808873433946, 31.424687952489897, 37.86513591362035, 0.7494291999999995, 65.0, 651, 278738, 402, 8.66157340000018
403, 2.895514159833487, 31.278126490421784, 37.676251704876236, 0.7488554500000003, 60.0, 624, 279362, 403, 8.48704110000017
404, 5.412856231774668, 31.326849510602635, 37.77864121293168, 0.7482227500000002, 360.0, 782, 280144, 404, 10.694439200000033
405, 3.6023011703375745, 31.212563639535954, 37.594277386890035, 0.7476989500000001, 50.0, 382, 280526, 405, 5.191706099999919
406, 4.105629801669574, 31.299644275647594, 37.69751270182166, 0.7472359000000001, 155.0, 647, 281173, 406, 8.830919100000301
407, 2.0043479219873244, 31.192987103147555, 37.5238292616636, 0.7467674499999998, 30.0, 394, 281567, 407, 5.429854599999999
408, 3.5625630383575606, 31.260767018572885, 37.6498216529176, 0.7460829999999993, 370.0, 1127, 282694, 408, 15.532467100000304
409, 4.199686762822819, 31.292144312374834, 37.73604978340259, 0.7453274499999998, 80.0, 552, 283246, 409, 7.883959199999936
410, 2.018715254279107, 31.206510140345646, 37.57330778787827, 0.7447748500000004, 165.0, 676, 283922, 410, 9.58785910000006
411, 5.264658189774462, 31.30074631882195, 37.76224984918236, 0.7441137999999999, 85.0, 793, 284715, 411, 11.113816000000043
412, 4.273088931513587, 31.33120382272087, 37.761412320530894, 0.7435008999999999, 100.0, 569, 285284, 412, 7.98018490000004
413, 5.546260040911824, 31.334732689968376, 37.79907521979754, 0.7428578500000003, 210.0, 860, 286144, 413, 11.991752899999938
414, 3.6141377770966225, 31.29947423672938, 37.698670051910064, 0.7421432499999999, 215.0, 728, 286872, 414, 11.66182660000004
415, 4.776294893225687, 31.31219994812681, 37.73314787630449, 0.74161045, 85.0, 456, 287328, 415, 6.8478697999998985
416, 3.5337400113786837, 31.34152967381805, 37.75148535617911, 0.7411761999999998, 65.0, 509, 287837, 416, 7.109807799999999
417, 2.9660160070390997, 31.223636509013872, 37.6257111291672, 0.7406857, 155.0, 581, 288418, 417, 8.179831800000102
418, 1.7143165807746634, 31.224137614044963, 37.535500930834424, 0.7401398500000002, 115.0, 632, 289050, 418, 9.686637899999823
419, 3.6916905692008535, 31.32351168434764, 37.71167031235582, 0.7395125499999998, 120.0, 762, 289812, 419, 11.13168590000032
420, 3.014682301691285, 31.11302677295826, 37.45138741387261, 0.7388659000000001, 135.0, 675, 290487, 420, 9.307901599999695
421, 3.374737963437083, 30.969105045846167, 37.306640361217745, 0.7383929499999997, 65.0, 376, 290863, 421, 5.385195599999861
422, 4.053795075328772, 31.003491577828765, 37.34731924457915, 0.7379411499999997, 110.0, 628, 291491, 422, 8.798737099999926
423, 2.8032575480900443, 31.05250749121179, 37.36671194863486, 0.7373368, 180.0, 715, 292206, 423, 9.92730279999978
424, 3.112398097013456, 31.008865497410746, 37.36093834694334, 0.7367166999999996, 125.0, 663, 292869, 424, 9.466916400000173
425, 4.08420885049484, 31.09563268025716, 37.50588535732693, 0.7359728500000001, 215.0, 990, 293859, 425, 14.31360339999992
426, 3.840029165167408, 31.097732608479664, 37.48653473053361, 0.7351682499999994, 255.0, 798, 294657, 426, 11.294677899999897
427, 2.185330420905458, 31.123821125711714, 37.43921374252864, 0.73455715, 85.0, 560, 295217, 427, 7.89962770000011
428, 1.907675123957044, 30.98530401418959, 37.285444388045235, 0.7339374999999999, 410.0, 817, 296034, 428, 11.596034000000145
429, 4.014884391943703, 31.072532826945896, 37.43813950674875, 0.7332674500000002, 180.0, 672, 296706, 429, 9.719496100000015
430, 2.9263342878328746, 31.056676283633728, 37.40648093372362, 0.7326621999999997, 210.0, 673, 297379, 430, 9.592146200000116
431, 4.5092394137692535, 31.089446902008397, 37.44716080616518, 0.7319570499999999, 215.0, 894, 298273, 431, 12.821155399999952
432, 3.384044437323298, 31.110554060644034, 37.55604639637227, 0.7313342499999999, 135.0, 490, 298763, 432, 7.001266700000087
433, 3.632941040036069, 31.06753349739667, 37.42238996671215, 0.73091665, 10.0, 438, 299201, 433, 6.531517099999746
434, 3.231558788949005, 31.119316457203947, 37.51512707585278, 0.7304689, 55.0, 557, 299758, 434, 8.21271650000017
435, 5.06199310895811, 31.74046689813787, 38.256529621311, 0.72996085, 95.0, 572, 300330, 435, 8.209321400000135
436, 2.2703351285890676, 32.27996451407671, 38.843050099909306, 0.7294730499999998, 10.0, 512, 300842, 436, 7.514473199999884
437, 5.146620192390062, 32.20226055710569, 38.85478119199168, 0.7288570000000003, 210.0, 857, 301699, 437, 12.506047200000012
438, 3.4362583834696654, 32.2281831137499, 38.84340517245345, 0.7281131499999999, 175.0, 796, 302495, 438, 11.53313560000015
439, 1.8055184361953585, 32.13028646802145, 38.683987608410064, 0.7274714500000002, 135.0, 630, 303125, 439, 9.006948499999908
440, 3.2232164120572246, 32.22814206180409, 38.80598856608073, 0.7269246999999996, 65.0, 585, 303710, 440, 8.422784200000024
441, 7.854067574483606, 32.22476323595587, 38.99107529082388, 0.7264706500000001, 55.0, 424, 304134, 441, 6.168071699999928
442, 4.201035607282974, 32.31810132989056, 38.98315580359333, 0.7258856500000005, 260.0, 876, 305010, 442, 13.021456599999965
443, 4.320746528862183, 32.16975775237911, 38.86477416803029, 0.7252736500000001, 30.0, 484, 305494, 443, 7.246928199999729
444, 1.8061493955491508, 32.22085591613269, 38.80661074841609, 0.7248362500000001, 105.0, 488, 305982, 444, 7.118790400000307
445, 3.465265334940039, 32.31401278236495, 38.98292319126393, 0.7242260499999998, 225.0, 868, 306850, 445, 12.827796500000204
446, 2.9177712507932276, 32.25710419125027, 38.93108726784035, 0.7232279500000003, 315.0, 1350, 308200, 446, 19.63840859999982
447, 2.0190922925869623, 32.19652222437216, 38.81639456782781, 0.7223032000000006, 210.0, 705, 308905, 447, 10.316208299999744
448, 4.399465476878849, 32.20118570517734, 38.95915384786537, 0.7217600500000001, 55.0, 502, 309407, 448, 7.40608710000015
449, 3.42353219762748, 32.24886356011913, 38.8731223492904, 0.7210922499999993, 215.0, 982, 310389, 449, 14.35287580000022
450, 4.2978017126698145, 32.39118912727985, 39.06892548082034, 0.7203610000000001, 120.0, 643, 311032, 450, 9.470435899999757
451, 3.555729297135258, 32.36962266266346, 39.05083853751421, 0.7198412499999994, 75.0, 512, 311544, 451, 7.4553163000000495
452, 2.105773458822856, 32.2752621472712, 38.84975549171894, 0.7192877500000004, 210.0, 718, 312262, 452, 10.793498099999852
453, 4.085201436117369, 32.34562872342414, 39.025950686469756, 0.71879275, 30.0, 382, 312644, 453, 5.693659099999877
454, 3.0410241669667957, 32.42950791897981, 39.09156063206665, 0.7182689499999995, 180.0, 782, 313426, 454, 11.651778299999933
455, 5.135510871753237, 32.405900148015036, 39.160903380582326, 0.7176299500000003, 85.0, 638, 314064, 455, 9.488059599999815
456, 2.020287990154866, 32.38903214540275, 38.96237899496828, 0.7170521499999996, 155.0, 646, 314710, 456, 9.446918000000096
457, 2.1720890036575455, 32.311308313588626, 38.90359349068397, 0.7164320500000002, 155.0, 732, 315442, 457, 11.063726999999744
458, 2.196391082469875, 32.29479157355346, 38.92258609048537, 0.7157916999999998, 155.0, 691, 316133, 458, 10.396450299999742
459, 2.950490211317128, 32.3745478585709, 39.02589012486066, 0.7150163499999999, 335.0, 1032, 317165, 459, 15.389567100000022
460, 4.326852901832207, 32.363934096756516, 39.034356790822706, 0.7142945499999998, 35.0, 572, 317737, 460, 8.644757200000186
461, 2.2235088810349137, 32.3561438308365, 38.99457809059882, 0.7134890500000003, 300.0, 1218, 318955, 461, 17.932807199999843
462, 3.92707046440399, 32.45045417872893, 39.13575780982438, 0.7125867999999996, 185.0, 787, 319742, 462, 11.80006719999983
463, 4.072037167225026, 32.8529717715933, 39.60635118081536, 0.7117853500000006, 170.0, 994, 320736, 463, 15.988342000000102
464, 2.870547512683226, 32.98940229070001, 39.72155634035101, 0.7109038000000003, 230.0, 965, 321701, 464, 15.101724799999829
465, 3.0344547303434997, 32.96413834559085, 39.69772382512312, 0.7101666999999997, 150.0, 673, 322374, 465, 10.131705799999963
466, 2.313207210816335, 32.868158932008605, 39.555696404498555, 0.7097086, 30.0, 345, 322719, 466, 5.2379924000001665
467, 2.147427315994636, 32.860940087701856, 39.53632251700175, 0.7093351000000001, 110.0, 485, 323204, 467, 7.391782400000011
468, 3.2490886943027997, 32.9336675119857, 39.62753726727665, 0.7088351499999999, 70.0, 626, 323830, 468, 9.443097800000032
469, 6.874452257743555, 32.95551547980515, 39.78434873011328, 0.7081903000000005, 225.0, 807, 324637, 469, 12.372699099999863
470, 4.17723382642843, 32.861081602722884, 39.59592241131157, 0.7074036999999997, 230.0, 941, 325578, 470, 14.147793000000092
471, 4.09562284400983, 32.9589218117974, 39.7133267196742, 0.7066634500000002, 105.0, 704, 326282, 471, 10.852913599999738
472, 1.9835934104242672, 32.94043650229772, 39.603063927756416, 0.70608745, 145.0, 576, 326858, 472, 8.774906000000101
473, 4.231488101697023, 32.92206897793925, 39.72876516686303, 0.7055339500000003, 210.0, 654, 327512, 473, 10.0019084999999
474, 3.463958761388831, 32.93688280377014, 39.64072517919402, 0.7047748, 285.0, 1033, 328545, 474, 16.07383350000009
475, 4.338256546330673, 32.96806576811237, 39.72493440133554, 0.7040183500000001, 135.0, 648, 329193, 475, 11.034661400000005
476, 2.220305144524154, 32.92322901273385, 39.59222572889083, 0.70344595, 150.0, 624, 329817, 476, 9.616442000000006
477, 5.282302429519243, 32.80878018583927, 39.55729355737177, 0.7029932499999998, 90.0, 382, 330199, 477, 5.780873299999712
478, 4.6018081324738125, 32.88627372944474, 39.60606601246172, 0.7021441, 580.0, 1505, 331704, 478, 22.881555399999797
479, 1.994343550068739, 32.832078451379715, 39.44896181411366, 0.7009205499999998, 565.0, 1214, 332918, 479, 18.77687100000003
480, 4.934484598063506, 32.93335610414162, 39.7365814443735, 0.6999355, 425.0, 975, 333893, 480, 14.964254900000014
481, 8.892747139274064, 33.06310503765688, 39.947885319338006, 0.6992843500000001, 65.0, 472, 334365, 481, 7.693141499999911
482, 5.211166371378982, 32.925172023986136, 39.65492898919746, 0.6987897999999995, 180.0, 627, 334992, 482, 9.821448000000146
483, 3.764283067245823, 32.82132023527422, 39.46789954576177, 0.6983308000000001, 55.0, 393, 335385, 483, 6.162820000000011
484, 2.020107517530763, 32.85171756589316, 39.50880922767205, 0.6978772000000001, 130.0, 615, 336000, 484, 9.505440599999929
485, 5.948029471694359, 33.01084532624199, 39.813327437355404, 0.6972980499999994, 310.0, 672, 336672, 485, 10.474040200000218
486, 1.8598643441218883, 32.9081361182034, 39.56808099895716, 0.69676525, 80.0, 512, 337184, 486, 8.047073799999907
487, 3.1353905250000818, 32.99389236786237, 39.74789082712295, 0.6962589999999999, 75.0, 613, 337797, 487, 9.96555649999982
488, 4.156293020703624, 32.978849058589105, 39.740921204194244, 0.6955812999999997, 175.0, 893, 338690, 488, 14.28099229999998
489, 4.773500458600412, 32.888286088259164, 39.6690853206256, 0.69494365, 70.0, 524, 339214, 489, 8.237348699999984
490, 3.59710146540224, 32.855118142233955, 39.565336977994, 0.69431905, 235.0, 864, 340078, 490, 13.719223600000078
491, 3.117960294217788, 32.75069371997963, 39.42184971137931, 0.6933888999999998, 315.0, 1203, 341281, 491, 19.044563700000253
492, 4.831358454931738, 32.847449333262894, 39.58167205666596, 0.69237055, 510.0, 1060, 342341, 492, 16.656118799999604
493, 2.8672982705557564, 32.739268002832155, 39.41171327493532, 0.6916203999999997, 110.0, 607, 342948, 493, 9.669367299999976
494, 5.718375410065874, 32.86196663091471, 39.650441274538146, 0.6911834499999999, 35.0, 364, 343312, 494, 5.781123300000218
495, 3.326005815785864, 32.75593952013099, 39.409937133789064, 0.6907608999999999, 45.0, 575, 343887, 495, 9.273258400000032
496, 2.8190818642069213, 32.81626502465183, 39.48691278851797, 0.6901232499999993, 170.0, 842, 344729, 496, 13.488351599999987
497, 2.185380365476822, 32.77903521579245, 39.42603121633115, 0.6894131500000001, 180.0, 736, 345465, 497, 11.697283399999833
498, 2.192118305684645, 32.81258093918426, 39.44854991285107, 0.6889042000000001, 35.0, 395, 345860, 498, 6.5868648999999095
499, 3.7556598341713348, 32.739797070914626, 39.416626804015216, 0.6883592500000003, 180.0, 816, 346676, 499, 13.134724400000323
500, 2.8393898877054085, 32.73543654363741, 39.42124796978593, 0.6876293499999996, 210.0, 806, 347482, 500, 12.932149000000209
501, 2.735979420521803, 32.76355410347208, 39.43853883799056, 0.6868818999999999, 230.0, 855, 348337, 501, 13.786599499999738
502, 5.205027484454764, 32.822341378410805, 39.623912954151855, 0.6861366999999998, 210.0, 801, 349138, 502, 12.955257999999958
503, 2.6855437151389197, 32.757501447200774, 39.445317435264585, 0.6853442500000001, 440.0, 960, 350098, 503, 15.52397480000036
504, 3.59805038657853, 32.67704611591909, 39.35790116759552, 0.6845207499999992, 155.0, 870, 350968, 504, 14.230392299999949
505, 3.8962101127511253, 32.654441028110654, 39.33126437068836, 0.6838138000000001, 180.0, 701, 351669, 505, 11.267996200000198
506, 3.7149950892428043, 32.71756476071214, 39.33961950312007, 0.6833246499999999, 40.0, 386, 352055, 506, 6.204764300000079
507, 2.608481426374514, 32.631395783593554, 39.23843154205443, 0.6828085000000004, 155.0, 761, 352816, 507, 12.137430800000402
508, 4.113840127232855, 32.61831123209752, 39.326473745075155, 0.6821524, 165.0, 697, 353513, 508, 11.199848599999768
509, 4.620187685923753, 32.69813196298777, 39.413848487510556, 0.6812789499999996, 460.0, 1244, 354757, 509, 20.275274199999785
510, 5.289153450405689, 32.63628316354629, 39.29783687248328, 0.6805440999999998, 65.0, 389, 355146, 510, 6.484844399999929
511, 3.726111925136489, 32.71393572613779, 39.384397124311455, 0.6800009500000004, 110.0, 818, 355964, 511, 13.632212999999865
512, 2.9683755915327175, 32.59250073330847, 39.23113612370389, 0.67933855, 170.0, 654, 356618, 512, 11.415141799999674
513, 4.166779962184437, 32.71405109203455, 39.40585877003677, 0.6787639000000002, 105.0, 623, 357241, 513, 10.330199200000152
514, 3.3499230645220797, 32.61696440039979, 39.254077750870756, 0.6778418500000007, 365.0, 1426, 358667, 514, 24.996346800000083
515, 2.2703751323946344, 32.5862116175852, 39.20808634788367, 0.6769175500000001, 105.0, 628, 359295, 515, 12.97857920000024
516, 3.7717891668617236, 32.704835572524, 39.39181456807873, 0.6759788499999991, 715.0, 1458, 360753, 516, 25.717000800000278
517, 3.317891873972583, 32.665069461717735, 39.3305421947584, 0.6748804, 240.0, 983, 361736, 517, 17.14213380000001
518, 4.0035087294736, 32.62642347073619, 39.27717106554386, 0.67410415, 120.0, 742, 362478, 518, 12.853703600000244
519, 2.181058115086385, 32.57585112435477, 39.17692582266671, 0.6736127499999999, 55.0, 350, 362828, 519, 5.96291519999977
520, 3.131285713817286, 32.696079952323174, 39.342917427467036, 0.6731663499999999, 80.0, 642, 363470, 520, 10.98270730000013
521, 5.184838006192856, 32.66492196823601, 39.37525886929138, 0.67256335, 155.0, 698, 364168, 521, 11.952032199999849
522, 3.623455825250551, 32.68519976563562, 39.37420160479973, 0.6719130999999998, 210.0, 747, 364915, 522, 13.215386999999737
523, 1.8097414879401525, 32.58781903584798, 39.141812978108725, 0.6714081999999999, 55.0, 375, 365290, 523, 6.884961499999918
524, 2.0070074263869264, 32.653354212132896, 39.23186268690156, 0.67105495, 90.0, 410, 365700, 524, 7.6251352999997835
525, 4.344192519783974, 32.65538981664095, 39.37419374040562, 0.6706202499999996, 45.0, 556, 366256, 525, 9.934664099999736
526, 4.531182223242165, 32.66540031135082, 39.340902253985405, 0.6700244500000002, 140.0, 768, 367024, 526, 13.555485699999736
527, 2.3536113426680605, 32.71733170842368, 39.33377072167775, 0.6694520499999997, 45.0, 504, 367528, 527, 8.791364700000031
528, 7.9369704470528895, 32.6850504531382, 39.40402077582189, 0.6689381500000003, 140.0, 638, 368166, 528, 11.320119799999702
529, 4.561828691297568, 32.67815654747055, 39.32219266038292, 0.6681983499999999, 290.0, 1006, 369172, 529, 17.721595100000286
530, 2.1702629024734224, 32.616113596129004, 39.18676143275235, 0.6675652000000003, 75.0, 401, 369573, 530, 6.992959600000177
531, 3.0462048175827166, 32.68105049299398, 39.33025986847234, 0.6670747000000001, 110.0, 689, 370262, 531, 11.918163100000129
532, 4.827430522048866, 32.73394285453545, 39.461631586263465, 0.6664370499999995, 140.0, 728, 370990, 532, 13.13111549999985
533, 2.276706030869439, 32.65671371201337, 39.276556313150124, 0.6658705, 10.0, 531, 371521, 533, 9.205298700000185
534, 5.097263876565382, 32.814543411579535, 39.52102910576137, 0.6653142999999999, 320.0, 705, 372226, 534, 11.896341699999994
535, 2.2376741944630254, 32.771568890275624, 39.426192541232055, 0.6646838500000001, 90.0, 696, 372922, 535, 11.545037500000035
536, 4.477862600630485, 32.74518874032157, 39.468972001164595, 0.6640084, 155.0, 805, 373727, 536, 13.704615799999829
537, 2.7593344932826107, 32.748332351603835, 39.394744860936726, 0.6632209000000004, 260.0, 945, 374672, 537, 15.835983800000122
538, 4.013958442667837, 32.73424261855477, 39.43541082951695, 0.6625108, 125.0, 633, 375305, 538, 10.971496000000116
539, 4.998502653401889, 32.904891101965745, 39.653692909840785, 0.6620256999999998, 90.0, 445, 375750, 539, 7.486795900000288
540, 3.171709123458302, 32.811868393834835, 39.49294713619003, 0.66154015, 105.0, 634, 376384, 540, 10.852823700000044
541, 3.7272608036160144, 32.714795042448536, 39.4201905564976, 0.6610897, 100.0, 367, 376751, 541, 7.402115899999899
542, 4.441091880569317, 32.79043623261851, 39.50061210857824, 0.6605591500000002, 415.0, 812, 377563, 542, 14.712725899999896
543, 4.8171420634508655, 32.74273478689846, 39.429240214252054, 0.6598846000000002, 110.0, 687, 378250, 543, 12.685037900000225
544, 2.0942811631359626, 32.75384798711528, 39.37065636365345, 0.6593094999999997, 180.0, 591, 378841, 544, 10.015085500000168
545, 3.3164729134345183, 32.74000137712626, 39.42609384286767, 0.6587929, 140.0, 557, 379398, 545, 9.59940620000043
546, 3.3832802877597072, 32.62290259810055, 39.241363570269414, 0.6582362499999999, 185.0, 680, 380078, 546, 11.700553499999842
547, 2.065762924867567, 32.428592633665275, 38.96291749932793, 0.65777005, 75.0, 356, 380434, 547, 6.044288099999903
548, 3.768528796193366, 32.47676859715188, 39.037537922230804, 0.6574356999999998, 55.0, 387, 380821, 548, 6.620564599999852
549, 4.016286332043646, 32.37373342954633, 38.965154809852294, 0.6569596, 135.0, 671, 381492, 549, 11.705897499999992
550, 3.5858874796383384, 32.44705386453999, 39.04458875295547, 0.6563125, 155.0, 767, 382259, 550, 13.128621099999691
551, 4.367013603220652, 32.3819221118549, 39.00461494514534, 0.6557176000000001, 55.0, 555, 382814, 551, 9.391154099999767
552, 2.309033824596554, 32.35485023771014, 38.88553726332528, 0.6552158499999997, 105.0, 560, 383374, 552, 9.497744400000101
553, 3.9847728993331817, 32.37460406221936, 39.01416464187392, 0.6546056500000003, 165.0, 796, 384170, 553, 13.499814599999809
554, 2.915828576569828, 32.37441992917181, 38.932164170782976, 0.6539067999999998, 180.0, 757, 384927, 554, 13.114588299999923
555, 4.655195565104485, 32.416107051849366, 39.07675542449951, 0.6533411500000001, 80.0, 500, 385427, 555, 8.784120199999961
556, 4.92492676864288, 32.41449391457342, 38.999281198747695, 0.6528929500000002, 110.0, 496, 385923, 556, 9.224988999999823
557, 4.085486773755353, 32.37852340386222, 38.997287901221604, 0.6523286499999995, 355.0, 758, 386681, 557, 13.405507599999964
558, 2.149415267057389, 32.46074433796561, 38.99050617018086, 0.6517728999999998, 110.0, 477, 387158, 558, 8.048933199999738
559, 3.808891197468521, 32.41276723084759, 39.04195963517743, 0.6510798999999997, 470.0, 1063, 388221, 559, 18.0548589
560, 3.7220918045261246, 32.36060502182934, 38.94612512087601, 0.6501646, 460.0, 971, 389192, 560, 16.751496899999893
561, 2.0741230170627434, 32.45539657847087, 39.023828857421876, 0.6493901499999999, 120.0, 750, 389942, 561, 12.835413000000244
562, 3.375666564424401, 31.87280212899913, 38.37573476708454, 0.64853515, 495.0, 1150, 391092, 562, 19.77688339999986
563, 3.8357646083410497, 31.79263632709443, 38.305336857341345, 0.64784575, 50.0, 382, 391474, 563, 6.62506059999987
564, 5.315486868573308, 31.867132445421262, 38.36985639960845, 0.6471991000000006, 245.0, 1055, 392529, 564, 18.49501390000023
565, 6.1022380684218005, 31.786071386737024, 38.341121605056486, 0.6463486000000003, 160.0, 835, 393364, 565, 14.178510199999891
566, 2.8329613712244854, 31.75279844165565, 38.18103232603513, 0.6455237499999998, 440.0, 998, 394362, 566, 17.787456300000485
567, 3.290317807967464, 31.82447560628255, 38.28643961372615, 0.6447884500000002, 140.0, 636, 394998, 567, 10.999203400000624
568, 2.0783252081984567, 31.753762159801664, 38.16105975923084, 0.644266, 100.0, 525, 395523, 568, 8.997072299999672
569, 4.148252088222819, 31.844142560081597, 38.32654726045422, 0.64372645, 210.0, 674, 396197, 569, 11.830328899999586
570, 4.686032597943613, 31.795682758605153, 38.32028217527816, 0.6429781000000001, 305.0, 989, 397186, 570, 16.98898349999945
571, 3.131363678887925, 31.763241406048046, 38.19419663934146, 0.6422270499999999, 185.0, 680, 397866, 571, 11.715025200000127
572, 3.575164316682421, 31.815613547205473, 38.2923749843931, 0.6416843500000002, 85.0, 526, 398392, 572, 9.030814499999906
573, 5.270723372195675, 31.835054914779423, 38.349396887991496, 0.6411605499999996, 160.0, 638, 399030, 573, 11.138601200000267
574, 4.831090514970004, 31.851735574227792, 38.36906672746707, 0.6405575500000003, 185.0, 702, 399732, 574, 12.164372199999889
575, 2.1176221818862877, 31.939921464141904, 38.37642090596555, 0.6400044999999999, 35.0, 527, 400259, 575, 9.094242599999234
576, 2.5529439038230013, 32.02352109096005, 38.4406368368113, 0.6395995000000002, 45.0, 373, 400632, 576, 6.473718899999767
577, 5.476861883370745, 32.12156179228894, 38.67169737615505, 0.6390568000000001, 170.0, 833, 401465, 577, 14.564085500000147
578, 3.9797579135516243, 31.99686489286016, 38.494522474388376, 0.6384920499999998, 80.0, 422, 401887, 578, 7.514892099999997
579, 2.8763787747724447, 32.037113381979225, 38.5249218106408, 0.6379138000000004, 460.0, 863, 402750, 579, 15.318054299999858
580, 3.799151773750782, 32.032748259159554, 38.57129979273032, 0.6371406999999997, 150.0, 855, 403605, 580, 15.002640700000484
581, 5.4816530588454375, 32.09903222429968, 38.68011358792414, 0.6363068499999999, 465.0, 998, 404603, 581, 17.432676100000208
582, 2.222865982680349, 32.01843772636162, 38.49152290069305, 0.6355580499999997, 160.0, 666, 405269, 582, 11.664215099999637
583, 3.6186461254984024, 32.02979061992995, 38.567523112809994, 0.6350324500000001, 50.0, 502, 405771, 583, 8.76787989999957
584, 3.530028148114556, 32.00630154494357, 38.52240920844013, 0.6343786, 145.0, 951, 406722, 584, 16.8679831999998
585, 3.9967314792253696, 31.968374888102215, 38.507298946380615, 0.6337778500000001, 50.0, 384, 407106, 585, 6.9799207999994906
586, 4.522309236166006, 32.12416793914612, 38.69037406601592, 0.6332293000000001, 255.0, 835, 407941, 586, 14.915645699999914
587, 5.858993984178617, 32.034006024052815, 38.58815377022289, 0.6324548500000001, 115.0, 886, 408827, 587, 15.735098500000277
588, 3.6628305896918385, 32.05654450204746, 38.561298998985954, 0.6316165000000001, 165.0, 977, 409804, 588, 17.268785500000376
589, 5.702963784643889, 31.989988940716405, 38.56302227967801, 0.6308272000000004, 465.0, 777, 410581, 589, 13.740362500000629
590, 1.9765807216691011, 31.835573408954826, 38.281842098679654, 0.6300131500000002, 155.0, 1032, 411613, 590, 18.269246200000453
591, 3.1178991746858986, 31.89474322119189, 38.366264540573646, 0.6292094500000001, 135.0, 754, 412367, 591, 13.485035300000163
592, 5.352619882460471, 31.83562005819143, 38.333540168968405, 0.6285704499999998, 105.0, 666, 413033, 592, 12.018886299999394
593, 3.1597719443090297, 31.855592065256804, 38.32956782467847, 0.6279053500000004, 135.0, 812, 413845, 593, 14.474944900000082
594, 5.8312163653265925, 31.882286221404197, 38.46078354499244, 0.6269950000000002, 260.0, 1211, 415056, 594, 21.79374430000007
595, 5.308562083631978, 31.867486719499553, 38.41325044751466, 0.6262705000000003, 85.0, 399, 415455, 595, 7.115779300000213
596, 4.68958179205656, 31.84889281626498, 38.30977836351716, 0.6258906999999999, 30.0, 445, 415900, 596, 7.975470800000039
597, 7.263460635198843, 31.893415330720426, 38.508924942528644, 0.6253552, 460.0, 745, 416645, 597, 13.47372709999945
598, 1.7565119159553235, 31.781158794056285, 38.15753058403771, 0.6246883, 125.0, 737, 417382, 598, 13.249254199999996
599, 3.497215807798938, 31.81603672010783, 38.294188054122586, 0.62394805, 385.0, 908, 418290, 599, 16.632295299999896
600, 3.9818221300434415, 31.81113295066051, 38.33886713248033, 0.62325865, 130.0, 624, 418914, 600, 11.427104800000052
601, 4.132478203751048, 31.784607888676742, 38.23380742714007, 0.6226731999999996, 175.0, 677, 419591, 601, 12.611074800000097
602, 4.119894813061013, 32.13960154414429, 38.70998077311929, 0.6219428500000002, 195.0, 946, 420537, 602, 17.490560999999616
603, 2.86676962396774, 32.27636757647275, 38.80888178728629, 0.6210824500000003, 195.0, 966, 421503, 603, 17.52602449999995
604, 3.795371849825996, 32.3204486788186, 38.90258176230895, 0.6201216999999996, 465.0, 1169, 422672, 604, 21.23520869999993
605, 2.7087234897497003, 32.28408191365407, 38.82277240609764, 0.6192964, 105.0, 665, 423337, 605, 12.18813929999942
606, 3.1221805769251993, 32.338494255819036, 38.89961284151746, 0.6186825999999995, 135.0, 699, 424036, 606, 12.727900299999419
607, 4.202843480830167, 32.36844102326814, 38.96945197303016, 0.61806835, 95.0, 666, 424702, 607, 12.127330000000256
608, 2.6429549300590076, 32.32835793650717, 38.88551073172108, 0.6172857999999997, 220.0, 1073, 425775, 608, 19.5824276000003
609, 5.450508242042587, 32.41892397367629, 39.067043285196654, 0.6163570000000002, 335.0, 991, 426766, 609, 18.25878499999999
610, 3.8418396579640173, 32.38546569426478, 38.9660990294687, 0.6157211500000002, 55.0, 422, 427188, 610, 7.784195799999907
611, 6.196703647928579, 32.491476645836464, 39.07513544061682, 0.6153674499999999, 105.0, 364, 427552, 611, 6.928336899999522
612, 4.506965922778318, 32.37812537865964, 39.00999526907287, 0.61471495, 170.0, 1086, 428638, 612, 20.02924929999972
613, 4.661627616407675, 32.36220162398332, 39.01630379603459, 0.6139688500000001, 10.0, 572, 429210, 613, 10.668622899999718
614, 5.22865104413576, 32.408130808261475, 39.01274693350799, 0.6134104000000001, 80.0, 669, 429879, 614, 12.426850400000149
615, 4.658096015791652, 31.9771981844592, 38.52805698028659, 0.6126733000000002, 220.0, 969, 430848, 615, 17.996070899999722
616, 2.1739362769248274, 31.95115473096734, 38.37760514770912, 0.6119654499999999, 135.0, 604, 431452, 616, 11.264884700000039
617, 5.006255207624457, 31.97177804938472, 38.52738425657921, 0.6113880999999998, 125.0, 679, 432131, 617, 12.629089000000022
618, 4.507167536835959, 32.010426286272526, 38.57651980793307, 0.6107027500000001, 240.0, 844, 432975, 618, 15.74904719999995
619, 3.0384322564526762, 31.91453494289969, 38.36194320635648, 0.6098446000000003, 150.0, 1063, 434038, 619, 19.874512000000323
620, 4.930054735530306, 31.877399081029434, 38.4000169638588, 0.6088680999999997, 250.0, 1107, 435145, 620, 21.091904600000817
621, 4.443861915756595, 31.971872683721113, 38.498542749251065, 0.6078511000000005, 415.0, 1153, 436298, 621, 21.673863800000618
622, 4.371702176602166, 31.938173008139433, 38.4728221021579, 0.6070861000000001, 110.0, 547, 436845, 622, 10.616362400000071
623, 4.281001472114615, 31.970476457121975, 38.46687693585931, 0.6064088500000001, 210.0, 958, 437803, 623, 18.109907600000042
624, 4.451422012626243, 32.05074231329334, 38.553049753862474, 0.6057342999999997, 55.0, 541, 438344, 624, 10.386673200000587
625, 3.292774179758048, 31.925388519039547, 38.403103668077854, 0.6051857500000001, 120.0, 678, 439022, 625, 13.13234840000041
626, 4.013137983452063, 31.992773160685893, 38.48567401692373, 0.6045525999999997, 135.0, 729, 439751, 626, 13.753106899999693
627, 2.05680583434452, 31.840103861762255, 38.23800759199189, 0.60392935, 170.0, 656, 440407, 627, 12.476309599999695
628, 1.876449511379323, 31.649497474682093, 38.03343290063177, 0.6033402999999997, 105.0, 653, 441060, 628, 12.53375320000032
629, 5.732403282234904, 31.777544659473858, 38.34426790247849, 0.6026347000000002, 260.0, 915, 441975, 629, 17.492826499999865
630, 4.162015806965149, 31.792019812033995, 38.263973085723656, 0.6019146999999997, 185.0, 685, 442660, 630, 13.045150799999647
631, 4.980509290333699, 31.70010095466802, 38.19644937986209, 0.6013148500000004, 155.0, 648, 443308, 631, 13.42308469999989
632, 5.6688784414179185, 31.75924062167897, 38.27093778722426, 0.60064075, 270.0, 850, 444158, 632, 16.084873200000402
633, 3.7616779960511835, 31.719664810167004, 38.198728300144126, 0.5997555999999997, 305.0, 1117, 445275, 633, 21.91940599999998
634, 5.4562579324567, 31.767936460595383, 38.27842199425948, 0.5990819499999998, 5.0, 380, 445655, 634, 7.302714699999342
635, 2.744030256625175, 31.741415717175617, 38.151070129468245, 0.5985383500000003, 195.0, 828, 446483, 635, 15.87584489999972
636, 3.0066354491913967, 31.748821332473163, 38.18712757317595, 0.5978755, 210.0, 645, 447128, 636, 12.329628700000285
637, 2.1359849306444327, 31.6614795949724, 38.059995884365506, 0.59726125, 140.0, 720, 447848, 637, 14.133982500000457
638, 2.833400836410721, 31.692039646086144, 38.09703776428795, 0.5965529500000001, 170.0, 854, 448702, 638, 16.457105299999967
639, 3.3933234293263874, 31.78208555986467, 38.280255368572504, 0.5959072000000001, 30.0, 581, 449283, 639, 11.27918310000041
640, 2.023069285421614, 31.74925106320649, 38.16214676945271, 0.5953492, 135.0, 659, 449942, 640, 12.621068299999934
641, 3.980169760433943, 31.766168868211416, 38.278694633272494, 0.5948739999999998, 65.0, 397, 450339, 641, 8.596253400000023
642, 4.011631370673506, 31.771575996344037, 38.237982501571985, 0.5943826000000001, 135.0, 695, 451034, 642, 15.035543699999835
643, 6.141380353377731, 31.753602495770863, 38.3401653154409, 0.5938543000000001, 45.0, 479, 451513, 643, 9.369819200000165
644, 4.484786098395906, 31.74908853546391, 38.21456411718353, 0.5933619999999997, 105.0, 615, 452128, 644, 11.798672599999918
645, 2.0995708553123813, 31.77859365833847, 38.19626085685961, 0.5928328000000002, 95.0, 561, 452689, 645, 10.79610219999995
646, 3.869326532141705, 31.788901645530018, 38.22340184036137, 0.5921721999999997, 140.0, 907, 453596, 646, 17.46319179999955
647, 6.168062256002913, 31.8191494760986, 38.28585927201429, 0.5914553500000003, 45.0, 686, 454282, 647, 13.244324100000085
648, 2.3313351813089715, 31.76396915938828, 38.12530001965198, 0.59098285, 65.0, 364, 454646, 648, 7.080149200000051
649, 4.398069742792813, 31.742907947012938, 38.21671641707634, 0.5905683999999997, 45.0, 557, 455203, 649, 10.788137199999255
650, 3.1890503310043634, 31.80331399867947, 38.27947533623548, 0.5900239000000002, 155.0, 653, 455856, 650, 12.690394600000218
651, 3.75420911099148, 31.74687104206889, 38.208591885036896, 0.5894951500000001, 90.0, 522, 456378, 651, 10.250185000000783
652, 4.60489106654335, 31.77000831542102, 38.24428897261861, 0.5890383999999999, 20.0, 493, 456871, 652, 9.615621299999475
653, 3.3877342594889077, 31.787846051996404, 38.26191478382457, 0.58856905, 75.0, 550, 457421, 653, 10.703702600000724
654, 3.658105777847869, 31.723235208518357, 38.164132815096046, 0.5879538999999999, 125.0, 817, 458238, 654, 15.890929099999994
655, 3.4108510955427747, 31.733885531099688, 38.15962226346413, 0.5872964500000003, 190.0, 644, 458882, 655, 12.688488400000097
656, 2.231015330432815, 31.935229458108072, 38.40526167460065, 0.5868505000000002, 5.0, 347, 459229, 656, 6.872926500000176
657, 4.335805345761552, 31.698654601227343, 38.12811839738081, 0.5862857499999996, 200.0, 908, 460137, 657, 17.881373799999892
658, 3.616035652665797, 31.896009427890217, 38.38594752806925, 0.58548025, 345.0, 882, 461019, 658, 17.867304799999147
659, 3.3771147107213944, 31.88466900918219, 38.348801831404366, 0.5848241499999998, 60.0, 576, 461595, 659, 11.348125599999548
660, 1.8934811886859266, 32.006436162452175, 38.46673587119743, 0.5844006999999999, 55.0, 365, 461960, 660, 7.505395899999712
661, 5.283512428935719, 31.96127012432403, 38.485909581326474, 0.5838589, 205.0, 839, 462799, 661, 18.004179900000054
662, 3.7632388549691833, 31.898044832475907, 38.3810222585638, 0.5828819499999995, 215.0, 1332, 464131, 662, 28.399633699999868
663, 5.690894606542223, 31.985775798356453, 38.50279944283621, 0.5820179499999995, 75.0, 588, 464719, 663, 12.584547499999644
664, 2.182418350864759, 31.89183235621509, 38.313484028795834, 0.5815638999999998, 0.0, 421, 465140, 664, 9.756133000000773
665, 5.32557528659578, 31.968963621072394, 38.51771733775642, 0.5809397499999999, 205.0, 966, 466106, 665, 25.375712600000043
666, 2.7625160519765273, 31.92499400584477, 38.33984059835395, 0.5801063500000002, 315.0, 886, 466992, 666, 30.091501699999753
667, 4.770109080824142, 31.897488003510695, 38.4047946709853, 0.5792396499999999, 250.0, 1040, 468032, 667, 21.50235429999975
668, 4.824144730456622, 31.892599530966883, 38.38654263048287, 0.5785475500000001, 80.0, 498, 468530, 668, 10.302889600000526
669, 4.922701741440429, 31.698358311123318, 38.21066318935818, 0.57812095, 30.0, 450, 468980, 669, 9.142711799999233
670, 4.349895439368581, 31.912274761555697, 38.36097402586314, 0.5776047999999998, 210.0, 697, 469677, 670, 14.615785999999389
671, 3.0440180152124987, 32.00291116090747, 38.4573416416114, 0.57691135, 155.0, 844, 470521, 671, 17.340605200000027
672, 5.855295503398094, 32.014863479527435, 38.587798556765996, 0.5762152, 120.0, 703, 471224, 672, 14.529124300000149
673, 6.056669728863522, 32.02218800042508, 38.51948286090377, 0.5755946500000002, 75.0, 676, 471900, 673, 13.810347399999955
674, 3.2380111690528968, 31.937202006322753, 38.420086587009486, 0.5748183999999993, 320.0, 1049, 472949, 674, 21.552826600000117
675, 3.519061282414826, 31.939387467784492, 38.447827548945455, 0.5741029, 135.0, 541, 473490, 675, 11.182592799999838
676, 3.788052230150779, 31.931323304508776, 38.37833304906363, 0.5734269999999999, 380.0, 961, 474451, 676, 19.730596200000036
677, 4.76835651809012, 32.00798006968656, 38.53518320198877, 0.57253285, 325.0, 1026, 475477, 677, 20.96394229999987
678, 4.5877107268668915, 31.87627244081946, 38.370935023621854, 0.5716981000000002, 215.0, 829, 476306, 678, 16.95453599999928
679, 2.729425856238836, 31.837467837643313, 38.256519357260174, 0.5711518, 50.0, 385, 476691, 679, 7.986660700000357
680, 5.13149025784089, 31.916334149287298, 38.4368356851431, 0.57068605, 55.0, 650, 477341, 680, 13.54112669999995
681, 3.758104936183277, 31.858639251469942, 38.3748809575412, 0.5702211999999999, 55.0, 383, 477724, 681, 7.9307754999999815
682, 3.438843309493928, 31.892278973809603, 38.35351217204127, 0.5697878500000001, 75.0, 580, 478304, 682, 12.128219499999432
683, 5.564433041355994, 31.904797903488145, 38.37975069598383, 0.5690466999999997, 365.0, 1067, 479371, 683, 22.405524999999216
684, 5.267481499973381, 31.964976048541573, 38.493844905288555, 0.5682686499999999, 160.0, 662, 480033, 684, 13.629960700000083
685, 4.620586452334011, 32.12569029357797, 38.65306453988455, 0.5677286500000001, 115.0, 538, 480571, 685, 11.138163800000257
686, 4.321026457142313, 32.19218675758807, 38.732375591146926, 0.5671855000000001, 170.0, 669, 481240, 686, 13.880061900000328
687, 5.067073571255521, 32.089823064312164, 38.64297360310737, 0.5666139999999996, 125.0, 601, 481841, 687, 12.542528400000265
688, 4.572705904650965, 32.166710960943966, 38.70542180143445, 0.5660717500000001, 80.0, 604, 482445, 688, 12.881854299999759
689, 3.485896577822074, 32.12828959737505, 38.58486927123297, 0.56557315, 115.0, 504, 482949, 689, 10.577988899999582
690, 6.442967603115712, 32.275557123604464, 38.898415497602045, 0.5650808499999999, 155.0, 590, 483539, 690, 12.480242199999338
691, 4.281861351238336, 32.1464095984821, 38.67243808081743, 0.5643685, 230.0, 993, 484532, 691, 20.702464099999816
692, 4.128399648952602, 32.11756923411152, 38.60856351757994, 0.5637398499999999, 45.0, 404, 484936, 692, 8.640178900000137
693, 3.724345191595632, 32.117382404935135, 38.58465728622423, 0.5630581000000001, 340.0, 1111, 486047, 693, 23.57516839999971
694, 2.35984741811462, 32.132199325956826, 38.61092233213118, 0.5621239000000001, 330.0, 965, 487012, 694, 20.126669400000537
695, 3.271001423729031, 32.17174371958508, 38.71038642789975, 0.5613953500000002, 140.0, 654, 487666, 695, 13.733615500000269
696, 2.8627212205910637, 32.17043347253954, 38.70057748905681, 0.5606298999999997, 365.0, 1047, 488713, 696, 22.075993299999936
697, 6.819807892414789, 32.232540858112515, 38.951167025018144, 0.5599746999999999, 40.0, 409, 489122, 697, 8.66249439999956
698, 4.348272078525625, 32.35509661423223, 38.943778815364986, 0.5592065500000001, 170.0, 1298, 490420, 698, 27.396083499999804
699, 3.3684666667331533, 32.59546948400673, 39.17177546312268, 0.5582498499999996, 215.0, 828, 491248, 699, 17.434459400000378
700, 5.10030940980773, 32.60964220134836, 39.268388503476196, 0.5573300500000002, 350.0, 1216, 492464, 700, 25.739246099999946
701, 3.3164352547137343, 32.648115839277, 39.23399296394583, 0.5564615500000004, 125.0, 714, 493178, 701, 15.285899299999983
702, 6.703349979510685, 32.61896758834803, 39.30608188457805, 0.5559499000000001, 55.0, 423, 493601, 702, 9.012639700000364
703, 4.441453589960027, 32.55513793987464, 39.1274772770497, 0.5555966499999999, 45.0, 362, 493963, 703, 7.779779299999973
704, 6.162447311840523, 32.636017476005115, 39.312989306175844, 0.55512055, 170.0, 696, 494659, 704, 14.955713100000139
705, 5.156409241968677, 32.59046737731449, 39.24904898559155, 0.5544104500000001, 125.0, 882, 495541, 705, 19.04168539999955
706, 4.784642133799376, 32.609254625880276, 39.23204600368202, 0.5533957000000004, 205.0, 1373, 496914, 706, 29.694564399999763
707, 3.408273319094375, 32.52948780455277, 39.103203775019544, 0.5524956999999996, 145.0, 627, 497541, 707, 14.824310400000286
708, 6.018822397561554, 32.51821980184438, 39.20445139554082, 0.5520371499999998, 90.0, 392, 497933, 708, 8.561433900000338
709, 5.135521362251991, 32.556615574983255, 39.1484106480272, 0.55152685, 125.0, 742, 498675, 709, 16.072610499999428
710, 3.15126608859796, 32.57759653562075, 39.15475655592881, 0.5508464500000003, 170.0, 770, 499445, 710, 16.48267599999963
711, 3.439127983994061, 32.7350421967045, 39.395514715871506, 0.5502209500000002, 45.0, 620, 500065, 711, 13.489388500000132
712, 2.476140267069799, 33.40427440045828, 40.118485083062964, 0.5497925499999997, 25.0, 332, 500397, 712, 7.175912300000164
713, 4.373176894092467, 33.558062021931015, 40.321831246217094, 0.54947035, 35.0, 384, 500781, 713, 8.461152500000026
714, 2.403947457333072, 33.50654463888216, 40.26921558540408, 0.5490298000000001, 160.0, 595, 501376, 714, 12.86106860000018
715, 3.3758217384507927, 33.65399631111527, 40.45641881320143, 0.5482409499999997, 270.0, 1158, 502534, 715, 25.399872799999685
716, 4.736982047681208, 33.6461080587996, 40.45799227646983, 0.5472306999999998, 295.0, 1087, 503621, 716, 24.045456099999683
717, 3.847976505856482, 33.63277731838702, 40.47517363535466, 0.5465071000000001, 70.0, 521, 504142, 717, 11.48744110000007
718, 9.32179271117416, 33.656648527715625, 40.57177279495291, 0.5460107500000002, 110.0, 582, 504724, 718, 12.765884299999925
719, 3.6232945373335217, 33.65025118141692, 40.44037728288055, 0.5454504999999996, 155.0, 663, 505387, 719, 14.38996860000043
720, 3.740765483569015, 33.6003526283033, 40.391895030628554, 0.5447809, 185.0, 825, 506212, 720, 17.870795900000303
721, 4.413586016162138, 33.67115264776501, 40.493613996281496, 0.5440842999999995, 110.0, 723, 506935, 721, 15.648626700000023
722, 4.474107582155988, 33.63814541399178, 40.495385022447856, 0.5433139000000001, 195.0, 989, 507924, 722, 22.185850900000332
723, 3.0418083694187343, 33.55874973601618, 40.35262204696757, 0.5424629499999999, 200.0, 902, 508826, 723, 20.52946840000004
724, 2.9982666988070608, 33.56465898220127, 40.332177567074126, 0.5417677000000001, 145.0, 643, 509469, 724, 14.263054000000011
725, 2.3911434093836075, 33.517433781577246, 40.27461785058634, 0.5412020499999998, 135.0, 614, 510083, 725, 13.86424580000039
726, 3.849862284092626, 33.38456339903281, 40.13177992592395, 0.54067015, 75.0, 568, 510651, 726, 12.426919300000009
727, 2.364574375652841, 33.24840714318412, 39.98315392630441, 0.5400995499999999, 175.0, 700, 511351, 727, 15.534239499999785
728, 3.6311337246665456, 33.28800174168178, 40.025443969593105, 0.5394758500000002, 85.0, 686, 512037, 728, 15.08779659999982
729, 2.319256417321808, 33.359539789312024, 40.10872294482063, 0.5388611499999999, 145.0, 680, 512717, 729, 14.785716600000342
730, 4.926484145424506, 33.30356516113764, 40.04759601701664, 0.5379863499999996, 415.0, 1264, 513981, 730, 27.61414590000004
731, 2.4658647181651845, 33.32415642689184, 40.01714779175434, 0.5371556499999998, 115.0, 582, 514563, 731, 13.106714300000021
732, 3.657637844693923, 33.39406934174352, 40.14973938540093, 0.5366075500000002, 135.0, 636, 515199, 732, 14.18046350000077
733, 3.973935740147057, 33.337030531346116, 40.090876071389154, 0.5360864499999999, 150.0, 522, 515721, 733, 11.75320229999943
734, 4.685734931467417, 33.26123411250564, 40.05115262067543, 0.5354699499999999, 210.0, 848, 516569, 734, 18.816884900000332
735, 3.433437598638484, 33.237738398987, 39.945601293327584, 0.5347904500000003, 180.0, 662, 517231, 735, 14.924155799999426
736, 2.7044390423452294, 33.262243791979884, 39.9560240451263, 0.5339836, 240.0, 1131, 518362, 736, 24.92261679999956
737, 4.450293436482892, 33.26312409117245, 40.07147584867006, 0.5330646999999997, 310.0, 911, 519273, 737, 20.22935099999995
738, 2.5909482658110456, 33.33578713401325, 40.06356337402893, 0.5323546000000001, 165.0, 667, 519940, 738, 14.726575699999557
739, 2.3279931566851064, 33.4426592978756, 40.195786357980914, 0.53185105, 65.0, 452, 520392, 739, 10.088405800000146
740, 3.7553598514557307, 33.47918884156028, 40.28434595033895, 0.5313929499999999, 35.0, 566, 520958, 740, 12.648976800000128
741, 3.6057226638667856, 33.3684566791241, 40.14333150570209, 0.5309042499999999, 115.0, 520, 521478, 741, 11.65285490000042
742, 5.003877360675786, 33.50447603642794, 40.3568619814786, 0.5303039499999999, 160.0, 814, 522292, 742, 18.094342699999288
743, 3.7484840464236933, 33.464156019988906, 40.23816195463876, 0.5296883500000001, 215.0, 554, 522846, 743, 12.372390399999858
744, 4.189400928427545, 33.45246618895458, 40.25132119856041, 0.5288770000000003, 355.0, 1249, 524095, 744, 28.00615740000012
745, 4.866517527579841, 33.5765332705538, 40.35217719682505, 0.5280593499999999, 115.0, 568, 524663, 745, 12.734612299999753
746, 3.3640637520495362, 33.37677815354715, 40.199972996749274, 0.527518, 140.0, 635, 525298, 746, 15.948377799999435
747, 4.599141409084564, 33.41220645439334, 40.11623767759742, 0.5270477500000001, 110.0, 410, 525708, 747, 10.106527400000232
748, 2.662612290378807, 33.49300787910998, 40.252235994944236, 0.5266009, 35.0, 583, 526291, 748, 14.435167399999955
749, 2.617739338442221, 33.47098416690679, 40.222951386326045, 0.52610635, 85.0, 516, 526807, 749, 12.926600199999484
750, 4.707360938423881, 33.49158889306317, 40.348002304339, 0.5255857000000003, 105.0, 641, 527448, 750, 15.936555100000078
751, 2.64844028618913, 33.51847306137565, 40.32667884586742, 0.5250110500000001, 110.0, 636, 528084, 751, 15.657357799999772
752, 2.552999402705905, 33.492787013201806, 40.24025903248188, 0.5244201999999996, 105.0, 677, 528761, 752, 16.68708669999978
753, 6.0926933158725625, 33.52594043394175, 40.36478148566352, 0.5236781500000001, 280.0, 972, 529733, 753, 23.93730669999968
754, 3.3258197704205337, 33.486216928336695, 40.25628923323634, 0.5228510499999998, 205.0, 866, 530599, 754, 21.751415699999598
755, 4.648346890318148, 33.64682496197616, 40.471144277838214, 0.5218925499999999, 625.0, 1264, 531863, 755, 31.54351560000032
756, 3.333169062967067, 33.6019309784149, 40.40967688304839, 0.52093765, 240.0, 858, 532721, 756, 21.834245199999714
757, 6.078526989745095, 33.667420973169044, 40.55490086941009, 0.5202131499999995, 105.0, 752, 533473, 757, 18.834456100000352
758, 5.0590263490725915, 33.62498273440612, 40.457671977691824, 0.5194864, 185.0, 863, 534336, 758, 21.648092899999938
759, 3.2304846398629152, 33.6011449860632, 40.366606768763596, 0.5187861999999995, 170.0, 693, 535029, 759, 17.55402849999973
760, 5.031935832301131, 33.66122444202374, 40.48300049026291, 0.5181278500000002, 205.0, 770, 535799, 760, 19.421736000000237
761, 4.582160360653038, 33.585206488575366, 40.486462238151276, 0.5175032499999997, 140.0, 618, 536417, 761, 15.530772699999943
762, 2.35223949974555, 33.38867611643869, 40.09429982849596, 0.5169938500000001, 65.0, 514, 536931, 762, 12.971985899999709
763, 2.365111000136222, 33.57493800923304, 40.32678287525467, 0.51658525, 110.0, 394, 537325, 763, 10.003528600000209
764, 2.760559961783725, 33.58948316058597, 40.36256192697061, 0.5160749499999997, 175.0, 740, 538065, 764, 18.698782299999948
765, 5.919520537655868, 33.55993026406604, 40.44237531508017, 0.5154688000000001, 95.0, 607, 538672, 765, 15.866347099999984
766, 4.394807139423969, 33.5772580909983, 40.41392744143063, 0.5148577, 195.0, 751, 539423, 766, 19.445726299999478
767, 3.884123033890501, 33.42280866305033, 40.19478884935379, 0.5140877500000004, 565.0, 960, 540383, 767, 24.510127300000022
768, 4.1516539989562515, 33.4045915539345, 40.201390975780704, 0.5134555000000001, 80.0, 445, 540828, 768, 11.38141220000034
769, 6.28569353635577, 33.2970466311887, 40.12080230164013, 0.5129424999999999, 180.0, 695, 541523, 769, 17.6524244000002
770, 2.755593139598126, 33.30361441984826, 40.01176323429231, 0.5121275500000002, 205.0, 1116, 542639, 770, 28.341498699999647
771, 5.134024732401521, 33.41547073153999, 40.2795425625298, 0.5113967500000001, 55.0, 508, 543147, 771, 12.971124200000304
772, 4.118542287604362, 33.28102573013776, 40.0097610718225, 0.5108032, 135.0, 811, 543958, 772, 20.80675820000033
773, 4.440123578150433, 33.34696432433793, 40.10690891545433, 0.5100575500000001, 245.0, 846, 544804, 773, 21.47314540000025
774, 2.7454467337565793, 33.30331879358063, 40.026746251835924, 0.5092822, 180.0, 877, 545681, 774, 22.444151699999566
775, 6.2026635872867875, 33.39004805582874, 40.239105188621664, 0.5086490500000002, 110.0, 530, 546211, 775, 13.71796859999995
776, 6.186061200715842, 33.23245811975131, 40.00362825906405, 0.5082431500000002, 70.0, 372, 546583, 776, 9.571145299999444
777, 4.660790456982481, 33.364333639918144, 40.11661682644406, 0.5077427499999998, 225.0, 740, 547323, 777, 19.10575180000069
778, 6.173517699456415, 33.37707850067309, 40.25051251203654, 0.5070070000000003, 185.0, 895, 548218, 778, 22.955143399999542
779, 3.359069614568648, 33.31852117674313, 40.039290164379366, 0.5061177999999997, 270.0, 1081, 549299, 779, 27.937667600000168
780, 4.932501366345443, 33.407096495995155, 40.179787195645844, 0.5050229499999999, 630.0, 1352, 550651, 780, 34.770719900000586
781, 6.609347470598656, 33.54148061762857, 40.395262101737174, 0.5042516499999998, 85.0, 362, 551013, 781, 9.488667800000258
782, 3.3331206292295286, 33.32129069653358, 40.0531523947584, 0.5036490999999998, 285.0, 977, 551990, 782, 25.26925619999929
783, 2.6534145845822534, 33.2432217743932, 39.91655069467973, 0.5030330500000001, 10.0, 392, 552382, 783, 10.122451700000056
784, 2.6888720163556394, 33.33163543216518, 40.06193494015053, 0.50263705, 65.0, 488, 552870, 784, 12.70372690000022
785, 4.61383482340752, 33.430066743669286, 40.21919985479438, 0.5020673499999998, 180.0, 778, 553648, 785, 20.099365700000817
786, 4.814382259641156, 33.40169733609224, 40.19307092322748, 0.5013154000000002, 265.0, 893, 554541, 786, 23.19428340000013
787, 6.246007994185649, 33.47236079954158, 40.32711512355481, 0.5005949499999996, 140.0, 708, 555249, 787, 18.421632900000077
788, 3.573897993369362, 33.37234758770805, 40.095292627737756, 0.4999123000000001, 145.0, 809, 556058, 788, 21.129178400000455
789, 4.041182339847026, 33.41108639245201, 40.17182182327807, 0.4991135499999996, 185.0, 966, 557024, 789, 25.258454599999823
790, 3.247961421135949, 33.45810164169744, 40.22937915817446, 0.49812310000000026, 415.0, 1235, 558259, 790, 32.37985620000018
791, 4.540202521692008, 33.5801616658636, 40.396422987563, 0.4973968000000002, 85.0, 379, 558638, 791, 9.944678899999417
792, 3.8526253413241895, 33.454094745867486, 40.23807122273307, 0.49654404999999974, 650.0, 1516, 560154, 792, 39.97429219999958
793, 5.448505662789507, 33.7289623813438, 40.60799142959583, 0.4952782000000004, 700.0, 1297, 561451, 793, 33.99712649999947
794, 6.692284101766367, 33.73882977765306, 40.660617963583974, 0.4942756000000002, 185.0, 931, 562382, 794, 24.549074499999733
795, 3.7935104969550264, 33.72866748679768, 40.52294010104555, 0.49361904999999984, 85.0, 528, 562910, 795, 14.067987999999787
796, 4.267389360620063, 33.716377816949915, 40.56445080277223, 0.4927546000000004, 330.0, 1393, 564303, 796, 37.02503350000006
797, 4.000846356162348, 33.69818032907674, 40.514048128434226, 0.49174930000000044, 145.0, 841, 565144, 797, 22.40144599999985
798, 4.815591251734391, 33.893154588717856, 40.79604684774158, 0.49113910000000005, 155.0, 515, 565659, 798, 13.715715000000273
799, 3.860748372862329, 33.78754812134302, 40.64155101274717, 0.4904793999999998, 195.0, 951, 566610, 799, 25.222161900000174
800, 4.914027280970053, 33.78246752841414, 40.64106928927839, 0.4897792000000002, 90.0, 605, 567215, 800, 16.18051579999974
801, 5.055833355162157, 33.82237825338973, 40.69384266723866, 0.4892715999999998, 110.0, 523, 567738, 801, 14.0543504999996
802, 4.255229696439496, 33.86569526993977, 40.692823494904495, 0.48884409999999995, 65.0, 427, 568165, 802, 11.43936770000073
803, 3.491603450546431, 33.75565122633942, 40.611067971517876, 0.48841975000000015, 120.0, 516, 568681, 803, 13.80559699999958
804, 2.7922481304170654, 33.679666838657944, 40.48011063928868, 0.4878302499999995, 155.0, 794, 569475, 804, 21.16512469999998
805, 6.905123769110719, 33.81077094965203, 40.68780459914097, 0.4873181499999999, 40.0, 344, 569819, 805, 9.232361299999866
806, 3.479012479826834, 33.44334442578061, 40.21620502438637, 0.4869055, 95.0, 573, 570392, 806, 15.324372399999447
807, 4.722687703342844, 33.52575031966441, 40.344030418355885, 0.4862197, 185.0, 951, 571343, 807, 25.698935000000347
808, 3.3507232313746114, 33.462503234494896, 40.2155294260803, 0.48543759999999997, 150.0, 787, 572130, 808, 21.35787639999944
809, 3.206575019332101, 33.46938156016822, 40.20968968659929, 0.4846199500000003, 495.0, 1030, 573160, 809, 27.635230100000626
810, 10.182296306850612, 33.598725672018425, 40.583543037881654, 0.48400209999999994, 35.0, 343, 573503, 810, 9.294610399999328
811, 2.771123247004267, 33.525638244401165, 40.31974631352211, 0.4835462499999998, 165.0, 670, 574173, 811, 18.163781799999924
812, 2.8251330982050757, 33.47930000750688, 40.23676503870609, 0.48293650000000005, 80.0, 685, 574858, 812, 18.731737299999622
813, 3.4399818548303696, 33.47521155754, 40.24903857692435, 0.4822830999999997, 135.0, 767, 575625, 813, 20.828299300000253
814, 6.307123700042344, 33.45713731563291, 40.27153427507624, 0.48177684999999987, 30.0, 358, 575983, 814, 9.806844299999284
815, 5.514148814606471, 33.42346608799134, 40.23876444498698, 0.4813147000000001, 85.0, 669, 576652, 815, 18.204885699999977
816, 6.274453109823118, 33.52512128722204, 40.34561291006848, 0.4804003000000002, 395.0, 1363, 578015, 816, 36.925773500000105
817, 4.33564551145522, 33.50550233132776, 40.286896335339286, 0.47925729999999955, 530.0, 1177, 579192, 817, 32.1768763
818, 5.55354686553243, 33.58582906765158, 40.40648024141876, 0.4784221, 140.0, 679, 579871, 818, 18.74051689999942
819, 3.943963088892042, 33.444679244954315, 40.23990772879697, 0.4779482500000001, 65.0, 374, 580245, 819, 10.440591300000051
820, 4.945229927133909, 33.19520359469536, 39.944284862145444, 0.47754054999999984, 40.0, 532, 580777, 820, 14.739394000000175
821, 5.05398138226709, 33.27227340824428, 40.0347534936803, 0.47694744999999994, 345.0, 786, 581563, 821, 21.524507099999028
822, 4.8266421536915, 33.23091059582574, 39.95423637798854, 0.47608975000000014, 430.0, 1120, 582683, 822, 30.64611589999913
823, 4.512075308400766, 33.227118238347586, 39.97535709484396, 0.47510379999999974, 310.0, 1071, 583754, 823, 29.435132100001283
824, 7.331939221727091, 33.337894743971496, 40.1822948427637, 0.47431720000000016, 205.0, 677, 584431, 824, 18.784722799999145
825, 4.295999294235263, 33.30391804362452, 40.032961188028025, 0.4735288, 370.0, 1075, 585506, 825, 29.61749249999957
826, 3.8460920471341216, 33.27390064224886, 39.99646319100683, 0.47281014999999993, 115.0, 522, 586028, 826, 14.499399899999844
827, 4.066324796654212, 33.327915231772614, 40.08679696425651, 0.4720190500000002, 210.0, 1236, 587264, 827, 34.41842859999997
828, 3.40065170391798, 33.280894570922854, 39.994332788085934, 0.47118159999999987, 160.0, 625, 587889, 828, 17.31530019999991
829, 4.035099487795208, 33.267362813541396, 40.01512733043864, 0.47066905, 90.0, 514, 588403, 829, 14.291236400000344
830, 4.340815950536135, 33.377469487215215, 40.14152498894337, 0.47026585000000015, 30.0, 382, 588785, 830, 10.702692000000752
831, 5.597986876988838, 33.28580968465401, 40.109133934741685, 0.4698176499999998, 55.0, 614, 589399, 831, 17.322119000000384
832, 3.639640076029757, 33.2903753792064, 40.00845861085178, 0.4689892000000003, 175.0, 1227, 590626, 832, 34.05510080000022
833, 3.57094368206225, 33.238053198871775, 39.95631108106378, 0.46812294999999965, 165.0, 698, 591324, 833, 19.54324550000092
834, 6.873609734854087, 33.26871866443161, 40.13386389274144, 0.46754379999999984, 110.0, 589, 591913, 834, 16.701717899999494
835, 5.087695597745068, 33.271889349238236, 40.06897552098025, 0.4669110999999997, 215.0, 817, 592730, 835, 23.02153299999918
836, 4.617320026392522, 33.25331053526505, 40.10187858083974, 0.4662950499999999, 90.0, 552, 593282, 836, 15.514223099999072
837, 4.3998676299432375, 33.38586606992975, 40.16990377015292, 0.4657311999999999, 205.0, 701, 593983, 837, 19.710032000000865
838, 6.142342218325285, 33.342551254644626, 40.15155259068672, 0.4649914000000002, 345.0, 943, 594926, 838, 26.44516889999977
839, 4.361132077430481, 33.240281510026485, 39.96789097894817, 0.4642713999999999, 135.0, 657, 595583, 839, 18.516592899999523
840, 3.292073784402588, 33.19940176177443, 39.87256127519217, 0.4635910000000003, 210.0, 855, 596438, 840, 24.05905940000048
841, 3.1751316234683307, 33.2056197321586, 39.89808583145506, 0.4628300499999998, 165.0, 836, 597274, 841, 23.460259399998904
842, 5.560468127324087, 33.270549906753914, 40.02648649448302, 0.46208485000000016, 160.0, 820, 598094, 842, 23.16454800000065
843, 3.723787413641749, 33.275603255126704, 40.01571720029101, 0.46127844999999973, 235.0, 972, 599066, 843, 27.53163289999975
844, 4.715576047413467, 33.314352485741914, 40.10491985339297, 0.4605588999999999, 120.0, 627, 599693, 844, 17.786192700001266
845, 4.880297982826707, 33.51794165248334, 40.35544188427557, 0.45978129999999956, 240.0, 1101, 600794, 845, 31.10591260000001
846, 4.200007628414132, 33.493730060124804, 40.329333271561495, 0.45899380000000006, 105.0, 649, 601443, 846, 18.525197700000717
847, 4.70152490290092, 33.47767552489291, 40.28721379865266, 0.4584105999999998, 115.0, 647, 602090, 847, 18.62142270000004
848, 4.010594995432003, 33.625525843712595, 40.45081615447998, 0.45795204999999994, 55.0, 372, 602462, 848, 10.835700500001622
849, 5.8667621048960354, 33.60664367439723, 40.46385759410292, 0.4574210500000001, 145.0, 808, 603270, 849, 22.905264900000475
850, 3.926310579692764, 33.559304639021214, 40.33277352994256, 0.4566407500000002, 385.0, 926, 604196, 850, 26.559387700001025
851, 5.6237313480949105, 33.63183661487615, 40.571511972730406, 0.45593515000000007, 160.0, 642, 604838, 851, 18.295227699998577
852, 5.230048861821578, 33.6259991518113, 40.457204280755455, 0.45533035000000005, 135.0, 702, 605540, 852, 21.523202300000776
853, 6.148286830852546, 33.58407900961893, 40.43819252429421, 0.4545928000000001, 265.0, 937, 606477, 853, 29.06945160000032
854, 3.482624973132353, 33.614633987851306, 40.393081771176305, 0.45389619999999997, 65.0, 611, 607088, 854, 17.61449619999985
855, 3.385644009212653, 33.50681119377231, 40.27421565114716, 0.45325675000000015, 340.0, 810, 607898, 855, 23.40112240000053
856, 4.305355098917208, 33.55178384818088, 40.36730454026955, 0.45254619999999995, 135.0, 769, 608667, 856, 22.325596000000587
857, 4.596628749648973, 33.58697284856215, 40.41183533018617, 0.4519063000000002, 155.0, 653, 609320, 857, 18.87227999999959
858, 2.390107168351102, 33.48993350652259, 40.244228939747245, 0.4513266999999997, 85.0, 635, 609955, 858, 18.300988900000448
859, 3.246049622025657, 33.65658133320263, 40.45692044430553, 0.45055315, 295.0, 1084, 611039, 859, 31.649557299999287
860, 5.029544188915369, 33.58088033137197, 40.42284378021179, 0.4498408000000001, 30.0, 499, 611538, 860, 14.507089700000506
861, 7.18985726214552, 33.574098423782324, 40.50713843047704, 0.44930079999999994, 160.0, 701, 612239, 861, 20.347575300000244
862, 4.0801959221271575, 33.55041509805267, 40.35070275113345, 0.4485924999999997, 295.0, 873, 613112, 862, 25.44444629999998
863, 4.6125521141935035, 33.50193755278716, 40.288856885755386, 0.4477834, 270.0, 925, 614037, 863, 26.79877149999993
864, 5.438682688866343, 33.62992975943429, 40.460890542166574, 0.4469733999999996, 165.0, 875, 614912, 864, 25.602015200000096
865, 3.6975538946266013, 33.60078932278737, 40.42145689048592, 0.4462858000000001, 135.0, 653, 615565, 865, 19.009607699999833
866, 5.250354697792071, 33.62196732957579, 40.51275997328689, 0.4456832499999998, 110.0, 686, 616251, 866, 20.01479780000045
867, 5.333917025173825, 33.516417878107006, 40.322507620503906, 0.44504245, 340.0, 738, 616989, 867, 21.793262400000458
868, 3.392588313208699, 33.535390909113936, 40.354725082868775, 0.4444772499999998, 60.0, 518, 617507, 868, 15.097486499998922
869, 4.4581765986268564, 33.56545131189024, 40.39368243322396, 0.44387605000000013, 165.0, 818, 618325, 869, 24.29116889999932
870, 3.75615298668871, 33.472858237987325, 40.26521697644058, 0.4431393999999999, 170.0, 819, 619144, 870, 24.32303200000024
871, 3.3673950568772852, 33.530283614993095, 40.280314733584724, 0.4424252500000001, 155.0, 768, 619912, 871, 22.574610100000427
872, 5.269442205034918, 33.506401385030436, 40.296359163714996, 0.44152164999999965, 555.0, 1240, 621152, 872, 36.572732200000246
873, 5.634175729352174, 33.500190005133106, 40.36014787601851, 0.44057080000000004, 290.0, 873, 622025, 873, 25.724001200000203
874, 4.8132855643868835, 33.36852685931426, 40.11564948061942, 0.43989940000000005, 130.0, 619, 622644, 874, 18.3400787999999
875, 2.870605236697861, 33.41465891551676, 40.16742797827942, 0.43933015000000014, 110.0, 646, 623290, 875, 19.20463759999984
876, 4.943781992017014, 33.51538405932383, 40.324179727723276, 0.43861779999999956, 190.0, 937, 624227, 876, 27.920715299998847
877, 5.124570589485657, 33.4789201483669, 40.28578972414316, 0.43782265000000004, 225.0, 830, 625057, 877, 24.76588889999948
878, 4.243018718289738, 33.48798162666076, 40.30470867546237, 0.43714044999999985, 130.0, 686, 625743, 878, 20.453060999998343
879, 3.8008862866561897, 33.47760689501338, 40.28580568892141, 0.4364118999999999, 300.0, 933, 626676, 879, 28.053125700000237
880, 4.480308402752617, 33.474974437968726, 40.36027011901001, 0.43570269999999994, 190.0, 643, 627319, 880, 19.237207500000295
881, 5.959924172996665, 33.549945809098844, 40.43510772971478, 0.4349494, 360.0, 1031, 628350, 881, 30.934270300000207
882, 4.813485356576566, 33.52825596793866, 40.36738450531502, 0.43398775000000034, 305.0, 1106, 629456, 882, 33.18689760000052
883, 5.3355012055031095, 33.60165327195754, 40.41182936245149, 0.4329414999999998, 360.0, 1219, 630675, 883, 36.67193210000005
884, 4.134754501726509, 33.62090513371239, 40.42520964125956, 0.4318484499999997, 385.0, 1210, 631885, 884, 36.37775949999923
885, 4.94417420144055, 33.62370023779721, 40.41790115942249, 0.4310577999999999, 75.0, 547, 632432, 885, 16.59117789999982
886, 4.1165788448507, 33.64185865252626, 40.418151712105946, 0.4302608499999997, 515.0, 1224, 633656, 886, 36.90513610000016
887, 4.410320505833448, 33.667606695374445, 40.53226132179374, 0.42952915, 5.0, 402, 634058, 887, 12.68670209999982
888, 6.69648275528048, 33.67184858604018, 40.561527270988876, 0.4289828499999998, 135.0, 812, 634870, 888, 24.64063999999962
889, 4.520561005330194, 33.67506488955399, 40.475398539777615, 0.4283190999999999, 125.0, 663, 635533, 889, 20.196723900000507
890, 4.171854086731946, 33.722206823390536, 40.55567054812433, 0.4274834499999996, 500.0, 1194, 636727, 890, 36.31863550000162
891, 2.49326314486219, 33.71978756923079, 40.470045109619505, 0.4266442, 95.0, 671, 637398, 891, 20.33667989999958
892, 7.658870819280599, 33.83394190505311, 40.76548178641351, 0.42601464999999966, 150.0, 728, 638126, 892, 22.24866370000018
893, 4.9104513556273774, 33.735581756957785, 40.5788548564559, 0.42519925, 265.0, 1084, 639210, 893, 33.34141239999917
894, 2.6156398660850293, 33.68006790011537, 40.46212118560192, 0.42448195000000016, 50.0, 510, 639720, 894, 15.553500599999097
895, 3.665473479681747, 33.92892585460013, 40.794696458282964, 0.4239725499999999, 200.0, 622, 640342, 895, 19.103909400000703
896, 4.08945409641614, 34.035034090362636, 40.91845178735486, 0.4235293, 70.0, 363, 640705, 896, 11.176404399999228
897, 4.384500030253888, 33.885929380941114, 40.850567867881374, 0.42321204999999995, 75.0, 342, 641047, 897, 10.488952400000926
898, 4.7193785380351585, 33.985454737583055, 40.87221259714287, 0.42276925000000004, 90.0, 642, 641689, 898, 19.92139379999935
899, 6.490949708374514, 34.01395997586457, 40.93091830930848, 0.42216984999999996, 190.0, 690, 642379, 899, 21.053163399999903
900, 2.716135249794209, 33.85756911035956, 40.6853271223541, 0.42170139999999995, 60.0, 351, 642730, 900, 10.866454000000886
901, 4.091114642380888, 33.980769690926486, 40.86909096321597, 0.4211308, 275.0, 917, 643647, 901, 28.115253699999812
902, 3.472421758315511, 33.90061520286926, 40.751113198603576, 0.42018309999999987, 440.0, 1189, 644836, 902, 36.425042799999574
903, 3.702630528532019, 33.90093938563321, 40.766100999471305, 0.41911524999999966, 290.0, 1184, 646020, 903, 36.46264279999923
904, 7.8828364154423225, 34.06664922344151, 41.15603047189936, 0.4183713999999998, 125.0, 469, 646489, 904, 14.5690883999996
905, 2.7207500726947766, 33.989821281723195, 40.79602677377911, 0.41792365000000004, 60.0, 526, 647015, 905, 16.195654399998602
906, 5.342008884080638, 33.97898567733118, 40.84784797086554, 0.4174745500000001, 60.0, 472, 647487, 906, 14.574269600001571
907, 4.809349022711181, 34.01179775778385, 40.90038448357935, 0.41683645, 185.0, 946, 648433, 907, 29.41701230000035
908, 5.3645624863514625, 33.974546909332275, 40.88582784524236, 0.41606334999999983, 180.0, 772, 649205, 908, 23.95600949999971
909, 5.390617202461221, 33.981612533103416, 40.86407439253713, 0.4154212000000001, 150.0, 655, 649860, 909, 20.5794163999999
910, 7.112758374181438, 34.03973612562178, 40.97727741143082, 0.4146552999999995, 175.0, 1047, 650907, 910, 32.78826529999969
911, 3.9851487038083047, 33.952545166015625, 40.80826198329966, 0.4139695000000001, 80.0, 477, 651384, 911, 15.009775999998965
912, 5.419193716787426, 33.857975343580684, 40.69437712176716, 0.4134699999999998, 45.0, 633, 652017, 912, 19.95475879999867
913, 6.2169380215238474, 33.95686820014406, 40.85912435542154, 0.4127779000000001, 155.0, 905, 652922, 913, 28.506758900000932
914, 4.120205451431344, 33.94533863042297, 40.808847546419145, 0.41203179999999967, 135.0, 753, 653675, 914, 23.57729189999918
915, 6.297130735027928, 33.93842463037456, 40.831857769988304, 0.41134465, 200.0, 774, 654449, 915, 24.358561799999734
916, 2.598735061937824, 33.93772122200499, 40.750505378398486, 0.41057334999999956, 195.0, 940, 655389, 916, 29.543330000000424
917, 2.3372277691775, 33.98671315321282, 40.80445898824663, 0.4099694499999998, 80.0, 402, 655791, 917, 12.61935639999865
918, 3.3785548142700765, 33.93257745107015, 40.77346488237381, 0.40935654999999976, 190.0, 960, 656751, 918, 30.049714299999323
919, 5.131930254049655, 33.97437405048456, 40.82161942101959, 0.4086851499999999, 50.0, 532, 657283, 919, 16.731045199998334
920, 10.786715150463506, 34.097136816736, 41.18245082790569, 0.40823335, 80.0, 472, 657755, 920, 15.173453999999765
921, 4.768027095740936, 34.01257192893107, 40.93430658142423, 0.4076091999999997, 205.0, 915, 658670, 921, 26.5532678999989
922, 3.484570803182197, 33.94233147280459, 40.79583857904377, 0.4068838, 100.0, 697, 659367, 922, 18.899448599999232
923, 2.889613715493662, 33.999035586182345, 40.831420144305426, 0.40625829999999985, 150.0, 693, 660060, 923, 19.36593879999964
924, 5.882713817253415, 34.3307160786503, 41.36461688523971, 0.40551309999999996, 270.0, 963, 661023, 924, 30.922450000000026
925, 3.6958613394730584, 34.385701877090014, 41.31622769676397, 0.4046608000000002, 205.0, 931, 661954, 925, 25.240108600000895
926, 6.597237651544781, 34.432242299055126, 41.490186325915445, 0.4036874499999997, 645.0, 1232, 663186, 926, 34.40183369999977
927, 3.358937302563825, 34.33714398093846, 41.261556907322095, 0.40271905, 265.0, 920, 664106, 927, 25.885798400000567
928, 3.9846816081123384, 34.29783911962058, 41.23155238001522, 0.40189600000000014, 285.0, 909, 665015, 928, 24.79986529999951
929, 2.696589058004447, 34.34151627667528, 41.25620623253311, 0.4012232500000001, 70.0, 586, 665601, 929, 15.970796700001301
930, 4.64615853598172, 34.32545637867668, 41.26394598267295, 0.40056354999999977, 230.0, 880, 666481, 930, 24.622437100000752
931, 5.997196024591642, 34.4122028212902, 41.44867152221932, 0.39973195, 220.0, 968, 667449, 931, 26.563910900000337
932, 2.738550930542331, 34.172695196828535, 41.03226439568304, 0.39901735, 120.0, 620, 668069, 932, 16.98357550000037
933, 3.6737720161946985, 34.438383832206675, 41.3861452738444, 0.3983914, 85.0, 771, 668840, 933, 22.891805000001114
934, 2.933414187688285, 34.37930738620269, 41.304712552290695, 0.39776365000000014, 195.0, 624, 669464, 934, 18.034589200000482
935, 3.8952674948041803, 34.34326624781005, 41.28962516070305, 0.39724254999999997, 25.0, 534, 669998, 935, 14.69698100000096
936, 5.128247918697392, 34.48158976259132, 41.48300860733936, 0.39674394999999996, 155.0, 574, 670572, 936, 15.899303000000145
937, 7.602809473490104, 34.41365862252306, 41.47912542996183, 0.3961873, 190.0, 663, 671235, 937, 18.051785099998597
938, 4.58066373376854, 34.36783390270524, 41.34883234042486, 0.39547, 205.0, 931, 672166, 938, 25.274721099998715
939, 3.5888420320971828, 34.36547359129799, 41.33048919589405, 0.3947401000000001, 80.0, 691, 672857, 939, 18.971110699998462
940, 3.706535974512188, 34.383963897388085, 41.35240100576024, 0.3939525999999999, 520.0, 1059, 673916, 940, 28.939891500000158
941, 4.472125766455104, 34.44840438785471, 41.48805592090787, 0.39305665, 350.0, 932, 674848, 941, 25.715822500000286
942, 4.657417004234654, 34.48096275521476, 41.4317489255602, 0.39218994999999957, 320.0, 994, 675842, 942, 27.55843460000142
943, 4.508183127708528, 34.42733838071699, 41.45421288983004, 0.39143170000000016, 170.0, 691, 676533, 943, 19.26557810000122
944, 2.4199608267932726, 34.32207314816514, 41.230917377508675, 0.3908871999999999, 35.0, 519, 677052, 944, 14.673531399999774
945, 5.069753509349452, 34.44064618108753, 41.49448370410059, 0.39042819999999995, 85.0, 501, 677553, 945, 14.191683299999568
946, 5.753769160941515, 34.43973869820164, 41.424074625860065, 0.3898085499999999, 560.0, 876, 678429, 946, 24.46952760000022
947, 2.683017395355905, 34.436595600335174, 41.38310593597649, 0.3891241, 155.0, 645, 679074, 947, 18.164042899999913
948, 4.240925010488085, 34.379776224882704, 41.31422112506369, 0.3886268500000001, 60.0, 460, 679534, 948, 12.9392497000008
949, 5.603222426230468, 34.50428989487766, 41.54316202601107, 0.38813139999999985, 95.0, 641, 680175, 949, 17.993672900000092
950, 2.4432519093324645, 34.75104853867713, 41.734555012971455, 0.38756484999999996, 110.0, 618, 680793, 950, 17.48431040000105
951, 6.0357086942129925, 34.823913898392625, 41.932413132859786, 0.3867174999999996, 245.0, 1265, 682058, 951, 35.750515699999596
952, 6.737261793716222, 34.85428898367095, 42.014454525727956, 0.3857203, 340.0, 951, 683009, 952, 26.792684899999585
953, 3.51482422466268, 34.80096996645384, 41.8370855532618, 0.3847591000000003, 505.0, 1185, 684194, 953, 33.421856100001605
954, 4.5021007028857465, 34.76969559180555, 41.82204038842681, 0.3838712499999997, 150.0, 788, 684982, 954, 22.324506000000838
955, 6.331711790115819, 34.85243527974065, 41.97788203092432, 0.38306125, 300.0, 1012, 685994, 955, 28.76116059999913
956, 2.5377542173100776, 34.690129208516396, 41.67128674737339, 0.382384, 60.0, 493, 686487, 956, 13.948488600000928
957, 5.1901705834872764, 34.77507485696975, 41.8562284627222, 0.38167750000000006, 320.0, 1077, 687564, 957, 30.440120199999
958, 3.288424176852881, 34.745074568123655, 41.75034311907708, 0.38078829999999997, 165.0, 899, 688463, 958, 25.688854199999696
959, 5.904992248302061, 34.81482640283254, 41.91946994230879, 0.3799503999999999, 300.0, 963, 689426, 959, 27.756433299999117
960, 5.7912380270325725, 34.7034707484585, 41.740909103353296, 0.3793464999999999, 75.0, 379, 689805, 960, 10.94701890000033
961, 6.165737860834429, 34.90190501051578, 41.97460275537827, 0.37867104999999995, 410.0, 1122, 690927, 961, 31.72178409999833
962, 4.618653508050665, 34.94506977062811, 41.989371637150235, 0.37788759999999993, 50.0, 619, 691546, 962, 17.707067299999835
963, 5.318124768137932, 34.99603960122635, 42.12958287481052, 0.3773075500000001, 70.0, 670, 692216, 963, 19.410662800000864
964, 3.8319259355762747, 34.9363726645793, 42.026615637320056, 0.37669014999999995, 195.0, 702, 692918, 964, 20.200547099999312
965, 6.7114734726081435, 34.833096484576956, 41.93802900314331, 0.37606825000000005, 105.0, 680, 693598, 965, 19.526180299999396
966, 4.274747686154426, 34.898561871759426, 41.99459994764633, 0.3753680499999997, 410.0, 876, 694474, 966, 25.184755199999927
967, 5.069176288617944, 34.87118703488147, 41.95443717999892, 0.37449864999999993, 255.0, 1056, 695530, 967, 30.351073499999984
968, 6.549126817997883, 34.99070558972806, 42.14276588311027, 0.3737305, 175.0, 651, 696181, 968, 18.859354399999575
969, 4.586495488108266, 34.81898325911615, 41.940089737979875, 0.3732859, 45.0, 337, 696518, 969, 9.826480100000481
970, 3.3186134357564345, 34.91234363663985, 41.966659950184294, 0.37270539999999974, 230.0, 953, 697471, 970, 27.920524499999374
971, 3.5517166100824915, 34.79701916873455, 41.83535349369049, 0.37187335, 205.0, 896, 698367, 971, 26.039777300000424
972, 2.74352643971673, 34.92015754615999, 41.9761177290196, 0.37118304999999985, 130.0, 638, 699005, 972, 18.551329100000657
973, 2.431888987594024, 34.85646275287022, 41.87728463529005, 0.3706862499999999, 80.0, 466, 699471, 973, 13.556724399999439
974, 3.5266843634982625, 34.85469389268111, 41.9055042920327, 0.3700562499999998, 230.0, 934, 700405, 974, 27.2421276999994
975, 2.906608442701806, 34.700218754142014, 41.710613952969986, 0.36934749999999994, 120.0, 641, 701046, 975, 18.80583640000077
976, 5.863427335129043, 34.86494947734632, 41.95828351107511, 0.3686828499999999, 125.0, 836, 701882, 976, 24.45601809999971
977, 4.651652014259623, 34.81047873516686, 41.9034252402871, 0.3679795, 75.0, 727, 702609, 977, 21.202863499998784
978, 2.9267283578550987, 34.775259142934416, 41.794955032368634, 0.3673089999999999, 250.0, 763, 703372, 978, 22.403558099998918
979, 3.968456444324656, 34.77738042447552, 41.815832959780906, 0.36667945, 95.0, 636, 704008, 979, 18.57261759999892
980, 4.760027239535083, 34.87225637537368, 41.96951296988954, 0.36622404999999997, 85.0, 376, 704384, 980, 11.139245599999413
981, 6.292133718529539, 34.88950281258089, 41.983763346231605, 0.36571869999999984, 355.0, 747, 705131, 981, 21.7308950000006
982, 4.767346352772882, 34.866711331626114, 41.9251848883548, 0.36495775, 270.0, 944, 706075, 982, 27.673390100000688
983, 3.9860532816986574, 34.79042856205893, 41.81342492709502, 0.3642885999999998, 80.0, 543, 706618, 983, 15.954069600000366
984, 4.742190111332979, 34.87263777317145, 41.88096759937428, 0.36388630000000005, 75.0, 351, 706969, 984, 10.446071700000175
985, 2.9239588311496885, 34.84435666875636, 41.857469355806394, 0.36355914999999983, 10.0, 376, 707345, 985, 11.111611099999209
986, 4.371174121313557, 34.733463934489656, 41.803506121343496, 0.36321354999999994, 30.0, 392, 707737, 986, 11.497037099999943
987, 3.472527372458518, 34.78199327355869, 41.78828451406592, 0.36253584999999994, 275.0, 1114, 708851, 987, 32.63438660000065
988, 3.7640220800451205, 34.80265058047891, 41.82448719997032, 0.3618279999999999, 65.0, 459, 709310, 988, 13.554150300000401
989, 3.996748116464118, 34.8164882214963, 41.84108320624795, 0.3613320999999999, 160.0, 643, 709953, 989, 19.092134599999554
990, 2.8611351519443984, 35.162889036413745, 42.22732640992405, 0.3608127999999998, 20.0, 511, 710464, 990, 15.156804599999305
991, 4.403883810641967, 35.31403874626904, 42.45651835940148, 0.36037539999999996, 85.0, 461, 710925, 991, 13.604100700000345
992, 5.601150896480041, 35.34493772983551, 42.49495174544198, 0.3599159499999999, 120.0, 560, 711485, 992, 16.649051500000496
993, 4.038019378136539, 35.46036436572765, 42.60008559436918, 0.35937774999999983, 80.0, 636, 712121, 993, 18.726341600000524
994, 6.139171317613569, 35.36761753935128, 42.56555789306218, 0.35857224999999965, 435.0, 1154, 713275, 994, 34.184545300000536
995, 6.338938433866609, 35.31076606923884, 42.490207928744226, 0.35755794999999996, 295.0, 1100, 714375, 995, 32.554098700000395
996, 6.365296314953733, 35.32901279868948, 42.52559961404178, 0.35680105, 80.0, 582, 714957, 996, 17.288243399998464
997, 4.012434593386146, 35.31477135041035, 42.42571599938062, 0.35619220000000007, 245.0, 771, 715728, 997, 22.961343599999964
998, 5.678889488437472, 35.32738246288181, 42.48026209277409, 0.35534080000000035, 310.0, 1121, 716849, 998, 33.25070179999966
999, 5.152222451782036, 35.43073466150206, 42.64143954966462, 0.3545829999999999, 140.0, 563, 717412, 999, 16.958597400000144
1000, 5.183299958278601, 35.36605846297629, 42.500612579122944, 0.35389810000000016, 170.0, 959, 718371, 1000, 28.575552199999947
1001, 3.895175403330467, 35.24253861491999, 42.401081419095426, 0.3532609, 120.0, 457, 718828, 1001, 13.722614400001476
1002, 3.7850594582817245, 35.28908431760726, 42.40212755510884, 0.35277625000000007, 155.0, 620, 719448, 1002, 18.446304400000372
1003, 5.651128151211161, 35.377876457982, 42.53510077631204, 0.35227809999999976, 95.0, 487, 719935, 1003, 14.661744399998497
1004, 4.453169225787144, 36.10106326826179, 43.456692573558094, 0.3517389999999999, 130.0, 711, 720646, 1004, 21.292121300000872
1005, 4.92805062108017, 36.141975601133666, 43.477395737383176, 0.35076115, 560.0, 1462, 722108, 1005, 43.608550099999775
1006, 4.423288205510949, 36.12107751794057, 43.420320136362015, 0.34931485000000045, 545.0, 1752, 723860, 1006, 52.42013219999899
1007, 3.91235758214302, 36.14984267325628, 43.434798336029054, 0.3481484499999999, 250.0, 840, 724700, 1007, 25.30677829999877
1008, 4.321377003543856, 36.212366774275495, 43.54867988939911, 0.3475373499999999, 70.0, 518, 725218, 1008, 15.538995999999315
1009, 5.1879318408329755, 36.18004763826051, 43.54215813316776, 0.3468979000000002, 205.0, 903, 726121, 1009, 27.2599553
1010, 3.049773152442784, 36.11851519761355, 43.380857878696276, 0.3458066499999999, 380.0, 1522, 727643, 1010, 45.63549779999994
1011, 4.248817077176946, 36.19133165959389, 43.522848783000825, 0.34489854999999997, 90.0, 496, 728139, 1011, 15.023964899999555
1012, 6.681046546919224, 36.182721343407266, 43.500018046452446, 0.34449984999999994, 95.0, 390, 728529, 1012, 11.801305599999978
1013, 5.917619795333889, 36.11780917833057, 43.46376027876547, 0.34381225000000004, 300.0, 1138, 729667, 1013, 34.475808099999995
1014, 5.819502045268536, 35.803857093205266, 43.07621765546021, 0.34288075, 175.0, 932, 730599, 1014, 28.358418199999505
1015, 4.813653137206154, 35.660378444896025, 42.90675286685719, 0.34200235, 360.0, 1020, 731619, 1015, 31.031264299999748
1016, 4.163510859914124, 35.672558738708496, 42.894753471374514, 0.34109335, 485.0, 1000, 732619, 1016, 30.39009579999947
1017, 4.751245082023755, 35.67882086883238, 43.01122432497878, 0.3404642499999998, 75.0, 398, 733017, 1017, 12.159171200000856
1018, 3.148176936408459, 35.7129054918303, 42.891654548700224, 0.33997419999999995, 290.0, 691, 733708, 1018, 21.207321899999442
1019, 5.736992410980834, 35.670727692678305, 42.91594090147647, 0.3390620499999998, 400.0, 1336, 735044, 1019, 41.20145270000103
1020, 7.517784274103653, 35.71634453864553, 43.00244974970219, 0.33810265, 455.0, 796, 735840, 1020, 24.404598500001157
1021, 2.962505917243077, 35.683493506233646, 42.84434896916392, 0.33741054999999986, 155.0, 742, 736582, 1021, 22.846691799999462
1022, 3.852942067425359, 35.73308686689897, 42.9457928536155, 0.3368291499999998, 50.0, 550, 737132, 1022, 16.95464400000128
1023, 6.1018322904024, 35.7163877870456, 43.014252926440946, 0.33639129999999995, 40.0, 423, 737555, 1023, 13.021143500000107
1024, 4.168500729503724, 35.70045974710311, 42.899697586439984, 0.3357136000000003, 490.0, 1083, 738638, 1024, 33.39508249999926
1025, 3.9137090036672526, 35.643519778182544, 42.82025163761084, 0.33497784999999997, 120.0, 552, 739190, 1025, 17.134720100000777
1026, 4.0332992919951405, 35.660779533036255, 42.85778598610414, 0.3344842000000001, 85.0, 545, 739735, 1026, 16.89619809999931
1027, 4.293895276648982, 35.83684040606022, 43.08519369736314, 0.33377815, 300.0, 1024, 740759, 1027, 31.521701899999243
1028, 2.970189330806814, 35.845492637361374, 43.06998947285938, 0.33302800000000005, 135.0, 643, 741402, 1028, 19.930666199999905
1029, 3.791378185890246, 35.73092009674484, 42.948063863271, 0.3324385000000001, 180.0, 667, 742069, 1029, 20.92229899999984
1030, 3.9040349926738465, 35.71668195255467, 42.923454516051244, 0.3318638499999998, 55.0, 610, 742679, 1030, 19.1037053
1031, 5.057940807631319, 35.714580566455155, 42.960951674697746, 0.33116815000000005, 145.0, 936, 743615, 1031, 29.024086600000373
1032, 2.6843595219256935, 35.828588907835915, 43.02665531179293, 0.3305822499999999, 45.0, 366, 743981, 1032, 11.401657099999284
1033, 4.136176494561803, 35.75227849519075, 42.96633577346802, 0.33017634999999995, 15.0, 536, 744517, 1033, 16.67937929999971
1034, 3.248095948937929, 35.758142935554936, 42.93681119522959, 0.3296966500000001, 110.0, 530, 745047, 1034, 16.742164799999955
1035, 5.416863710900732, 35.80260418910606, 43.102370879229376, 0.32922864999999996, 110.0, 510, 745557, 1035, 15.741212700000688
1036, 3.11098578461494, 35.72475548516807, 42.93748835877516, 0.3285028000000001, 125.0, 1103, 746660, 1036, 34.74196839999968
1037, 4.863640109161536, 35.74515486399333, 43.0044697265625, 0.32766894999999985, 110.0, 750, 747410, 1037, 23.44099930000084
1038, 6.552863511688089, 35.79871687693139, 43.09052611050541, 0.32716719999999994, 50.0, 365, 747775, 1038, 11.483975799999826
1039, 4.593817427250572, 35.88287606395659, 43.060245396660974, 0.32678335000000003, 40.0, 488, 748263, 1039, 15.298570599999948
1040, 4.226604759822947, 35.72457524542194, 42.939106562411745, 0.3260471499999999, 505.0, 1148, 749411, 1040, 35.82615299999998
1041, 3.1957312875460504, 35.65412049356142, 42.828787211405626, 0.3252907, 60.0, 533, 749944, 1041, 16.72114750000037
1042, 3.9845145399395547, 35.80253072370563, 43.03196314153109, 0.32476869999999985, 145.0, 627, 750571, 1042, 19.81191150000086
1043, 4.116174592345692, 35.71332188991078, 42.93154249693218, 0.32397354999999994, 470.0, 1140, 751711, 1043, 35.66297250000025
1044, 4.39358177885383, 35.75043488902929, 42.96660933194731, 0.32301685000000013, 290.0, 986, 752697, 1044, 31.061611000000994
1045, 3.7165676714527227, 35.74734350840251, 43.0040473029727, 0.3222896499999999, 30.0, 630, 753327, 1045, 19.59952340000018
1046, 7.690941670768947, 35.71778589824461, 42.980546798346175, 0.32181535, 55.0, 424, 753751, 1046, 13.440254500001174
1047, 4.677399408746942, 35.73844354654075, 42.95527143028161, 0.3211003, 385.0, 1165, 754916, 1047, 36.37069230000088
1048, 4.492969689216725, 35.660807131390236, 42.88606611030046, 0.3200923000000001, 265.0, 1075, 755991, 1048, 33.88223210000069
1049, 5.135925596876022, 35.78871281941732, 43.06885454226763, 0.3193452999999999, 80.0, 585, 756576, 1049, 18.588150400000814
1050, 4.924350688464692, 35.72463531148398, 42.9426947187441, 0.31878414999999993, 185.0, 662, 757238, 1050, 20.892286199999944
1051, 4.315562062180616, 35.79627651275798, 43.02695570757045, 0.3180654999999999, 90.0, 935, 758173, 1051, 29.610787499999788
1052, 4.375791636862598, 35.715418930892106, 42.92869082859584, 0.31723524999999986, 245.0, 910, 759083, 1052, 29.060645400000794
1053, 5.154597873082951, 35.761252047380815, 42.986203039717125, 0.3163964499999998, 335.0, 954, 760037, 1053, 30.403717199998937
1054, 4.639400930381944, 36.147749585777476, 43.495866784065825, 0.3156660999999999, 140.0, 669, 760706, 1054, 21.22551249999924
1055, 3.263392305503425, 36.03816698675286, 43.247712636102825, 0.31516795000000003, 60.0, 438, 761144, 1055, 13.948539199998777
1056, 5.6855869864655455, 36.08883641521383, 43.39812573735018, 0.31453615000000007, 275.0, 966, 762110, 1056, 30.949126600000454
1057, 6.101468071029837, 36.22720015729724, 43.62990784360118, 0.3137625999999999, 35.0, 753, 762863, 1057, 23.965652000000773
1058, 4.40710691901205, 36.052521111830224, 43.3921353457109, 0.3130421499999999, 185.0, 848, 763711, 1058, 27.071609999999055
1059, 6.057122953541308, 36.16088181614397, 43.497633922530945, 0.3121002999999998, 225.0, 1245, 764956, 1059, 39.68406709999908
1060, 6.249117105927954, 36.03699397773636, 43.319034555045164, 0.3113794, 80.0, 357, 765313, 1060, 11.572996000000785
1061, 4.903001540794475, 36.10997768824584, 43.441690455739696, 0.31066209999999966, 425.0, 1237, 766550, 1061, 39.52108210000006
1062, 2.978327167915783, 36.142320146859134, 43.41213444625923, 0.30980349999999995, 130.0, 671, 767221, 1062, 21.413213499999983
1063, 3.303192801368884, 36.09530453483898, 43.33971233794483, 0.3092198500000001, 85.0, 626, 767847, 1063, 20.1710151999996
1064, 7.095052523951455, 36.144975216320375, 43.46559916937873, 0.3086397999999999, 195.0, 663, 768510, 1064, 21.388000900000407
1065, 4.16585488712824, 36.16813084846589, 43.45404899411085, 0.3080462499999998, 80.0, 656, 769166, 1065, 21.072990099999515
1066, 6.210812243580529, 36.081286161848645, 43.41539918103264, 0.30728754999999996, 230.0, 1030, 770196, 1066, 33.142240799999854
1067, 6.258779406162849, 36.01017125313601, 43.35240919798518, 0.306397, 150.0, 949, 771145, 1067, 30.72345519999908
1068, 3.7488706290877114, 36.05223137140274, 43.31108857393265, 0.30553794999999995, 180.0, 960, 772105, 1068, 31.067862300000343
1069, 2.8260805226382106, 36.03333581012228, 43.296487222010946, 0.3048058, 65.0, 667, 772772, 1069, 21.574755700001333
1070, 6.865497137982767, 36.002898592028174, 43.305258321238085, 0.304219, 105.0, 637, 773409, 1070, 20.807333800001288
1071, 4.839906927973891, 36.06231699500064, 43.35636683648506, 0.3033856000000002, 170.0, 1215, 774624, 1071, 39.14597539999886
1072, 2.8526215248825877, 36.000233456582734, 43.23783191912102, 0.3025418499999999, 80.0, 660, 775284, 1072, 21.449330699999337
1073, 3.065369591769054, 35.96327482767814, 43.19283389816467, 0.30186954999999993, 120.0, 834, 776118, 1073, 26.84974770000008
1074, 4.880470275670011, 36.083152348272634, 43.40397676129207, 0.30115719999999985, 220.0, 749, 776867, 1074, 24.179400999999416
1075, 3.7230371915136287, 36.01109982656201, 43.27582099180266, 0.30043674999999986, 90.0, 852, 777719, 1075, 27.807491699999446
1076, 3.862333710670562, 35.970223586247684, 43.20767321485154, 0.29975725, 110.0, 658, 778377, 1076, 21.522905699999683
1077, 4.661906635974409, 36.044697210960784, 43.34245907400072, 0.29911194999999996, 235.0, 776, 779153, 1077, 25.537259300001097
1078, 4.804860862518034, 36.07335810036952, 43.37929222398672, 0.2983743999999999, 185.0, 863, 780016, 1078, 29.0934040000011
1079, 4.151775606211067, 35.96388204351899, 43.24329651963287, 0.29754279999999994, 295.0, 985, 781001, 1079, 32.14398900000015
1080, 3.155158057253796, 35.87813066960882, 43.101376404417024, 0.2966706999999998, 290.0, 953, 781954, 1080, 31.101189400000294
1081, 5.570982628602248, 35.89348657656939, 43.22090540176783, 0.29580310000000004, 240.0, 975, 782929, 1081, 31.719878400001107
1082, 4.614681198110437, 35.802234945813474, 43.011493715465576, 0.29504845, 150.0, 702, 783631, 1082, 24.33501729999989
1083, 4.587347046231906, 35.88554022181898, 43.118733058284775, 0.29437840000000004, 155.0, 787, 784418, 1083, 27.28491849999955
1084, 3.575492158866359, 35.96192004957137, 43.20388444195169, 0.29361295000000015, 195.0, 914, 785332, 1084, 30.198073899999144
1085, 5.2710242414963435, 36.01136826276779, 43.3117195725441, 0.29291365, 120.0, 640, 785972, 1085, 21.078130599998985
1086, 5.283289135853857, 35.945644727640726, 43.189723938421494, 0.2923403500000001, 115.0, 634, 786606, 1086, 20.830480700000408
1087, 5.834586805177146, 35.940802849079, 43.24510391761517, 0.29172880000000007, 140.0, 725, 787331, 1087, 23.56020129999888
1088, 4.8737113203228635, 35.97167340865046, 43.27935158391917, 0.2911127499999998, 135.0, 644, 787975, 1088, 21.16478289999941
1089, 4.240429023001002, 35.90799674184331, 43.14030177077968, 0.29033155000000005, 145.0, 1092, 789067, 1089, 36.16894359999969
1090, 4.714045920104284, 35.94426626986655, 43.284333979512475, 0.28937980000000013, 285.0, 1023, 790090, 1090, 34.006352099999276
1091, 5.167355461358386, 35.84647834088374, 43.1277325388651, 0.28854099999999994, 215.0, 841, 790931, 1091, 27.74383999999918
1092, 4.036804673007078, 35.912930415414486, 43.14491619783289, 0.28781064999999995, 160.0, 782, 791713, 1092, 26.155923399999665
1093, 4.343112494568878, 35.91247871058526, 43.176708809735125, 0.28699479999999983, 395.0, 1031, 792744, 1093, 33.92314470000019
1094, 4.48507720669359, 35.909408502578735, 43.14559380722046, 0.28608085000000005, 245.0, 1000, 793744, 1094, 33.00130200000058
1095, 7.230762547910717, 35.9883113567026, 43.327084542327846, 0.28520470000000014, 245.0, 947, 794691, 1095, 31.54591849999997
1096, 3.1441805595316143, 35.92462556181588, 43.12332706952574, 0.28448740000000006, 110.0, 647, 795338, 1096, 21.561903300000267
1097, 5.07875185477374, 35.94774892920122, 43.21934224150176, 0.2837561500000001, 260.0, 978, 796316, 1097, 32.53491960000065
1098, 7.0634612910779975, 36.063484326485664, 43.40532243636347, 0.28309284999999995, 95.0, 496, 796812, 1098, 16.627717100000154
1099, 3.1217532069157294, 35.84089706196048, 43.042411187799964, 0.2824268500000002, 390.0, 984, 797796, 1099, 32.719861599998694
1100, 5.401494047895595, 35.90743767483489, 43.17355188184239, 0.2815074999999999, 220.0, 1059, 798855, 1100, 35.76319659999899
1101, 4.406784354709089, 36.02778647885178, 43.28982874841401, 0.28079335, 30.0, 528, 799383, 1101, 17.751480099999753
1102, 4.953963109871204, 36.07581697463989, 43.37916528875178, 0.2800607499999998, 760.0, 1100, 800483, 1102, 37.06343050000032
1103, 4.924993421600172, 36.18066764118696, 43.48432965712114, 0.27938754999999993, 30.0, 396, 800879, 1103, 13.421779000000242
1104, 4.68052455290308, 36.22979407384992, 43.55109712481499, 0.27874854999999993, 225.0, 1024, 801903, 1104, 34.71471400000155
1105, 3.8893273224359457, 36.260778390280734, 43.57857995791386, 0.2779848999999999, 60.0, 673, 802576, 1105, 22.835869799999273
1106, 3.295924800123155, 36.18125650060107, 43.430721981948345, 0.27745119999999995, 110.0, 513, 803089, 1106, 17.153440399999454
1107, 4.41462571033034, 36.246150227154004, 43.5823405369991, 0.27679195, 255.0, 952, 804041, 1107, 32.4556352999989
1108, 5.21194859191827, 36.29614710145526, 43.66394861539205, 0.27610435, 125.0, 576, 804617, 1108, 19.604956699999093
1109, 3.1490025914886584, 36.253098398794926, 43.54849182307024, 0.2756138499999999, 140.0, 514, 805131, 1109, 17.475187899999582
1110, 4.266690077260137, 36.239959040867916, 43.628612842756446, 0.2750333499999999, 135.0, 776, 805907, 1110, 26.409450399998605
1111, 6.2714317108044115, 36.316780894112206, 43.76541488751735, 0.2742890499999998, 475.0, 878, 806785, 1111, 29.795056200000545
1112, 4.864919608818999, 36.2763858569319, 43.62746188422246, 0.2734075, 245.0, 1081, 807866, 1112, 37.008410399999775
1113, 3.653892407576148, 36.1980734707213, 43.47788429031281, 0.27254620000000007, 405.0, 833, 808699, 1113, 28.206070199999886
1114, 5.929846218735326, 36.25500028222838, 43.61083676929153, 0.2714756499999997, 520.0, 1546, 810245, 1114, 52.33903400000054
1115, 3.1158750766820935, 36.03911100333953, 43.315464387457055, 0.27055585, 85.0, 498, 810743, 1115, 17.094350100000156
1116, 5.036476753119493, 36.107262995705675, 43.42133392130214, 0.26975890000000013, 330.0, 1273, 812016, 1116, 43.58576220000032
1117, 6.040690237870349, 36.214135763969395, 43.52939219944106, 0.26858709999999963, 700.0, 1331, 813347, 1117, 45.44826049999938
1118, 6.296218094091083, 36.18684064879898, 43.57738365745052, 0.267814, 65.0, 387, 813734, 1118, 13.434307899999112
1119, 6.715235568991263, 36.04186423837322, 43.32245277509298, 0.2674755999999999, 60.0, 365, 814099, 1119, 12.458725000000413
1120, 5.150966453338428, 36.10677779496774, 43.44459894846177, 0.2670071500000001, 115.0, 676, 814775, 1120, 23.349780999998984
1121, 5.968670924504598, 36.082140523647865, 43.36776367148224, 0.26635330000000007, 220.0, 777, 815552, 1121, 26.408464500000264
1122, 3.1086967864105683, 36.040407427363526, 43.262060992164756, 0.26576694999999995, 125.0, 526, 816078, 1122, 18.129646400000638
1123, 5.466277137093197, 36.13456979735589, 43.47089157033389, 0.2650474, 150.0, 1073, 817151, 1123, 37.058715299999676
1124, 5.392559360776041, 36.20575425781768, 43.53327431243443, 0.26414065000000003, 235.0, 942, 818093, 1124, 32.430141200000435
1125, 6.298428385550606, 36.09486993310487, 43.47487815142852, 0.26353404999999996, 80.0, 406, 818499, 1125, 14.12741509999978
1126, 4.604580615255166, 36.08210531934745, 43.3436548072481, 0.26268310000000006, 430.0, 1485, 819984, 1126, 51.237502300000415
1127, 4.537219199261728, 35.495376721160724, 42.67678714801014, 0.2615225499999998, 385.0, 1094, 821078, 1127, 37.71406519999982
1128, 3.3373638414642186, 35.50016263079103, 42.66388158582175, 0.26075215, 105.0, 618, 821696, 1128, 21.683709999999337
1129, 8.172738312734003, 35.54843468027016, 42.7590627866922, 0.2601248499999999, 120.0, 776, 822472, 1129, 27.016671599998517
1130, 6.154480585974823, 35.58233464066899, 42.79854535306956, 0.25940349999999995, 295.0, 827, 823299, 1130, 28.452105700000175
1131, 3.0406560985976747, 35.481120580402695, 42.59165123163905, 0.2587806999999999, 105.0, 557, 823856, 1131, 19.317742100000032
1132, 5.793001493362911, 35.57682631184177, 42.78363199482177, 0.25828795, 50.0, 538, 824394, 1132, 18.914297299999816
1133, 3.7831461942771933, 35.45257026398623, 42.638350831137764, 0.25765704999999994, 220.0, 864, 825258, 1133, 30.37220940000043
1134, 8.266242249256214, 35.56484413146973, 42.87176016024555, 0.2569816, 70.0, 637, 825895, 1134, 22.286368800001583
1135, 6.155098851374436, 35.56959005269667, 42.82676762917394, 0.2563264, 355.0, 819, 826714, 1135, 28.374083700000483
1136, 3.0924690527677097, 35.42605051222969, 42.54273395678576, 0.25571304999999994, 135.0, 544, 827258, 1136, 19.138260400000945
1137, 4.467799965893792, 35.43600156625271, 42.60289269679767, 0.25501960000000007, 240.0, 997, 828255, 1137, 34.84821640000155
1138, 5.45008021521438, 35.511986085235094, 42.7180066301523, 0.2541591999999999, 180.0, 915, 829170, 1138, 32.103466199998365
1139, 5.506655732809533, 35.414585412966424, 42.56297586442855, 0.25327449999999985, 615.0, 1051, 830221, 1139, 36.63731319999897
1140, 4.111126903063842, 35.393213066741495, 42.518253006204205, 0.25255494999999983, 100.0, 548, 830769, 1140, 19.375405599999795
1141, 7.178363552253713, 35.495480713136295, 42.7317497819822, 0.25180524999999976, 360.0, 1118, 831887, 1141, 39.423338099999455
1142, 3.325040362321812, 35.45437401895938, 42.54966629691746, 0.25109514999999993, 90.0, 460, 832347, 1142, 16.35539599999902
1143, 4.066225890637863, 35.35417884190877, 42.45285605930147, 0.25051014999999993, 145.0, 840, 833187, 1143, 29.322546800000055
1144, 5.551421470141837, 35.479557182107655, 42.58219265370142, 0.24982974999999996, 135.0, 672, 833859, 1144, 23.671218499999668
1145, 4.407739682658111, 35.40193648858371, 42.532345380651236, 0.24923439999999994, 115.0, 651, 834510, 1145, 23.104781500000172
1146, 5.519514207091175, 35.39383926832607, 42.60680155671401, 0.24870789999999998, 150.0, 519, 835029, 1146, 18.24385550000079
1147, 6.629759672942099, 35.339488443151694, 42.53163907930448, 0.24830109999999989, 50.0, 385, 835414, 1147, 13.760694599999624
1148, 4.987496611979607, 35.42516273120983, 42.62105748722422, 0.24764589999999984, 170.0, 1071, 836485, 1148, 37.79799289999937
1149, 4.011516129096717, 35.446420354018976, 42.560901307471006, 0.24679944999999998, 180.0, 810, 837295, 1149, 28.564228400000502
1150, 4.798321027472252, 35.37779518918293, 42.54039209412365, 0.24606594999999992, 320.0, 820, 838115, 1150, 29.322213600000396
1151, 6.984602648445538, 35.35629874638149, 42.53309927259173, 0.24538195000000002, 100.0, 700, 838815, 1151, 24.78371679999873
1152, 4.130436953138775, 35.35588407752149, 42.49046352078533, 0.24479379999999984, 100.0, 607, 839422, 1152, 21.50526979999995
1153, 5.160804096713477, 35.47163954136534, 42.70877683532905, 0.24423084999999994, 260.0, 644, 840066, 1153, 23.082316800000626
1154, 2.8693830246775756, 34.556962959380016, 41.51922697889004, 0.24371335, 80.0, 506, 840572, 1154, 18.11801749999904
1155, 8.473120091296732, 34.686903071403506, 41.79446903069814, 0.24326964999999992, 60.0, 480, 841052, 1155, 17.00495520000004
1156, 4.960255763264774, 34.73727728928192, 41.78400018909309, 0.2426981499999999, 135.0, 790, 841842, 1156, 28.057863500000167
1157, 2.9572495405298116, 34.60829380021166, 41.541457944841525, 0.24210144999999994, 85.0, 536, 842378, 1157, 19.35350709999875
1158, 6.553175551616057, 34.67686465828719, 41.71376517290127, 0.24155964999999996, 290.0, 668, 843046, 1158, 23.894170999999915
1159, 5.93853012385899, 34.67067912553303, 41.703892901349114, 0.2407667499999999, 265.0, 1094, 844140, 1159, 39.01211870000043
1160, 8.15165528838512, 34.67184993754033, 41.68567946022649, 0.2397664, 460.0, 1129, 845269, 1160, 40.360109100000045
1161, 5.4027475126135025, 34.62517898365603, 41.64282964851897, 0.23883355000000003, 245.0, 944, 846213, 1161, 33.92633449999994
1162, 4.954388962186796, 34.71373179130948, 41.74557767258477, 0.2379722499999999, 410.0, 970, 847183, 1162, 34.645751899999595
1163, 6.374420295307292, 34.698255828363976, 41.770789445336185, 0.23735484999999998, 50.0, 402, 847585, 1163, 14.673025599997345
1164, 5.079944678792988, 34.65179905926224, 41.68913276700208, 0.23692735, 40.0, 548, 848133, 1164, 19.827410800000507
1165, 3.938584459485946, 34.71050518828553, 41.69511714538971, 0.23640354999999988, 60.0, 616, 848749, 1165, 22.206728299999668
1166, 5.40875893273445, 34.73740909969996, 41.84002979722603, 0.23578614999999994, 270.0, 756, 849505, 1166, 27.464750999999524
1167, 4.9801393115646535, 34.49720887041402, 41.50276376471861, 0.2350310499999999, 175.0, 922, 850427, 1167, 33.171022899998206
1168, 4.102384267895276, 34.39668526103478, 41.34429243247928, 0.23432139999999985, 190.0, 655, 851082, 1168, 23.685952600000746
1169, 6.865813782542217, 34.375937114808615, 41.382795782321836, 0.23356539999999984, 225.0, 1025, 852107, 1169, 37.13175779999801
1170, 5.070971916965733, 34.32771286243794, 41.28055511793523, 0.23282424999999987, 85.0, 622, 852729, 1170, 22.858933600000455
1171, 6.230931064302159, 34.403945985774406, 41.400878332079074, 0.23210784999999987, 355.0, 970, 853699, 1171, 35.17852370000037
1172, 6.360166763422879, 34.448237043331105, 41.538563646791594, 0.2314292499999999, 195.0, 538, 854237, 1172, 19.68261530000018
1173, 5.097779427096247, 34.41400909143336, 41.438350526024315, 0.2308811499999999, 135.0, 680, 854917, 1173, 24.897025199999916
1174, 3.4572361049673552, 34.40714419027247, 41.32844853308414, 0.23011254999999994, 305.0, 1028, 855945, 1174, 37.778396199999406
1175, 6.1366882432129355, 34.3484305874332, 41.3254086630685, 0.2292404499999999, 210.0, 910, 856855, 1175, 32.95931299999938
1176, 4.319999702811088, 34.27821490329458, 41.22550745672309, 0.22865589999999994, 60.0, 389, 857244, 1176, 14.260790100001032
1177, 3.0594347640872, 34.42097182457264, 41.31703033814063, 0.22829364999999993, 80.0, 416, 857660, 1177, 15.273463699999411
1178, 6.551852885519668, 34.30227669404478, 41.28798176317799, 0.2279300499999999, 50.0, 392, 858052, 1178, 14.52326290000201
1179, 3.780636261216202, 34.389835662483186, 41.34790892102323, 0.2273706999999999, 300.0, 851, 858903, 1179, 31.26681649999955
1180, 4.390560166357141, 34.29301595206213, 41.20983868223248, 0.226765, 35.0, 495, 859398, 1180, 18.061747600000672
1181, 6.150177808006307, 34.20773334465103, 41.15679402836783, 0.22609135, 280.0, 1002, 860400, 1181, 36.43488160000197
1182, 4.158866289458529, 34.03842767153428, 40.926079991245494, 0.2254464999999999, 65.0, 431, 860831, 1182, 15.723008200002369
1183, 3.8617586322976805, 33.941545458537774, 40.77539133831738, 0.22469905, 385.0, 1230, 862061, 1183, 44.96486989999903
1184, 2.94945021104571, 33.97175276923824, 40.785435889218306, 0.2238791499999999, 110.0, 592, 862653, 1184, 21.857527500000288
1185, 4.870445408796754, 34.06926984824095, 40.974081081484385, 0.2232658, 185.0, 771, 863424, 1185, 28.376143299999967
1186, 3.989035532520763, 33.975472345621235, 40.86822561784224, 0.22263174999999993, 120.0, 638, 864062, 1186, 23.49913480000032
1187, 5.001658455904179, 33.961349023486974, 40.833716825413624, 0.22181724999999994, 415.0, 1172, 865234, 1187, 42.88409469999897
1188, 4.732405380870419, 33.872620757968946, 40.78238866521024, 0.22113324999999998, 30.0, 348, 865582, 1188, 13.025210199997673
1189, 4.0895876586437225, 33.98578179952899, 40.829708412335755, 0.22068594999999996, 135.0, 646, 866228, 1189, 23.833611199999723
1190, 5.660866078152648, 34.032264539089155, 40.88753426853934, 0.21985119999999994, 295.0, 1209, 867437, 1190, 44.57055279999986
1191, 5.892586776602815, 34.00090799154866, 40.865510597353804, 0.21889449999999988, 170.0, 917, 868354, 1191, 34.18509840000115
1192, 4.986185308299486, 33.935327169544465, 40.78139413995781, 0.21814839999999988, 210.0, 741, 869095, 1192, 27.58532429999832
1193, 3.7982110277181333, 33.974275934494145, 40.784041259248376, 0.21739014999999998, 255.0, 944, 870039, 1193, 34.76326770000014
1194, 3.174692727164716, 35.11314473613616, 42.186635560886835, 0.21679794999999993, 55.0, 372, 870411, 1194, 13.896713499998441
1195, 7.758254068231179, 35.15961432052871, 42.3804364608506, 0.21636504999999995, 125.0, 590, 871001, 1195, 21.94429410000157
1196, 3.791260925978597, 35.00986785620031, 42.08240218453564, 0.21571615000000002, 210.0, 852, 871853, 1196, 31.72870459999831
1197, 6.240445683220034, 35.133668830491835, 42.337751270599135, 0.21503439999999996, 105.0, 663, 872516, 1197, 24.71981429999869
1198, 6.433922311469181, 35.0481602621941, 42.15048603432431, 0.21403944999999988, 545.0, 1548, 874064, 1198, 57.566500000000815
1199, 3.964879338755825, 35.08076493416802, 42.16460908469507, 0.21291805000000003, 265.0, 944, 875008, 1199, 35.577737999999954
1200, 6.591244387232418, 35.11135318286982, 42.317493435634375, 0.21193704999999985, 415.0, 1236, 876244, 1200, 46.213595799999894
1201, 4.066579291703844, 35.08915076410384, 42.159176981062664, 0.21101994999999976, 135.0, 802, 877046, 1201, 29.671421200000623
1202, 4.745885036833454, 35.04823514034874, 42.124820767229764, 0.21027429999999997, 255.0, 855, 877901, 1202, 32.1506507999984
1203, 4.5075905840406065, 35.09363748480589, 42.22975510025759, 0.20965599999999993, 120.0, 519, 878420, 1203, 19.667446300001757
1204, 5.093103416172075, 35.07174551634141, 42.17146768687684, 0.20913084999999995, 145.0, 648, 879068, 1204, 24.321584900000744
1205, 4.054655894107445, 35.10845255512762, 42.18133822888559, 0.20845944999999994, 270.0, 844, 879912, 1205, 31.706801399999677
1206, 7.685942384217467, 35.169916821434384, 42.34554296584356, 0.20784339999999998, 35.0, 525, 880437, 1206, 20.022957200002566
1207, 3.753867640150346, 35.1641966791557, 42.25622368011353, 0.2070441999999999, 320.0, 1251, 881688, 1207, 47.3453479000018
1208, 7.361068485775276, 35.21002886922736, 42.42595582593951, 0.20596824999999996, 290.0, 1140, 882828, 1208, 44.095533600000635
1209, 4.3988691259417445, 35.1928708856756, 42.29325312824992, 0.20493549999999988, 340.0, 1155, 883983, 1209, 43.80240309999863
1210, 2.6991252020027834, 35.22282348118775, 42.32588123429752, 0.20416194999999995, 135.0, 564, 884547, 1210, 21.295479600001272
1211, 4.494194651644938, 35.01127371199195, 42.09640181035741, 0.2035364499999999, 375.0, 826, 885373, 1211, 31.54222480000317
1212, 4.7613487291750065, 35.09472290561197, 42.24292524842368, 0.20272419999999985, 190.0, 979, 886352, 1212, 38.92320469999686
1213, 4.2771580544037695, 35.05112922817505, 42.130777226262914, 0.20191509999999988, 160.0, 819, 887171, 1213, 31.428374099999928
1214, 5.310018582135274, 35.151278702036066, 42.330319304122504, 0.20130309999999993, 65.0, 541, 887712, 1214, 20.35418820000268
1215, 5.566549258190955, 35.216273440538686, 42.389503969114905, 0.20084949999999993, 55.0, 467, 888179, 1215, 17.915992300000653
1216, 3.6861319974597837, 35.20266925343088, 42.33510264490107, 0.20034999999999997, 50.0, 643, 888822, 1216, 24.607925699998304
1217, 2.6445918121052308, 35.11832514864996, 42.175433378686925, 0.19981269999999987, 125.0, 551, 889373, 1217, 20.990435899999284
1218, 3.603958879402364, 35.16426138856613, 42.27867020752951, 0.19895904999999997, 380.0, 1346, 890719, 1218, 51.50405350000074
1219, 4.055731008785694, 35.326014505392514, 42.49083624717622, 0.19793529999999995, 535.0, 929, 891648, 1219, 35.35843360000217
1220, 4.1939450317984495, 35.24087748361464, 42.366813697625155, 0.1971554499999999, 205.0, 804, 892452, 1220, 30.777899000000616
1221, 2.887788175039691, 35.24292403045378, 42.36698885338544, 0.1964957499999999, 190.0, 662, 893114, 1221, 25.317741300001217
1222, 6.324471719282401, 35.33073991552576, 42.54730713584206, 0.19585134999999992, 220.0, 770, 893884, 1222, 29.451970999998593
1223, 5.129074930165495, 35.18224268668038, 42.321123142787386, 0.19511109999999998, 145.0, 875, 894759, 1223, 33.535147999999026
1224, 4.680960807032136, 35.26928236999048, 42.455938872595326, 0.19442125, 55.0, 658, 895417, 1224, 25.25609020000047
1225, 4.694448650154067, 35.2289067176564, 42.381508068391994, 0.19366704999999992, 265.0, 1018, 896435, 1225, 38.99208599999838
1226, 5.187338488035529, 35.26367262779813, 42.395155737005126, 0.1929888999999999, 120.0, 489, 896924, 1226, 18.917705200001365
1227, 4.04989512023603, 35.27349444798061, 42.444967535647976, 0.19225854999999986, 380.0, 1134, 898058, 1227, 43.87054949999947
1228, 5.253807641620184, 35.206449934687924, 42.3620381376169, 0.1914399999999999, 125.0, 685, 898743, 1228, 26.70874470000126
1229, 4.440409017048089, 35.26123419123883, 42.409563500003934, 0.19062909999999997, 345.0, 1117, 899860, 1229, 43.19416099999944
1230, 3.433343244011098, 35.23337269843893, 42.378636855267466, 0.18970345000000002, 380.0, 940, 900800, 1230, 36.831141700000444
1231, 3.9647743697788402, 35.30097033956776, 42.44309095963188, 0.18902169999999993, 35.0, 575, 901375, 1231, 22.156994299999496
1232, 3.6785564648043443, 35.23999874786246, 42.357967810569406, 0.18834355, 425.0, 932, 902307, 1232, 36.31590390000201
1233, 4.510454311817785, 35.26977545933536, 42.422149813437635, 0.18724959999999985, 410.0, 1499, 903806, 1233, 58.60964299999978
1234, 5.185700605253723, 35.28651559999346, 42.47929907776011, 0.18616014999999994, 415.0, 922, 904728, 1234, 35.89331899999888
1235, 4.168409818526713, 35.218888458009324, 42.33428452966913, 0.18549054999999995, 105.0, 566, 905294, 1235, 22.061718400000245
1236, 5.3755255281330285, 35.249516733698975, 42.40433226610771, 0.18499914999999992, 110.0, 526, 905820, 1236, 20.555425799997465
1237, 6.731365920807186, 35.2737410455001, 42.52102001792506, 0.18454869999999995, 60.0, 475, 906295, 1237, 18.73121099999844
1238, 7.588840441562508, 35.22965131154874, 42.440138031796714, 0.18403974999999995, 135.0, 656, 906951, 1238, 26.152458900000056
1239, 2.521508507716269, 35.32081316495012, 42.4175944595562, 0.18359199999999998, 35.0, 339, 907290, 1239, 13.396628099999361
1240, 5.488758259047171, 35.2707044476975, 42.4166772899594, 0.1829291499999999, 675.0, 1134, 908424, 1240, 44.32130630000029
1241, 5.598922624088663, 35.27199802229462, 42.43870332183644, 0.18206379999999997, 165.0, 789, 909213, 1241, 30.815452300001198
1242, 6.670542751256567, 35.42514068413031, 42.61619706222795, 0.18136629999999995, 180.0, 761, 909974, 1242, 30.075107799999387
1243, 3.9738679093196296, 35.898092086839235, 43.15666741409538, 0.18073314999999993, 80.0, 646, 910620, 1243, 25.62379560000045
1244, 5.729872596698308, 35.944178368977994, 43.240246243611395, 0.1801553499999999, 85.0, 638, 911258, 1244, 25.524221200001193
1245, 6.634479227725949, 35.85928046635219, 43.152219946725026, 0.17955324999999994, 110.0, 700, 911958, 1245, 27.787874900001043
1246, 7.377362664204683, 35.91054405280295, 43.22699903460578, 0.1788336999999999, 215.0, 899, 912857, 1246, 35.5963597000009
1247, 4.924566969249871, 35.90678935853886, 43.18368576810122, 0.17790535, 535.0, 1164, 914021, 1247, 45.76453179999953
1248, 3.819805021368075, 35.896299113398015, 43.11943453360295, 0.17707104999999995, 100.0, 690, 914711, 1248, 27.39966579999964
1249, 5.478519901350812, 35.94284171745425, 43.23865804125051, 0.17632135, 515.0, 976, 915687, 1249, 38.310179700001754
1250, 5.614411219338114, 35.89103708419468, 43.200773850926815, 0.17526204999999995, 450.0, 1378, 917065, 1250, 54.20844209999996
1251, 5.637424760982276, 36.01379932621894, 43.27458653957931, 0.1740758499999999, 330.0, 1258, 918323, 1251, 50.26883810000072
1252, 6.1815921749688885, 35.89962117017898, 43.181807269881254, 0.17325549999999992, 125.0, 565, 918888, 1252, 22.38935870000205
1253, 4.0202251127753845, 35.89693317019912, 43.14704579119467, 0.1724122, 235.0, 1309, 920197, 1253, 51.80638420000105
1254, 6.7638474493436025, 35.8040637576334, 43.0864628832962, 0.17158329999999994, 55.0, 533, 920730, 1254, 21.29413030000069
1255, 5.394347242522435, 35.86103090692739, 43.10980387203029, 0.17106894999999994, 85.0, 610, 921340, 1255, 24.355043799998384
1256, 3.2857281488047527, 35.743292062743805, 42.94840719307909, 0.17029899999999984, 425.0, 1101, 922441, 1256, 43.92708230000062
1257, 5.85637826408101, 35.75880170930421, 43.022075586443904, 0.16928829999999992, 670.0, 1145, 923586, 1257, 45.77406809999957
1258, 5.710133462732992, 35.704872414140674, 42.98443292443309, 0.16848775, 180.0, 634, 924220, 1258, 25.401320199998736
1259, 4.335686429428408, 35.70686041360878, 42.93658933984228, 0.16782894999999998, 200.0, 830, 925050, 1259, 33.56580400000166
1260, 6.811557412377834, 35.844963781247735, 43.1519126597291, 0.16716429999999996, 140.0, 647, 925697, 1260, 26.046311300000525
1261, 6.0319487874796005, 35.75834635847008, 43.01777807556757, 0.16637319999999992, 455.0, 1111, 926808, 1261, 44.6445492999992
1262, 5.684002976573032, 35.747826120127804, 42.888403610561205, 0.16566624999999993, 105.0, 460, 927268, 1262, 18.461933800001134
1263, 3.3317348954694714, 35.69215370559115, 42.8287490694678, 0.16516179999999994, 135.0, 661, 927929, 1263, 26.56780400000207
1264, 5.4111263846537945, 35.69601279773163, 42.95637262031641, 0.16450479999999998, 215.0, 799, 928728, 1264, 32.36737339999672
1265, 5.6387216695971825, 35.72476760125557, 43.004122412330986, 0.16384779999999996, 160.0, 661, 929389, 1265, 26.564399599999888
1266, 5.738726228931961, 35.81091187668431, 43.09471621666714, 0.16325649999999994, 105.0, 653, 930042, 1266, 26.295653699999093
1267, 4.188816819652527, 36.03665430957349, 43.327720336766916, 0.16249600000000003, 330.0, 1037, 931079, 1267, 41.873695499998576
1268, 4.941410432007635, 36.069958872566055, 43.37949519594684, 0.16151409999999994, 370.0, 1145, 932224, 1268, 46.2886553999997
1269, 3.8257456721897753, 36.094988302092084, 43.42677178315567, 0.16058439999999988, 390.0, 921, 933145, 1269, 37.24787060000017
1270, 3.421378527596897, 35.99192440544551, 43.264267590581156, 0.15986124999999993, 130.0, 686, 933831, 1270, 27.870840200001112
1271, 5.46441813197758, 36.2273838221158, 43.531074824208076, 0.15924384999999996, 70.0, 686, 934517, 1271, 28.268178499998612
1272, 5.435318486413258, 36.05479073598289, 43.35058103626358, 0.15864444999999996, 115.0, 646, 935163, 1272, 26.54684819999966
1273, 5.914882700773102, 36.1911689158236, 43.56370559006594, 0.15795325, 195.0, 890, 936053, 1273, 36.457076399998186
1274, 7.2920947897352235, 36.185365068844646, 43.49301914743499, 0.15707844999999987, 320.0, 1054, 937107, 1274, 43.03311620000022
1275, 3.537413927733898, 36.143518081665036, 43.440230784098304, 0.15626664999999995, 210.0, 750, 937857, 1275, 30.460144699998636
1276, 5.426182831318497, 36.09646115921162, 43.440125319692825, 0.1555403499999999, 230.0, 864, 938721, 1276, 35.245095400001446
1277, 4.50319030106696, 36.02317926108119, 43.33060234713267, 0.15500214999999998, 45.0, 332, 939053, 1277, 13.487572699999873
1278, 2.356545400828267, 35.97393924141851, 43.19748043668443, 0.15466644999999998, 55.0, 414, 939467, 1278, 16.856886899997335
1279, 4.3893343448198054, 36.10810309867182, 43.39614655082748, 0.1540998999999999, 150.0, 845, 940312, 1279, 34.53426060000129
1280, 4.486709205025784, 36.120029616555875, 43.4580194094641, 0.15323679999999995, 235.0, 1073, 941385, 1280, 44.14837189999889
1281, 4.877841704389546, 36.114372728249926, 43.45845575549203, 0.15221889999999988, 775.0, 1189, 942574, 1281, 48.87066820000109
1282, 6.7119696426904945, 36.12286370564876, 43.47972346036628, 0.15130764999999996, 310.0, 836, 943410, 1282, 34.45346989999962
1283, 5.716729653695217, 36.169627198125916, 43.55752466128205, 0.1506281499999999, 170.0, 674, 944084, 1283, 28.184694600000512
1284, 5.630789631477589, 36.12304614026259, 43.47196929278541, 0.15009354999999994, 120.0, 514, 944598, 1284, 21.330316999999923
1285, 6.278569057428183, 36.23277232914619, 43.61360414470145, 0.14951755, 205.0, 766, 945364, 1285, 31.69216139999844
1286, 8.796431041426128, 36.22070471445719, 43.631110685843005, 0.14902704999999994, 20.0, 324, 945688, 1286, 13.432074399999692
1287, 4.067063448616041, 36.089059943924404, 43.35213414494863, 0.14858064999999993, 170.0, 668, 946356, 1287, 27.466981800000212
1288, 5.008377131753831, 36.16413900998325, 43.487377888847455, 0.14769999999999997, 400.0, 1289, 947645, 1288, 53.291297900002974
1289, 5.21933815300248, 36.07619126538745, 43.38521236843533, 0.14668659999999994, 280.0, 963, 948608, 1289, 39.89369119999901
1290, 3.3549721902861322, 36.13680796523561, 43.45700786242259, 0.1458441999999999, 405.0, 909, 949517, 1290, 37.629143699999986
1291, 5.0954648518632055, 35.86543075674273, 43.10664573913724, 0.14506974999999994, 215.0, 812, 950329, 1291, 33.9606767999976
1292, 4.974890320881371, 35.442365389066005, 42.6119126182847, 0.14439744999999993, 180.0, 682, 951011, 1292, 28.38890149999861
1293, 6.011178957952993, 35.49295827598054, 42.73046918152684, 0.14379219999999995, 215.0, 663, 951674, 1293, 28.000253499998507
1294, 7.759137387874019, 35.62833711137744, 42.90570596295988, 0.14302269999999986, 270.0, 1047, 952721, 1294, 43.2618341999987
1295, 2.808776613730749, 35.59268946963061, 42.744946186644555, 0.14232025, 35.0, 514, 953235, 1295, 21.74625129999913
1296, 4.521224757455706, 35.46186269159044, 42.65402981496605, 0.14175909999999994, 85.0, 733, 953968, 1296, 30.517937299999176
1297, 4.849998096403267, 35.54989393835976, 42.807613088971095, 0.14112684999999991, 155.0, 672, 954640, 1297, 28.062647099999595
1298, 9.003266253731189, 35.542065685956906, 42.77401087834285, 0.14038569999999995, 275.0, 975, 955615, 1298, 40.81581179999921
1299, 7.301256438865541, 35.541408335234344, 42.80257182484224, 0.13943259999999985, 215.0, 1143, 956758, 1299, 47.716536600000836
1300, 4.240673001846298, 35.56376636266708, 42.7011585521698, 0.1385582499999999, 135.0, 800, 957558, 1300, 33.57210089999717
1301, 6.401073930621618, 35.58155623123108, 42.85352855275271, 0.13762899999999995, 345.0, 1265, 958823, 1301, 52.64448739999716
1302, 4.391612548859039, 35.508231785212786, 42.67684256889475, 0.13656519999999994, 580.0, 1099, 959922, 1302, 46.02183049999803
1303, 5.427074742301678, 35.43749485015869, 42.62094954649607, 0.13585464999999988, 105.0, 480, 960402, 1303, 20.211647500000254
1304, 4.401535314798259, 35.243735914445, 42.39136059874507, 0.1353587499999999, 155.0, 622, 961024, 1304, 26.271880000000237
1305, 5.283973271839005, 35.330674065207816, 42.490721704439544, 0.13438809999999998, 400.0, 1535, 962559, 1305, 64.82643180000014
1306, 3.295349344994762, 35.35670737842522, 42.46344924020295, 0.13347009999999998, 35.0, 505, 963064, 1306, 21.132309999997233
1307, 2.3708998352581823, 35.23094619797076, 42.30577784650635, 0.13294494999999998, 150.0, 662, 963726, 1307, 28.13263989999905
1308, 3.6716996681008496, 35.262691472744834, 42.40405255749568, 0.1320647499999999, 940.0, 1294, 965020, 1308, 54.83678249999866
1309, 5.993939619451142, 35.27571056180958, 42.50073624538219, 0.1312875999999999, 60.0, 433, 965453, 1309, 18.403965900000912
1310, 5.105516976272609, 35.33587655683806, 42.47726619205291, 0.13053294999999993, 280.0, 1244, 966697, 1310, 53.118602000002284
1311, 6.763765335770075, 35.325655225569825, 42.498124072596106, 0.12944124999999998, 265.0, 1182, 967879, 1311, 50.431032700002106
1312, 5.3147652665261, 35.28059354671663, 42.50834474877013, 0.12862179999999995, 125.0, 639, 968518, 1312, 27.23821870000029
1313, 4.310351334899664, 35.339749420166015, 42.44108042907715, 0.12810924999999992, 45.0, 500, 969018, 1313, 21.276909299998806
1314, 4.6188613279184825, 35.25122482065355, 42.404678388685944, 0.1275327999999999, 250.0, 781, 969799, 1314, 33.39128619999974
1315, 3.9383536986759955, 35.1688234253435, 42.283061962254, 0.12690954999999993, 195.0, 604, 970403, 1315, 25.78512039999987
1316, 6.3166351879292035, 35.105137071785144, 42.24056635698544, 0.12622239999999996, 135.0, 923, 971326, 1316, 39.82441349999863
1317, 3.913508992197004, 35.12550920210544, 42.225000273506595, 0.12552084999999993, 175.0, 636, 971962, 1317, 27.465094600000157
1318, 4.747795608980226, 35.222957351172745, 42.353563536637985, 0.12480534999999993, 205.0, 954, 972916, 1318, 41.070610900002066
1319, 4.91155253341198, 35.18513893432617, 42.328382159423825, 0.12409479999999992, 125.0, 625, 973541, 1319, 26.746047500000714
1320, 6.8503154540624385, 35.264813896890836, 42.483491123886274, 0.12360609999999991, 75.0, 461, 974002, 1320, 19.969390800000838
1321, 3.789673494780363, 35.14749091311564, 42.252919518966316, 0.12311199999999994, 45.0, 637, 974639, 1321, 27.38489860000118
1322, 4.814379405630981, 35.02733841186134, 42.127118692611354, 0.12240279999999992, 205.0, 939, 975578, 1322, 42.28085270000156
1323, 4.4350944780669845, 35.142061209020206, 42.26520423668657, 0.12127959999999992, 975.0, 1557, 977135, 1323, 67.4788716999974
1324, 6.139786922944098, 35.12581590127547, 42.26203697499585, 0.11998539999999988, 335.0, 1319, 978454, 1324, 57.46156020000126
1325, 2.9413744604508385, 35.15999045181998, 42.22966446415071, 0.11915469999999995, 90.0, 527, 978981, 1325, 22.62035190000097
1326, 5.166884578840024, 35.09435396332672, 42.21594746907552, 0.11860704999999994, 120.0, 690, 979671, 1326, 29.905962500000896
1327, 6.057565491454743, 35.981913133642045, 43.32330058628981, 0.11771964999999991, 340.0, 1282, 980953, 1327, 55.72005459999855
1328, 4.687775691443492, 36.27319936591286, 43.62903509086337, 0.11666304999999995, 170.0, 1066, 982019, 1328, 46.0293113000007
1329, 5.803156479346752, 36.335425805664066, 43.762411083984375, 0.11590209999999997, 80.0, 625, 982644, 1329, 27.214824900001986
1330, 4.1745730209482295, 36.303017528672775, 43.64159004568434, 0.11510154999999994, 270.0, 1154, 983798, 1330, 50.3679856000017
1331, 3.846439613249111, 36.34141981199886, 43.70948789360818, 0.11426184999999991, 160.0, 712, 984510, 1331, 31.022418900000048
1332, 7.102581206936082, 36.32463349722609, 43.812555838234815, 0.11337264999999998, 535.0, 1264, 985774, 1332, 54.90286040000137
1333, 5.354247089934484, 36.280603694108336, 43.67133532261243, 0.11232549999999994, 285.0, 1063, 986837, 1333, 46.56840150000062
1334, 4.912131454827439, 36.39048806622497, 43.766832596216446, 0.1114259499999999, 220.0, 936, 987773, 1334, 41.18681459999789
1335, 5.616779405793239, 36.319259611984776, 43.71589968977303, 0.11067849999999994, 145.0, 725, 988498, 1335, 31.521540499998082
1336, 2.64586592345529, 36.31817076368356, 43.66593088491137, 0.11017359999999994, 50.0, 397, 988895, 1336, 17.405992099997093
1337, 8.061431491126617, 36.36073197258843, 43.787062575851664, 0.10943604999999991, 310.0, 1242, 990137, 1337, 55.21780089999811
1338, 6.749389225229621, 36.1377446975708, 43.51680270385742, 0.10865214999999998, 55.0, 500, 990637, 1338, 21.9049468000012
1339, 3.7151081209633756, 36.138664317003546, 43.41060799583394, 0.10809054999999997, 195.0, 748, 991385, 1339, 32.80924340000274
1340, 5.097406300001747, 36.054370846591155, 43.29854944250086, 0.10734444999999997, 195.0, 910, 992295, 1340, 39.895825600000535
1341, 7.584696671771899, 36.129824711983666, 43.52935111062568, 0.10667844999999994, 140.0, 570, 992865, 1341, 25.182001000001037
1342, 5.932718391472199, 36.21456365741667, 43.53054323040071, 0.10614744999999995, 150.0, 610, 993475, 1342, 26.998989700001403
1343, 6.542986765214324, 36.144419169746705, 43.480626213176365, 0.10557189999999993, 195.0, 669, 994144, 1343, 29.506844799998362
1344, 5.637529564970317, 36.12237742352529, 43.52041305179352, 0.10477854999999994, 235.0, 1094, 995238, 1344, 48.439394599998195
1345, 4.547130751309635, 36.09949474197497, 43.4269008554143, 0.10397349999999993, 150.0, 695, 995933, 1345, 30.994199100001424
1346, 8.153026044793682, 36.1311702873317, 43.53458499545833, 0.10342404999999993, 40.0, 526, 996459, 1346, 23.347720599998866
1347, 4.745771025265417, 36.106010990758094, 43.413786420514505, 0.10290834999999995, 165.0, 620, 997079, 1347, 27.33791370000108
1348, 5.99432781502295, 36.12374218281369, 43.47188444731851, 0.10232604999999993, 120.0, 674, 997753, 1348, 30.099687199999607
1349, 7.473974886905766, 36.174770743266, 43.53981551623325, 0.1014741999999999, 240.0, 1219, 998972, 1349, 54.39795200000299
