,loss,mae,mean_q,mean_eps,episode_reward,nb_episode_steps,nb_steps,episode,duration
0,0,0,0,0,125.0,478,478,0,1.001540499999999
1, 0, 0, 0, 0, 210.0, 749, 1227, 1, 1.5633034000000006
2, 0, 0, 0, 0, 50.0, 529, 1756, 2, 1.0538878
3, 0, 0, 0, 0, 45.0, 542, 2298, 3, 1.1222668000000002
4, 0, 0, 0, 0, 45.0, 390, 2688, 4, 0.8060815999999988
5, 0, 0, 0, 0, 155.0, 825, 3513, 5, 1.6815028000000005
6, 0, 0, 0, 0, 160.0, 628, 4141, 6, 1.2848453999999982
7, 0, 0, 0, 0, 210.0, 858, 4999, 7, 1.7422357999999996
8, 0, 0, 0, 0, 180.0, 721, 5720, 8, 1.4520194999999987
9, 0, 0, 0, 0, 400.0, 1444, 7164, 9, 2.8327456999999967
10, 0, 0, 0, 0, 135.0, 719, 7883, 10, 1.4923050999999994
11, 0, 0, 0, 0, 165.0, 539, 8422, 11, 1.1079657999999988
12, 0, 0, 0, 0, 230.0, 814, 9236, 12, 1.718316399999999
13, 0, 0, 0, 0, 95.0, 668, 9904, 13, 1.3506758999999988
14, 0, 0, 0, 0, 55.0, 518, 10422, 14, 1.0381090999999998
15, 0, 0, 0, 0, 120.0, 693, 11115, 15, 1.3873290000000011
16, 0, 0, 0, 0, 135.0, 646, 11761, 16, 1.3105350000000016
17, 0, 0, 0, 0, 90.0, 551, 12312, 17, 1.1427645999999996
18, 0, 0, 0, 0, 105.0, 606, 12918, 18, 1.2418898000000027
19, 0, 0, 0, 0, 115.0, 645, 13563, 19, 1.3374714999999995
20, 0, 0, 0, 0, 45.0, 467, 14030, 20, 0.9626079000000018
21, 0, 0, 0, 0, 105.0, 593, 14623, 21, 1.1738439000000014
22, 0, 0, 0, 0, 360.0, 1000, 15623, 22, 1.9923757999999978
23, 0, 0, 0, 0, 50.0, 568, 16191, 23, 1.1740268
24, 0, 0, 0, 0, 105.0, 715, 16906, 24, 1.4729849999999942
25, 0, 0, 0, 0, 155.0, 651, 17557, 25, 1.340837900000004
26, 0, 0, 0, 0, 155.0, 619, 18176, 26, 1.2853223999999983
27, 0, 0, 0, 0, 35.0, 431, 18607, 27, 0.9204518000000022
28, 0, 0, 0, 0, 330.0, 1023, 19630, 28, 2.043832899999998
29, 0, 0, 0, 0, 55.0, 559, 20189, 29, 1.1616005999999999
30, 0, 0, 0, 0, 125.0, 659, 20848, 30, 1.346655400000003
31, 0, 0, 0, 0, 120.0, 522, 21370, 31, 1.0848293000000027
32, 0, 0, 0, 0, 135.0, 594, 21964, 32, 1.222070599999995
33, 0, 0, 0, 0, 285.0, 830, 22794, 33, 1.6687876000000017
34, 0, 0, 0, 0, 85.0, 390, 23184, 34, 0.811822400000004
35, 0, 0, 0, 0, 135.0, 685, 23869, 35, 1.4101057999999966
36, 0, 0, 0, 0, 485.0, 1003, 24872, 36, 1.9735390000000024
37, 0, 0, 0, 0, 260.0, 783, 25655, 37, 1.6393545999999972
38, 0, 0, 0, 0, 80.0, 647, 26302, 38, 1.3316294999999982
39, 0, 0, 0, 0, 215.0, 908, 27210, 39, 1.8334963000000002
40, 0, 0, 0, 0, 40.0, 477, 27687, 40, 0.9873638999999912
41, 0, 0, 0, 0, 135.0, 629, 28316, 41, 1.2616158999999953
42, 0, 0, 0, 0, 30.0, 492, 28808, 42, 1.000840299999993
43, 0, 0, 0, 0, 225.0, 912, 29720, 43, 1.8343399999999974
44, 0, 0, 0, 0, 30.0, 410, 30130, 44, 0.8677016999999978
45, 0, 0, 0, 0, 35.0, 372, 30502, 45, 0.7466797999999955
46, 0, 0, 0, 0, 85.0, 393, 30895, 46, 0.783022900000006
47, 0, 0, 0, 0, 35.0, 575, 31470, 47, 1.1850079000000022
48, 0, 0, 0, 0, 135.0, 665, 32135, 48, 1.3579414000000014
49, 0, 0, 0, 0, 65.0, 558, 32693, 49, 1.0956977000000023
50, 0, 0, 0, 0, 210.0, 652, 33345, 50, 1.293034800000001
51, 0, 0, 0, 0, 210.0, 709, 34054, 51, 1.4060648999999898
52, 0, 0, 0, 0, 210.0, 640, 34694, 52, 1.2735244999999935
53, 0, 0, 0, 0, 180.0, 682, 35376, 53, 1.3274713999999932
54, 0, 0, 0, 0, 105.0, 553, 35929, 54, 1.1122812999999923
55, 0, 0, 0, 0, 395.0, 1006, 36935, 55, 2.013058700000002
56, 0, 0, 0, 0, 65.0, 498, 37433, 56, 0.9909449000000023
57, 0, 0, 0, 0, 195.0, 843, 38276, 57, 1.6510215999999929
58, 0, 0, 0, 0, 105.0, 528, 38804, 58, 1.0664669000000089
59, 0, 0, 0, 0, 120.0, 759, 39563, 59, 1.5358577000000082
60, 0, 0, 0, 0, 310.0, 791, 40354, 60, 1.5467165000000023
61, 0, 0, 0, 0, 130.0, 743, 41097, 61, 1.4879365000000035
62, 0, 0, 0, 0, 345.0, 1286, 42383, 62, 2.4736672000000084
63, 0, 0, 0, 0, 110.0, 593, 42976, 63, 1.1684343000000013
64, 0, 0, 0, 0, 210.0, 705, 43681, 64, 1.3949381000000045
65, 0, 0, 0, 0, 110.0, 632, 44313, 65, 1.2904903000000019
66, 0, 0, 0, 0, 120.0, 639, 44952, 66, 1.2683873000000006
67, 0, 0, 0, 0, 395.0, 1015, 45967, 67, 1.9619904999999989
68, 0, 0, 0, 0, 655.0, 1200, 47167, 68, 2.3399936999999937
69, 0, 0, 0, 0, 110.0, 643, 47810, 69, 1.3516110999999995
70, 0, 0, 0, 0, 45.0, 456, 48266, 70, 0.9389866000000069
71, 0, 0, 0, 0, 180.0, 659, 48925, 71, 1.3401865000000015
72, 0, 0, 0, 0, 120.0, 722, 49647, 72, 1.535454400000006
73, 0, 0, 0, 0, 80.0, 392, 50039, 73, 0.8260309000000063
74, 0, 0, 0, 0, 185.0, 774, 50813, 74, 1.5361984999999976
75, 0, 0, 0, 0, 125.0, 660, 51473, 75, 1.3633662999999956
76, 0, 0, 0, 0, 90.0, 465, 51938, 76, 1.0219641999999993
77, 0, 0, 0, 0, 240.0, 923, 52861, 77, 1.8405642000000029
78, 0, 0, 0, 0, 60.0, 394, 53255, 78, 0.802445899999995
79, 0, 0, 0, 0, 230.0, 955, 54210, 79, 1.9394465000000025
80, 0, 0, 0, 0, 105.0, 605, 54815, 80, 1.2321070999999932
81, 0, 0, 0, 0, 110.0, 616, 55431, 81, 1.2483947999999998
82, 0, 0, 0, 0, 105.0, 642, 56073, 82, 1.2835728000000017
83, 0, 0, 0, 0, 110.0, 504, 56577, 83, 1.0548846000000083
84, 0, 0, 0, 0, 115.0, 908, 57485, 84, 1.8401099999999957
85, 0, 0, 0, 0, 130.0, 513, 57998, 85, 1.0260047000000014
86, 0, 0, 0, 0, 320.0, 1235, 59233, 86, 2.4269913999999915
87, 0, 0, 0, 0, 185.0, 675, 59908, 87, 1.3366743999999926
88, 0, 0, 0, 0, 135.0, 723, 60631, 88, 1.4623817000000088
89, 0, 0, 0, 0, 325.0, 705, 61336, 89, 1.461709099999979
90, 0, 0, 0, 0, 315.0, 1105, 62441, 90, 2.1876358000000096
91, 0, 0, 0, 0, 515.0, 906, 63347, 91, 1.7832738000000177
92, 0, 0, 0, 0, 130.0, 527, 63874, 92, 1.0864680999999905
93, 0, 0, 0, 0, 85.0, 738, 64612, 93, 1.500078099999996
94, 0, 0, 0, 0, 220.0, 924, 65536, 94, 1.836394299999995
95, 0, 0, 0, 0, 190.0, 801, 66337, 95, 1.607676099999992
96, 0, 0, 0, 0, 80.0, 440, 66777, 96, 0.9240010000000041
97, 0, 0, 0, 0, 90.0, 461, 67238, 97, 0.9270765999999924
98, 0, 0, 0, 0, 475.0, 1179, 68417, 98, 2.3336185
99, 0, 0, 0, 0, 60.0, 401, 68818, 99, 0.8242442000000096
100, 0, 0, 0, 0, 320.0, 1084, 69902, 100, 2.240256800000026
101, 0, 0, 0, 0, 170.0, 577, 70479, 101, 1.1576112000000194
102, 0, 0, 0, 0, 110.0, 684, 71163, 102, 1.3656853999999896
103, 0, 0, 0, 0, 35.0, 524, 71687, 103, 1.0873559999999998
104, 0, 0, 0, 0, 45.0, 393, 72080, 104, 0.8541606000000002
105, 0, 0, 0, 0, 170.0, 714, 72794, 105, 1.4106812999999931
106, 0, 0, 0, 0, 75.0, 419, 73213, 106, 0.8501631999999972
107, 0, 0, 0, 0, 120.0, 684, 73897, 107, 1.3850393999999824
108, 0, 0, 0, 0, 485.0, 1308, 75205, 108, 2.5264608000000237
109, 0, 0, 0, 0, 120.0, 561, 75766, 109, 1.1560782999999901
110, 0, 0, 0, 0, 75.0, 515, 76281, 110, 1.0618824999999958
111, 0, 0, 0, 0, 85.0, 638, 76919, 111, 1.2920687000000157
112, 0, 0, 0, 0, 155.0, 673, 77592, 112, 1.37607109999999
113, 0, 0, 0, 0, 315.0, 997, 78589, 113, 1.95193230000001
114, 0, 0, 0, 0, 95.0, 587, 79176, 114, 1.2063943999999935
115, 0, 0, 0, 0, 90.0, 598, 79774, 115, 1.277201099999985
116, 0, 0, 0, 0, 135.0, 920, 80694, 116, 1.8380541000000221
117, 0, 0, 0, 0, 130.0, 625, 81319, 117, 1.3000380000000007
118, 0, 0, 0, 0, 155.0, 469, 81788, 118, 0.9913177999999903
119, 0, 0, 0, 0, 70.0, 604, 82392, 119, 1.2392635000000212
120, 0, 0, 0, 0, 65.0, 385, 82777, 120, 0.7785994000000187
121, 0, 0, 0, 0, 230.0, 702, 83479, 121, 1.4522361999999873
122, 0, 0, 0, 0, 190.0, 1099, 84578, 122, 2.362955900000003
123, 0, 0, 0, 0, 135.0, 634, 85212, 123, 1.351781499999987
124, 0, 0, 0, 0, 80.0, 509, 85721, 124, 1.0967702000000088
125, 0, 0, 0, 0, 100.0, 574, 86295, 125, 1.2567345999999873
126, 0, 0, 0, 0, 360.0, 834, 87129, 126, 1.690245300000015
127, 0, 0, 0, 0, 325.0, 1008, 88137, 127, 2.059572199999991
128, 0, 0, 0, 0, 155.0, 510, 88647, 128, 1.0955126000000064
129, 0, 0, 0, 0, 20.0, 505, 89152, 129, 1.0789662000000249
130, 0, 0, 0, 0, 340.0, 1177, 90329, 130, 2.4564120999999943
131, 0, 0, 0, 0, 135.0, 658, 90987, 131, 1.4048303999999803
132, 0, 0, 0, 0, 105.0, 596, 91583, 132, 1.2663675999999953
133, 0, 0, 0, 0, 60.0, 548, 92131, 133, 1.1459229000000164
134, 0, 0, 0, 0, 110.0, 498, 92629, 134, 1.0496643000000176
135, 0, 0, 0, 0, 350.0, 775, 93404, 135, 1.6221624000000077
136, 0, 0, 0, 0, 230.0, 863, 94267, 136, 1.8174735000000055
137, 0, 0, 0, 0, 155.0, 527, 94794, 137, 1.1329680000000053
138, 0, 0, 0, 0, 45.0, 414, 95208, 138, 0.884603999999996
139, 0, 0, 0, 0, 325.0, 821, 96029, 139, 1.7235936999999808
140, 0, 0, 0, 0, 60.0, 374, 96403, 140, 0.799062900000024
141, 0, 0, 0, 0, 175.0, 657, 97060, 141, 1.3867757000000154
142, 0, 0, 0, 0, 205.0, 902, 97962, 142, 1.8773133999999914
143, 0, 0, 0, 0, 175.0, 799, 98761, 143, 1.6655953000000068
144, 0, 0, 0, 0, 60.0, 536, 99297, 144, 1.1534162000000094
145, 133.9796210800541, 92.83000792840099, 119.06793151197408, 0.9098325999999999, 435.0, 1075, 100372, 145, 5.147301999999996
146, 49.970344755186964, 93.2187057039631, 114.8992274768317, 0.9091832499999991, 315.0, 1072, 101444, 146, 9.689619700000009
147, 44.89469655120038, 92.98017396462016, 113.69761272300822, 0.9083962000000002, 210.0, 677, 102121, 147, 6.287271800000013
148, 44.49611126612186, 93.1233531644855, 113.85017566758971, 0.9077617000000004, 155.0, 733, 102854, 148, 6.569178300000004
149, 42.30793597361388, 93.1461985791489, 113.36934562535167, 0.9072693999999999, 30.0, 361, 103215, 149, 3.4054346000000066
150, 39.90482035771157, 92.76403656746577, 112.78391097355815, 0.9069215499999997, 70.0, 412, 103627, 150, 3.702635700000002
151, 34.588292082991124, 92.98262562132314, 113.10783643232732, 0.90643825, 180.0, 662, 104289, 151, 6.185036799999978
152, 37.10324376591099, 92.93220009723777, 113.02411608205583, 0.9055234000000005, 515.0, 1371, 105660, 152, 12.55761750000002
153, 36.970438192438394, 92.91817851112502, 112.88827678360342, 0.9045793000000001, 105.0, 727, 106387, 153, 6.714813599999957
154, 36.27237327462111, 92.70388924887635, 112.34810647780758, 0.9039951999999992, 120.0, 571, 106958, 154, 5.22742999999997
155, 34.73411470015072, 92.80423431026125, 112.60445455902989, 0.9035528500000002, 65.0, 412, 107370, 155, 3.865887999999984
156, 32.90017820389803, 92.69214403136702, 112.38882999052358, 0.9030407500000005, 110.0, 726, 108096, 156, 6.837216699999999
157, 35.90769677274009, 92.83431799427024, 112.49664069950454, 0.9022919500000004, 405.0, 938, 109034, 157, 8.811076700000001
158, 32.37216175895982, 92.83223538664429, 112.38871585029311, 0.90156295, 135.0, 682, 109716, 158, 6.273306300000002
159, 35.23361197764846, 91.21206585018115, 110.5595490576207, 0.9009428499999994, 115.0, 696, 110412, 159, 6.490619699999968
160, 22.535310289640005, 89.96269507965867, 109.02873510099215, 0.9000487000000009, 420.0, 1291, 111703, 160, 11.984704399999998
161, 18.832632171057668, 89.92774563132173, 108.87943730329603, 0.8991203500000003, 135.0, 772, 112475, 161, 7.293836700000043
162, 18.368031788150354, 89.8036327528884, 108.75103083574389, 0.8983098999999992, 215.0, 1029, 113504, 162, 9.625882699999977
163, 21.50231167607414, 89.90846630254873, 109.03357797689712, 0.8975651500000001, 155.0, 626, 114130, 163, 5.867148299999997
164, 19.44338745825431, 89.78326202841366, 108.83575026568245, 0.8969774499999998, 150.0, 680, 114810, 164, 6.468769400000042
165, 21.531385619342956, 89.82951905813076, 108.82607872541561, 0.8962457500000002, 285.0, 946, 115756, 165, 8.811000799999988
166, 16.852267333112966, 89.8907270705738, 108.7899617935522, 0.8955383499999995, 85.0, 626, 116382, 166, 5.983223399999986
167, 20.3587799389641, 89.78373403673048, 108.77235074476762, 0.8949794500000002, 110.0, 616, 116998, 167, 5.83996540000004
168, 18.1912168963627, 89.82538996063154, 108.65786467165294, 0.8943539500000003, 410.0, 774, 117772, 168, 7.428648799999962
169, 14.520597940100764, 89.78166456867878, 108.63671096763515, 0.8938261000000003, 30.0, 399, 118171, 169, 3.6809716999999864
170, 20.22636115669024, 89.8531565524564, 108.92212089689652, 0.8934647500000004, 40.0, 404, 118575, 170, 3.887286500000016
171, 20.66865522151626, 89.88881303114412, 108.88239211789227, 0.8930048499999996, 65.0, 618, 119193, 171, 5.912801699999989
172, 18.620237797885746, 89.7269198430049, 108.55218878659335, 0.8924495500000001, 120.0, 616, 119809, 172, 5.917401699999971
173, 24.363506129946575, 89.85107811004761, 108.59402387687959, 0.8919482500000001, 80.0, 498, 120307, 173, 4.777546500000028
174, 29.08082641254772, 89.79198413249875, 108.65436159874783, 0.8915063499999997, 60.0, 484, 120791, 174, 4.675219200000015
175, 28.705614767264372, 89.72710815353773, 108.69569431134124, 0.8911076500000001, 65.0, 402, 121193, 175, 3.8046740999999997
176, 20.850316318769135, 89.83600524730896, 108.58211195870732, 0.8905262500000001, 460.0, 890, 122083, 176, 8.638383500000032
177, 20.89662826628912, 89.68733220836646, 108.48961222154581, 0.8898138999999993, 110.0, 693, 122776, 177, 6.733216500000026
178, 24.49332029369945, 89.71953088908083, 108.44050495391743, 0.8889674500000008, 440.0, 1188, 123964, 178, 11.368577200000004
179, 21.92113661439153, 89.67119640231786, 108.39741523087133, 0.8879405500000003, 410.0, 1094, 125058, 179, 10.599960399999986
180, 25.007884982247024, 89.62447569265305, 108.36026610368452, 0.8870904999999994, 110.0, 795, 125853, 180, 7.7657107
181, 22.18835126809057, 89.6331873859851, 108.27154328012224, 0.8865554499999998, 50.0, 394, 126247, 181, 3.9108117999999763
182, 21.854668837327225, 89.72232544328578, 108.41776573863845, 0.8860915000000001, 115.0, 637, 126884, 182, 6.117653800000028
183, 23.37432853082936, 89.7838821226625, 108.31616770918453, 0.8854327000000002, 210.0, 827, 127711, 183, 7.902263699999992
184, 22.402130882055978, 89.67434265221726, 108.28874297925688, 0.8847374499999999, 110.0, 718, 128429, 184, 6.939295099999981
185, 26.51806569369742, 89.71406620916596, 108.39071826545559, 0.8842158999999998, 80.0, 441, 128870, 185, 4.351953399999957
186, 22.77434691742285, 89.56341770039269, 108.12534839952762, 0.8836556499999998, 210.0, 804, 129674, 186, 7.866877699999975
187, 20.425810009166785, 89.17481178416872, 107.67563650078904, 0.88293295, 210.0, 802, 130476, 187, 7.731051100000002
188, 14.884055251660554, 88.94215986246952, 107.38470954602332, 0.8823961, 50.0, 391, 130867, 188, 3.8846927000000164
189, 15.086089711724304, 88.821042699138, 107.08231796805315, 0.8819915500000001, 90.0, 508, 131375, 189, 5.187958299999991
190, 21.063400995942345, 88.7713023582391, 107.15348835329038, 0.8813561499999992, 210.0, 904, 132279, 190, 8.928035500000021
191, 17.424428079809463, 88.90693568534591, 107.13987162972793, 0.8804201500000008, 675.0, 1176, 133455, 191, 11.606463500000018
192, 18.493471023874065, 88.89606786506357, 107.24973631732773, 0.8792168500000005, 485.0, 1498, 134953, 192, 14.859331899999916
193, 19.65590574270413, 88.7268224739734, 107.04937308982566, 0.8781782499999998, 160.0, 810, 135763, 193, 8.134575400000017
194, 19.505918655892927, 88.88241950385004, 107.17424341929045, 0.8775635499999997, 60.0, 556, 136319, 194, 5.500059999999962
195, 17.917820315035623, 88.83887274434247, 107.10742516905617, 0.8769704500000004, 155.0, 762, 137081, 195, 7.525771899999995
196, 17.78241885230598, 88.84673061060518, 107.0380830728963, 0.8762679999999999, 120.0, 799, 137880, 196, 8.00732759999994
197, 21.049198236405473, 88.74297104361672, 107.06543393884814, 0.8755506999999996, 105.0, 795, 138675, 197, 8.005245999999943
198, 19.549903428751573, 88.6477012161381, 106.9715746572195, 0.87497515, 55.0, 484, 139159, 198, 4.94149630000004
199, 16.972893521602337, 88.73378077580378, 106.85300533588116, 0.8744648499999997, 135.0, 650, 139809, 199, 6.512031200000024
200, 16.647750404309505, 88.3251571759929, 106.51621001443745, 0.8738443000000002, 120.0, 729, 140538, 200, 7.282995800000094
201, 15.548298132563843, 88.2467949576635, 106.3873073464573, 0.8731071999999994, 185.0, 909, 141447, 201, 9.192742100000032
202, 15.99666161472733, 88.23633609806095, 106.35929301837542, 0.87229855, 410.0, 888, 142335, 202, 9.030526400000099
203, 14.210705910175125, 88.13723775945559, 106.26429355363905, 0.8716055499999996, 105.0, 652, 142987, 203, 6.6473823999999695
204, 12.378319565805128, 88.12883650824196, 106.30480255364137, 0.8709647500000003, 155.0, 772, 143759, 204, 7.9423375999999735
205, 12.640572940568788, 88.21795105896479, 106.2898843051133, 0.8703324999999996, 105.0, 633, 144392, 205, 6.485345300000063
206, 16.780860311153205, 88.2058006197625, 106.43487819052703, 0.8696232999999997, 385.0, 943, 145335, 206, 9.738261799999918
207, 13.54501214552881, 88.13145767795584, 106.1949366585153, 0.8689518999999997, 105.0, 549, 145884, 207, 5.5394876000000295
208, 17.990752136552487, 88.27101378007369, 106.47509643752853, 0.8683583500000004, 310.0, 770, 146654, 208, 7.935564199999931
209, 16.061615264415742, 88.14639913746387, 106.30268857217249, 0.8676225999999997, 215.0, 865, 147519, 209, 8.936193199999934
210, 13.608121808995023, 88.24699618142539, 106.29408044576027, 0.8667127000000001, 175.0, 1157, 148676, 210, 11.934650000000033
211, 14.715563504029088, 88.21814538967202, 106.31314998757192, 0.8659683999999997, 105.0, 497, 149173, 211, 5.191029800000024
212, 17.172327433930008, 88.19597167559667, 106.3017395264981, 0.8654090500000001, 135.0, 746, 149919, 212, 7.784160600000064
213, 16.926172644689657, 88.80905602533615, 107.0149169240869, 0.8647506999999995, 210.0, 717, 150636, 213, 7.510102999999958
214, 11.704202644258379, 88.76264594043685, 106.92465181439836, 0.8640909999999997, 135.0, 749, 151385, 214, 7.716889199999969
215, 15.067689985627831, 88.82065944293403, 107.04907229804452, 0.8634362500000001, 120.0, 706, 152091, 215, 7.444544699999938
216, 10.469092792057129, 88.82103381482473, 106.92673895349465, 0.8628944500000004, 125.0, 498, 152589, 216, 5.251905800000031
217, 13.166149330024771, 88.87273573270802, 107.09063755215807, 0.8620137999999999, 460.0, 1459, 154048, 217, 15.156376099999989
218, 14.491955364107067, 88.72593186859392, 107.01675876389201, 0.8611466500000001, 85.0, 468, 154516, 218, 4.987354699999969
219, 9.853488767358858, 88.68653941275505, 106.75841665509994, 0.8607587499999999, 65.0, 394, 154910, 219, 4.237511900000072
220, 17.097565464997214, 88.82627697138824, 107.18800537345945, 0.8601751000000001, 235.0, 903, 155813, 220, 9.665357299999982
221, 12.027499503490835, 88.75166889048216, 106.9230938195193, 0.8595518500000002, 80.0, 482, 156295, 221, 5.052254000000062
222, 18.628581843236315, 88.78094282682362, 107.07506170532052, 0.8590203999999995, 95.0, 699, 156994, 222, 7.396937699999967
223, 12.131721120178069, 88.66169496822559, 106.8081107754536, 0.8582801499999998, 260.0, 946, 157940, 223, 10.130417299999976
224, 16.406602279417772, 88.84801104587689, 107.06460564321578, 0.8575587999999996, 105.0, 657, 158597, 224, 6.974169599999982
225, 15.505582771105553, 88.72558204309264, 106.89747019525784, 0.8569616500000001, 155.0, 670, 159267, 225, 7.113250300000004
226, 15.785942475623395, 88.69221343074936, 106.86939916036215, 0.8562866499999996, 180.0, 830, 160097, 226, 8.89067030000001
227, 13.863367613026353, 88.16128319912269, 106.1746382791488, 0.8556386500000001, 105.0, 610, 160707, 227, 6.569029499999942
228, 13.554396720418342, 88.10953966606078, 106.2117609121205, 0.8550284500000003, 210.0, 746, 161453, 228, 8.01698900000008
229, 12.352993675906484, 88.13309457918493, 106.18478552841559, 0.8542315000000005, 245.0, 1025, 162478, 229, 10.994116600000098
230, 13.126601349189405, 88.26194998157342, 106.31339531766749, 0.8534151999999994, 145.0, 789, 163267, 230, 8.47483370000009
231, 10.083981407276209, 88.09500878945065, 106.02410153630049, 0.8527771000000001, 105.0, 629, 163896, 231, 6.806685399999992
232, 14.593616702906802, 88.01184059004909, 106.17880976655833, 0.8522703999999999, 125.0, 497, 164393, 232, 5.441757499999994
233, 12.935844809873196, 88.14152274795725, 106.27754566820362, 0.8516912500000003, 210.0, 790, 165183, 233, 8.601585099999966
234, 14.625571641915789, 88.15935424963634, 106.15023980538051, 0.8511629500000001, 65.0, 384, 165567, 234, 4.215639799999963
235, 14.749891161588115, 88.30272815584475, 106.37723484850194, 0.8507466999999996, 105.0, 541, 166108, 235, 5.897041100000024
236, 13.838852600207026, 88.23692808682081, 106.38440208654715, 0.8500343499999993, 240.0, 1042, 167150, 236, 11.37453000000005
237, 10.795101322820477, 88.13404827982828, 106.0826970922065, 0.8491883500000001, 210.0, 838, 167988, 237, 9.20026370000005
238, 11.410538360103965, 88.11986106872558, 106.1486437511444, 0.8484512500000001, 135.0, 800, 168788, 238, 8.701798100000019
239, 13.392099867826255, 88.20431364593898, 106.28657274810085, 0.8477411499999994, 210.0, 778, 169566, 239, 8.542243400000075
240, 8.373527752196235, 87.59219505213484, 105.43940316373286, 0.8470710999999996, 165.0, 711, 170277, 240, 7.843107499999974
241, 11.743133804370196, 86.90235764723558, 104.69076682848808, 0.8463124000000001, 250.0, 975, 171252, 241, 10.685731400000009
242, 10.394521451300117, 86.8758357831627, 104.70208650333866, 0.8455910500000001, 90.0, 628, 171880, 242, 7.0090977999999495
243, 10.435041031421036, 86.87727329681134, 104.58891732754303, 0.8449425999999994, 150.0, 813, 172693, 243, 9.045810599999982
244, 11.574949692155963, 86.87326080281629, 104.66768033653696, 0.8442387999999998, 180.0, 751, 173444, 244, 8.367740200000071
245, 13.617635943161117, 86.73297814263238, 104.46268662346733, 0.8437388499999996, 45.0, 360, 173804, 245, 3.9572895000000017
246, 11.149292932722135, 86.83509703566091, 104.51381045941727, 0.8432951500000003, 120.0, 626, 174430, 246, 7.013110100000063
247, 11.430138961416809, 86.90893402256755, 104.7243704987358, 0.8425765, 565.0, 971, 175401, 247, 10.874658600000089
248, 11.614717478786195, 86.8569427141462, 104.6076054600307, 0.8417457999999994, 135.0, 875, 176276, 248, 9.644841700000029
249, 11.169915684380488, 86.84583981750254, 104.69732480912215, 0.8410015000000003, 185.0, 779, 177055, 249, 8.732868300000064
250, 12.14972700441585, 86.95854139492998, 104.78379422488096, 0.8401307500000004, 225.0, 1156, 178211, 250, 13.01791030000004
251, 13.134046836389794, 86.93365012274847, 104.75879023096583, 0.8393108499999995, 105.0, 666, 178877, 251, 7.421971900000017
252, 16.459565833441207, 86.79488369434348, 104.64843608527784, 0.8388073000000001, 50.0, 453, 179330, 252, 4.92941380000002
253, 13.137477546564961, 86.94683127060871, 104.70765023306664, 0.8383464999999999, 110.0, 571, 179901, 253, 6.453142900000103
254, 9.073641955252175, 86.22086593298603, 103.82991719417434, 0.8377768, 155.0, 695, 180596, 254, 7.898421299999882
255, 10.053844598142227, 86.04644109140528, 103.60805670105584, 0.8372368000000002, 70.0, 505, 181101, 255, 5.744348199999877
256, 8.88028796598897, 86.16067142887516, 103.66965581991293, 0.8367098499999999, 140.0, 666, 181767, 256, 7.519320200000038
257, 10.761001675008977, 86.189693666854, 103.81647513847432, 0.8361955000000004, 10.0, 477, 182244, 257, 5.449216699999852
258, 8.320226323839865, 86.284613646959, 103.91578571419967, 0.8357072500000001, 145.0, 608, 182852, 258, 6.8864597000001595
259, 11.057460662165573, 86.31831772037938, 103.97527677528204, 0.8351038, 200.0, 733, 183585, 259, 8.435391199999913
260, 8.96714337231036, 86.22797639491195, 103.82941366026432, 0.8343225999999999, 200.0, 1003, 184588, 260, 11.406739600000037
261, 19.08973890650753, 86.4515024325778, 104.56689804353037, 0.8335476999999993, 165.0, 719, 185307, 261, 8.28751710000006
262, 9.625623729464579, 86.2417009854387, 103.81262037114057, 0.8329190500000003, 135.0, 678, 185985, 262, 7.660854099999824
263, 10.22503497842935, 86.19186947013759, 103.84057566485828, 0.8323295499999995, 155.0, 632, 186617, 263, 7.134707000000162
264, 10.942816443513422, 86.19325451121611, 103.83029867733227, 0.8316626500000003, 210.0, 850, 187467, 264, 9.786073100000067
265, 11.043016745754988, 86.27921304608336, 103.91104481007793, 0.8310983499999997, 75.0, 404, 187871, 265, 4.661247900000035
266, 12.826431015623, 86.26672714414129, 103.96216871129276, 0.8306506000000001, 70.0, 591, 188462, 266, 6.89745599999992
267, 10.069218995595914, 86.18358689587882, 103.78367324899581, 0.8299949500000008, 210.0, 866, 189328, 267, 9.882665999999972
268, 9.136231014634578, 86.37163147491502, 104.03317114521953, 0.8293141000000002, 135.0, 647, 189975, 268, 7.523100000000113
269, 12.417986070268482, 85.91836551915155, 103.57233837346104, 0.828685, 155.0, 751, 190726, 269, 8.71471419999989
270, 9.860474598222009, 85.77467996022745, 103.27754197737538, 0.8278704999999992, 210.0, 1059, 191785, 270, 12.23559380000006
271, 9.879363431196127, 85.73507840292794, 103.1914747919355, 0.8271419500000001, 120.0, 560, 192345, 271, 6.602176500000041
272, 9.663582170956124, 85.76120979407314, 103.32678444006923, 0.8263657000000001, 305.0, 1165, 193510, 272, 13.569334000000026
273, 8.791189423122374, 85.64840904547243, 103.12586558594995, 0.8255768499999998, 120.0, 588, 194098, 273, 6.919553799999903
274, 12.474455106817185, 85.75198088884353, 103.44501032829285, 0.82502425, 120.0, 640, 194738, 274, 7.482913499999995
275, 7.653755646123144, 85.67317007830043, 103.11841233304875, 0.8243605000000006, 200.0, 835, 195573, 275, 9.914807199999814
276, 12.066520850749532, 85.79093122543043, 103.34630101683793, 0.8236315000000002, 210.0, 785, 196358, 276, 9.126349000000118
277, 10.217338687956818, 85.70683482100324, 103.20290970220799, 0.8230015, 55.0, 615, 196973, 277, 7.090257500000007
278, 7.917547782937832, 85.65229174670051, 103.08618804987739, 0.8224799499999996, 15.0, 544, 197517, 278, 6.512463400000115
279, 11.257482414104581, 85.68708562939092, 103.20979462798114, 0.8219917000000001, 20.0, 541, 198058, 279, 6.393828299999996
280, 9.380197276402024, 85.73829927056084, 103.22872234361743, 0.8214499000000001, 120.0, 663, 198721, 280, 7.87507329999994
281, 12.11961988712612, 85.69348652201488, 103.29475344034066, 0.82091215, 110.0, 532, 199253, 281, 6.3057633999999325
282, 9.26399887652455, 85.33162451012603, 102.7183181464061, 0.8201899, 210.0, 1073, 200326, 282, 12.799349399999983
283, 9.016637573984855, 84.43293615330987, 101.71547165528976, 0.8193704499999998, 130.0, 748, 201074, 283, 8.890086999999994
284, 8.216106732589985, 84.50530357930198, 101.71082170401047, 0.8187323500000002, 110.0, 670, 201744, 284, 8.024288999999953
285, 10.156912219065886, 84.43939331861642, 101.68122440118056, 0.8182436499999999, 60.0, 416, 202160, 285, 4.97418289999996
286, 8.07364574060862, 84.45795212028929, 101.68193857418083, 0.8177666500000004, 120.0, 644, 202804, 286, 7.676803399999926
287, 9.786329638191793, 84.59582901722091, 101.96125316079036, 0.8172388, 80.0, 529, 203333, 287, 6.359177700000146
288, 8.968021031209203, 84.51429684956868, 101.85642310445623, 0.8167685499999996, 55.0, 516, 203849, 288, 6.207668900000044
289, 8.216358768004998, 84.54693438025082, 101.78980034472896, 0.8161691499999997, 150.0, 816, 204665, 289, 9.8521867999998
290, 9.793705881526279, 84.48135550298039, 101.79233504615127, 0.8154986499999998, 70.0, 674, 205339, 290, 8.102967700000136
291, 10.537004670962279, 84.40196097054545, 101.68363245566782, 0.8148205000000004, 180.0, 833, 206172, 291, 9.980530899999849
292, 10.047445876320717, 84.5429458759188, 101.82657899697915, 0.8142021999999998, 105.0, 541, 206713, 292, 6.542882299999974
293, 11.421709709526196, 84.39644340662005, 101.66381338133034, 0.8135145999999995, 475.0, 987, 207700, 293, 11.92814210000006
294, 9.26743644483188, 84.45676067565769, 101.70125648517099, 0.8127005500000001, 185.0, 822, 208522, 294, 9.998498199999858
295, 8.387809734402309, 84.4736279729587, 101.64805690328873, 0.8119688500000002, 210.0, 804, 209326, 295, 9.821133800000098
296, 7.606647381524392, 84.69515038245673, 101.96550456476034, 0.8111228499999993, 265.0, 1076, 210402, 296, 12.842715699999872
297, 6.168957826476229, 85.08112455626666, 102.38923916574252, 0.8102138500000007, 180.0, 944, 211346, 297, 11.546420699999999
298, 9.343614862492336, 84.85188152562434, 102.14850429554082, 0.8094308500000005, 155.0, 796, 212142, 298, 9.65507679999996
299, 7.553756719257902, 84.99693271412569, 102.34869269202737, 0.80876665, 155.0, 680, 212822, 299, 8.358331300000145
300, 7.861008835848515, 85.01825629088358, 102.35675371915411, 0.8081577999999999, 160.0, 673, 213495, 300, 8.334697499999947
301, 10.960617300271988, 84.8998946027058, 102.22967085675495, 0.8073937000000008, 195.0, 1025, 214520, 301, 12.70014059999994
302, 7.48897652702656, 84.88178736320741, 102.24940754650672, 0.8066944000000003, 105.0, 529, 215049, 302, 6.598530799999935
303, 8.689860846651229, 85.02281229119552, 102.34475399125442, 0.8062340500000003, 45.0, 494, 215543, 303, 6.2141584999999395
304, 12.016147951441898, 84.91225743879352, 102.36568283616451, 0.8057552499999998, 105.0, 570, 216113, 304, 7.207808099999966
305, 8.467416690389808, 85.0794409664334, 102.38909089535697, 0.80513605, 160.0, 806, 216919, 305, 9.993165899999894
306, 8.783520498244641, 84.95283448560008, 102.20877219568847, 0.8044974999999999, 135.0, 613, 217532, 306, 7.740216700000019
307, 10.321552006256146, 84.96074071526527, 102.34628350536029, 0.8038760500000004, 195.0, 768, 218300, 307, 9.605362100000093
308, 9.96756539250986, 84.9671268108609, 102.32193015853711, 0.8031673, 160.0, 807, 219107, 308, 10.173894799999971
309, 8.222065125005773, 84.94215485289857, 102.15311242647036, 0.8025175000000001, 60.0, 637, 219744, 309, 8.029506800000036
310, 9.266090138046392, 85.1430385002931, 102.55174295924219, 0.8015959000000006, 460.0, 1411, 221155, 310, 17.57307639999999
311, 8.270220675457145, 85.27555710971826, 102.67404010887206, 0.8006761, 135.0, 633, 221788, 311, 8.025502200000119
312, 9.621553422333045, 85.17266371336626, 102.50387426979184, 0.8002175499999999, 65.0, 386, 222174, 312, 4.936459300000024
313, 6.259079668745534, 85.10427684123833, 102.38405632755578, 0.7997967999999996, 75.0, 549, 222723, 313, 7.019410600000128
314, 7.849069529894701, 85.20724454532375, 102.54303774227391, 0.7992878499999999, 75.0, 582, 223305, 314, 7.386717800000042
315, 6.758636010544641, 85.09124797200921, 102.42336479901093, 0.7987518999999996, 105.0, 609, 223914, 315, 7.8004536999999345
316, 8.247017374585772, 85.11077898768752, 102.45676171387865, 0.7980944500000005, 180.0, 852, 224766, 316, 11.002492399999937
317, 8.931475534175451, 84.93952681468083, 102.26549876653232, 0.7975238499999999, 80.0, 416, 225182, 317, 5.273726899999929
318, 7.655035323292856, 85.03962264262455, 102.27774407830037, 0.7970810499999996, 45.0, 568, 225750, 318, 7.384027399999923
319, 8.326398707725359, 85.17842567529571, 102.59252246470933, 0.7964249499999998, 205.0, 890, 226640, 319, 11.497209399999974
320, 8.748152807833039, 85.16545990316625, 102.50655269112816, 0.7956878499999998, 110.0, 748, 227388, 320, 9.582195800000136
321, 11.032832945348064, 85.09938607228203, 102.54914727814746, 0.7951770999999999, 80.0, 387, 227775, 321, 4.921634999999924
322, 8.776382369853609, 85.28957699928924, 102.63477109547713, 0.7946276499999999, 210.0, 834, 228609, 322, 10.77953709999997
323, 11.063200862286077, 85.17315422803506, 102.53596612776833, 0.7939391500000003, 210.0, 696, 229305, 323, 8.965324699999883
324, 9.856316978864948, 85.10332984102392, 102.50636281834204, 0.7932709000000003, 165.0, 789, 230094, 324, 10.199955600000067
325, 8.13080261399696, 84.14211456725647, 101.24495262732873, 0.7925941000000006, 115.0, 715, 230809, 325, 9.376935000000003
326, 7.235404085629101, 84.19627197378236, 101.317723840805, 0.7920284500000001, 105.0, 542, 231351, 326, 7.040012299999944
327, 10.389332586790283, 84.13345181660196, 101.31382301385455, 0.7913466999999991, 240.0, 973, 232324, 327, 12.641356000000087
328, 8.654632169166264, 84.36052891502324, 101.5992985811079, 0.7906033, 210.0, 679, 233003, 328, 8.98616560000005
329, 10.886061668678291, 84.18373961700316, 101.374647313429, 0.7899651999999999, 110.0, 739, 233742, 329, 9.774359000000004
330, 8.985827843537406, 84.16226095774817, 101.2287352546813, 0.7893491500000003, 30.0, 630, 234372, 330, 8.282982299999958
331, 10.755444447375261, 84.22885048499474, 101.60190401517428, 0.7887731499999995, 165.0, 650, 235022, 331, 8.658827000000201
332, 7.262071829430664, 84.21581525842852, 101.32974716379672, 0.7881606999999999, 135.0, 711, 235733, 332, 9.309732300000178
333, 8.029256032413269, 84.0915000180164, 101.16685279018908, 0.78761665, 135.0, 498, 236231, 333, 6.587600699999939
334, 7.39133972918383, 84.1734363538329, 101.23965476954588, 0.78719725, 40.0, 434, 236665, 334, 5.807779999999866
335, 9.38916420398974, 84.20969435747932, 101.41372290218578, 0.7867724500000002, 40.0, 510, 237175, 335, 6.760293600000068
336, 9.170438217028277, 84.09974738955498, 101.21518893539906, 0.7860821499999997, 405.0, 1024, 238199, 336, 13.558883899999955
337, 9.392820511941324, 84.27868478340015, 101.46812038756254, 0.7853648500000002, 110.0, 570, 238769, 337, 7.633501099999876
338, 7.854812813768357, 84.09029225112259, 101.23236279322494, 0.7846795000000003, 195.0, 953, 239722, 338, 12.697483499999862
339, 7.104702135113845, 84.03430157137993, 101.09785002514832, 0.7840112500000003, 120.0, 532, 240254, 339, 7.1492203999998765
340, 8.165797994152094, 83.74659975492037, 100.80426326653897, 0.7834208499999998, 425.0, 780, 241034, 340, 10.48728570000003
341, 8.512185634564489, 83.75612321976692, 100.7585117124742, 0.7828466499999999, 105.0, 496, 241530, 341, 6.6456161000000975
342, 10.098610973265982, 83.8105906299709, 100.92584028735604, 0.7821869500000007, 285.0, 970, 242500, 342, 12.989078299999846
343, 8.264248122971866, 83.83646017505276, 100.8753520288775, 0.7815272499999998, 5.0, 496, 242996, 343, 6.673776299999872
344, 9.21487680993863, 83.77446209352408, 100.87174483341957, 0.7810025500000001, 150.0, 670, 243666, 344, 9.0406117
345, 7.299251088496284, 83.76431185388505, 100.77390000212895, 0.7803423999999995, 210.0, 797, 244463, 345, 10.800031499999932
346, 8.448062784205645, 83.76201244500967, 100.81847637127608, 0.77970295, 210.0, 624, 245087, 346, 8.501072699999895
347, 11.371824485499685, 84.07377760972435, 101.25623215200179, 0.7790347000000001, 215.0, 861, 245948, 347, 11.67410679999989
348, 7.723002339431148, 83.83089693050819, 100.87508463160611, 0.7780946500000001, 250.0, 1228, 247176, 348, 16.60041350000006
349, 10.692135574452864, 83.88592170757023, 101.01697425216925, 0.7771302999999995, 215.0, 915, 248091, 349, 12.458241400000134
350, 7.471433581426068, 83.82646564311904, 100.83592757033782, 0.7763887000000002, 90.0, 733, 248824, 350, 10.016675499999792
351, 9.784106483348669, 83.75146496601594, 100.88349419373732, 0.7757780500000004, 35.0, 624, 249448, 351, 8.718306999999868
352, 10.1071616105233, 83.63613483343232, 100.64438597004066, 0.7751768500000001, 110.0, 712, 250160, 352, 9.620206599999847
353, 13.176172114127166, 83.22057360669116, 100.38883057707673, 0.7745346999999995, 120.0, 715, 250875, 353, 9.826014299999997
354, 6.645349852807169, 83.21117081531654, 100.09257165973412, 0.7739605, 65.0, 561, 251436, 354, 7.7696244999999635
355, 6.859365750636373, 83.16383813983225, 100.00466602281254, 0.7734749499999999, 45.0, 518, 251954, 355, 7.185761300000195
356, 9.034311451324045, 83.14495831319731, 100.11793731010124, 0.7729790500000004, 65.0, 584, 252538, 356, 8.032768100000112
357, 10.331682499862255, 83.13357917957737, 100.16572071735123, 0.7724170000000005, 65.0, 665, 253203, 357, 9.308739500000001
358, 8.48835081012943, 83.08765305144877, 100.03255350619932, 0.7719399999999998, 100.0, 395, 253598, 358, 5.421583000000055
359, 11.052956658290041, 83.23433323783088, 100.34234432939871, 0.7714783000000004, 105.0, 631, 254229, 359, 8.650897700000087
360, 8.253091374856409, 83.20660049246943, 100.1377275379133, 0.7709792500000001, 90.0, 478, 254707, 360, 6.709234699999797
361, 6.475868679101651, 83.10655188927284, 99.97640340951773, 0.7704716499999995, 110.0, 650, 255357, 361, 9.19753250000008
362, 7.420911895474056, 83.20260186628862, 100.09501270195106, 0.7696247500000002, 395.0, 1232, 256589, 362, 17.107626400000072
363, 8.732240377499636, 83.03265133672336, 99.87428008445299, 0.7688133999999999, 115.0, 571, 257160, 363, 8.108521399999972
364, 10.749802666491476, 83.18043377129315, 100.1775378711118, 0.76837375, 65.0, 406, 257566, 364, 5.760878999999932
365, 7.682013850554534, 83.22047964800511, 100.20710909289366, 0.7679827, 80.0, 463, 258029, 365, 6.486801900000046
366, 6.618387940832797, 83.06816105281605, 99.94366032936993, 0.7675295499999997, 105.0, 544, 258573, 366, 7.651472699999886
367, 6.634190454582373, 83.34927936735608, 100.29302755083357, 0.76709575, 110.0, 420, 258993, 367, 5.971239100000048
368, 8.002652544421808, 83.16187107449485, 100.09005407605852, 0.7665287499999999, 225.0, 840, 259833, 368, 11.91020750000007
369, 10.940488766146972, 83.01336644265504, 99.98666757229155, 0.7658965000000003, 115.0, 565, 260398, 369, 7.902382799999941
370, 11.032346368979926, 82.55799050379281, 99.43333031240135, 0.7654195000000003, 60.0, 495, 260893, 370, 7.105330699999968
371, 8.632105081516118, 82.59269759918561, 99.37397093330587, 0.7648425999999998, 410.0, 787, 261680, 371, 11.230327900000248
372, 8.030683470565817, 82.7713191514245, 99.63212638231194, 0.76405915, 430.0, 954, 262634, 372, 13.518453900000168
373, 10.683294140133981, 82.70994835882611, 99.59969249430529, 0.7632455499999993, 210.0, 854, 263488, 373, 12.264914200000021
374, 10.038676084718615, 82.62592662595353, 99.37906691353277, 0.7626227500000001, 105.0, 530, 264018, 374, 7.605440400000134
375, 8.725172692411382, 82.60445111234424, 99.35149985299984, 0.7621286499999996, 105.0, 568, 264586, 375, 8.120177199999944
376, 8.026979467413748, 82.68109030046821, 99.47110023934145, 0.7615972000000004, 115.0, 613, 265199, 376, 8.782743700000083
377, 10.26767707456109, 82.81804154986985, 99.68992935367889, 0.76102795, 120.0, 652, 265851, 377, 9.415079999999762
378, 8.285771568854173, 82.6561040516623, 99.48113017738936, 0.7605090999999997, 75.0, 501, 266352, 378, 7.293501399999968
379, 6.655112477196487, 82.7229345053321, 99.44918843548561, 0.7600469500000001, 90.0, 526, 266878, 379, 7.5957893999998305
380, 8.136519755379855, 82.61820601187766, 99.3693357604915, 0.7593913000000003, 230.0, 931, 267809, 380, 13.511878700000125
381, 11.427169262320417, 82.79839728398578, 99.81636571687926, 0.7587536500000002, 110.0, 486, 268295, 381, 7.0990624000000935
382, 10.363630180641149, 82.75791917397426, 99.64387647922223, 0.7581605499999999, 135.0, 832, 269127, 382, 11.964437199999793
383, 8.526975703673745, 82.84642380565855, 99.75670020903775, 0.7574279499999998, 125.0, 796, 269923, 383, 11.547163900000214
384, 8.01171174738234, 83.35261740239021, 100.26068065075725, 0.75680965, 120.0, 578, 270501, 384, 8.569247999999789
385, 6.68026733131551, 83.2921116957024, 100.14249757984977, 0.7563686499999996, 35.0, 402, 270903, 385, 5.925992799999676
386, 8.153202843161532, 83.47143746243317, 100.48447227751679, 0.7558741000000003, 180.0, 697, 271600, 386, 10.245095900000251
387, 9.701949078657034, 83.44017050030831, 100.47712131335771, 0.7552368999999999, 195.0, 719, 272319, 387, 10.466659799999888
388, 10.209848869202743, 83.52048505716655, 100.6185254338962, 0.7545515500000002, 135.0, 804, 273123, 388, 11.681359300000167
389, 9.096943930140105, 83.42867594163027, 100.39435339119524, 0.7537474000000004, 465.0, 983, 274106, 389, 14.458783399999902
390, 7.9107046732812325, 83.4770274718115, 100.4095933442223, 0.7528649500000002, 485.0, 978, 275084, 390, 14.377691900000173
391, 12.167287564159952, 83.56099849426528, 100.64162501024427, 0.7521057999999995, 110.0, 709, 275793, 391, 10.49537489999966
392, 8.358314359406043, 83.34353227789727, 100.25599666117951, 0.7514668, 105.0, 711, 276504, 392, 10.576776000000336
393, 11.451423188967018, 83.48753752479693, 100.52166120944428, 0.7506590500000002, 315.0, 1084, 277588, 393, 16.150325900000098
394, 8.830001952017055, 83.30291934543186, 100.17354919832516, 0.749827, 160.0, 765, 278353, 394, 11.362064299999929
395, 11.052404437438977, 83.46237046281261, 100.53089373887643, 0.7491024999999994, 180.0, 845, 279198, 395, 12.789538200000152
396, 8.836096158687104, 83.37704167467483, 100.31515326688356, 0.74842615, 110.0, 658, 279856, 396, 9.85783530000026
397, 14.93466929876142, 83.01660446590847, 99.98110264672174, 0.7479680500000001, 60.0, 360, 280216, 397, 5.514535799999976
398, 7.867370516263377, 82.77946067044539, 99.58627563614183, 0.7474069000000004, 440.0, 887, 281103, 398, 13.464015300000028
399, 9.167388063081553, 82.81683805701505, 99.70579169427099, 0.7467201999999997, 80.0, 639, 281742, 399, 9.6476746000003
400, 12.229540107829413, 82.78021431225947, 99.66191217106733, 0.7460983000000002, 210.0, 743, 282485, 400, 11.219547499999862
401, 7.332458467245689, 82.83180091181413, 99.6577887981396, 0.7453985500000001, 210.0, 812, 283297, 401, 12.2568768000001
402, 8.75494281198537, 82.81157218974246, 99.657291373498, 0.7442821000000005, 760.0, 1669, 284966, 402, 25.034088299999894
403, 7.020907388085861, 82.76096856577225, 99.5501077158279, 0.7432129000000003, 310.0, 707, 285673, 403, 10.626263200000267
404, 12.0778749595441, 82.74294900952961, 99.65472836382733, 0.7425298000000001, 285.0, 811, 286484, 404, 12.416183499999988
405, 7.940078079466909, 82.73036810895866, 99.51778875847222, 0.7418777500000004, 215.0, 638, 287122, 405, 9.7226627
406, 9.15412293485069, 82.79518930204623, 99.62132123800424, 0.7412630499999998, 210.0, 728, 287850, 406, 11.220146300000124
407, 9.688558608325787, 82.71100723795044, 99.56535580457547, 0.7405196499999998, 315.0, 924, 288774, 407, 14.230687599999783
408, 10.33322975379044, 82.81546672044603, 99.76712183825738, 0.7396970500000002, 285.0, 904, 289678, 408, 13.898252599999978
409, 7.6081980818527795, 82.22035946164813, 98.92652609234764, 0.7389878500000002, 120.0, 672, 290350, 409, 10.36027490000015
410, 8.632371877039875, 81.90223601057723, 98.5961264876632, 0.7381859499999995, 410.0, 1110, 291460, 410, 17.07143780000024
411, 8.923299243395737, 81.86699675664073, 98.58622199655376, 0.7372823500000004, 350.0, 898, 292358, 411, 13.945869199999834
412, 10.115863061306493, 81.93971935983187, 98.65043146427556, 0.7364026000000002, 260.0, 1057, 293415, 412, 16.29124589999992
413, 11.182474799259493, 81.83732741407056, 98.49117240223629, 0.7355997999999998, 155.0, 727, 294142, 413, 11.38351990000001
414, 10.205388147598025, 81.82526564324039, 98.5003816275761, 0.7350768999999999, 80.0, 435, 294577, 414, 6.929780700000265
415, 7.821251978954444, 81.93745303153992, 98.56181114453535, 0.73450675, 365.0, 832, 295409, 415, 12.988182999999935
416, 9.763047077413821, 81.83925705382278, 98.48844274595463, 0.7338906999999996, 105.0, 537, 295946, 416, 8.460300199999892
417, 6.450813392256948, 81.98765773253682, 98.58640479299345, 0.7334177500000002, 75.0, 514, 296460, 417, 8.153149499999927
418, 10.042079634612591, 81.95998829835739, 98.6782117056406, 0.7327481499999998, 315.0, 974, 297434, 418, 15.381303600000138
419, 9.619195303563297, 81.9933981522799, 98.74325394820559, 0.7320277000000004, 155.0, 627, 298061, 419, 9.794531800000186
420, 8.731061644087273, 82.03214181240067, 98.70142064257719, 0.7315088500000001, 105.0, 526, 298587, 420, 8.658279400000083
421, 9.439795512286945, 81.94826526641846, 98.67747699022293, 0.7309841499999996, 120.0, 640, 299227, 421, 10.362395599999672
422, 10.014848352815584, 81.86093850694759, 98.58825688010187, 0.7303852000000001, 75.0, 691, 299918, 422, 10.90146360000017
423, 11.630041657730317, 81.79662849649627, 98.57781435785749, 0.7297821999999997, 105.0, 649, 300567, 423, 10.224579999999605
424, 10.19526455456942, 81.8073128176407, 98.49154836806893, 0.72929845, 75.0, 426, 300993, 424, 6.834740499999953
425, 8.304931580680082, 81.63609051908571, 98.21514176097402, 0.7286338000000008, 290.0, 1051, 302044, 425, 16.837215300000025
426, 12.564677274920655, 81.82056229069548, 98.52779365635519, 0.7278746500000003, 110.0, 636, 302680, 426, 10.259289300000091
427, 5.377957503783879, 81.80566370545937, 98.366764820268, 0.7274057500000001, 90.0, 406, 303086, 427, 6.541335600000366
428, 12.364396291153236, 81.73428651103823, 98.4968384784574, 0.7268229999999994, 235.0, 889, 303975, 428, 14.320676100000128
429, 8.993487008939008, 81.74762647525613, 98.3859932273833, 0.7260985, 135.0, 721, 304696, 429, 11.840461199999936
430, 11.414062420818098, 81.76644669749581, 98.46277642881854, 0.7254513999999994, 160.0, 717, 305413, 430, 11.676034099999924
431, 9.86101451215343, 81.75658627804195, 98.44315932799722, 0.724888, 105.0, 535, 305948, 431, 8.811558899999909
432, 9.963781857884065, 81.76392932099421, 98.49642995935707, 0.7243677999999999, 160.0, 621, 306569, 432, 10.017397099999926
433, 8.585188542851824, 81.66685823677412, 98.32524198644302, 0.7238129499999999, 85.0, 612, 307181, 433, 10.055343600000015
434, 9.092228330206126, 81.75358933210373, 98.33648278315862, 0.7233647500000001, 65.0, 384, 307565, 434, 6.309652299999925
435, 7.9068011486718435, 81.66476541133316, 98.27915512369559, 0.7228782999999999, 210.0, 697, 308262, 435, 11.322472999999718
436, 8.356571521432267, 81.8722528680327, 98.53205735259854, 0.7221214000000005, 435.0, 985, 309247, 436, 15.839500000000044
437, 8.606694539666266, 81.7473951999569, 98.34624117924173, 0.7210836999999992, 500.0, 1321, 310568, 437, 21.642023699999754
438, 7.1987786596157495, 81.64771546174102, 98.21256999944353, 0.7201477, 135.0, 759, 311327, 438, 12.374236999999994
439, 9.610062459287533, 81.817249336628, 98.49651690066119, 0.7194943000000005, 155.0, 693, 312020, 439, 11.47142389999999
440, 6.300150918371884, 81.76552253467486, 98.32365873629453, 0.7189273000000002, 75.0, 567, 312587, 440, 9.379909899999802
441, 5.098280418377656, 81.82128757986463, 98.3159889035862, 0.7184498499999997, 75.0, 494, 313081, 441, 8.121651800000109
442, 8.427659771346319, 81.69329714307598, 98.36908030458005, 0.7180210000000001, 90.0, 459, 313540, 442, 7.616228399999727
443, 9.361213881137543, 81.76817925585176, 98.43898968018054, 0.7175836, 60.0, 513, 314053, 443, 8.4582233000001
444, 10.271325101109749, 81.86234304866689, 98.66744640166746, 0.7170161499999994, 145.0, 748, 314801, 444, 12.256497599999875
445, 6.699898648177095, 81.89305535746362, 98.50797324106483, 0.7163321500000003, 170.0, 772, 315573, 445, 12.74472139999989
446, 7.511649376647712, 81.72792445075582, 98.27991757364669, 0.7156044999999995, 155.0, 845, 316418, 446, 13.842173699999876
447, 8.944933826660803, 81.69764042207282, 98.28118929602326, 0.71494435, 75.0, 622, 317040, 447, 10.432601499999691
448, 10.768145907594707, 81.84693818233687, 98.61986517943384, 0.7143759999999999, 110.0, 641, 317681, 448, 10.669235200000003
449, 8.713084167999478, 81.71153221276528, 98.30175759813642, 0.7137352000000005, 210.0, 783, 318464, 449, 12.916100599999936
450, 7.401683655404855, 81.80680032760378, 98.37872956291078, 0.7130426499999999, 145.0, 756, 319220, 450, 12.533189899999797
451, 8.639246676819393, 81.7924208960975, 98.48655625120901, 0.7124207500000003, 155.0, 626, 319846, 451, 10.36093660000006
452, 8.305630608916058, 81.26087563724842, 97.7247099795584, 0.7119001000000001, 80.0, 531, 320377, 452, 8.874530999999934
453, 9.850467866488698, 81.32117801493206, 97.91058907894458, 0.7112048499999999, 285.0, 1014, 321391, 453, 16.90297039999996
454, 8.006996919582416, 81.1858775811794, 97.68781669143303, 0.7104366999999999, 135.0, 693, 322084, 454, 11.530083300000115
455, 12.099987719847698, 81.1082912149654, 97.68724828135686, 0.7098575499999996, 105.0, 594, 322678, 455, 9.849515800000063
456, 8.258025315350402, 81.2620523875345, 97.73027718628035, 0.7090642000000005, 420.0, 1169, 323847, 456, 19.355215500000213
457, 8.415358718266853, 81.23710459782527, 97.78715792142428, 0.7082456500000003, 155.0, 650, 324497, 457, 10.914890300000025
458, 7.349455151782192, 81.2327846565632, 97.70516762588963, 0.7075967499999999, 245.0, 792, 325289, 458, 13.235175899999831
459, 6.359193791137185, 81.20215908316679, 97.60592778101316, 0.7069694499999998, 105.0, 602, 325891, 459, 10.114244299999882
460, 7.9628371946684275, 81.28337895051213, 97.76811240392787, 0.7064038000000002, 120.0, 655, 326546, 460, 10.902997400000004
461, 8.19324087614584, 81.29586771604214, 97.8671369056326, 0.7057890999999995, 170.0, 711, 327257, 461, 11.917046400000345
462, 5.950931575122026, 81.22535884293072, 97.70676946011679, 0.7051618000000003, 35.0, 683, 327940, 462, 11.518173599999955
463, 6.389895513636647, 81.2172918834314, 97.71650715947288, 0.7044624999999997, 195.0, 871, 328811, 463, 14.533579200000077
464, 5.48180865938586, 81.09417830056292, 97.493073223083, 0.70384915, 120.0, 492, 329303, 464, 8.296169400000053
465, 9.121071162752639, 81.21519397553944, 97.82288048918683, 0.7034482000000001, 105.0, 399, 329702, 465, 6.646418499999982
466, 9.126172638656012, 80.8614644326799, 97.42364854239375, 0.7029392499999995, 105.0, 732, 330434, 466, 12.204483299999993
467, 8.629896136598278, 80.62265092775989, 97.01807625988808, 0.7021792, 185.0, 957, 331391, 467, 16.103696899999704
468, 11.560004235111428, 80.58183922023949, 97.02890352954923, 0.7014542499999996, 180.0, 654, 332045, 468, 10.964906100000007
469, 6.960021941970169, 80.63897111820428, 96.94803877049655, 0.7008868, 110.0, 607, 332652, 469, 10.246360199999799
470, 8.218368641607588, 80.83912457514076, 97.27250445488446, 0.7002109000000001, 185.0, 895, 333547, 470, 15.037162799999805
471, 7.054683255023976, 80.46113279350566, 96.78377705490935, 0.69959125, 30.0, 482, 334029, 471, 8.09564939999973
472, 8.492446671304462, 80.69349991900366, 97.16403580911505, 0.6990881499999999, 120.0, 636, 334665, 472, 10.685724500000106
473, 7.3632389805050655, 80.61736686112451, 96.94889755718043, 0.6983627499999996, 440.0, 976, 335641, 473, 16.45441380000011
474, 8.2449371087814, 80.66635619736815, 97.07719311663882, 0.6974542000000002, 225.0, 1043, 336684, 474, 17.604474400000072
475, 12.19359377207677, 80.64337065470153, 97.27971455273708, 0.6968219499999998, 15.0, 362, 337046, 475, 6.143166400000155
476, 9.500506251955487, 80.67453710794955, 97.02339617006338, 0.6962351499999999, 330.0, 942, 337988, 476, 15.919282700000167
477, 8.48376806299688, 80.73043912348454, 97.12851531602797, 0.6951601000000003, 400.0, 1447, 339435, 477, 24.328939600000012
478, 8.896053084333161, 80.73508716356253, 97.14389499282284, 0.6938888500000003, 695.0, 1378, 340813, 478, 23.27122700000018
479, 7.885931775808334, 80.63355470784505, 96.96675903998481, 0.6927624999999992, 330.0, 1125, 341938, 479, 19.465160999999625
480, 8.86255684577375, 80.76035046907064, 97.26823330365018, 0.69206095, 30.0, 434, 342372, 480, 7.971405600000253
481, 8.63539159277635, 80.67459188328081, 97.01203645514467, 0.6916014999999996, 80.0, 587, 342959, 481, 9.579958199999965
482, 9.660469487429197, 80.69038388388498, 97.11182599748884, 0.69083335, 295.0, 1120, 344079, 482, 17.003776700000344
483, 10.008329935816857, 80.63597492492582, 97.11248084122334, 0.6900355, 145.0, 653, 344732, 483, 10.136151999999583
484, 9.008926807819861, 80.76273135240166, 97.19293713195162, 0.6893978500000002, 210.0, 764, 345496, 484, 11.486049199999798
485, 6.87321258035272, 80.62299703347563, 96.90148972020005, 0.68887585, 80.0, 396, 345892, 485, 6.0367841000002045
486, 7.391871376792529, 80.62761138069611, 97.0303497196897, 0.6884056000000003, 135.0, 649, 346541, 486, 10.42016650000005
487, 9.763207446113764, 80.61046216127684, 97.00235502211024, 0.6877382499999999, 235.0, 834, 347375, 487, 14.363369700000021
488, 8.300912510875046, 80.6668319070576, 97.07100493071096, 0.6870911500000002, 110.0, 604, 347979, 488, 10.842112499999985
489, 7.47075313105619, 80.66216813854705, 97.01625908873135, 0.6865201, 135.0, 665, 348644, 489, 10.294670399999632
490, 10.978557518937372, 80.6600704948941, 97.1440756204245, 0.6860278, 30.0, 429, 349073, 490, 6.5273041999998895
491, 9.66098864512358, 80.67530260587993, 97.05597822901832, 0.6854842000000001, 185.0, 779, 349852, 491, 12.171480299999985
492, 8.041124361917044, 80.5554178934768, 96.91410983365355, 0.6848712999999997, 120.0, 583, 350435, 492, 9.327827999999954
493, 8.56282309928731, 80.30430728778168, 96.58787994384765, 0.6841611999999999, 225.0, 995, 351430, 493, 15.73634979999997
494, 9.638221752368258, 80.28215590725826, 96.69584877690424, 0.6833529999999998, 175.0, 801, 352231, 494, 12.505803900000046
495, 7.906766522436771, 80.27441606341668, 96.65584961513304, 0.6827540500000001, 65.0, 530, 352761, 495, 8.606220399999984
496, 6.464109374833228, 80.34323270373514, 96.5720167305757, 0.6822505, 15.0, 589, 353350, 496, 9.728248699999767
497, 8.52305339638553, 80.34466841592955, 96.67962457954539, 0.6816740499999998, 160.0, 692, 354042, 497, 11.114384299999983
498, 7.403041204219272, 80.28810148335745, 96.56147412798339, 0.6810517000000003, 165.0, 691, 354733, 498, 11.796498100000008
499, 6.304103406992826, 80.38941059329294, 96.64221966266632, 0.6804239499999996, 120.0, 704, 355437, 499, 12.5424352
500, 6.460691338001583, 80.20466590037543, 96.45021573958859, 0.6797165500000001, 190.0, 868, 356305, 500, 15.002100900000187
501, 5.727588633431649, 80.22131281153054, 96.43773098777051, 0.6791400999999998, 115.0, 413, 356718, 501, 7.510696999999709
502, 9.266901921226593, 80.17967185745697, 96.48884628204529, 0.6785785000000003, 65.0, 835, 357553, 502, 15.385373200000231
503, 7.9160560531332, 80.2030468366004, 96.45932131887271, 0.6779309499999999, 120.0, 604, 358157, 503, 9.826556600000004
504, 7.5452159021424565, 80.18220386857614, 96.38340569717438, 0.67744, 110.0, 487, 358644, 504, 7.537685999999667
505, 6.298584792026356, 80.38193001181392, 96.63463503088654, 0.6769022500000001, 105.0, 708, 359352, 505, 10.734442699999818
506, 6.8778868166734455, 80.27748395201571, 96.553773970378, 0.6764031999999999, 120.0, 401, 359753, 506, 6.018557599999895
507, 8.594236345624614, 79.9216167227175, 96.12238231458161, 0.6755985999999998, 195.0, 1387, 361140, 507, 21.35808730000008
508, 9.024814555742456, 79.74113762813545, 95.99695987341539, 0.6746167000000001, 160.0, 795, 361935, 508, 13.076647299999877
509, 5.5376329915363245, 79.72967837037159, 95.79127949092235, 0.6740983000000002, 35.0, 357, 362292, 509, 6.739260100000138
510, 7.157896320892103, 79.82120980002664, 95.98566556988341, 0.6735663999999997, 275.0, 825, 363117, 510, 12.958681999999953
511, 6.108794871561542, 80.02175545454502, 96.21080804394629, 0.6729697000000001, 50.0, 501, 363618, 511, 7.8213064000001395
512, 9.132475118377053, 79.76816996501458, 96.02737929260427, 0.67242655, 210.0, 706, 364324, 512, 10.926316900000074
513, 8.581169442178643, 79.80988339015416, 96.06640739830173, 0.6719324500000002, 20.0, 392, 364716, 513, 6.272581000000173
514, 6.630957799483221, 79.89977734395379, 96.10573588070368, 0.6714865000000001, 120.0, 599, 365315, 514, 9.430110700000114
515, 8.329716211095974, 80.02496996461903, 96.21189418400333, 0.6707925999999997, 270.0, 943, 366258, 515, 14.743654100000185
516, 8.90721984043859, 79.96693915233845, 96.22530702464131, 0.6700366000000002, 110.0, 737, 366995, 516, 11.541426400000091
517, 9.128922790735514, 79.8950093485616, 96.18607946923682, 0.6692545000000001, 185.0, 1001, 367996, 517, 15.979758900000434
518, 6.50586922199444, 79.98903606502154, 96.12341346449524, 0.66856825, 140.0, 524, 368520, 518, 8.228512099999989
519, 7.579887523483463, 79.89996455195975, 96.13598966541677, 0.6679548999999996, 410.0, 839, 369359, 519, 14.797952200000054
520, 10.749634649511023, 79.55324277010831, 95.72872116287033, 0.6670576, 285.0, 1155, 370514, 520, 19.001077099999748
521, 9.470648714772812, 79.14800996315188, 95.1992230531646, 0.6662426499999999, 135.0, 656, 371170, 521, 10.673987399999987
522, 5.672267916888901, 79.11877809774997, 95.05353885226779, 0.6657247, 110.0, 495, 371665, 522, 8.132881999999881
523, 6.895449817069223, 79.02072403096707, 94.9863456797377, 0.6652611999999999, 50.0, 535, 372200, 523, 8.894667900000059
524, 7.086436418319377, 78.96367527802319, 94.9032631367882, 0.6647135500000001, 135.0, 682, 372882, 524, 11.284449100000074
525, 7.772209020427022, 79.20043582182664, 95.26454731134268, 0.6641258500000001, 105.0, 624, 373506, 525, 10.358078099999602
526, 8.254896763306824, 79.04399127663726, 95.0721421019401, 0.6634976499999997, 160.0, 772, 374278, 526, 12.346335299999737
527, 7.243137415689644, 79.08803819332319, 95.1213414573887, 0.6627556000000001, 250.0, 877, 375155, 527, 14.207902699999977
528, 8.514136741068379, 79.03893527062012, 95.06870841415119, 0.6619050999999994, 230.0, 1013, 376168, 528, 16.399327399999947
529, 6.917235861522528, 79.14945283275148, 95.19126903632045, 0.6611518000000001, 120.0, 661, 376829, 529, 10.765051299999868
530, 6.8686552832278265, 79.1487750894751, 95.21226374757585, 0.6604723000000002, 135.0, 849, 377678, 530, 13.912049900000056
531, 8.86967816805905, 79.10685354524315, 95.16472272238884, 0.6594336999999995, 615.0, 1459, 379137, 531, 23.62925519999999
532, 6.093623085575209, 79.01989619639697, 94.99862125740964, 0.6585328, 20.0, 543, 379680, 532, 8.647813800000222
533, 8.104076573110909, 78.95747610603024, 94.99572234760272, 0.6578532999999999, 185.0, 967, 380647, 533, 15.667864999999892
534, 7.36220328862479, 78.8741145510155, 94.89450366054771, 0.65699605, 210.0, 938, 381585, 534, 15.066911400000208
535, 8.234683164534356, 78.91767565114726, 94.9073509661769, 0.6560883999999996, 500.0, 1079, 382664, 535, 17.612459800000124
536, 7.806722734025435, 78.92598938941956, 94.93495840147922, 0.6550556500000002, 345.0, 1216, 383880, 536, 19.4756210999999
537, 7.181690882416083, 78.90960281326792, 94.92204091103211, 0.6542051500000001, 75.0, 674, 384554, 537, 10.980947900000047
538, 7.4076385766048105, 78.89331030318426, 94.9361937989181, 0.6537187000000001, 80.0, 407, 384961, 538, 6.608363100000133
539, 5.828967478267754, 78.87371546105493, 94.82139384595654, 0.6533578000000001, 35.0, 395, 385356, 539, 6.465167999999721
540, 8.031737300466764, 79.03964892463505, 95.06536504360432, 0.6527966500000003, 155.0, 852, 386208, 540, 13.896705300000121
541, 8.647644954903575, 78.94733048524779, 95.0009192380983, 0.6520829500000004, 210.0, 734, 386942, 541, 11.948926199999732
542, 5.483989248182548, 78.80428598348986, 94.69155908906411, 0.6515339500000001, 150.0, 486, 387428, 542, 8.059886300000016
543, 7.550757077327253, 79.00147729659153, 94.97472691173611, 0.6510191499999995, 110.0, 658, 388086, 543, 10.765063800000007
544, 6.826520577922624, 78.8940380784139, 94.91957864629101, 0.6504310000000002, 125.0, 649, 388735, 544, 10.732847599999786
545, 7.718670981746046, 78.81945374771372, 94.79412357612107, 0.6495724000000004, 445.0, 1259, 389994, 545, 20.704815600000074
546, 8.350234851850454, 78.48229993515298, 94.40543214592348, 0.6484005999999998, 585.0, 1345, 391339, 546, 22.260390699999334
547, 11.232183858024431, 78.681018976442, 94.71741989645676, 0.6476202999999997, 50.0, 389, 391728, 547, 6.587086900000031
548, 7.302051234682765, 78.36833710276753, 94.2333230394836, 0.6472000000000001, 85.0, 545, 392273, 548, 9.244901299999583
549, 8.16863186955452, 78.4594755915285, 94.37868915586981, 0.6466599999999996, 175.0, 655, 392928, 549, 11.087592300000324
550, 9.232534566782004, 78.51815114494498, 94.53222185155919, 0.6458347, 240.0, 1179, 394107, 550, 19.92583310000009
551, 6.32911691490171, 78.46653296477604, 94.3884830892521, 0.64493425, 155.0, 822, 394929, 551, 13.517101299999922
552, 5.735161343828226, 78.4820195991041, 94.34858087392954, 0.64431865, 65.0, 546, 395475, 552, 8.994846900000084
553, 5.683334454693087, 78.4561885326584, 94.31497076251374, 0.6438393999999997, 105.0, 519, 395994, 553, 8.800726399999803
554, 7.005792524455634, 78.60093770050196, 94.5155036545414, 0.6433264000000001, 115.0, 621, 396615, 554, 10.348307499999464
555, 7.207014488522706, 78.43900376948064, 94.32125533254523, 0.6427647999999999, 110.0, 627, 397242, 555, 10.678218999999444
556, 9.070842582090147, 78.45330375264804, 94.44339566843637, 0.6421955500000001, 185.0, 638, 397880, 556, 10.840818599999693
557, 8.546029822063984, 78.54827320351917, 94.5131292235717, 0.6415489, 240.0, 799, 398679, 557, 13.711941800000204
558, 8.485220426682623, 78.31828008005996, 94.14350950834569, 0.6409593999999997, 30.0, 511, 399190, 558, 8.536018400000103
559, 7.374539206193243, 78.49794977253471, 94.47131645939432, 0.64044055, 160.0, 642, 399832, 559, 10.583664600000702
560, 6.521175338765077, 77.90096234909034, 93.64200852213916, 0.6398586999999998, 210.0, 651, 400483, 560, 10.864291300000332
561, 5.640928178998752, 77.68292322399815, 93.33253472806744, 0.6390671499999998, 385.0, 1108, 401591, 561, 18.809889699999985
562, 9.31776052254897, 77.86918696834957, 93.66385598910057, 0.6382233999999996, 140.0, 767, 402358, 562, 13.192395299999589
563, 7.447081527012026, 77.58756396301791, 93.35188987927559, 0.63756235, 155.0, 702, 403060, 563, 11.928966199999195
564, 5.0699492663013, 77.53061617424429, 93.23873402132065, 0.6369417999999996, 65.0, 677, 403737, 564, 11.591406200000165
565, 9.72512621087069, 77.85448629141298, 93.7836972170924, 0.6363955000000001, 55.0, 537, 404274, 565, 9.190979299999526
566, 9.254509259435467, 77.63605969651302, 93.4017747147639, 0.6359144499999999, 125.0, 532, 404806, 566, 9.220649400000184
567, 9.182602750991858, 77.8190857769521, 93.66736277145922, 0.6351247000000001, 425.0, 1223, 406029, 567, 20.62218959999973
568, 9.497635591770505, 77.84045839967811, 93.69247249856946, 0.6342156999999996, 195.0, 797, 406826, 568, 13.687358199999835
569, 7.375614219547926, 77.72724526465973, 93.4691485660384, 0.6336235000000001, 85.0, 519, 407345, 569, 9.016270000000077
570, 9.747031827330817, 77.95526677381469, 93.84107624002898, 0.6331546, 80.0, 523, 407868, 570, 8.942497199999707
571, 8.794260516045968, 77.68273051459074, 93.48848853775218, 0.632386, 520.0, 1185, 409053, 571, 20.53629490000003
572, 7.755565212655437, 77.67551013443821, 93.45434424230295, 0.6312722499999994, 365.0, 1290, 410343, 572, 22.04733159999978
573, 9.628423589375592, 77.7576971482861, 93.55007858867793, 0.6304015000000003, 120.0, 645, 410988, 573, 11.04777710000053
574, 5.553683639424188, 77.61939503503224, 93.26757954188756, 0.6298277499999995, 45.0, 630, 411618, 574, 10.903326399999969
575, 5.598781902916157, 77.61142087349525, 93.32940686299251, 0.6290762500000001, 570.0, 1040, 412658, 575, 17.801958600000034
576, 9.851557754940837, 77.76659408613057, 93.74147368160565, 0.6284512, 35.0, 349, 413007, 576, 6.027806899999632
577, 7.670514292132597, 77.63158798610637, 93.29603256084155, 0.6278572, 285.0, 971, 413978, 577, 16.716807800000424
578, 7.903083494240509, 77.70519786205107, 93.51494331730223, 0.6272348499999997, 80.0, 412, 414390, 578, 7.433412000000317
579, 5.857003668234462, 77.57993096755561, 93.20902309561134, 0.6268699000000002, 110.0, 399, 414789, 579, 6.826208299999962
580, 6.09473556718292, 77.85681527883895, 93.61174395664986, 0.6263429500000002, 375.0, 772, 415561, 580, 13.417228799999975
581, 10.004208732811346, 77.68431433214879, 93.53602702669542, 0.6256440999999995, 120.0, 781, 416342, 581, 13.651718699999947
582, 8.914480996288457, 77.69655125315596, 93.46120809300979, 0.6250528, 80.0, 533, 416875, 582, 9.195663800000148
583, 7.750735622903287, 77.68936731555148, 93.45513310251894, 0.62440885, 230.0, 898, 417773, 583, 15.467669300000125
584, 9.274613018164377, 77.79789803937048, 93.62213810903583, 0.6235538500000003, 495.0, 1002, 418775, 584, 17.701108600000225
585, 5.009727528077046, 77.7194267253536, 93.34429500667193, 0.6229260999999997, 45.0, 393, 419168, 585, 6.958291599999939
586, 12.795082823830828, 77.82983871190915, 93.81689489638475, 0.6225706, 55.0, 397, 419565, 586, 7.089973899999677
587, 5.645921056297306, 77.80640608715672, 93.56525366757892, 0.6221709999999999, 75.0, 491, 420056, 587, 8.640992100000403
588, 7.942661273320751, 78.22090836248454, 94.0695952240532, 0.6216458499999998, 145.0, 676, 420732, 588, 11.887221399999362
589, 10.74859826740721, 78.28668478851706, 94.23238467927501, 0.6211648, 80.0, 393, 421125, 589, 6.88496269999996
590, 8.499662442492838, 78.20360884679799, 94.07939344561066, 0.6206666500000001, 335.0, 714, 421839, 590, 12.430478199999925
591, 10.264471625713616, 78.20147947887612, 94.1067515359364, 0.6200667999999996, 105.0, 619, 422458, 591, 11.017400100000486
592, 10.008145946359662, 78.24457081001063, 94.18761625984646, 0.61938055, 245.0, 906, 423364, 592, 15.78899679999995
593, 4.9595618108791975, 78.11004570532334, 93.8121859102263, 0.6186654999999996, 105.0, 683, 424047, 593, 11.982842600000367
594, 5.4249861362670035, 77.98125028396402, 93.69312424937706, 0.6181574499999999, 95.0, 446, 424493, 594, 7.852865700000621
595, 8.539242929188326, 78.1120507551387, 93.95404614943234, 0.6175359999999999, 320.0, 935, 425428, 595, 16.263962199999696
596, 10.694278716276854, 78.23936296120668, 94.24837365109697, 0.6169046500000002, 55.0, 468, 425896, 596, 8.549524500000189
597, 6.782651689571267, 78.09618713416629, 93.86164445723827, 0.6163300000000002, 230.0, 809, 426705, 597, 14.383596800000305
598, 8.853935555698346, 78.17539241857696, 94.0054506446883, 0.6157350999999998, 85.0, 513, 427218, 598, 9.34793930000069
599, 6.222887791106195, 78.07582310532078, 93.81564168294271, 0.6151330000000002, 165.0, 825, 428043, 599, 14.73080630000004
600, 7.893060156544826, 78.01850709968438, 93.84384312976006, 0.6144395499999996, 135.0, 716, 428759, 600, 12.819726699999592
601, 5.050200823814638, 78.02356407719273, 93.74815482477987, 0.61389415, 135.0, 496, 429255, 601, 8.893254900000102
602, 8.99298641282813, 78.07701690214917, 93.9967260260331, 0.6133717, 125.0, 665, 429920, 602, 11.61713189999955
603, 11.374757140801997, 78.24555527143781, 94.21677939641155, 0.6128884000000001, 50.0, 409, 430329, 603, 7.441251500000362
604, 7.254100270018504, 78.47623132638894, 94.29470431108884, 0.6122417500000001, 185.0, 1028, 431357, 604, 18.493795999999747
605, 4.836885146002479, 78.44922614702719, 94.23019761603496, 0.6116018499999999, 105.0, 394, 431751, 605, 7.1158873999993375
606, 8.972464132728602, 78.36830008853678, 94.24582739759144, 0.6110794000000003, 195.0, 767, 432518, 606, 13.921224300000176
607, 6.485759114012397, 78.26991696738027, 94.09761709669617, 0.6104408499999999, 50.0, 652, 433170, 607, 11.908995800000412
608, 5.035517698449966, 78.38511690971178, 94.18480265690731, 0.60997195, 50.0, 390, 433560, 608, 7.171326199999385
609, 7.00066035774019, 78.25988025241428, 94.1168051147461, 0.6095939499999997, 110.0, 450, 434010, 609, 8.046735899999476
610, 10.677941892128091, 78.20908594510915, 94.0915048938215, 0.6092218, 105.0, 377, 434387, 610, 6.795100999999704
611, 8.44442783332342, 78.26895593799719, 94.10583687408355, 0.6087560499999997, 105.0, 658, 435045, 611, 11.81586520000019
612, 8.747401077969375, 78.36900651005578, 94.22375464597985, 0.6082569999999999, 80.0, 451, 435496, 612, 8.232372299999952
613, 6.7564334055285, 78.2773584126609, 94.10438291302603, 0.6073975000000005, 680.0, 1459, 436955, 613, 26.27621040000031
614, 9.377051621527954, 78.33898615233838, 94.26309072328742, 0.6063319, 255.0, 909, 437864, 614, 16.278983199999857
615, 6.66420066947607, 78.30073681441287, 94.09175398190322, 0.6056335000000002, 105.0, 643, 438507, 615, 11.653996899999584
616, 8.981556899521662, 78.23695251117336, 94.1218192769874, 0.6049094500000004, 220.0, 966, 439473, 616, 17.289516099999673
617, 7.831255100632823, 78.20006773009781, 94.0314787280652, 0.6041845000000005, 135.0, 645, 440118, 617, 11.664114000000154
618, 8.239455447947124, 77.24122472269885, 92.80740100943783, 0.6036053499999999, 80.0, 642, 440760, 618, 11.506271299999753
619, 8.13534002939652, 77.41516659189061, 93.07952839583419, 0.6030585999999997, 140.0, 573, 441333, 619, 10.388606100000288
620, 6.485333091675628, 77.27186335712194, 92.92570665517749, 0.6024915999999999, 175.0, 687, 442020, 620, 12.633954699999776
621, 7.550981441586927, 77.45232148143327, 93.18031341436918, 0.6019452999999999, 120.0, 527, 442547, 621, 9.86298429999988
622, 5.88921223578759, 77.3026776599751, 92.89398664743166, 0.6013855000000004, 355.0, 717, 443264, 622, 14.30159999999978
623, 7.727301153043906, 77.41482442721986, 93.13604593276978, 0.6006524499999998, 210.0, 912, 444176, 623, 17.020069899999726
624, 7.380681422037128, 77.16375233302607, 92.75125107809762, 0.5999531500000004, 150.0, 642, 444818, 624, 11.53695930000049
625, 7.24238471830046, 77.46316528320312, 93.10721677309508, 0.5994910000000001, 35.0, 385, 445203, 625, 7.227920399999675
626, 6.919960106462996, 77.16118256493067, 92.75288867466341, 0.5990517999999997, 95.0, 591, 445794, 626, 10.804743499999859
627, 9.065584764110582, 77.25170197815154, 92.93889013443973, 0.5984002000000004, 185.0, 857, 446651, 627, 16.032057800000075
628, 7.643996601649957, 77.39363392674646, 93.07942051850549, 0.5977242999999999, 210.0, 645, 447296, 628, 13.121364699999504
629, 9.969175087030118, 77.48081997602414, 93.34635309072641, 0.59725855, 40.0, 390, 447686, 629, 7.171653200000037
630, 6.872987074357969, 77.47244129810963, 93.1253273995431, 0.5967833499999999, 135.0, 666, 448352, 630, 12.416354200000569
631, 7.109576199175929, 77.31074464143212, 92.90984203566366, 0.5962424499999996, 155.0, 536, 448888, 631, 9.953352100000302
632, 10.58772012251019, 77.38621387856959, 93.17963628059172, 0.5954752000000002, 285.0, 1169, 450057, 632, 21.63317779999943
633, 9.073579009298596, 76.70611123093192, 92.28249685037676, 0.5945814999999994, 135.0, 817, 450874, 633, 15.053600899999765
634, 6.883204106596931, 76.60197164084165, 92.07226543572112, 0.5937422500000002, 505.0, 1048, 451922, 634, 19.3536795
635, 10.269800865685754, 76.71096871816532, 92.28726049165752, 0.5927806000000003, 245.0, 1089, 453011, 635, 20.525745500000085
636, 5.837836074483696, 76.75254019160505, 92.3037026392581, 0.5919876999999997, 175.0, 673, 453684, 636, 12.411186399999679
637, 6.845921326544344, 76.75196029236598, 92.23773395941124, 0.5913950500000003, 105.0, 644, 454328, 637, 11.950922300000457
638, 7.557300247062164, 76.78989909712676, 92.28433442571361, 0.5908226499999999, 85.0, 628, 454956, 638, 12.03083400000014
639, 9.679322281745401, 76.74494993002108, 92.411610971583, 0.5903128, 80.0, 505, 455461, 639, 9.515319699999964
640, 11.64051869680558, 76.77688557507824, 92.4174995280553, 0.5898434499999999, 155.0, 538, 455999, 640, 10.205190199999379
641, 6.139143067078427, 76.60188241168346, 92.07092190085913, 0.5893124499999999, 110.0, 642, 456641, 641, 12.384002900000269
642, 6.466438213055082, 76.6632408306753, 92.16791804471463, 0.5887108000000003, 120.0, 695, 457336, 642, 13.064020699999674
643, 7.865664503820262, 76.73246592422642, 92.28980862481, 0.5879170000000002, 425.0, 1069, 458405, 643, 20.236637500000143
644, 8.391281166254164, 76.658740564853, 92.27780461190315, 0.5871700000000001, 80.0, 591, 458996, 644, 11.063563200000317
645, 7.27336065271708, 76.67550258185919, 92.21288264267088, 0.5864468499999996, 330.0, 1016, 460012, 645, 19.040686199999982
646, 11.164434641829345, 76.36913061417596, 91.90130937168364, 0.5857560999999999, 120.0, 519, 460531, 646, 9.948790000000372
647, 7.0405320708537005, 76.15189699846921, 91.55149551953657, 0.5851926999999999, 310.0, 733, 461264, 647, 13.861963500000456
648, 10.280691621011993, 76.1986516237997, 91.79016428613811, 0.5845721500000005, 110.0, 646, 461910, 648, 13.570921700000326
649, 5.413518063768477, 76.29303084690102, 91.61752565054012, 0.5840551000000002, 30.0, 503, 462413, 649, 9.741385499999524
650, 5.500483976096711, 76.16207568794047, 91.4997956703254, 0.5835254499999997, 155.0, 674, 463087, 650, 12.970958199999586
651, 7.184080500452561, 75.94327325502215, 91.29565184527007, 0.5830471, 25.0, 389, 463476, 651, 7.492458200000328
652, 5.049166938125859, 76.13069562071584, 91.46074813901237, 0.5826371500000002, 65.0, 522, 463998, 652, 10.005663100000675
653, 7.558213181968839, 76.33529091916076, 91.84439775353098, 0.5821533999999997, 50.0, 553, 464551, 653, 10.6113665999992
654, 8.24847527363721, 76.24585988661822, 91.71835020177505, 0.5815220500000002, 135.0, 850, 465401, 654, 16.304801600000246
655, 9.456448131202674, 76.354159964325, 91.8168039682072, 0.5808654999999997, 85.0, 609, 466010, 655, 11.681999700000233
656, 6.695836765964467, 76.24365995934816, 91.63067487609753, 0.5803426000000003, 30.0, 553, 466563, 656, 10.73044260000006
657, 7.234246236206775, 76.18433136129156, 91.57707751150622, 0.5798053000000002, 110.0, 641, 467204, 657, 12.279255399999784
658, 6.699708986688744, 76.10936675133644, 91.45096169508896, 0.5792396499999996, 140.0, 616, 467820, 658, 11.820396600000095
659, 9.71126933570334, 76.26905091576026, 91.7834145975237, 0.5784436000000001, 330.0, 1153, 468973, 659, 22.003065299999435
660, 7.539382638491861, 76.3048798091828, 91.77040190250996, 0.5776696, 75.0, 567, 469540, 660, 11.122858599999745
661, 6.993121230138376, 76.0627809718902, 91.42231542025542, 0.5770126000000001, 340.0, 893, 470433, 661, 17.345176099999662
662, 6.122086010576425, 75.92866863561989, 91.26830671046218, 0.5763735999999999, 30.0, 527, 470960, 662, 10.295138099999349
663, 6.771002192894618, 76.0076514398484, 91.37275188627697, 0.5759001999999999, 15.0, 525, 471485, 663, 10.287548000000243
664, 7.250403386959131, 75.95161064811374, 91.41888528630354, 0.57541555, 50.0, 552, 472037, 664, 10.760561900000539
665, 10.985079408113895, 76.12217268396597, 91.69288721667317, 0.5745632499999994, 235.0, 1342, 473379, 665, 26.230217000000266
666, 6.086451819389483, 76.03188166379007, 91.33479092572186, 0.5737262499999999, 155.0, 518, 473897, 666, 10.149174900000617
667, 8.758883232243447, 76.22665629933473, 91.67070298326817, 0.57326545, 75.0, 506, 474403, 667, 10.027023700000427
668, 7.076537383960687, 76.02197862447446, 91.40164404632534, 0.5726368000000002, 215.0, 891, 475294, 668, 17.734225900000638
669, 6.5351078030528935, 75.98212786032114, 91.31354891723271, 0.5719325500000001, 145.0, 674, 475968, 669, 13.847646000000168
670, 7.03731403647396, 76.04103802818541, 91.41153427907481, 0.5714452000000002, 55.0, 409, 476377, 670, 8.286029599999893
671, 10.783060814021614, 76.01085066280103, 91.52300233972096, 0.5710320999999999, 110.0, 509, 476886, 671, 10.256362899999658
672, 6.807177681599596, 75.97970309380676, 91.29980523647858, 0.5705591500000002, 45.0, 542, 477428, 672, 10.472683199999665
673, 7.7183140869451865, 75.99486717736615, 91.42531188268626, 0.5699602000000001, 175.0, 789, 478217, 673, 15.424036800000067
674, 8.460620342431515, 75.87677213475536, 91.24118841401022, 0.5693697999999998, 65.0, 523, 478740, 674, 10.575750199999675
675, 9.227084418775839, 76.07049553547431, 91.53217081192436, 0.5689382499999999, 55.0, 436, 479176, 675, 8.740576300000612
676, 8.659333048278794, 76.0413520897136, 91.54285067670486, 0.5684972500000001, 100.0, 544, 479720, 676, 11.547733000000335
677, 7.802584243672235, 75.31595127166264, 90.561217641964, 0.5677705, 230.0, 1071, 480791, 677, 21.418270799999846
678, 6.455012364258137, 75.01133097567299, 90.14972245563833, 0.5669983000000001, 150.0, 645, 481436, 678, 12.906858099999226
679, 9.886156799256103, 75.09754395604733, 90.3337250139246, 0.5664394, 110.0, 597, 482033, 679, 11.83544509999956
680, 4.71155846893203, 74.82938575744629, 89.94845973744111, 0.5659871499999998, 105.0, 408, 482441, 680, 8.667086200000085
681, 12.191316227390342, 74.99907794810555, 90.2815655374247, 0.5655736, 80.0, 511, 482952, 681, 10.335288199999923
682, 5.891609797515481, 74.99532789342544, 90.11755182948048, 0.56514475, 60.0, 442, 483394, 682, 8.964707899999667
683, 8.33912250897791, 74.87979716565235, 90.07011896156403, 0.5646470500000002, 140.0, 664, 484058, 683, 13.456542799999625
684, 7.035678016959257, 75.07122766582015, 90.23551696577883, 0.5640728499999998, 125.0, 612, 484670, 684, 12.78149409999969
685, 8.396551051684218, 75.00383983368084, 90.238939562317, 0.5630446, 1085.0, 1673, 486343, 685, 33.21915150000041
686, 6.103080808981917, 74.90951972904062, 90.0233646937779, 0.5619925000000002, 80.0, 665, 487008, 686, 13.33576660000017
687, 8.522744165399136, 74.95756839570545, 90.12656739343217, 0.5614475499999999, 100.0, 546, 487554, 687, 10.912500200000068
688, 8.867341357861566, 74.9681936151841, 90.19926662694395, 0.5606510499999994, 380.0, 1224, 488778, 688, 24.532792100000734
689, 7.260638270696456, 74.89385637370023, 89.96985933997415, 0.5597834499999998, 135.0, 704, 489482, 689, 14.365339400000266
690, 6.878843137896375, 74.91286013419167, 90.04175877152828, 0.5592614499999999, 150.0, 456, 489938, 690, 9.228431399999863
691, 8.528662418198149, 75.51358554385124, 90.86964783274799, 0.55856575, 315.0, 1090, 491028, 691, 21.839125700000295
692, 7.505614802671543, 75.49984530952032, 90.78278162598298, 0.5579038000000001, 50.0, 381, 491409, 692, 7.7032656999999745
693, 7.37907743100162, 75.65575953560514, 90.92468836536146, 0.5574366999999999, 75.0, 657, 492066, 693, 13.278038299999935
694, 6.555769742852763, 75.61527207223993, 90.88659576416016, 0.5569272999999998, 120.0, 475, 492541, 694, 9.846920500000124
695, 7.097150643455222, 75.67841939723237, 90.99035169723186, 0.55654435, 65.0, 376, 492917, 695, 7.763780199999928
696, 6.709220802174453, 75.61332612825773, 90.89977357843968, 0.5559967, 255.0, 841, 493758, 696, 17.196822700000666
697, 6.745983819653911, 75.5620454554404, 90.86166482248613, 0.5552694999999995, 195.0, 775, 494533, 697, 15.83943569999974
698, 8.92640016988487, 75.66154685894924, 91.04666128455561, 0.5546606499999999, 120.0, 578, 495111, 698, 11.968698799999402
699, 9.315079388666335, 75.7190915138726, 91.0206283510985, 0.5541651999999999, 140.0, 523, 495634, 699, 11.030821999999716
700, 8.141963770464443, 75.57295734813542, 90.87684490158522, 0.5536648000000002, 95.0, 589, 496223, 700, 12.089465300000484
701, 7.011343335801804, 75.46558841069539, 90.64631345536974, 0.5532053500000002, 10.0, 432, 496655, 701, 8.784743799999887
702, 7.299084153178129, 75.66506512145641, 90.97626453617261, 0.5526243999999996, 385.0, 859, 497514, 702, 17.504951100000653
703, 8.232717120150056, 75.58015489129006, 90.82916848142888, 0.5519035, 145.0, 743, 498257, 703, 15.20465409999997
704, 5.232146055623889, 75.66014232635499, 90.97284280776978, 0.55138915, 35.0, 400, 498657, 704, 8.168696400000044
705, 9.204267994785086, 75.6329206631178, 90.91770511796146, 0.5510161000000001, 55.0, 429, 499086, 705, 8.778707600000416
706, 10.187837362149292, 75.58313189180667, 90.92766366558016, 0.55053595, 110.0, 638, 499724, 706, 13.153175499999634
707, 7.87508372298889, 75.08162022997196, 90.22429540909225, 0.5499648999999998, 135.0, 631, 500355, 707, 12.908550500000274
708, 7.393566972949218, 74.24977646122538, 89.2289437781716, 0.5494046500000002, 100.0, 614, 500969, 708, 12.60838479999984
709, 7.580995092551674, 74.36343265758558, 89.44562934498278, 0.5488462000000001, 110.0, 627, 501596, 709, 13.036417799999981
710, 7.23897385265383, 74.22924798152687, 89.24009354977332, 0.5483538999999997, 95.0, 467, 502063, 710, 9.827937199999724
711, 5.889087069475673, 74.50146733379907, 89.50789270274326, 0.5479066, 105.0, 527, 502590, 711, 10.85912019999978
712, 7.769459426126757, 74.31003324416719, 89.34251797066631, 0.5473054, 140.0, 809, 503399, 712, 16.97893169999952
713, 7.424723264342601, 74.35634022458977, 89.45495993937921, 0.5465489500000001, 410.0, 872, 504271, 713, 18.632249899999806
714, 9.886704554191287, 74.32867869185611, 89.41160779364607, 0.5457218499999997, 195.0, 966, 505237, 714, 20.627091700000165
715, 8.66448516343397, 74.53889310253834, 89.62941259729402, 0.5449838500000002, 150.0, 674, 505911, 715, 16.128450000000157
716, 10.409462145933016, 74.45764250267209, 89.57079162597657, 0.5443948, 35.0, 635, 506546, 716, 15.87799989999985
717, 7.335973848998546, 74.47693468729655, 89.54239159901937, 0.54383905, 60.0, 600, 507146, 717, 17.723874799999976
718, 6.99137887185347, 74.21275823065575, 89.25306731961298, 0.5432518000000002, 85.0, 705, 507851, 718, 18.500264599999355
719, 7.957705460727214, 74.13901489257813, 89.08928910827636, 0.5427095499999997, 85.0, 500, 508351, 719, 12.73572140000033
720, 7.680786438393661, 74.38002672112984, 89.41166040601922, 0.5421722500000001, 155.0, 694, 509045, 720, 14.782126799999787
721, 9.131273158702506, 74.41714460686987, 89.51876858630813, 0.5416358500000001, 95.0, 498, 509543, 721, 10.50360340000043
722, 5.605368857574685, 74.54472702287404, 89.54216981119538, 0.5411223999999999, 120.0, 643, 510186, 722, 14.079275299999608
723, 10.681602301380108, 74.56530449845009, 89.74740415345494, 0.5405050000000001, 165.0, 729, 510915, 723, 15.511526299999787
724, 11.05317303573384, 74.42905289145077, 89.55004584368537, 0.5400239499999999, 40.0, 340, 511255, 724, 7.376621200000045
725, 5.131616132587751, 74.61251135980724, 89.61352542346314, 0.5395573000000004, 125.0, 697, 511952, 725, 14.695017500000176
726, 8.490593668648867, 74.59703189570729, 89.71911239624023, 0.53902225, 120.0, 492, 512444, 726, 10.606834100000015
727, 7.083182379967875, 74.4025618463969, 89.45270567969453, 0.5381753499999992, 515.0, 1390, 513834, 727, 30.009161699999822
728, 10.264411824514092, 74.57054839959125, 89.72129839160775, 0.5370165999999998, 425.0, 1185, 515019, 728, 25.199150100000224
729, 7.100066817744237, 74.51565821831215, 89.55636456270173, 0.5360041, 495.0, 1065, 516084, 729, 22.911609900000258
730, 6.9037656634286515, 74.70984643436475, 89.78187410935956, 0.5350834000000002, 495.0, 981, 517065, 730, 21.456170099999326
731, 8.946684546768665, 74.72371188168803, 89.89236709554359, 0.5343017499999996, 105.0, 756, 517821, 731, 16.372091100000034
732, 9.300230946860026, 74.62445127768595, 89.78000616896999, 0.53363215, 170.0, 732, 518553, 732, 16.834522500000276
733, 7.417919142039073, 74.62250349256728, 89.61962934097333, 0.5331448, 30.0, 351, 518904, 733, 7.693356300000232
734, 6.838855329811286, 74.55506588367933, 89.60213479031337, 0.5327064999999997, 115.0, 623, 519527, 734, 14.02005250000002
735, 9.410822364757406, 74.67372967418612, 89.77656015583888, 0.5322524499999998, 40.0, 386, 519913, 735, 9.175113799999963
736, 8.316461128735726, 73.30529637299767, 88.14963180187137, 0.5317885, 155.0, 645, 520558, 736, 14.11611189999985
737, 7.144517530015735, 73.09584721853567, 87.84128939828207, 0.5311886500000004, 100.0, 688, 521246, 737, 14.832199899999978
738, 10.437065966773034, 73.08532600097656, 87.96124783935547, 0.5303165499999998, 350.0, 1250, 522496, 738, 27.48073420000037
739, 6.370625493892998, 73.03812414903734, 87.74360130536034, 0.5294350000000001, 140.0, 709, 523205, 739, 16.130621500000416
740, 5.623411203095503, 72.99426487307917, 87.67484959852943, 0.5288778999999999, 65.0, 529, 523734, 740, 11.784129000000576
741, 9.131471925372045, 73.09599871298983, 87.91929288618176, 0.5282699500000004, 290.0, 822, 524556, 741, 17.879150600000685
742, 6.571350123412304, 73.1076932364282, 87.83372158917061, 0.52755535, 240.0, 766, 525322, 742, 17.401712099999713
743, 6.826928957966307, 72.97526151903214, 87.71752079071537, 0.52698745, 155.0, 496, 525818, 743, 11.306725299999925
744, 9.39566442013591, 73.23332196343408, 88.07178286316021, 0.5264973999999999, 135.0, 593, 526411, 744, 13.04277059999913
745, 8.919448800616259, 73.01693544374947, 87.88276383043461, 0.5258970999999996, 355.0, 741, 527152, 745, 16.72812739999972
746, 7.057760532300633, 73.09895700674791, 87.84651903005746, 0.52537645, 105.0, 416, 527568, 746, 9.82243970000036
747, 7.00787161685325, 73.2394758482237, 88.02770022830448, 0.52502275, 105.0, 370, 527938, 747, 8.217271299999993
748, 7.992918368041246, 72.97226540751048, 87.73084124396829, 0.5246573499999998, 80.0, 442, 528380, 748, 11.418262799999866
749, 6.780867449949643, 73.02214507843826, 87.76267307340018, 0.5241358, 155.0, 717, 529097, 749, 17.158568699999705
750, 8.90095908621653, 73.09031817575338, 88.02267981886108, 0.5236003000000001, 65.0, 473, 529570, 750, 10.514121899999736
751, 9.10972757844209, 73.02628225233497, 87.75319179674474, 0.5230922499999998, 125.0, 656, 530226, 751, 14.845674700000018
752, 8.295949965099462, 72.9275672439551, 87.69855840103804, 0.5225140000000001, 115.0, 629, 530855, 752, 14.065083399999821
753, 5.299906314337423, 72.86097205645665, 87.50550388498894, 0.52204105, 55.0, 422, 531277, 753, 9.86236000000008
754, 11.049348618502908, 72.85870715933787, 87.64067956390141, 0.5215635999999996, 135.0, 639, 531916, 754, 14.389464100000623
755, 7.097380635711584, 72.82765045166016, 87.47306266527498, 0.5210757999999998, 15.0, 445, 532361, 755, 10.129194300000563
756, 5.908009210255294, 72.59834731110429, 87.26687080585852, 0.5206213, 115.0, 565, 532926, 756, 12.763582900000074
757, 9.244691101855489, 72.724059360251, 87.45443051685184, 0.5201703999999999, 50.0, 437, 533363, 757, 9.743871499999841
758, 7.452294263384883, 72.81292131000623, 87.52899126162255, 0.5197933, 80.0, 401, 533764, 758, 9.398211199999423
759, 7.34818303620499, 72.86460932306707, 87.58903880350545, 0.5191209999999999, 390.0, 1093, 534857, 759, 24.456595100000413
760, 5.709634992811415, 72.52164521797624, 87.1021867378679, 0.5184590499999999, 60.0, 378, 535235, 760, 8.473537099999703
761, 9.402682418231025, 72.79602566214649, 87.48899780861571, 0.5178686500000002, 205.0, 934, 536169, 761, 21.236807399999634
762, 7.767468463278672, 72.68735847986332, 87.32331418777261, 0.5170469500000004, 125.0, 892, 537061, 762, 20.38496530000066
763, 7.853210520364374, 72.95106754378969, 87.6824327689243, 0.5160807999999997, 385.0, 1255, 538316, 763, 28.487223400000403
764, 6.513648018096257, 72.80705199195343, 87.45318773880746, 0.5151452500000001, 190.0, 824, 539140, 764, 20.39205099999981
765, 10.31515164026823, 72.93616116236127, 87.79324526509279, 0.5146043499999998, 85.0, 378, 539518, 765, 9.283804800000325
766, 7.725698152942391, 72.65649198663645, 87.38001192027124, 0.5140166500000002, 250.0, 928, 540446, 766, 21.972701000000598
767, 9.623580064230564, 72.74999916915495, 87.51524868311058, 0.5131692999999995, 415.0, 955, 541401, 767, 21.977337100000113
768, 6.634388697823298, 72.72116443931793, 87.37216082026576, 0.512434, 110.0, 679, 542080, 768, 15.72970449999957
769, 8.628612159237043, 72.57173950992413, 87.19811349840306, 0.5118872499999997, 120.0, 536, 542616, 769, 13.608358000000408
770, 7.85331868118081, 72.87414176770429, 87.58443363551987, 0.5113238500000001, 125.0, 716, 543332, 770, 16.488251599999785
771, 14.736189677814643, 72.91816235860189, 87.8364605585734, 0.51073165, 80.0, 600, 543932, 771, 13.636021599999367
772, 6.063711148017319, 72.57792569696903, 87.16832472383976, 0.5100008500000001, 320.0, 1024, 544956, 772, 23.284603699999934
773, 9.860274127551488, 72.73453702169752, 87.44904668898809, 0.5092565499999999, 150.0, 630, 545586, 773, 14.904655999999704
774, 9.213343671116657, 72.698635865088, 87.44521104316587, 0.5085595000000004, 250.0, 919, 546505, 774, 23.35333510000055
775, 7.17654962062658, 72.67567352886172, 87.35864883172708, 0.507844, 155.0, 671, 547176, 775, 16.33353100000022
776, 10.692551441853572, 72.7227014033364, 87.39257633242019, 0.5072279500000001, 110.0, 698, 547874, 776, 31.415608500000417
777, 11.076494198723385, 72.69149406064481, 87.49272891892173, 0.5066065000000001, 60.0, 683, 548557, 777, 22.57535259999986
778, 8.989234693122633, 72.61524129154706, 87.33120561850191, 0.5061209499999999, 125.0, 396, 548953, 778, 10.585266799999772
779, 7.936436128061256, 72.47444947913058, 87.04268487224029, 0.5057397999999999, 80.0, 451, 549404, 779, 12.444583299999977
780, 4.925595444506651, 72.51122527017202, 87.07955855601217, 0.50525155, 140.0, 634, 550038, 780, 15.583514699999796
781, 4.558946889023579, 71.85947526390873, 86.3398857875843, 0.5047853499999998, 40.0, 402, 550440, 781, 9.772989199999756
782, 5.724340357287572, 71.91034682347224, 86.36837949019213, 0.5043704499999999, 45.0, 520, 550960, 782, 12.881885700000566
783, 7.314712787033024, 71.9839531652312, 86.4841727732417, 0.5039569000000002, 60.0, 399, 551359, 783, 9.903019200000017
784, 12.796378075359819, 72.18798976431867, 86.93468409597516, 0.5035527999999998, 115.0, 499, 551858, 784, 12.098253300000579
785, 7.26411818903546, 72.10107182814413, 86.6771511605495, 0.5029606000000003, 170.0, 817, 552675, 785, 20.154215800000202
786, 5.556085946732725, 72.02404139592097, 86.6119918146077, 0.50244085, 75.0, 338, 553013, 786, 8.457751999999346
787, 8.668130036881216, 72.15488291129792, 86.69738350554907, 0.5021010999999999, 60.0, 417, 553430, 787, 10.249651400000403
788, 7.037757620518958, 72.13772551925094, 86.69077823780201, 0.5014274500000001, 320.0, 1080, 554510, 788, 26.861785500000224
789, 7.481187499863291, 71.92736785295168, 86.48310864495214, 0.5005827999999997, 185.0, 797, 555307, 789, 19.49423780000052
790, 8.660556153674436, 71.89955548542302, 86.4579482504992, 0.5000027499999998, 90.0, 492, 555799, 790, 12.239714600000298
791, 6.356356088187527, 72.04003342446457, 86.51698206143901, 0.4995055, 100.0, 613, 556412, 791, 16.62873969999964
792, 6.027908783428238, 71.87280655665616, 86.35275304957365, 0.4990033000000001, 115.0, 503, 556915, 792, 15.121959699999934
793, 7.646168619354406, 72.30398702557626, 86.95457443176025, 0.49844079999999996, 135.0, 747, 557662, 793, 22.899385299999267
794, 11.041254597628404, 71.98960651088856, 86.56847875749517, 0.4978989999999998, 75.0, 457, 558119, 794, 12.109535700000379
795, 6.971301402801367, 72.0798237793281, 86.60961498445867, 0.49698955000000017, 595.0, 1564, 559683, 795, 40.39083070000015
796, 7.385155250178461, 71.85330153221368, 86.36545514221605, 0.49595320000000026, 110.0, 739, 560422, 796, 22.494877799999813
797, 9.765524669100117, 71.70384128309507, 86.25746570780841, 0.4952129499999999, 240.0, 906, 561328, 797, 33.54699290000008
798, 7.388389994296075, 71.58305773440547, 86.04021687451237, 0.49446280000000026, 200.0, 761, 562089, 798, 32.09889410000051
799, 10.10995064604624, 71.8775194070901, 86.41395486236378, 0.4938377499999999, 80.0, 628, 562717, 799, 26.41510239999934
800, 9.048417762885913, 71.80540143363797, 86.46761173946359, 0.49331170000000013, 80.0, 541, 563258, 800, 23.787705099999584
801, 7.678292180168199, 71.79343831861341, 86.31354826849861, 0.4928684499999998, 140.0, 444, 563702, 801, 17.4719341
802, 7.160529490689345, 71.59726855606185, 86.05189720312387, 0.49227894999999977, 490.0, 866, 564568, 802, 37.546478399999614
803, 7.439195410103842, 71.77930482961065, 86.28496200807633, 0.49149865000000015, 240.0, 868, 565436, 803, 35.06646819999969
804, 6.610185570834334, 71.78527957133599, 86.28740234868015, 0.4908294999999998, 60.0, 619, 566055, 804, 25.218466600000284
805, 6.393724181496634, 71.66211822526208, 86.13744115007334, 0.4901333500000002, 270.0, 928, 566983, 805, 40.744329400000424
806, 10.560061668832974, 71.8642785512257, 86.4308336570905, 0.48942504999999975, 30.0, 646, 567629, 806, 27.96120719999999
807, 7.532552243908867, 71.71084718704223, 86.12128027677537, 0.4888463500000001, 80.0, 640, 568269, 807, 28.101638699999967
808, 7.637566684311754, 71.72401789645176, 86.15550367109053, 0.4882586499999999, 155.0, 666, 568935, 808, 24.616667599999346
809, 6.698390066623688, 71.66152940833051, 86.15934957421344, 0.48775195, 70.0, 460, 569395, 809, 14.934939300000224
810, 9.385142240421903, 71.6317565367997, 86.10612253762461, 0.48725154999999987, 155.0, 652, 570047, 810, 19.042595199999596
811, 7.263465782078942, 70.55574477847732, 84.77275441117143, 0.4865256999999996, 420.0, 961, 571008, 811, 36.64427440000054
812, 6.844934740719574, 70.63792602351454, 84.86484608884717, 0.4857638499999999, 125.0, 732, 571740, 812, 30.220385099999476
813, 5.755849390498789, 70.56684253333914, 84.78524548845898, 0.4849893999999995, 235.0, 989, 572729, 813, 42.27686900000026
814, 9.254105791266035, 70.5055343176931, 84.77597258243655, 0.48436165000000003, 30.0, 406, 573135, 814, 16.531237900000633
815, 6.649607842691113, 70.58041072178268, 84.83188535438201, 0.4838418999999998, 120.0, 749, 573884, 815, 30.78917089999959
816, 9.182445372549855, 70.56604151336514, 84.83547740079919, 0.48315205000000017, 185.0, 784, 574668, 816, 32.58969210000032
817, 4.844854538874514, 70.68649996243991, 84.93151311479376, 0.4826471500000001, 65.0, 338, 575006, 817, 14.592849399999977
818, 10.969409790887896, 70.514472757067, 84.84989953041077, 0.48229344999999973, 85.0, 448, 575454, 818, 19.429410000000644
819, 8.35404188668513, 70.62325845578177, 84.93927277076922, 0.4817674000000002, 190.0, 721, 576175, 819, 29.09058300000106
820, 11.55305343520219, 70.47802058542807, 84.79818901302308, 0.48121434999999996, 80.0, 508, 576683, 820, 20.388214900000094
821, 6.043695766174376, 70.58090079340953, 84.74539077699416, 0.48075445000000006, 40.0, 514, 577197, 821, 21.468224100000953
822, 5.716897236214226, 70.50910725387624, 84.69772206430024, 0.4799813499999999, 340.0, 1204, 578401, 822, 49.045526200001405
823, 7.125146453327034, 70.45255379378796, 84.64084193110466, 0.47920915000000003, 20.0, 512, 578913, 823, 21.175363899999866
824, 6.8473842498412125, 70.64834694136256, 84.89201298688232, 0.4786921, 105.0, 637, 579550, 824, 26.55336239999997
825, 5.963487129792036, 70.64805791482507, 84.84808761475095, 0.4781795499999998, 80.0, 502, 580052, 825, 20.82374770000024
826, 8.327061486421597, 70.30549213772728, 84.52012448083786, 0.47757565000000024, 250.0, 840, 580892, 826, 34.03405919999932
827, 7.253319945421305, 70.27293664055901, 84.47959762435775, 0.47694790000000004, 135.0, 555, 581447, 827, 23.119542499998715
828, 8.081128943194614, 70.62835507187546, 84.88083838503897, 0.47651005000000013, 80.0, 418, 581865, 828, 17.035227599999416
829, 8.321096305455539, 70.510946918222, 84.76750152017952, 0.4757918500000002, 480.0, 1178, 583043, 829, 48.20420489999924
830, 9.54018415652703, 70.51740247779918, 84.74746812481746, 0.47502100000000014, 110.0, 535, 583578, 830, 22.024637300000904
831, 7.997523456501464, 70.44944506386916, 84.63542831937472, 0.47443465000000007, 375.0, 768, 584346, 831, 31.78952659999959
832, 8.324095241585221, 70.4408939222769, 84.65935927980966, 0.4737303999999996, 195.0, 797, 585143, 832, 33.48912899999959
833, 9.569229560179842, 70.58691604932149, 84.96359213193257, 0.47311255, 105.0, 576, 585719, 833, 24.35157430000072
834, 10.432157460366836, 70.33878537572996, 84.52676149618746, 0.4726305999999999, 90.0, 495, 586214, 834, 20.96673969999938
835, 9.347178988466094, 70.56528453414707, 84.79569702298328, 0.47194975000000033, 290.0, 1018, 587232, 835, 42.55170480000015
836, 9.437556036226793, 70.39392823035564, 84.72996053783172, 0.47129545, 60.0, 436, 587668, 836, 18.1906841
837, 9.815554043293803, 70.42294752175651, 84.70364772288434, 0.4708324, 60.0, 593, 588261, 837, 24.723929200001294
838, 6.964380981164345, 70.48324638599257, 84.65295363644701, 0.47010789999999997, 325.0, 1017, 589278, 838, 43.15411909999966
839, 6.433749104896303, 70.22782341972899, 84.32640509842508, 0.4692430000000004, 215.0, 905, 590183, 839, 37.493139000000156
840, 7.660633817809063, 69.21566923152017, 83.18025660646555, 0.46867285, 35.0, 362, 590545, 840, 15.181509299998652
841, 8.916516626309491, 69.55119597840452, 83.63635923952876, 0.46828449999999977, 70.0, 501, 591046, 841, 21.514833299999736
842, 10.563273957975513, 69.61613343816708, 83.7450334201515, 0.4678169500000001, 85.0, 538, 591584, 842, 22.83903629999986
843, 6.58196308585013, 69.6197738887984, 83.6599748859189, 0.4672180000000001, 165.0, 793, 592377, 843, 33.46490929999891
844, 10.51913753569853, 69.5635716740678, 83.72419827158858, 0.46663975000000013, 80.0, 492, 592869, 844, 20.220924399998694
845, 5.9963969524882055, 69.53180598865856, 83.5241804781827, 0.46617084999999986, 170.0, 550, 593419, 845, 23.19071559999975
846, 9.66354421374158, 69.5952474815601, 83.76186806937888, 0.4655241999999998, 210.0, 887, 594306, 846, 36.76641980000022
847, 8.016310238627934, 69.48602597991382, 83.5161175289037, 0.46483165, 120.0, 652, 594958, 847, 22.610332300000664
848, 5.788495796407066, 69.5111390029768, 83.48027976595522, 0.46424215, 110.0, 658, 595616, 848, 23.744178700000703
849, 7.024403662789276, 69.4865951478667, 83.54754203725084, 0.4636571500000002, 90.0, 642, 596258, 849, 18.334937899999204
850, 7.8462161753633275, 69.41505215228901, 83.44232069464822, 0.46289259999999993, 240.0, 1057, 597315, 850, 30.21475520000058
851, 6.072885123515561, 69.47873560443723, 83.45838576959808, 0.46201915000000027, 225.0, 884, 598199, 851, 24.592742599999838
852, 9.82356203894349, 69.5837674546749, 83.6940269064396, 0.46145214999999995, 55.0, 376, 598575, 852, 10.451111799999126
853, 9.844186746307782, 69.44759773254394, 83.60289583478655, 0.46112544999999994, 55.0, 350, 598925, 853, 9.743979599999875
854, 5.97340903328828, 69.5448189965027, 83.53590973441322, 0.4606633000000001, 105.0, 677, 599602, 854, 19.96596910000153
855, 5.098431068822129, 69.60162650330426, 83.65427030798507, 0.4601944, 105.0, 365, 599967, 855, 10.103426300000137
856, 6.9572489025763105, 69.0910977772304, 83.0476203264509, 0.45971514999999963, 105.0, 700, 600667, 856, 19.35258520000025
857, 12.611907843363847, 69.33780895852294, 83.46552346514157, 0.4592282499999999, 50.0, 382, 601049, 857, 10.645287800000006
858, 8.570878401966846, 69.01781885914257, 82.93421330751089, 0.4586904999999999, 190.0, 813, 601862, 858, 22.930879900000946
859, 6.367394960609046, 69.16125160245164, 83.0810915613581, 0.4579552000000003, 235.0, 821, 602683, 859, 25.265195299998595
860, 7.177788159308895, 69.11569042082756, 83.07435383458291, 0.45723699999999995, 135.0, 775, 603458, 860, 22.130944200000158
861, 6.948837701434144, 69.03660402734295, 82.96175975425571, 0.4564751500000003, 180.0, 918, 604376, 861, 27.422226800001226
862, 5.738363857422255, 69.0756910838912, 82.95448796095046, 0.4556552499999997, 290.0, 904, 605280, 862, 26.370975300000282
863, 7.931521309720408, 69.16978956921265, 83.12572566872777, 0.45502119999999985, 75.0, 505, 605785, 863, 15.010888099999647
864, 7.282947510698734, 68.98683327680443, 82.8967113494873, 0.4544861499999999, 160.0, 684, 606469, 864, 21.002514600000723
865, 5.743382736345257, 69.18461673827971, 83.13975033273012, 0.4538215000000002, 200.0, 793, 607262, 865, 23.336204900000666
866, 8.953891357197564, 69.06999697863938, 82.99350595568293, 0.45323650000000015, 80.0, 507, 607769, 866, 15.240670299999692
867, 8.93477094132419, 69.16444115245014, 83.18871917491295, 0.45271404999999976, 165.0, 654, 608423, 867, 19.698066499999186
868, 6.922670826662419, 69.16101827695388, 83.11582891183306, 0.45212949999999996, 155.0, 645, 609068, 868, 18.707263799999055
869, 8.152228577505975, 69.14467377715059, 83.12172448853434, 0.45159354999999995, 90.0, 546, 609614, 869, 16.171614800001407
870, 6.67138582670819, 69.14820046500186, 83.04995821168328, 0.4509775000000003, 150.0, 823, 610437, 870, 24.581899800001338
871, 7.9350430013672, 69.16086647587437, 83.13308309739635, 0.45038395000000003, 135.0, 496, 610933, 871, 14.873365299999932
872, 6.475525709893555, 69.25434439182281, 83.1721610069275, 0.44987274999999965, 105.0, 640, 611573, 872, 19.135614599999826
873, 8.634894570281343, 69.35219239724363, 83.35747284020435, 0.4492611999999999, 155.0, 719, 612292, 873, 21.121387699999104
874, 7.028798280978474, 69.16632987214099, 83.11821042722758, 0.4485816999999997, 135.0, 791, 613083, 874, 24.390924499999528
875, 4.883826584950167, 69.28210510134073, 83.17733005703431, 0.4480538499999999, 65.0, 382, 613465, 875, 11.430067900000722
876, 5.619524946635855, 69.12144551390693, 83.0177160331181, 0.4475795500000001, 120.0, 672, 614137, 876, 19.732838800000536
877, 8.980905067779476, 69.07904844688359, 83.06586012994856, 0.44691624999999985, 205.0, 802, 614939, 877, 24.105167200001233
878, 7.244999779021646, 69.50608066749072, 83.53345265225788, 0.4463839000000003, 75.0, 381, 615320, 878, 11.325486499999897
879, 8.028418586337114, 69.19946733305726, 83.15274602189848, 0.44585694999999986, 410.0, 790, 616110, 879, 23.334247900000264
880, 7.079174798617446, 69.19762365323652, 83.16015271974901, 0.4450609000000001, 425.0, 979, 617089, 880, 29.638396700000158
881, 6.715443574468051, 69.21547595533126, 83.16127127430921, 0.4442535999999996, 210.0, 815, 617904, 881, 24.500100700000985
882, 5.480207767607509, 69.13349456471192, 83.03223578727517, 0.4436694999999998, 75.0, 483, 618387, 882, 14.446612899999309
883, 7.376131130655168, 69.09746616916502, 83.02796810843472, 0.4428405999999995, 390.0, 1359, 619746, 883, 41.030503099998896
884, 7.891646876968631, 69.23936598504608, 83.25556593085054, 0.44204995, 105.0, 398, 620144, 884, 11.87930310000047
885, 7.142400321553025, 69.22679240552685, 83.20716799965388, 0.4416930999999999, 45.0, 395, 620539, 885, 11.764164500000334
886, 9.028329662516866, 69.07631475499777, 83.05500031929122, 0.44102890000000045, 390.0, 1081, 621620, 886, 32.49908399999913
887, 9.644680325299502, 69.17881956481934, 83.16326103210449, 0.4400924499999996, 365.0, 1000, 622620, 887, 30.057284399999844
888, 10.173774067219346, 69.17169412374497, 83.21053050756454, 0.43935445, 155.0, 640, 623260, 888, 19.8483698
889, 8.759008654719027, 69.3413137663539, 83.35340181201573, 0.4388477499999998, 55.0, 486, 623746, 889, 14.822042300000248
890, 9.637690356019911, 69.08996100146031, 83.0982287929464, 0.4383145000000002, 105.0, 699, 624445, 890, 21.48534759999893
891, 10.420037983559906, 69.03331952198081, 83.01601053174213, 0.4377709000000001, 105.0, 509, 624954, 891, 15.118798600000446
892, 9.15629564512114, 69.20552576289458, 83.18598199091038, 0.4371134499999996, 155.0, 952, 625906, 892, 29.802919899999324
893, 6.923595976815602, 69.01006985601978, 82.92857993651774, 0.4362998500000001, 235.0, 856, 626762, 893, 26.46033659999921
894, 6.442908589323566, 69.04789571100152, 82.92431154226583, 0.43573960000000006, 95.0, 389, 627151, 894, 11.756904599998961
895, 9.840113537017883, 69.24393756944458, 83.25780266424697, 0.43510239999999994, 195.0, 1027, 628178, 895, 31.728303500000038
896, 6.273062159003578, 69.12666875612238, 83.0731463660781, 0.4343491, 170.0, 647, 628825, 896, 23.623483999999735
897, 8.501953956472946, 69.21562657820776, 83.21425298004453, 0.43360525000000005, 315.0, 1006, 629831, 897, 29.986547900000005
898, 10.090865199487597, 68.25243574329173, 82.08125375135533, 0.43278940000000027, 415.0, 807, 630638, 898, 23.741189499998654
899, 5.342352947156377, 67.90295659715885, 81.55732705659956, 0.43228180000000005, 30.0, 321, 630959, 899, 9.418854600000486
900, 6.888760868494117, 67.81830268533223, 81.46557074730549, 0.43184304999999984, 180.0, 654, 631613, 900, 21.477873899999395
901, 4.983985697197239, 67.96113597229935, 81.60134535313692, 0.43134220000000006, 80.0, 459, 632072, 901, 13.500988099998722
902, 10.353102540227807, 67.95429303868097, 81.74443520611597, 0.43091335000000003, 5.0, 494, 632566, 902, 14.372169700000086
903, 7.809857171321853, 67.88864361302237, 81.60474426826734, 0.4303706499999997, 135.0, 712, 633278, 903, 20.626086099999156
904, 7.077684714559567, 67.9043464725082, 81.5950235676121, 0.42978384999999997, 80.0, 592, 633870, 904, 17.878105300000243
905, 9.426748405742238, 67.88033447146972, 81.60495691610903, 0.42922809999999995, 135.0, 643, 634513, 905, 19.043057599999884
906, 8.089349801805742, 68.02903345849413, 81.76499974163896, 0.42854860000000017, 245.0, 867, 635380, 906, 25.059410699999717
907, 8.362966491904439, 67.96562691217737, 81.66136785579633, 0.42798069999999994, 50.0, 395, 635775, 907, 11.861316500000612
908, 7.2584820872620694, 68.01876845540879, 81.77072087541411, 0.4276251999999999, 70.0, 395, 636170, 908, 11.972545999999056
909, 11.793685049871387, 67.88085401576498, 81.69063449942547, 0.42728184999999996, 75.0, 368, 636538, 909, 11.944336100001237
910, 6.649206170098113, 67.83343348044495, 81.51935569351056, 0.4267747, 95.0, 759, 637297, 910, 22.81498300000021
911, 7.66515611016576, 67.94144905270554, 81.62623441715476, 0.4260330999999996, 195.0, 889, 638186, 911, 26.381497400001535
912, 6.587327096079077, 67.97762643328365, 81.6424106337269, 0.42534324999999995, 75.0, 644, 638830, 912, 19.929721300000892
913, 8.36115056023534, 68.0466861469405, 81.8029815412703, 0.4244486499999999, 465.0, 1344, 640174, 913, 39.84497999999985
914, 7.306645209901035, 68.53641248393703, 82.39010373966114, 0.42357744999999997, 40.0, 592, 640766, 914, 18.005286100000376
915, 9.337545241402314, 68.65414678522971, 82.55517276831432, 0.42290425000000015, 85.0, 904, 641670, 915, 28.365801300000385
916, 9.620663086340038, 68.52636753762162, 82.38806868871731, 0.4220757999999999, 460.0, 937, 642607, 916, 28.603330399999322
917, 7.242327889539505, 68.53980466707156, 82.38194748091567, 0.42148945, 75.0, 366, 642973, 917, 11.202863599999546
918, 9.646036915670418, 68.55557582838118, 82.41165707392899, 0.4210237, 65.0, 669, 643642, 918, 20.580205299998852
919, 7.029052209797896, 68.5074626850632, 82.28778487871278, 0.42036489999999976, 185.0, 795, 644437, 919, 23.716122699999687
920, 8.548392684312493, 68.4853007153767, 82.32118575165912, 0.41971194999999983, 75.0, 656, 645093, 920, 20.098411299999498
921, 5.698548888256127, 68.43512039380698, 82.19809768009921, 0.4192417, 50.0, 389, 645482, 921, 12.038749800000005
922, 9.078612742228295, 68.49694400616546, 82.359393173901, 0.41891590000000006, 15.0, 335, 645817, 922, 11.360568399999465
923, 7.813844426892421, 68.56681095264577, 82.42727582013165, 0.41846139999999993, 155.0, 675, 646492, 923, 20.937150300000212
924, 9.285321523930092, 68.5074068629777, 82.38816751995144, 0.41785434999999976, 65.0, 674, 647166, 924, 20.727654000000257
925, 7.80317573265715, 68.62002801371145, 82.64719608851841, 0.41738725, 15.0, 364, 647530, 925, 10.983936399999948
926, 7.290967244127018, 68.56442161127623, 82.34697306397473, 0.4170011499999998, 40.0, 494, 648024, 926, 15.178815899998881
927, 5.543136668663759, 68.43570817800669, 82.21090776492387, 0.41660335000000004, 50.0, 390, 648414, 927, 11.785406400000284
928, 6.313536676096659, 68.41255291298238, 82.17481740468129, 0.41567679999999996, 445.0, 1669, 650083, 928, 51.55887090000033
929, 10.677994409476169, 67.82914717039475, 81.59316851739251, 0.41464045000000005, 105.0, 634, 650717, 929, 19.296645699998408
930, 7.285673634375672, 67.69220792280662, 81.34261340063972, 0.41408874999999995, 120.0, 592, 651309, 930, 18.344146399998863
931, 7.759376964781487, 67.62981277637267, 81.21734235833965, 0.4135419999999998, 65.0, 623, 651932, 931, 19.209046099998886
932, 7.278778605124494, 67.59162216977134, 81.17356228210765, 0.4130879499999999, 55.0, 386, 652318, 932, 11.60088800000085
933, 6.3708463654260745, 67.63474202156067, 81.25306443301115, 0.41251825000000003, 150.0, 880, 653198, 933, 26.856266800001322
934, 8.365849889018412, 67.78124815184495, 81.48040831993366, 0.41186125000000007, 120.0, 580, 653778, 934, 19.09678669999994
935, 9.713481795526324, 67.7274148601752, 81.40956808053531, 0.41122585, 180.0, 832, 654610, 935, 29.168802800000776
936, 8.062904780578313, 67.74421215257304, 81.4137256070503, 0.4104221499999997, 265.0, 954, 655564, 936, 36.16085109999949
937, 7.268140910774149, 67.6659450267317, 81.31311969200404, 0.40969990000000023, 100.0, 651, 656215, 937, 21.058117700000366
938, 6.6485923146788695, 67.65741736341865, 81.22899161995231, 0.40919904999999973, 85.0, 462, 656677, 938, 14.142348800000036
939, 5.760012802207156, 67.64786651009007, 81.19302647239283, 0.40882015000000005, 60.0, 380, 657057, 939, 11.535111999999572
940, 9.129639998489264, 67.76288823984531, 81.48834726806994, 0.40833910000000007, 145.0, 689, 657746, 940, 21.605647799999133
941, 7.790192304348404, 67.68944610868182, 81.36102099232859, 0.4077518499999998, 90.0, 616, 658362, 941, 17.416563900000256
942, 6.491128175357299, 67.63040699486847, 81.22544628442758, 0.40694725, 370.0, 1172, 659534, 942, 33.223213499999474
943, 5.206245224184499, 67.2388280820207, 80.74740723383943, 0.40611790000000014, 160.0, 671, 660205, 943, 19.503695499999594
944, 6.067926519049822, 66.87391708749776, 80.36857668694898, 0.4053956500000001, 260.0, 934, 661139, 944, 26.35958699999901
945, 4.85590851895119, 66.90636828573126, 80.32779083251953, 0.40480435000000003, 80.0, 380, 661519, 945, 10.700017600000137
946, 7.821204461082899, 66.99553306571123, 80.5508443258711, 0.40422790000000003, 210.0, 901, 662420, 946, 25.62141039999915
947, 5.757280009117163, 66.84214402219497, 80.25336566403756, 0.4034700999999997, 125.0, 783, 663203, 947, 21.854937699999937
948, 7.054900496951125, 66.80744339747982, 80.23389930092827, 0.40295484999999986, 80.0, 362, 663565, 948, 10.28836229999979
949, 10.642584852149001, 66.96170306585532, 80.54785632918366, 0.40253769999999994, 110.0, 565, 664130, 949, 15.950954100000672
950, 5.796625123172999, 66.97032216787338, 80.49031108617783, 0.40199545000000014, 140.0, 640, 664770, 950, 18.606714600000487
951, 6.571015370774355, 66.84365578478138, 80.30156099982784, 0.4013335, 210.0, 831, 665601, 951, 25.89323290000175
952, 5.452622769097039, 66.88306034059453, 80.38159479891746, 0.40077999999999997, 50.0, 399, 666000, 952, 12.561950100000104
953, 7.514804105236765, 66.87329162573006, 80.38946317509418, 0.40032189999999995, 70.0, 619, 666619, 953, 19.483594499999526
954, 9.065361132917788, 66.8884360447826, 80.45079901778458, 0.3997081, 110.0, 745, 667364, 954, 23.416850699999486
955, 7.574028783740401, 66.97956080955629, 80.50366547624577, 0.39884770000000036, 345.0, 1167, 668531, 955, 37.894911299999876
956, 8.80910838245823, 66.92395039256678, 80.4727525368372, 0.39780909999999975, 300.0, 1141, 669672, 956, 35.79857170000105
957, 7.145010641397246, 66.30474014282227, 79.64942644362482, 0.39696040000000016, 185.0, 745, 670417, 957, 23.741394000000582
958, 6.241459171946456, 65.85394920338175, 79.07197915601252, 0.39631150000000004, 140.0, 697, 671114, 958, 21.978400899999542
959, 7.830180083395857, 65.89810808355158, 79.27225330237187, 0.39570085, 85.0, 660, 671774, 959, 21.068434299999353
960, 5.557495443266816, 65.97494972348213, 79.21671310663223, 0.3951158499999998, 125.0, 640, 672414, 960, 20.31615520000014
961, 8.221901827528358, 65.93494301873284, 79.24461433257657, 0.3943117, 325.0, 1147, 673561, 961, 36.73480970000128
962, 9.398886713052855, 65.96102252241228, 79.32270605080411, 0.3934207000000003, 190.0, 833, 674394, 962, 27.13189020000027
963, 8.953555297765877, 65.92676543503973, 79.25322735727315, 0.39254499999999987, 280.0, 1113, 675507, 963, 35.19078190000073
964, 6.233977431827058, 65.89468634157022, 79.14511117502727, 0.39185559999999997, 45.0, 419, 675926, 964, 13.967955599999186
965, 6.711424092143697, 65.92009182124175, 79.23493261608351, 0.3914929, 30.0, 387, 676313, 965, 12.464200099999289
966, 5.738297740149599, 65.96777888648963, 79.20373135482772, 0.39089439999999964, 180.0, 943, 677256, 966, 30.06027499999982
967, 7.000036923862476, 65.91731388448811, 79.20075057507705, 0.39009475, 95.0, 834, 678090, 967, 27.22848420000082
968, 7.510808144743507, 65.980594962746, 79.28694588035256, 0.38926899999999987, 160.0, 1001, 679091, 968, 32.42749830000139
969, 7.294205204565491, 65.81850635772267, 79.11495001841399, 0.38847339999999997, 175.0, 767, 679858, 969, 25.04615400000148
970, 7.299977160410253, 65.51917354789323, 78.74149959815476, 0.38797795, 35.0, 334, 680192, 970, 10.812689300000784
971, 8.32460459027596, 65.3985429049016, 78.5859699287491, 0.38737855000000004, 440.0, 998, 681190, 971, 32.36340040000141
972, 5.20124894980904, 65.24804983893745, 78.38645300190511, 0.38674179999999975, 50.0, 417, 681607, 972, 13.497357100000954
973, 7.6557373758884495, 65.2281678700411, 78.35647716897338, 0.3862567, 125.0, 661, 682268, 973, 21.598500199999762
974, 11.504659860336929, 65.39247876348007, 78.63999718419414, 0.3856339, 100.0, 723, 682991, 974, 23.36390399999982
975, 8.302174471122957, 65.22759334676232, 78.43833897397543, 0.38501739999999995, 105.0, 647, 683638, 975, 21.212103300000308
976, 7.330640658546646, 65.11599754741174, 78.19937646298008, 0.38454940000000015, 25.0, 393, 684031, 976, 12.809401900000012
977, 6.264381750171155, 65.17152948259809, 78.32028681862803, 0.38415745, 65.0, 478, 684509, 977, 15.584056600000622
978, 9.427624038464762, 65.32729590090713, 78.56569429077854, 0.3835531000000002, 315.0, 865, 685374, 978, 28.050612699998965
979, 7.032397631693424, 65.2158283479675, 78.3326802644867, 0.3824451999999999, 745.0, 1597, 686971, 979, 51.60043310000037
980, 6.97195162706905, 65.229969216264, 78.37497194426608, 0.3814308999999999, 135.0, 657, 687628, 980, 21.76835189999838
981, 5.985087206022666, 65.14723138793748, 78.2510635029748, 0.3808576000000001, 100.0, 617, 688245, 981, 20.18066379999982
982, 8.757535251733227, 65.26853987482112, 78.43336138122122, 0.38020285, 165.0, 838, 689083, 982, 27.31181039999865
983, 9.939146953728772, 65.21107259154012, 78.39815700639434, 0.37965159999999987, 80.0, 387, 689470, 983, 12.641897199999221
984, 8.042088814667466, 65.17115063946362, 78.35097982197924, 0.3791237499999999, 245.0, 786, 690256, 984, 25.877645000000484
985, 11.996472553885173, 64.84652487739685, 78.04850132049076, 0.3784865499999999, 80.0, 630, 690886, 985, 20.81900829999904
986, 5.365410139492477, 64.66310852119722, 77.66997821072498, 0.37790425, 80.0, 664, 691550, 986, 22.191991800000324
987, 6.349220680137538, 64.67911959145724, 77.66255195208528, 0.37732015, 130.0, 634, 692184, 987, 21.0906128000006
988, 5.478279933868957, 64.74036751438649, 77.76687487386498, 0.37660915, 200.0, 946, 693130, 988, 31.18093090000002
989, 7.551295351790433, 64.76561888363241, 77.8196324323622, 0.37588960000000005, 185.0, 653, 693783, 989, 21.573719699999856
990, 7.3695645453864085, 64.72498361738293, 77.77186607446994, 0.3752370999999999, 140.0, 797, 694580, 990, 26.507135899999412
991, 7.296647262282487, 64.66102324960954, 77.69921045602406, 0.37449100000000013, 210.0, 861, 695441, 991, 28.40220430000045
992, 9.65538968212869, 64.66591563074664, 77.79858138786442, 0.37380340000000006, 110.0, 667, 696108, 992, 22.028681899999356
993, 8.490238335051048, 64.66020862725179, 77.73517843511263, 0.3732796000000001, 25.0, 497, 696605, 993, 16.764122500000667
994, 6.2001841997514004, 64.6253634781134, 77.63869826520076, 0.37278144999999985, 60.0, 610, 697215, 994, 20.340688999998747
995, 6.212963170108495, 64.94258677852046, 78.01742999102618, 0.3722572, 65.0, 555, 697770, 995, 18.302475200000117
996, 8.02889953324428, 64.76497553265284, 77.90798644646911, 0.3716389000000001, 225.0, 819, 698589, 996, 27.259735400000864
997, 8.52299676927765, 64.70389176803886, 77.79196327172437, 0.37089955000000024, 135.0, 824, 699413, 997, 27.402658499999234
998, 7.615281629812704, 65.48946847818225, 78.7269240951971, 0.37013229999999997, 405.0, 881, 700294, 998, 29.670420899999954
999, 8.35499422499244, 67.10499389925151, 80.73724999699567, 0.36956214999999987, 75.0, 386, 700680, 999, 12.85805210000035
1000, 8.222992420593236, 67.09645157368132, 80.6202631615561, 0.36911799999999995, 100.0, 601, 701281, 1000, 20.05345440000019
1001, 8.574546113923976, 66.85010126013505, 80.34208135102925, 0.36867655000000005, 100.0, 380, 701661, 1001, 12.804632100000163
1002, 10.211575459533183, 67.22455751474264, 80.85256340419365, 0.36794575000000035, 300.0, 1244, 702905, 1002, 41.731630099999165
1003, 7.048117806682041, 67.06480425572984, 80.55922442015807, 0.36703989999999975, 215.0, 769, 703674, 1003, 26.04171519999909
1004, 7.187732291813438, 67.07552005416113, 80.57395096366287, 0.36637659999999983, 125.0, 705, 704379, 1004, 23.617169200000717
1005, 7.557071293569455, 67.10538954903458, 80.60219849548668, 0.36563949999999973, 140.0, 933, 705312, 1005, 31.37638650000008
1006, 8.63861143210148, 67.19580877436141, 80.8072699937593, 0.36482319999999996, 200.0, 881, 706193, 1006, 29.49057670000002
1007, 9.085168025479085, 67.21258080915426, 80.75749611122978, 0.36385480000000003, 620.0, 1271, 707464, 1007, 43.141137399999934
1008, 8.790878924660774, 67.08393588694246, 80.63435170980357, 0.36273969999999967, 510.0, 1207, 708671, 1008, 40.625828700000056
1009, 5.990961454772719, 67.22992012159068, 80.71005788363888, 0.3619171000000001, 90.0, 621, 709292, 1009, 21.153651499998887
1010, 9.261730920460264, 67.10152787677312, 80.67098880487647, 0.3614783499999999, 50.0, 354, 709646, 1010, 12.198850999999195
1011, 8.709198531383565, 67.38712333687839, 81.01170224700617, 0.3609217000000001, 435.0, 883, 710529, 1011, 29.706806800000777
1012, 13.211985207549871, 67.64235998581279, 81.41607685233244, 0.3603457, 65.0, 397, 710926, 1012, 13.841819499999474
1013, 8.183812289557991, 67.51600161642216, 81.13197382958488, 0.35981334999999987, 225.0, 786, 711712, 1013, 26.562644300000102
1014, 5.097005866991507, 67.58675835411827, 81.1434572237032, 0.3592099000000001, 135.0, 555, 712267, 1014, 18.802146800000628
1015, 9.606027141932783, 67.5405043832187, 81.20334819925243, 0.35869914999999986, 165.0, 580, 712847, 1015, 30.029360599999563
1016, 5.437422880946204, 67.63181870926257, 81.22857538267624, 0.35824465, 30.0, 430, 713277, 1016, 15.678536199999144
1017, 7.798488072312881, 67.45800280704677, 81.12081900623357, 0.3578104000000001, 80.0, 535, 713812, 1017, 20.321394399999917
1018, 8.19717362441934, 67.51648271673977, 81.12450980195905, 0.3572060499999998, 345.0, 808, 714620, 1018, 27.219175999998697
1019, 6.99675740175328, 67.3675411389597, 80.91933270183212, 0.35660349999999985, 95.0, 531, 715151, 1019, 17.91090980000081
1020, 8.201756960878502, 67.48894574448869, 81.108544921875, 0.3560315499999999, 230.0, 740, 715891, 1020, 25.10528019999947
1021, 8.077227311071598, 67.49583601987452, 81.151102258209, 0.3553992999999999, 130.0, 665, 716556, 1021, 22.42096020000099
1022, 6.902211348882821, 67.46248038580976, 81.04879166037115, 0.3546041499999999, 185.0, 1102, 717658, 1022, 37.385720300000685
1023, 5.8623395797639795, 67.60045928955078, 81.15769908640644, 0.35388099999999995, 70.0, 505, 718163, 1023, 17.174290400000245
1024, 8.17473972464702, 67.37129184155809, 81.00142551921036, 0.35309979999999974, 395.0, 1231, 719394, 1024, 42.357425899999726
1025, 7.188689902424812, 67.4208336907464, 81.06172164138015, 0.3520963, 245.0, 999, 720393, 1025, 34.39160559999982
1026, 8.255129022473238, 67.6403435160411, 81.36717284825137, 0.35114905000000035, 340.0, 1106, 721499, 1026, 38.20215740000094
1027, 7.243521262681921, 67.50307502546859, 81.09068945440322, 0.35047944999999997, 45.0, 382, 721881, 1027, 13.207667500000753
1028, 7.670120950580014, 67.54999177944586, 81.11540492276967, 0.35001775, 45.0, 644, 722525, 1028, 22.120616599999266
1029, 8.013973240661384, 67.52458974962683, 81.15823914884635, 0.34918299999999997, 610.0, 1211, 723736, 1029, 41.5512095999984
1030, 9.276803322211661, 67.4394044009122, 81.09285104154337, 0.34845985000000007, 20.0, 396, 724132, 1030, 13.622440600000118
1031, 8.235662820900595, 67.63636276333831, 81.31229235626931, 0.34789465, 300.0, 860, 724992, 1031, 30.326161399998455
1032, 9.167722127669387, 67.71967193815443, 81.40329185061985, 0.34734565, 35.0, 360, 725352, 1032, 12.493727600000057
1033, 8.414613035887012, 67.52879658690964, 81.165097966592, 0.3468115, 170.0, 827, 726179, 1033, 28.804357700000764
1034, 7.222177990845272, 67.63760837093814, 81.24197572142214, 0.34619364999999996, 135.0, 546, 726725, 1034, 19.075970400001097
1035, 7.929345936517286, 67.64567047375787, 81.35017179203325, 0.34565365, 125.0, 654, 727379, 1035, 22.76048230000015
1036, 10.845119575950662, 67.63001541154263, 81.3541084231564, 0.34494490000000005, 250.0, 921, 728300, 1036, 32.37763599999926
1037, 7.0101875210149975, 67.62681793914841, 81.20798254228825, 0.3439337500000002, 575.0, 1326, 729626, 1037, 53.067051199999696
1038, 8.140775911136897, 67.28492377922278, 80.8916619609086, 0.3430404999999999, 215.0, 659, 730285, 1038, 21.350040999999692
1039, 6.591679162466735, 66.75615150050113, 80.19411353395697, 0.3424874499999998, 50.0, 570, 730855, 1039, 17.795336499999394
1040, 5.800324709559705, 66.74136408085764, 80.15817127577249, 0.34176429999999974, 300.0, 1037, 731892, 1040, 32.60062420000031
1041, 7.305477065607613, 66.7909984738219, 80.28172456329943, 0.34106814999999985, 70.0, 510, 732402, 1041, 17.937621400000353
1042, 7.806957176277288, 66.69523979129647, 80.12234365133415, 0.3403598499999997, 190.0, 1064, 733466, 1042, 34.41020690000005
1043, 6.177067758807217, 66.67404089203801, 80.11386710477163, 0.3395822499999999, 125.0, 664, 734130, 1043, 22.185741499999494
1044, 7.569840017382619, 66.65822992727124, 80.10173412351395, 0.3389207499999998, 155.0, 806, 734936, 1044, 25.860986600000615
1045, 10.408653796126071, 66.93017346465231, 80.56871645844339, 0.3382119999999999, 155.0, 769, 735705, 1045, 25.058861100000286
1046, 8.085600793192652, 66.93500003922864, 80.41212348000539, 0.3373898499999997, 340.0, 1058, 736763, 1046, 44.56477819999964
1047, 6.785672157327064, 66.58344748879776, 80.01369010942594, 0.33671530000000005, 100.0, 441, 737204, 1047, 17.732895999999528
1048, 7.594058825778799, 66.6656598573649, 80.09986540812244, 0.33625269999999985, 85.0, 587, 737791, 1048, 23.863951100000122
1049, 6.180125608001695, 66.6856537732211, 80.05776700106534, 0.33569155, 210.0, 660, 738451, 1049, 26.679372000000512
1050, 6.306973689985878, 66.68522988404746, 80.07104173801288, 0.33493194999999987, 495.0, 1028, 739479, 1050, 42.2051205000007
1051, 6.948275071734895, 66.68721231143317, 80.14774388254047, 0.33402025, 345.0, 998, 740477, 1051, 42.016935399999056
1052, 5.199324151516979, 66.29417030790933, 79.60031001425197, 0.3333078999999998, 95.0, 585, 741062, 1052, 23.055819899998824
1053, 10.521852540465774, 66.55964705356858, 80.03808692230315, 0.3327413499999999, 115.0, 674, 741736, 1053, 25.219631899999513
1054, 9.030504221161504, 66.42444186424142, 79.84172375996907, 0.33207624999999985, 330.0, 804, 742540, 1054, 29.555510599999252
1055, 6.873259071633219, 66.50584029197692, 79.79821189880371, 0.33153445, 80.0, 400, 742940, 1055, 14.260715899999923
1056, 5.1544275403929305, 66.29925910601598, 79.58564183920508, 0.33111775, 65.0, 526, 743466, 1056, 20.301519200000257
1057, 9.626251762396864, 66.59454700353518, 80.00634491079721, 0.33039459999999965, 200.0, 1081, 744547, 1057, 45.6727105000009
1058, 5.210957251257609, 66.38989298260844, 79.70340693890503, 0.329662, 125.0, 547, 745094, 1058, 23.455326799999966
1059, 7.760167236707007, 66.36037824566667, 79.70043172515948, 0.32924169999999997, 75.0, 387, 745481, 1059, 20.94209690000025
1060, 9.102394735693476, 66.48287793555177, 79.91188303872687, 0.3285968500000003, 225.0, 1046, 746527, 1060, 38.11622630000056
1061, 9.471622553234006, 66.51133176859688, 79.976552140479, 0.32775894999999994, 210.0, 816, 747343, 1061, 34.85784339999918
1062, 9.5253691149169, 66.53934634965042, 79.98526051948811, 0.32718295, 75.0, 464, 747807, 1062, 15.77207350000026
1063, 6.939112985496363, 66.43361159055931, 79.78806068884074, 0.32681124999999994, 20.0, 362, 748169, 1063, 13.82832690000032
1064, 7.72809433864737, 66.3624237717934, 79.72754179389732, 0.3262775499999998, 240.0, 824, 748993, 1064, 28.61973620000026
1065, 4.979089693640263, 66.49064484185595, 79.82242505490991, 0.32565384999999986, 145.0, 562, 749555, 1065, 18.759367999999085
1066, 6.578251529624106, 65.96234806741421, 79.27196191653177, 0.32496714999999976, 200.0, 964, 750519, 1066, 36.17047889999958
1067, 6.678004487126471, 65.49132370085339, 78.69634268253887, 0.3239244999999999, 270.0, 1353, 751872, 1067, 46.43868629999997
1068, 9.884452513847615, 65.66774518650733, 78.95268684808462, 0.32302224999999996, 155.0, 652, 752524, 1068, 22.028110499999457
1069, 7.925918426200089, 65.51997337954111, 78.73902269539585, 0.32250474999999995, 55.0, 498, 753022, 1069, 18.791809100001046
1070, 6.247818170364073, 65.40279018277585, 78.53227917589136, 0.3219773499999999, 130.0, 674, 753696, 1070, 21.858486600000106
1071, 12.627546362940727, 65.64695618131834, 79.08561779701546, 0.3213126999999999, 170.0, 803, 754499, 1071, 26.87400870000056
1072, 5.593617590395813, 65.37780058119031, 78.4569823436248, 0.32068809999999986, 50.0, 585, 755084, 1072, 22.916316599999845
1073, 7.952874640495547, 65.46739236154863, 78.67795130411784, 0.32000634999999994, 280.0, 930, 756014, 1073, 35.477181799999016
1074, 6.133825954658339, 65.4467368258898, 78.62391708191647, 0.31936194999999995, 80.0, 502, 756516, 1074, 20.387425699998857
1075, 7.622863330751014, 65.47633702120335, 78.6848155508796, 0.31888584999999997, 105.0, 556, 757072, 1075, 22.672188900000037
1076, 6.942145127184228, 65.555884973234, 78.75850719737696, 0.31835935000000015, 75.0, 614, 757686, 1076, 23.25139660000059
1077, 6.876969796993556, 65.43978868467786, 78.60640026183242, 0.31772349999999994, 145.0, 799, 758485, 1077, 26.756236600000193
1078, 6.1745041180167455, 65.43457048545856, 78.64071780187957, 0.31700665, 295.0, 794, 759279, 1078, 30.912000499998612
1079, 6.526303504037765, 65.43623434850412, 78.57383049366086, 0.3164171499999998, 60.0, 516, 759795, 1079, 21.044650800000454
1080, 7.742360978847808, 65.15080666805707, 78.27958130798822, 0.3159000999999999, 110.0, 633, 760428, 1080, 22.090490700000373
1081, 7.831878099491388, 64.65363144965227, 77.65240475614715, 0.31526019999999993, 260.0, 789, 761217, 1081, 25.503293300000223
1082, 6.825881708500576, 64.66458723776317, 77.67426468456868, 0.31436695000000003, 190.0, 1196, 762413, 1082, 38.40174119999938
1083, 6.842657783477426, 64.73939872988694, 77.80880546569824, 0.31332835, 250.0, 1112, 763525, 1083, 35.689060199998494
1084, 6.26076011077162, 64.72571921275662, 77.75177964376748, 0.31253364999999994, 170.0, 654, 764179, 1084, 20.580476200000703
1085, 6.86949341879195, 64.80701421251233, 77.86836800799274, 0.31170295000000026, 540.0, 1192, 765371, 1085, 38.79984460000014
1086, 6.287525323642925, 64.71144078536467, 77.74794457175516, 0.3108497499999998, 110.0, 704, 766075, 1086, 24.693848799999614
1087, 7.030312512585526, 64.77194035401818, 77.85060649076168, 0.31030209999999997, 80.0, 513, 766588, 1087, 17.981809000000794
1088, 7.201500371957022, 64.80305785112421, 77.85724592012633, 0.30963384999999993, 305.0, 972, 767560, 1088, 33.06024500000058
1089, 5.366969273032912, 64.67302611937006, 77.60413473198213, 0.30904705, 20.0, 332, 767892, 1089, 11.4283265999984
1090, 6.743349554495509, 64.55983400488908, 77.53930113178725, 0.30859975, 160.0, 662, 768554, 1090, 23.50798720000057
1091, 8.152652425585561, 64.74567868891037, 77.83996672809698, 0.3077874999999998, 240.0, 1143, 769697, 1091, 37.54650539999966
1092, 7.956987939378079, 65.71978453776971, 78.94652387830946, 0.30697749999999996, 115.0, 657, 770354, 1092, 21.399864300001354
1093, 6.6040019634243015, 66.43411226945615, 79.7586374092356, 0.30634390000000006, 160.0, 751, 771105, 1093, 23.969615900001372
1094, 9.113997045428674, 66.4479549835145, 79.89498411227304, 0.30554785, 330.0, 1018, 772123, 1094, 32.35456079999858
1095, 6.235348562368551, 66.4152449430802, 79.78884045010238, 0.3048013, 95.0, 641, 772764, 1095, 20.96255999999994
1096, 7.213377818929575, 66.58562871484513, 79.9725510162267, 0.30435399999999996, 85.0, 353, 773117, 1096, 11.121158800000558
1097, 7.638543109915187, 66.4107863702675, 79.78974155933932, 0.30371859999999967, 380.0, 1059, 774176, 1097, 33.82572569999866
1098, 8.928758567899333, 66.36440082680417, 79.78622806089948, 0.3029392, 95.0, 673, 774849, 1098, 22.12550470000133
1099, 11.01773700257534, 66.65482484413485, 80.13079822709408, 0.30245364999999985, 105.0, 406, 775255, 1099, 13.62010730000111
1100, 8.578456432384959, 66.56203598087117, 80.00713919785063, 0.30184615, 200.0, 944, 776199, 1100, 35.4090099999994
1101, 7.535653593900235, 66.34338947949489, 79.7489561920447, 0.301177, 45.0, 543, 776742, 1101, 20.844836500000383
1102, 6.06129859290994, 66.46095009558711, 79.8370176616468, 0.30064195, 65.0, 646, 777388, 1102, 24.1543572999999
1103, 8.701175722530333, 66.4913752640259, 79.97473186198377, 0.3001123000000001, 135.0, 531, 777919, 1103, 20.36299809999946
1104, 6.717274156978002, 66.3849050991528, 79.75979507721222, 0.29927394999999996, 530.0, 1332, 779251, 1104, 50.001870100000815
1105, 8.413997993388865, 66.30520137340756, 79.70040828914233, 0.29829744999999985, 185.0, 838, 780089, 1105, 32.6379737999996
1106, 6.905269797398494, 66.58732431265024, 79.97956727247971, 0.2976278499999999, 145.0, 650, 780739, 1106, 24.853248199999143
1107, 8.715290495413885, 66.48995999650167, 79.871859807864, 0.2970468999999999, 115.0, 641, 781380, 1107, 24.68626099999892
1108, 7.587186438689372, 66.51728800047248, 79.91785954029037, 0.2962373500000001, 330.0, 1158, 782538, 1108, 43.92763610000111
1109, 6.126190837710844, 66.75826776962373, 80.17161532449205, 0.29534319999999986, 135.0, 829, 783367, 1109, 31.62747429999945
1110, 7.686771044279704, 66.58249424882077, 80.00050677528864, 0.29454355, 255.0, 948, 784315, 1110, 35.70382989999962
1111, 5.408203324653484, 66.62049091480397, 79.9625996794524, 0.2938132, 200.0, 675, 784990, 1111, 26.3050463999989
1112, 8.788922278807973, 66.51051488462484, 79.94265874826684, 0.29312785, 385.0, 848, 785838, 1112, 32.060737300000255
1113, 6.191080457202286, 66.52502788335443, 79.89367980550672, 0.29240829999999995, 105.0, 751, 786589, 1113, 28.762757899999997
1114, 6.2269609411191285, 66.54057051838818, 79.87412648706392, 0.29177739999999996, 125.0, 651, 787240, 1114, 24.558371799999804
1115, 6.77390326877405, 66.46083654325777, 79.81252972116629, 0.2908895499999999, 635.0, 1322, 788562, 1115, 50.42029100000036
1116, 7.674430242501319, 66.66619873046875, 80.14060662909698, 0.28993059999999987, 265.0, 809, 789371, 1116, 30.502835200000845
1117, 11.144744092933378, 66.49251817367048, 80.00575497345983, 0.28905085, 440.0, 1146, 790517, 1117, 43.0392740999996
1118, 4.997565891965162, 66.24351058047041, 79.50773471712726, 0.28821925, 120.0, 702, 791219, 1118, 26.802205500000127
1119, 9.304542706960225, 66.0088976065951, 79.35149742217652, 0.28767744999999983, 50.0, 502, 791721, 1119, 19.127465500001563
1120, 7.465708896299021, 66.3011001271939, 79.65995119427322, 0.28696104999999983, 365.0, 1090, 792811, 1120, 41.56640750000042
1121, 9.128461987271573, 66.34218440532221, 79.7292036765068, 0.2860066, 225.0, 1031, 793842, 1121, 39.44533530000081
1122, 6.190158757235954, 66.21707992771279, 79.51607443805884, 0.28506925000000005, 530.0, 1052, 794894, 1122, 41.198299400000906
1123, 7.224300214422589, 66.25815880080738, 79.57937673862547, 0.2844235, 60.0, 383, 795277, 1123, 14.858997299999828
1124, 6.055129826675321, 66.20158201040223, 79.53736549200013, 0.2840963499999999, 50.0, 344, 795621, 1124, 13.346784400000615
1125, 10.57085531700344, 66.18102208482033, 79.5579368631253, 0.28368370000000004, 135.0, 573, 796194, 1125, 21.83923760000107
1126, 8.065481175832888, 66.34285732477653, 79.67256540410659, 0.28299744999999993, 145.0, 952, 797146, 1126, 36.32452939999894
1127, 7.930364543417605, 66.38179604600116, 79.78689024390243, 0.2822000499999999, 100.0, 820, 797966, 1127, 31.22612570000092
1128, 6.763138001853565, 66.21497018778099, 79.55929372535562, 0.28123479999999973, 795.0, 1325, 799291, 1128, 51.08128260000012
1129, 6.255062002044899, 65.81455671258193, 79.01796084107713, 0.2801619999999999, 310.0, 1059, 800350, 1129, 40.69316400000025
1130, 7.013532659507567, 65.2034192977413, 78.34019045265772, 0.2794762, 90.0, 465, 800815, 1130, 17.895195899998726
1131, 9.298386767246695, 65.13975844272348, 78.23880645840667, 0.27911215, 75.0, 344, 801159, 1131, 13.528002200000628
1132, 4.858110864887411, 65.08216478047746, 78.1528955952505, 0.2786369499999999, 110.0, 712, 801871, 1132, 27.53438189999906
1133, 4.67851677815405, 65.01697565348975, 78.05169069889389, 0.2780974, 25.0, 487, 802358, 1133, 18.932707100000698
1134, 8.24688406318219, 65.12446987451366, 78.26894555948934, 0.27697194999999974, 745.0, 2014, 804372, 1134, 79.13576430000103
1135, 5.510389433535593, 65.07605651399497, 78.17363866034542, 0.2756439999999999, 145.0, 937, 805309, 1135, 34.98404189999928
1136, 8.2618382274129, 65.14713875478691, 78.33949982788286, 0.27494739999999984, 50.0, 611, 805920, 1136, 23.12222920000022
1137, 7.711460266133835, 65.19131175220241, 78.38734034103452, 0.27443755000000003, 95.0, 522, 806442, 1137, 17.600901100000556
1138, 5.173870629115381, 64.89089540122212, 77.90635013303896, 0.27389215, 320.0, 690, 807132, 1138, 23.608293100000083
1139, 12.626526078204034, 65.11055371996383, 78.34182341669647, 0.27342189999999994, 50.0, 355, 807487, 1139, 12.76784939999925
1140, 8.260467332358264, 65.07881788526262, 78.23914229723871, 0.27282114999999985, 365.0, 980, 808467, 1140, 36.22658099999899
1141, 5.842569522928859, 65.15019954598995, 78.2556767154679, 0.27202600000000005, 130.0, 787, 809254, 1141, 28.558415499999683
1142, 8.150524601075972, 64.81183656832067, 77.87018150448006, 0.27126595, 170.0, 902, 810156, 1142, 34.962943699998505
1143, 6.040104040110758, 64.31943311370928, 77.22645050364255, 0.27051175000000005, 165.0, 774, 810930, 1143, 28.132620399999723
1144, 6.679231486181011, 64.36953806215661, 77.3256745194641, 0.26979040000000004, 300.0, 829, 811759, 1144, 30.143190599999798
1145, 6.160592081107471, 64.46316157101212, 77.43719747473777, 0.2691829, 35.0, 521, 812280, 1145, 23.26826340000116
1146, 6.538736366779098, 64.293180521614, 77.28704602865909, 0.26867214999999983, 135.0, 614, 812894, 1146, 27.45231380000041
1147, 7.435383065872722, 64.49303919148241, 77.48765312260032, 0.26786934999999995, 270.0, 1170, 814064, 1147, 51.86600620000172
1148, 6.680967306185106, 64.41208111748398, 77.35474667139133, 0.2669608, 295.0, 849, 814913, 1148, 30.962341300000844
1149, 8.84526130828617, 64.45025916015737, 77.46726478061447, 0.26609229999999984, 175.0, 1081, 815994, 1149, 39.45889449999959
1150, 7.313302746619993, 64.40602978128356, 77.39604929780928, 0.2649249999999999, 390.0, 1513, 817507, 1150, 56.524566199997935
1151, 6.425218030399547, 64.47595363033744, 77.40172664862229, 0.2640646, 50.0, 399, 817906, 1151, 15.025401599999896
1152, 7.024750207823918, 64.5588744887732, 77.5336611946125, 0.2637054999999999, 30.0, 399, 818305, 1152, 14.282031499998993
1153, 7.9899133294820786, 64.34403228133378, 77.30951283522232, 0.2632518999999999, 70.0, 609, 818914, 1153, 22.440879300000233
1154, 5.822783060827243, 64.25712662834495, 77.18589338245566, 0.26263179999999997, 200.0, 769, 819683, 1154, 29.608969400000205
1155, 8.357346504351154, 63.844829245438405, 76.74261188907447, 0.26174979999999987, 150.0, 1191, 820874, 1155, 49.75023929999952
1156, 6.466147158920765, 63.47066252136231, 76.27250074768067, 0.2609888499999999, 50.0, 500, 821374, 1156, 18.191381199998432
1157, 8.51742483817146, 63.631050153517386, 76.45036545605727, 0.26025264999999975, 360.0, 1136, 822510, 1157, 42.93333600000187
1158, 8.564600116740804, 63.46762597030551, 76.30980368047895, 0.2595088, 110.0, 517, 823027, 1158, 19.199310399999376
1159, 6.882597299490237, 63.7092286528963, 76.50305740761034, 0.25903855, 115.0, 528, 823555, 1159, 18.020722900000692
1160, 7.807145821327337, 63.66597501293416, 76.50396731269919, 0.25855164999999997, 55.0, 554, 824109, 1160, 20.22424740000133
1161, 6.927131157954002, 63.545183966391065, 76.33873656920366, 0.2578987000000001, 255.0, 897, 825006, 1161, 31.1437302000013
1162, 9.882078674187888, 63.60562148202276, 76.47081178141481, 0.25731640000000006, 65.0, 397, 825403, 1162, 13.692955900001834
1163, 5.447548926676555, 63.60482267553589, 76.34812224313114, 0.2567772999999999, 365.0, 801, 826204, 1163, 27.99164540000129
1164, 6.41636738125668, 63.50487375481184, 76.31099260315415, 0.25583634999999993, 595.0, 1290, 827494, 1164, 44.621132500000385
1165, 7.924660392170691, 63.62033530150757, 76.48878242787946, 0.25489539999999994, 105.0, 801, 828295, 1165, 30.752658900000824
1166, 8.49127196952672, 63.60066906703001, 76.40145638820523, 0.2543014, 30.0, 519, 828814, 1166, 22.11861510000017
1167, 4.933680378234208, 63.65162208898744, 76.44738659455409, 0.2538869499999999, 70.0, 402, 829216, 1167, 16.76334769999812
1168, 7.202312283003281, 63.45521037568771, 76.27607245896579, 0.2532686499999999, 165.0, 972, 830188, 1168, 38.81513930000074
1169, 7.138473148303058, 63.04489249056996, 75.70887892888481, 0.25258734999999993, 150.0, 542, 830730, 1169, 22.462816600000224
1170, 6.830099778102456, 62.97333848096606, 75.66473717214147, 0.25190559999999984, 210.0, 973, 831703, 1170, 39.97357380000176
1171, 7.336664929842621, 63.02934551960004, 75.72994468662748, 0.25081299999999995, 460.0, 1455, 833158, 1171, 60.7115881000027
1172, 8.660277512762185, 63.085264411661264, 75.8960210322462, 0.24991209999999994, 50.0, 547, 833705, 1172, 22.105186400000093
1173, 9.937482358173655, 63.12519424046452, 75.8219969979388, 0.24943824999999994, 80.0, 506, 834211, 1173, 20.698963200000435
1174, 6.373827666854081, 62.894796157228775, 75.52916244838549, 0.24871375000000004, 150.0, 1104, 835315, 1174, 44.15090269999928
1175, 11.296373247280869, 63.15362985459462, 75.95083876102859, 0.2477750499999999, 300.0, 982, 836297, 1175, 34.035986499999126
1176, 8.712269079531634, 63.08529948922585, 75.80897482656835, 0.2470100499999999, 225.0, 718, 837015, 1176, 25.183165200000076
1177, 7.130639934642884, 63.11396161565241, 75.81272547499938, 0.24640074999999997, 95.0, 636, 837651, 1177, 22.001713099998597
1178, 8.681034003716542, 63.04990510232584, 75.84284431202096, 0.24580539999999998, 185.0, 687, 838338, 1178, 24.031546099999105
1179, 8.463318225710442, 63.039076805114746, 75.81666326065795, 0.24493284999999987, 615.0, 1252, 839590, 1179, 43.79761050000161
1180, 11.287220469420163, 63.78295625793735, 76.78035803231919, 0.24407289999999982, 90.0, 659, 840249, 1180, 23.027148599998327
1181, 6.156024246770917, 64.70970174192472, 77.72322133770426, 0.24348159999999983, 65.0, 655, 840904, 1181, 25.98012650000237
1182, 5.367145327019592, 64.67722327453868, 77.64496280420805, 0.24286329999999992, 190.0, 719, 841623, 1182, 29.50120650000099
1183, 6.706483982407988, 64.69358240888624, 77.69118072810431, 0.24208299999999985, 205.0, 1015, 842638, 1183, 41.505553099999815
1184, 7.788088178373056, 64.58007652657408, 77.65104728706703, 0.24119559999999998, 145.0, 957, 843595, 1184, 39.90365219999876
1185, 6.289422138962455, 64.6790989454471, 77.71988460331949, 0.24018130000000013, 395.0, 1297, 844892, 1185, 53.19277990000046
1186, 5.120337232512446, 64.71970687373992, 77.68863913540467, 0.23930469999999995, 145.0, 651, 845543, 1186, 26.70243980000305
1187, 6.658343566329785, 64.61223292004463, 77.62798551420926, 0.2386089999999999, 180.0, 895, 846438, 1187, 37.17659989999811
1188, 8.941675768573495, 64.66212462817921, 77.69092332054586, 0.23790024999999987, 175.0, 680, 847118, 1188, 28.00402480000048
1189, 7.373469507400035, 64.63563706364884, 77.7028840533994, 0.23734809999999998, 85.0, 547, 847665, 1189, 22.719982399998116
1190, 6.924481703951495, 64.63500956396699, 77.70370800673699, 0.23659119999999992, 195.0, 1135, 848800, 1190, 46.59520649999831
1191, 6.978576022020085, 64.60100184297475, 77.65130026129228, 0.23583159999999997, 10.0, 553, 849353, 1191, 23.206969899998512
1192, 6.243998539762562, 64.56490454600657, 77.53583906131465, 0.23531859999999996, 125.0, 587, 849940, 1192, 24.15794630000164
1193, 7.362047094106674, 64.14229927810968, 77.10879328110639, 0.23482494999999992, 95.0, 510, 850450, 1193, 21.334056200001214
1194, 6.5343715158858515, 64.12829453917756, 77.08398915433335, 0.23443884999999992, 50.0, 348, 850798, 1194, 14.310620500000368
1195, 5.677564967846133, 64.13401323823174, 77.05659677564483, 0.23402034999999996, 145.0, 582, 851380, 1195, 24.464619900001708
1196, 7.847927883127267, 64.31951787105548, 77.31787322232715, 0.2333278, 265.0, 957, 852337, 1196, 39.82467099999849
1197, 8.53153780730147, 64.13659473372857, 77.09124405277885, 0.23267484999999996, 55.0, 494, 852831, 1197, 20.60911599999963
1198, 6.394982282406702, 64.25687982754445, 77.23684978334923, 0.23216679999999987, 80.0, 635, 853466, 1198, 26.96850970000014
1199, 6.250682860035305, 64.1696496317861, 77.10185174670946, 0.23153274999999987, 180.0, 774, 854240, 1199, 32.0587775999993
1200, 7.399997031724721, 64.24378373668189, 77.24336917330358, 0.23092389999999993, 60.0, 579, 854819, 1200, 24.491868500001146
1201, 7.19477473642944, 64.03857205542016, 76.96931832445378, 0.23021739999999988, 210.0, 991, 855810, 1201, 41.32481839999673
1202, 7.986374214185136, 64.06727326529366, 77.03910761151995, 0.22945644999999992, 110.0, 700, 856510, 1202, 29.407861800002138
1203, 7.359176413923348, 64.28536478348964, 77.25092940256386, 0.2289677499999999, 70.0, 386, 856896, 1203, 16.43677590000152
1204, 7.011711688302223, 64.13382648971846, 77.06945258566418, 0.22850784999999996, 180.0, 636, 857532, 1204, 26.762266500001715
1205, 7.2080565696060654, 64.2382023010254, 77.16715544128418, 0.22799664999999994, 90.0, 500, 858032, 1205, 21.11939269999857
1206, 6.298652943856311, 64.10703528062352, 76.98396992953319, 0.22729464999999993, 260.0, 1060, 859092, 1206, 44.92662709999786
1207, 8.373865317262892, 64.16034269439085, 77.13569226509213, 0.22641354999999994, 330.0, 898, 859990, 1207, 37.80323599999974
1208, 6.647531505320177, 64.26062404514775, 77.1940696335745, 0.2252516499999998, 455.0, 1684, 861674, 1208, 70.95947789999991
1209, 11.133217997645506, 64.29082057456009, 77.33516848588191, 0.22406545000000005, 355.0, 952, 862626, 1209, 40.1999470999981
1210, 5.969109270873108, 64.34047821866787, 77.28215002044429, 0.2231942499999999, 230.0, 984, 863610, 1210, 41.363981200000126
1211, 8.558444068642558, 64.34014091977647, 77.30109332625274, 0.22246884999999994, 140.0, 628, 864238, 1211, 26.551259899999422
1212, 6.008285061698261, 64.36327841794129, 77.31234943746045, 0.2217861999999999, 405.0, 889, 865127, 1212, 37.67912770000112
1213, 7.475182694693406, 64.27291840235392, 77.235695215861, 0.22111614999999996, 80.0, 600, 865727, 1213, 25.29324919999999
1214, 5.998085375382027, 64.14695859559825, 77.04131367643114, 0.22052664999999994, 340.0, 710, 866437, 1214, 30.29171150000184
1215, 6.847563761450294, 64.35086851765338, 77.35352492941949, 0.2199079, 100.0, 665, 867102, 1215, 28.17964380000194
1216, 9.335397579405303, 64.15504342399552, 77.06455044849449, 0.21937959999999995, 70.0, 509, 867611, 1216, 21.52606800000285
1217, 6.013913582429314, 64.29734730211581, 77.2153572057464, 0.21860244999999998, 345.0, 1218, 868829, 1217, 51.74842450000142
1218, 7.525381971382704, 64.37017941084065, 77.38920844239615, 0.21764259999999996, 245.0, 915, 869744, 1218, 38.91192580000279
1219, 9.913362254363221, 64.6851483816778, 77.80709138374736, 0.21685149999999997, 220.0, 843, 870587, 1219, 36.08737839999958
1220, 6.612042505154765, 64.73683874859073, 77.77540949379525, 0.21619539999999995, 265.0, 615, 871202, 1220, 26.40973809999923
1221, 7.3544454932069545, 64.88951917795035, 77.94068424518292, 0.21573144999999994, 40.0, 416, 871618, 1221, 17.816883600000438
1222, 8.142689576832591, 64.8243827404732, 77.85862230502224, 0.21513069999999998, 160.0, 919, 872537, 1222, 39.37200269999812
1223, 7.647944999133128, 64.86049230797703, 77.97706464591275, 0.21426895, 160.0, 996, 873533, 1223, 42.74985000000015
1224, 8.683012398835775, 64.73299251247097, 77.81101070094753, 0.21365425, 85.0, 370, 873903, 1224, 16.06889880000017
1225, 8.036757422543417, 64.82942473455111, 77.92007975298338, 0.21300489999999994, 425.0, 1073, 874976, 1225, 46.07913879999978
1226, 7.204122517126266, 64.88275218125605, 77.953635339347, 0.21187269999999997, 455.0, 1443, 876419, 1226, 62.321979100001045
1227, 5.687517466647102, 64.85920419947986, 77.8373141854842, 0.21080259999999998, 245.0, 935, 877354, 1227, 40.70609200000035
1228, 7.308508842457993, 64.98355551635133, 78.15029249060318, 0.21002139999999997, 170.0, 801, 878155, 1228, 34.358000000000175
1229, 9.035459679328309, 64.72891250681103, 77.80868130526181, 0.20936979999999997, 150.0, 647, 878802, 1229, 28.04643539999961
1230, 8.087220041240965, 64.87281808712213, 77.95343883495613, 0.20862189999999997, 350.0, 1015, 879817, 1230, 43.68423800000164
1231, 4.388546866296375, 64.23618855449439, 77.07541143557447, 0.20800584999999996, 25.0, 354, 880171, 1231, 15.450665899999876
1232, 8.507258807546725, 64.01830639102594, 76.91953932599324, 0.20756979999999994, 80.0, 615, 880786, 1232, 26.554209199999605
1233, 7.513492659484656, 63.9892428898605, 76.85632683178461, 0.20672109999999994, 345.0, 1271, 882057, 1233, 55.70617019999918
1234, 7.511389104125436, 63.94420947284424, 76.78273564834124, 0.20592999999999997, 60.0, 487, 882544, 1234, 20.99199079999744
1235, 8.479984641163133, 63.94012738025095, 76.8681383358212, 0.20548224999999992, 105.0, 508, 883052, 1235, 22.612177099999826
1236, 6.265265862292391, 64.03943122925797, 76.91346446711843, 0.20470015, 195.0, 1230, 884282, 1236, 53.995898700002726
1237, 6.925723860279108, 63.8316551722013, 76.67663454398131, 0.20372545000000003, 215.0, 936, 885218, 1237, 40.837839600000734
1238, 9.326565897685155, 64.08053084738386, 76.9987713976305, 0.20316429999999994, 20.0, 311, 885529, 1238, 13.95844120000038
1239, 6.930492120498867, 64.0000828704393, 76.86637419772286, 0.20271294999999995, 190.0, 692, 886221, 1239, 30.11365569999907
1240, 5.45197697159122, 63.961222529106436, 76.77448573197854, 0.20222559999999992, 15.0, 391, 886612, 1240, 17.250434999998106
1241, 8.031778231104637, 63.991416400206006, 76.89314318717794, 0.20154204999999997, 325.0, 1128, 887740, 1241, 49.2380301000012
1242, 9.118019594854982, 64.16801003608995, 77.17635958140133, 0.2007397, 115.0, 655, 888395, 1242, 29.02012560000003
1243, 9.090597805052909, 64.04621361618265, 76.98427403124073, 0.19998279999999993, 235.0, 1027, 889422, 1243, 45.355768599998555
1244, 10.081248927950025, 64.07236573546083, 77.04683726917614, 0.1991988999999999, 30.0, 715, 890137, 1244, 31.86580729999696
1245, 6.698693186007486, 63.42869234501794, 76.21045205715146, 0.19851669999999988, 200.0, 801, 890938, 1245, 35.45601449999958
1246, 8.265684686686605, 63.50485122313193, 76.33360767364502, 0.19776384999999985, 250.0, 872, 891810, 1246, 38.95566880000115
1247, 7.801768502949221, 63.64320397755456, 76.49555132925566, 0.1968894999999999, 415.0, 1071, 892881, 1247, 47.717074299998785
1248, 10.46494885949278, 63.63963783022915, 76.56340002730902, 0.19617984999999996, 95.0, 506, 893387, 1248, 22.515547399998468
1249, 6.494028877810839, 63.49859490777214, 76.24234596627657, 0.19543059999999995, 300.0, 1159, 894546, 1249, 51.28218679999918
1250, 9.441180992469262, 63.53728783298546, 76.42851261801563, 0.19452564999999994, 245.0, 852, 895398, 1250, 37.82468700000027
1251, 6.1081321715542165, 63.42980593672846, 76.18672052641887, 0.1936872999999999, 320.0, 1011, 896409, 1251, 45.047488899999735
1252, 5.321362128366774, 63.49831877083614, 76.26703829100464, 0.19293219999999997, 135.0, 667, 897076, 1252, 30.111106699998345
1253, 7.684203447129012, 63.36560656279132, 76.14270676589352, 0.19228509999999993, 260.0, 771, 897847, 1253, 34.08809499999916
1254, 6.834449383464727, 63.36618449263139, 76.11296280739523, 0.19131939999999995, 580.0, 1375, 899222, 1254, 61.786272800000006
1255, 7.311368214915993, 63.589328964465096, 76.39809880287683, 0.19028574999999995, 245.0, 922, 900144, 1255, 41.30363959999886
1256, 11.556969985442677, 64.31980556802651, 77.3698544256466, 0.1896962499999999, 90.0, 388, 900532, 1256, 17.35868670000127
1257, 4.6127032302841755, 64.1614833479168, 77.06039802700866, 0.18936099999999992, 75.0, 357, 900889, 1257, 16.02413499999966
1258, 8.35412255777806, 64.14991373355294, 77.0829735743253, 0.1887260499999999, 360.0, 1054, 901943, 1258, 47.61116000000038
1259, 6.5931327645212345, 64.1707785558804, 77.0463537269973, 0.1878368499999999, 225.0, 922, 902865, 1259, 41.18716580000182
1260, 4.716679296786746, 64.20691494787893, 77.10310809843001, 0.18719874999999997, 110.0, 496, 903361, 1260, 22.445445800000016
1261, 7.16659592549128, 64.25299526284809, 77.25232802627033, 0.1865354499999999, 460.0, 978, 904339, 1261, 44.38857509999798
1262, 8.794380927929248, 64.30384198963547, 77.27852420776561, 0.18581229999999987, 140.0, 629, 904968, 1262, 28.48763870000039
1263, 7.6970212220978205, 64.25322084748343, 77.2053708647457, 0.18496854999999998, 485.0, 1246, 906214, 1263, 56.467431699999
1264, 4.458449984406865, 64.2921594389333, 77.19831912149519, 0.18413964999999993, 135.0, 596, 906810, 1264, 26.988036500002636
1265, 9.022395059710643, 64.25845952744972, 77.25158278072932, 0.18329499999999996, 235.0, 1281, 908091, 1265, 58.6979124999998
1266, 4.715129414548254, 64.05874516611142, 76.86070181329154, 0.18251784999999993, 135.0, 446, 908537, 1266, 20.488284099999873
1267, 8.254557989695865, 64.3311663438689, 77.26260896898665, 0.18193555, 185.0, 848, 909385, 1267, 39.08739609999975
1268, 7.730761281067205, 64.24689503774269, 77.20075520062478, 0.18122139999999998, 115.0, 739, 910124, 1268, 34.29387190000125
1269, 7.81894975478766, 64.24628601489613, 77.20892566604753, 0.18039294999999994, 245.0, 1102, 911226, 1269, 50.527875399999175
1270, 5.346723010836298, 64.21002340594234, 77.08090923432995, 0.17935569999999998, 365.0, 1203, 912429, 1270, 55.152388899998186
1271, 6.7699815299013535, 64.18951215675409, 77.10938554942179, 0.17850159999999995, 70.0, 695, 913124, 1271, 32.09771190000174
1272, 6.7564305116127175, 64.3559458352686, 77.35897966710533, 0.1779674499999999, 25.0, 492, 913616, 1272, 22.424724599997717
1273, 5.144161158022674, 64.11821132604626, 76.98210682523424, 0.17743554999999991, 170.0, 690, 914306, 1273, 31.684689400000934
1274, 8.18464009487233, 64.20796358335268, 77.1998385382699, 0.17661024999999997, 390.0, 1144, 915450, 1274, 52.38806979999936
1275, 7.312467353104289, 64.12251384574246, 77.04706398837537, 0.17579664999999992, 210.0, 664, 916114, 1275, 34.939335899998696
1276, 8.320966416927424, 64.26874071922676, 77.22355075301876, 0.17522154999999992, 105.0, 614, 916728, 1276, 35.984920999999304
1277, 7.585769875428375, 64.2753389015968, 77.2112981328042, 0.17452179999999984, 475.0, 941, 917669, 1277, 46.3729373999995
1278, 5.884563789898731, 64.30518058522043, 77.21623649672112, 0.17364025000000002, 260.0, 1018, 918687, 1278, 46.68663870000091
1279, 8.108444653510388, 64.20289557794982, 77.14468095272402, 0.1726133499999999, 240.0, 1264, 919951, 1279, 58.12626440000167
1280, 6.013124031533382, 63.939289886794406, 76.73273263577215, 0.17174394999999992, 85.0, 668, 920619, 1280, 30.88021110000045
1281, 6.482128025175724, 63.88523295798836, 76.70127938865937, 0.17096904999999993, 250.0, 1054, 921673, 1281, 49.02141389999815
1282, 7.3818260203626815, 63.79709301138283, 76.66935866506476, 0.17019549999999992, 205.0, 665, 922338, 1282, 32.23814080000011
1283, 7.302065603882292, 63.921471842909625, 76.82113296709856, 0.1695888999999999, 155.0, 683, 923021, 1283, 31.537703000001784
1284, 9.91425827860224, 63.92119923416449, 76.90701924538126, 0.1691051499999999, 60.0, 392, 923413, 1284, 18.137019900001178
1285, 10.263523004967489, 64.08288261507764, 77.08846337589218, 0.1687465, 90.0, 405, 923818, 1285, 18.818271000000095
1286, 5.934640613633722, 63.86297357331191, 76.7157261394233, 0.16808995000000002, 225.0, 1054, 924872, 1286, 49.21714619999693
1287, 6.824530901717502, 63.82150260261867, 76.65759137003717, 0.16734654999999996, 125.0, 598, 925470, 1287, 27.279548200000136
1288, 8.986313534975052, 63.82252154442572, 76.76455372471963, 0.16672869999999992, 185.0, 775, 926245, 1288, 29.907689099996787
1289, 5.696672954885898, 63.8466796123672, 76.63554707444344, 0.1658773, 350.0, 1117, 927362, 1289, 44.167559400000755
1290, 5.587692285196966, 63.78100102827214, 76.57256778332713, 0.16483419999999988, 465.0, 1201, 928563, 1290, 46.85236850000001
1291, 5.8374562037877356, 63.818648755928656, 76.65148240311623, 0.1637974, 320.0, 1103, 929666, 1291, 42.88843800000177
1292, 7.464842972103377, 63.26822444263009, 76.01124831594888, 0.16284609999999997, 300.0, 1011, 930677, 1292, 39.721743300000526
1293, 5.766736979844748, 63.099986668332335, 75.77417111788628, 0.16203519999999996, 205.0, 791, 931468, 1293, 31.071056299999327
1294, 4.5855141493378495, 63.19031410620957, 75.85981752506639, 0.16150914999999993, 50.0, 378, 931846, 1294, 14.843424799997592
1295, 7.201737647736445, 63.13162553310394, 75.8699630022049, 0.16105104999999992, 165.0, 640, 932486, 1295, 24.99806239999816
1296, 8.54534015891548, 63.13822326595115, 75.89809070401789, 0.1602352, 410.0, 1173, 933659, 1296, 46.113517999998294
1297, 10.820017899475506, 63.127154340696094, 75.90725038998092, 0.15934914999999997, 95.0, 796, 934455, 1297, 31.20452899999873
1298, 6.228898192291658, 62.983731780627934, 75.59447494601318, 0.15870024999999996, 100.0, 646, 935101, 1298, 25.53524969999853
1299, 6.7961205469472095, 63.17382187730684, 75.88961886108078, 0.1578951999999999, 400.0, 1143, 936244, 1299, 45.32713770000191
1300, 6.43194823684656, 63.12443774173644, 75.84217059900072, 0.1570266999999999, 140.0, 787, 937031, 1300, 31.55535830000008
1301, 6.734874082176514, 63.23240108614654, 75.99761612836052, 0.15632829999999992, 135.0, 765, 937796, 1301, 30.215523300001223
1302, 6.572753913049915, 63.11086813256896, 75.78273471020537, 0.15561819999999993, 180.0, 813, 938609, 1302, 32.31602539999949
1303, 6.008189883682391, 63.09619765488998, 75.7672571596892, 0.15483834999999987, 240.0, 920, 939529, 1303, 36.75151370000094
1304, 6.144143131095916, 62.990777901240754, 75.65395228068034, 0.15412194999999995, 140.0, 672, 940201, 1304, 26.69677800000136
1305, 8.406649600190576, 63.145895190536976, 75.92193302512169, 0.15358914999999995, 135.0, 512, 940713, 1305, 20.17216819999885
1306, 8.121405538479717, 63.13499279603557, 75.88228582816824, 0.15304869999999998, 210.0, 689, 941402, 1306, 27.218215599998075
1307, 7.441777512125793, 63.100166398970806, 75.79873635338956, 0.15251904999999996, 110.0, 488, 941890, 1307, 19.23617070000182
1308, 7.186005893107815, 63.264844380016825, 75.98545939370385, 0.15173379999999995, 520.0, 1257, 943147, 1308, 50.12299130000247
1309, 6.423668004669432, 63.29384100178389, 75.96942717225093, 0.15085719999999997, 170.0, 691, 943838, 1309, 27.610349500002485
1310, 7.205979368887668, 63.03225026120595, 75.76044925423555, 0.1501205499999999, 290.0, 946, 944784, 1310, 37.7234998999993
1311, 7.217307394614718, 63.1272572454859, 75.84608024847311, 0.14947524999999995, 60.0, 488, 945272, 1311, 19.464688500000193
1312, 4.92910623544308, 63.29212624909448, 75.94330274863322, 0.14903604999999998, 125.0, 488, 945760, 1312, 19.302892800002155
1313, 7.823918752339053, 63.31516107443006, 76.07935089519438, 0.14821074999999995, 605.0, 1346, 947106, 1313, 53.70632359999945
1314, 5.188761507047856, 63.16437555160325, 75.78892560461078, 0.14743089999999992, 75.0, 387, 947493, 1314, 15.712448100002803
1315, 6.946152593144963, 63.188830166396755, 75.91145258413323, 0.14695119999999992, 135.0, 679, 948172, 1315, 27.0745820000011
1316, 6.574610523351315, 63.13240349826528, 75.85561407857867, 0.14616324999999994, 330.0, 1072, 949244, 1316, 42.985407599997416
1317, 4.296347747766535, 63.19901300600062, 75.8635401301359, 0.14550895, 60.0, 382, 949626, 1317, 15.392331300001388
1318, 6.452827542413276, 63.05471581111372, 75.69238111880549, 0.14511609999999991, 70.0, 491, 950117, 1318, 19.507648299997527
1319, 6.029742843601913, 62.16242072636607, 74.63536060594193, 0.14461884999999994, 70.0, 614, 950731, 1319, 24.787597300000925
1320, 8.832755901090716, 62.27154445100105, 74.80624438976419, 0.14402934999999994, 135.0, 696, 951427, 1320, 28.12549840000065
1321, 7.116220624501608, 62.09178327962655, 74.58092214623277, 0.14305464999999992, 435.0, 1470, 952897, 1321, 59.67507639999894
1322, 6.191163463052826, 62.14417307459893, 74.67519424969878, 0.1419409, 235.0, 1005, 953902, 1322, 40.40858559999833
1323, 9.395094775101718, 62.37711032792634, 75.00219889622109, 0.14125914999999994, 105.0, 510, 954412, 1323, 20.81595440000092
1324, 9.696938021115681, 62.1629251423788, 74.76542558780224, 0.14067909999999992, 395.0, 779, 955191, 1324, 31.659689200001594
1325, 8.844778086218609, 62.11409370715801, 74.70882825456427, 0.14002434999999994, 200.0, 676, 955867, 1325, 27.5168620000004
1326, 8.677581218517807, 62.209707501816425, 74.79488230404789, 0.13945734999999992, 60.0, 584, 956451, 1326, 23.636945100002777
1327, 4.093065134964826, 62.190669454327065, 74.63448386155922, 0.1388998, 195.0, 655, 957106, 1327, 26.536188199999742
1328, 6.542829719798587, 62.39470944449166, 74.9653730392456, 0.13841244999999996, 35.0, 428, 957534, 1328, 17.337945900002524
1329, 10.756018167359429, 62.25989996868631, 74.86826919752899, 0.1378368999999999, 280.0, 851, 958385, 1329, 34.69664499999999
1330, 9.748662479948706, 62.36233377562394, 75.00939840752375, 0.13704804999999995, 240.0, 902, 959287, 1330, 36.47890499999994
1331, 7.450127986695794, 62.076188123245615, 74.60037335991665, 0.13581459999999995, 605.0, 1839, 961126, 1331, 74.31128970000282
1332, 4.4887350685746075, 61.89570821328942, 74.35214798763928, 0.13476114999999994, 65.0, 502, 961628, 1332, 20.259045699996932
1333, 8.164011177441587, 61.89299001089757, 74.39639839965724, 0.13395969999999988, 305.0, 1279, 962907, 1333, 51.8243747000015
1334, 6.539789312603501, 61.77690781431441, 74.18264579940701, 0.13287249999999995, 220.0, 1137, 964044, 1334, 46.22285639999973
1335, 7.0184550145740525, 61.83215551126108, 74.32894488928733, 0.13189779999999993, 250.0, 1029, 965073, 1335, 41.73689209999793
1336, 6.873070215777884, 61.982621481659216, 74.43350541701011, 0.13114044999999994, 115.0, 654, 965727, 1336, 26.783750700000382
1337, 5.515114000846039, 61.84025253642689, 74.22026432384145, 0.13035114999999992, 220.0, 1100, 966827, 1337, 45.1790164999984
1338, 8.078565190742093, 61.96086588213521, 74.4713103657384, 0.1295073999999999, 200.0, 775, 967602, 1338, 32.05095230000006
1339, 6.820102692405655, 61.787184764914315, 74.22929917426958, 0.12883014999999992, 165.0, 730, 968332, 1339, 29.828816199998982
1340, 6.140692284978089, 61.770140392292475, 74.20410748132711, 0.12772089999999992, 835.0, 1735, 970067, 1340, 71.28520870000284
1341, 7.421975034580179, 61.96703547166713, 74.39692728251663, 0.12660759999999996, 85.0, 739, 970806, 1341, 30.306894000001193
1342, 8.413968238955016, 61.82991816761729, 74.28251142397032, 0.12586554999999994, 145.0, 910, 971716, 1342, 37.286454799999774
1343, 6.690897966468678, 61.9915292405765, 74.46497162271233, 0.1252530999999999, 35.0, 451, 972167, 1343, 18.761769799999456
1344, 6.456332906663681, 61.93494220334757, 74.36938953540111, 0.1247445999999999, 140.0, 679, 972846, 1344, 28.027020400000765
1345, 6.725392536298763, 61.962092664820204, 74.44434408605451, 0.12428694999999998, 40.0, 338, 973184, 1345, 14.212212999998883
1346, 5.440781804322305, 61.99725785989576, 74.41206026861308, 0.12383379999999995, 125.0, 669, 973853, 1346, 27.799571699997614
1347, 6.957096073922574, 61.99610981754228, 74.43653436735565, 0.12316554999999994, 100.0, 816, 974669, 1347, 33.80396890000338
1348, 5.596711868663465, 62.04697527609581, 74.52759580375735, 0.12225384999999993, 525.0, 1210, 975879, 1348, 50.40205729999798
1349, 5.981060622429306, 61.95582714947787, 74.39585585633586, 0.12127374999999989, 195.0, 968, 976847, 1349, 40.05773749999935
1350, 7.336515332582176, 61.92485832179197, 74.40258376536099, 0.12054519999999994, 145.0, 651, 977498, 1350, 27.41109359999973
1351, 5.625123649528346, 62.06240043334262, 74.4960118716525, 0.1198593999999999, 255.0, 873, 978371, 1351, 36.329223400000046
1352, 7.210639555124789, 61.976250455011865, 74.44365640886201, 0.11896749999999992, 450.0, 1109, 979480, 1352, 46.46847530000014
1353, 6.262307874760986, 62.06406756631689, 74.50638769810496, 0.11819304999999992, 135.0, 612, 980092, 1353, 25.59482349999962
1354, 7.3746457902272455, 61.833360567512884, 74.26053324370584, 0.11749869999999991, 250.0, 931, 981023, 1354, 39.05309259999922
1355, 6.513650481655383, 61.76800403036333, 74.22084468378681, 0.11664954999999994, 130.0, 956, 981979, 1355, 40.055066900000384
1356, 8.94296415764335, 61.758419232755095, 74.21724020468223, 0.11588634999999996, 170.0, 740, 982719, 1356, 30.97346859999743
1357, 5.888506083264856, 61.857150892102034, 74.26085125717553, 0.11518389999999996, 140.0, 821, 983540, 1357, 34.39809520000199
1358, 8.890980070002719, 61.824634312740905, 74.34314777994324, 0.11430504999999994, 230.0, 1132, 984672, 1358, 47.39201409999805
1359, 6.650480563296721, 61.75706679710975, 74.19960295457106, 0.11350314999999994, 80.0, 650, 985322, 1359, 27.393457500002114
1360, 7.161348871363983, 61.701964290857134, 74.11723574694985, 0.11262699999999996, 395.0, 1297, 986619, 1360, 54.38364100000035
1361, 5.903433969434427, 61.643320769305504, 74.00662655433642, 0.11175669999999993, 170.0, 637, 987256, 1361, 26.86528129999715
1362, 6.83328718996518, 61.79234306241962, 74.22335095372553, 0.11062539999999993, 1280.0, 1877, 989133, 1362, 78.87500200000068
1363, 7.225596995206504, 61.70345973968506, 74.15145947293537, 0.10948554999999995, 110.0, 656, 989789, 1363, 27.4803095999996
1364, 8.354971894325473, 62.15728903080218, 74.7824246738497, 0.10886454999999995, 195.0, 724, 990513, 1364, 30.639533199999278
1365, 6.826204501092434, 62.461864645236005, 75.01833707149898, 0.10815354999999996, 160.0, 856, 991369, 1365, 35.97471030000088
1366, 7.265816917034243, 62.46778330148435, 75.0654307720708, 0.10721754999999993, 330.0, 1224, 992593, 1366, 51.61547570000039
1367, 6.499065532255145, 62.247219108319086, 74.78969259477029, 0.10628739999999991, 90.0, 843, 993436, 1367, 35.977012499999546
1368, 5.645187127446049, 62.39864787371036, 74.92136275935657, 0.10561959999999994, 20.0, 641, 994077, 1368, 27.214475000000675
1369, 7.396720395169475, 62.372927344419104, 74.95106425429836, 0.10482624999999991, 290.0, 1122, 995199, 1369, 47.56408690000171
1370, 8.630526606080144, 62.38288835392442, 75.0057662183185, 0.10383759999999996, 240.0, 1075, 996274, 1370, 46.184670099999494
1371, 9.153154298039897, 62.34125586003254, 74.99199284407274, 0.10299879999999992, 225.0, 789, 997063, 1371, 33.755760299998656
1372, 7.717273466871701, 62.20467183117859, 74.68290311841918, 0.10237329999999996, 155.0, 601, 997664, 1372, 25.547448900000745
1373, 6.584221514050516, 62.29317731029787, 74.81461666318803, 0.10178649999999993, 90.0, 703, 998367, 1373, 30.097054099998786
1374, 6.011419490067398, 62.42328847997329, 74.95851180132698, 0.10131714999999993, 50.0, 340, 998707, 1374, 14.690473300001031
1375, 5.799322201242438, 62.383260811969734, 74.9151426251093, 0.10066959999999991, 285.0, 1099, 999806, 1375, 46.868719499998406
