,loss,mae,mean_q,mean_eps,episode_reward,nb_episode_steps,nb_steps,episode,duration
0,0,0,0,0,125.0,635,635,0,2.2386450999999994
1, 0, 0, 0, 0, 90.0, 647, 1282, 1, 1.5043277999999987
2, 0, 0, 0, 0, 205.0, 925, 2207, 2, 2.2057755000000014
3, 0, 0, 0, 0, 125.0, 583, 2790, 3, 1.5264898000000002
4, 0, 0, 0, 0, 110.0, 660, 3450, 4, 1.4100171999999986
5, 0, 0, 0, 0, 65.0, 516, 3966, 5, 1.3021636
6, 0, 0, 0, 0, 150.0, 686, 4652, 6, 1.6092432999999993
7, 0, 0, 0, 0, 40.0, 355, 5007, 7, 0.7503315999999991
8, 0, 0, 0, 0, 80.0, 557, 5564, 8, 1.1641778999999985
9, 0, 0, 0, 0, 15.0, 380, 5944, 9, 0.8899462000000007
10, 0, 0, 0, 0, 110.0, 473, 6417, 10, 1.1175426000000002
11, 0, 0, 0, 0, 180.0, 704, 7121, 11, 1.5519622999999996
12, 0, 0, 0, 0, 75.0, 406, 7527, 12, 0.857392100000002
13, 0, 0, 0, 0, 65.0, 597, 8124, 13, 1.2361527999999957
14, 0, 0, 0, 0, 185.0, 758, 8882, 14, 1.6413033000000041
15, 0, 0, 0, 0, 155.0, 646, 9528, 15, 1.3190656000000018
16, 0, 0, 0, 0, 75.0, 342, 9870, 16, 0.7293434999999988
17, 0, 0, 0, 0, 95.0, 538, 10408, 17, 1.1156700999999956
18, 0, 0, 0, 0, 120.0, 714, 11122, 18, 1.4478334000000004
19, 0, 0, 0, 0, 110.0, 662, 11784, 19, 1.4049759000000037
20, 0, 0, 0, 0, 75.0, 557, 12341, 20, 1.2372921000000048
21, 0, 0, 0, 0, 175.0, 722, 13063, 21, 1.4781223000000026
22, 0, 0, 0, 0, 65.0, 593, 13656, 22, 1.2462625999999943
23, 0, 0, 0, 0, 195.0, 824, 14480, 23, 1.6698491000000004
24, 0, 0, 0, 0, 30.0, 423, 14903, 24, 0.8602206000000052
25, 0, 0, 0, 0, 225.0, 813, 15716, 25, 1.6362377000000023
26, 0, 0, 0, 0, 210.0, 813, 16529, 26, 1.6742622000000011
27, 0, 0, 0, 0, 180.0, 693, 17222, 27, 1.420334700000005
28, 0, 0, 0, 0, 120.0, 974, 18196, 28, 1.997532200000002
29, 0, 0, 0, 0, 210.0, 797, 18993, 29, 1.614839400000001
30, 0, 0, 0, 0, 180.0, 725, 19718, 30, 1.4768144999999961
31, 0, 0, 0, 0, 80.0, 551, 20269, 31, 1.126125100000003
32, 0, 0, 0, 0, 195.0, 701, 20970, 32, 1.4077911999999984
33, 0, 0, 0, 0, 55.0, 499, 21469, 33, 1.0288044999999997
34, 0, 0, 0, 0, 515.0, 1102, 22571, 34, 2.1825131000000013
35, 0, 0, 0, 0, 135.0, 565, 23136, 35, 1.1730328000000014
36, 0, 0, 0, 0, 35.0, 496, 23632, 36, 1.0369749000000041
37, 0, 0, 0, 0, 105.0, 448, 24080, 37, 0.9453630000000004
38, 0, 0, 0, 0, 180.0, 575, 24655, 38, 1.1695899999999995
39, 0, 0, 0, 0, 80.0, 495, 25150, 39, 1.0324089000000072
40, 0, 0, 0, 0, 60.0, 426, 25576, 40, 0.9056022000000041
41, 0, 0, 0, 0, 180.0, 1068, 26644, 41, 2.1779288000000037
42, 0, 0, 0, 0, 80.0, 380, 27024, 42, 0.7908867000000015
43, 0, 0, 0, 0, 230.0, 908, 27932, 43, 1.8677700000000073
44, 0, 0, 0, 0, 120.0, 798, 28730, 44, 1.6272352999999953
45, 0, 0, 0, 0, 95.0, 657, 29387, 45, 1.3491315999999927
46, 0, 0, 0, 0, 110.0, 634, 30021, 46, 1.3288401000000079
47, 0, 0, 0, 0, 130.0, 803, 30824, 47, 1.6714037999999931
48, 0, 0, 0, 0, 65.0, 387, 31211, 48, 0.8115210999999931
49, 0, 0, 0, 0, 45.0, 382, 31593, 49, 0.7978970000000061
50, 0, 0, 0, 0, 20.0, 476, 32069, 50, 0.9893473999999998
51, 0, 0, 0, 0, 430.0, 1374, 33443, 51, 2.648029600000001
52, 0, 0, 0, 0, 55.0, 482, 33925, 52, 0.9872847000000036
53, 0, 0, 0, 0, 135.0, 649, 34574, 53, 1.3285482000000002
54, 0, 0, 0, 0, 50.0, 583, 35157, 54, 1.213606200000001
55, 0, 0, 0, 0, 495.0, 1027, 36184, 55, 2.037686999999991
56, 0, 0, 0, 0, 90.0, 659, 36843, 56, 1.3390179999999958
57, 0, 0, 0, 0, 80.0, 507, 37350, 57, 1.0431562999999926
58, 0, 0, 0, 0, 385.0, 1117, 38467, 58, 2.206409899999997
59, 0, 0, 0, 0, 500.0, 1016, 39483, 59, 2.0351399000000043
60, 0, 0, 0, 0, 115.0, 917, 40400, 60, 1.8627366999999992
61, 0, 0, 0, 0, 30.0, 527, 40927, 61, 1.0815139000000045
62, 0, 0, 0, 0, 50.0, 585, 41512, 62, 1.1965813999999995
63, 0, 0, 0, 0, 85.0, 344, 41856, 63, 0.7157140999999996
64, 0, 0, 0, 0, 215.0, 1438, 43294, 64, 2.832460400000002
65, 0, 0, 0, 0, 485.0, 1015, 44309, 65, 1.9761266000000006
66, 0, 0, 0, 0, 320.0, 908, 45217, 66, 1.7380405999999908
67, 0, 0, 0, 0, 20.0, 397, 45614, 67, 0.8009713999999946
68, 0, 0, 0, 0, 45.0, 405, 46019, 68, 0.8279872999999895
69, 0, 0, 0, 0, 265.0, 868, 46887, 69, 1.7032951999999995
70, 0, 0, 0, 0, 60.0, 568, 47455, 70, 1.175324500000002
71, 0, 0, 0, 0, 105.0, 572, 48027, 71, 1.184034699999998
72, 0, 0, 0, 0, 345.0, 1076, 49103, 72, 2.140397000000007
73, 0, 0, 0, 0, 30.0, 482, 49585, 73, 1.0093750999999997
74, 0, 0, 0, 0, 155.0, 654, 50239, 74, 1.3631082999999933
75, 0, 0, 0, 0, 245.0, 1124, 51363, 75, 2.266493799999992
76, 0, 0, 0, 0, 170.0, 596, 51959, 76, 1.1881122000000062
77, 0, 0, 0, 0, 105.0, 766, 52725, 77, 1.5214870000000076
78, 0, 0, 0, 0, 80.0, 621, 53346, 78, 1.263110900000001
79, 0, 0, 0, 0, 295.0, 1017, 54363, 79, 2.024097900000001
80, 0, 0, 0, 0, 110.0, 421, 54784, 80, 0.8873918000000174
81, 0, 0, 0, 0, 165.0, 641, 55425, 81, 1.2511815999999953
82, 0, 0, 0, 0, 200.0, 1142, 56567, 82, 2.219485899999995
83, 0, 0, 0, 0, 50.0, 596, 57163, 83, 1.196209500000009
84, 0, 0, 0, 0, 155.0, 695, 57858, 84, 1.3633687999999893
85, 0, 0, 0, 0, 130.0, 729, 58587, 85, 1.459341199999983
86, 0, 0, 0, 0, 180.0, 628, 59215, 86, 1.3055789000000004
87, 0, 0, 0, 0, 110.0, 543, 59758, 87, 1.1008931000000075
88, 0, 0, 0, 0, 45.0, 404, 60162, 88, 0.8525788000000034
89, 0, 0, 0, 0, 145.0, 669, 60831, 89, 1.313426700000008
90, 0, 0, 0, 0, 70.0, 553, 61384, 90, 1.1794213999999954
91, 0, 0, 0, 0, 35.0, 453, 61837, 91, 0.9781052000000159
92, 0, 0, 0, 0, 415.0, 1036, 62873, 92, 2.0949364999999887
93, 0, 0, 0, 0, 110.0, 600, 63473, 93, 1.2303070000000105
94, 0, 0, 0, 0, 140.0, 926, 64399, 94, 1.9405122000000006
95, 0, 0, 0, 0, 330.0, 1136, 65535, 95, 2.205756799999989
96, 0, 0, 0, 0, 125.0, 547, 66082, 96, 1.0977993000000197
97, 0, 0, 0, 0, 230.0, 754, 66836, 97, 1.4761535000000094
98, 0, 0, 0, 0, 230.0, 777, 67613, 98, 1.561661799999996
99, 0, 0, 0, 0, 75.0, 468, 68081, 99, 0.9538392000000044
100, 0, 0, 0, 0, 280.0, 918, 68999, 100, 1.7899151000000018
101, 0, 0, 0, 0, 110.0, 405, 69404, 101, 0.821438999999998
102, 0, 0, 0, 0, 80.0, 503, 69907, 102, 1.0087355999999943
103, 0, 0, 0, 0, 335.0, 1058, 70965, 103, 2.0463456000000235
104, 0, 0, 0, 0, 75.0, 509, 71474, 104, 1.0701980000000049
105, 0, 0, 0, 0, 170.0, 656, 72130, 105, 1.3658420999999805
106, 0, 0, 0, 0, 100.0, 548, 72678, 106, 1.1381298999999956
107, 0, 0, 0, 0, 80.0, 395, 73073, 107, 0.8454275999999936
108, 0, 0, 0, 0, 45.0, 360, 73433, 108, 0.72081799999998
109, 0, 0, 0, 0, 355.0, 649, 74082, 109, 1.2828006000000016
110, 0, 0, 0, 0, 50.0, 419, 74501, 110, 0.8841424999999958
111, 0, 0, 0, 0, 35.0, 371, 74872, 111, 0.7710019999999815
112, 0, 0, 0, 0, 200.0, 867, 75739, 112, 1.7492248000000075
113, 0, 0, 0, 0, 180.0, 848, 76587, 113, 1.7104293999999811
114, 0, 0, 0, 0, 25.0, 346, 76933, 114, 0.7259972999999889
115, 0, 0, 0, 0, 80.0, 398, 77331, 115, 0.8434383000000025
116, 0, 0, 0, 0, 220.0, 923, 78254, 116, 1.860579400000006
117, 0, 0, 0, 0, 55.0, 399, 78653, 117, 0.8264393000000041
118, 0, 0, 0, 0, 165.0, 512, 79165, 118, 1.058354300000019
119, 0, 0, 0, 0, 265.0, 798, 79963, 119, 1.581963700000017
120, 0, 0, 0, 0, 425.0, 774, 80737, 120, 1.5330948999999805
121, 0, 0, 0, 0, 160.0, 524, 81261, 121, 1.0546244999999885
122, 0, 0, 0, 0, 135.0, 678, 81939, 122, 1.371580999999992
123, 0, 0, 0, 0, 75.0, 440, 82379, 123, 0.8824857000000179
124, 0, 0, 0, 0, 15.0, 434, 82813, 124, 0.8777534000000173
125, 0, 0, 0, 0, 150.0, 556, 83369, 125, 1.1010363999999981
126, 0, 0, 0, 0, 220.0, 757, 84126, 126, 1.5512826000000075
127, 0, 0, 0, 0, 25.0, 347, 84473, 127, 0.7384019000000137
128, 0, 0, 0, 0, 135.0, 503, 84976, 128, 1.047531699999979
129, 0, 0, 0, 0, 135.0, 675, 85651, 129, 1.3346284999999796
130, 0, 0, 0, 0, 140.0, 825, 86476, 130, 1.676193699999999
131, 0, 0, 0, 0, 365.0, 968, 87444, 131, 1.9184995999999899
132, 0, 0, 0, 0, 310.0, 972, 88416, 132, 1.991585299999997
133, 0, 0, 0, 0, 100.0, 687, 89103, 133, 1.4205827000000113
134, 0, 0, 0, 0, 90.0, 561, 89664, 134, 1.1273272999999904
135, 0, 0, 0, 0, 200.0, 994, 90658, 135, 1.9848590000000002
136, 0, 0, 0, 0, 55.0, 525, 91183, 136, 1.091271899999981
137, 0, 0, 0, 0, 65.0, 559, 91742, 137, 1.1258188999999845
138, 0, 0, 0, 0, 35.0, 501, 92243, 138, 1.0448731999999836
139, 0, 0, 0, 0, 165.0, 723, 92966, 139, 1.4510833999999875
140, 0, 0, 0, 0, 105.0, 586, 93552, 140, 1.182620500000013
141, 0, 0, 0, 0, 180.0, 620, 94172, 141, 1.3208998000000065
142, 0, 0, 0, 0, 185.0, 891, 95063, 142, 1.760044899999997
143, 0, 0, 0, 0, 35.0, 382, 95445, 143, 0.8083245999999917
144, 0, 0, 0, 0, 105.0, 510, 95955, 144, 1.092940800000008
145, 0, 0, 0, 0, 280.0, 894, 96849, 145, 1.8022186999999974
146, 0, 0, 0, 0, 65.0, 431, 97280, 146, 0.8982407999999964
147, 0, 0, 0, 0, 65.0, 491, 97771, 147, 1.0262010000000146
148, 0, 0, 0, 0, 185.0, 613, 98384, 148, 1.2653157000000022
149, 0, 0, 0, 0, 100.0, 497, 98881, 149, 1.0182076000000109
150, 0, 0, 0, 0, 135.0, 473, 99354, 150, 0.9759609000000182
151, 9.999455815785891, 9.715230684775811, 12.81132765559407, 0.8198604999999998, 280.0, 801, 100155, 151, 9.862495899999999
152, 5.046361534376822, 9.810484647750854, 12.01767654249654, 0.8191135, 175.0, 676, 100831, 152, 35.455551600000035
153, 4.930129968816308, 9.790766020489347, 11.962447756668059, 0.8176573000000003, 275.0, 942, 101773, 153, 52.52401649999996
154, 4.951573622160853, 9.779117375228067, 11.943924652717829, 0.8163208000000002, 35.0, 543, 102316, 154, 29.867893800000047
155, 4.7301599151807325, 9.781183615662998, 11.928926345997287, 0.8154729999999998, 65.0, 399, 102715, 155, 21.777871600000026
156, 4.4359598603463715, 9.766297694136924, 11.89216136693357, 0.8143956999999996, 150.0, 798, 103513, 156, 41.84876969999999
157, 4.845624862881158, 9.759886546397773, 11.928988941823404, 0.813106, 120.0, 635, 104148, 157, 32.62565619999998
158, 4.10514630422266, 9.731208392551967, 11.841390571363975, 0.8120872, 70.0, 497, 104645, 158, 25.467576699999995
159, 4.476667234247793, 9.738663475964032, 11.867865327869499, 0.8106922000000001, 530.0, 1053, 105698, 159, 54.53861649999999
160, 4.739910653508568, 9.738483184206801, 11.855567804329313, 0.8090325999999999, 270.0, 791, 106489, 160, 44.66232739999998
161, 4.374609361577463, 9.723373307666925, 11.857022376170809, 0.8079706, 60.0, 389, 106878, 161, 21.528586399999995
162, 4.449873086720577, 9.718091390334145, 11.810195445332234, 0.8069914, 155.0, 699, 107577, 162, 36.34296990000007
163, 4.470225324006785, 9.716436025475254, 11.814568650107137, 0.8056125999999996, 165.0, 833, 108410, 163, 43.17129190000003
164, 4.584468309306926, 9.722657063377463, 11.807270342692572, 0.8038657, 630.0, 1108, 109518, 164, 57.88892939999994
165, 4.574400356859348, 10.037325913669498, 12.174242173745736, 0.8021611000000005, 260.0, 786, 110304, 165, 41.263118899999995
166, 4.24429737469134, 10.520820734253967, 12.745647882160387, 0.8009236000000002, 100.0, 589, 110893, 166, 32.51408199999992
167, 4.280032487602921, 10.51544600420886, 12.744078452880675, 0.7997940999999998, 105.0, 666, 111559, 167, 37.20906190000005
168, 3.5054327955727134, 10.50388246869284, 12.675331494164846, 0.7984008999999999, 355.0, 882, 112441, 168, 49.26558590000002
169, 4.491607824961345, 10.50492691451853, 12.707907306425499, 0.7971318999999998, 155.0, 528, 112969, 169, 29.86944859999994
170, 3.6190287051200865, 10.498940302530924, 12.685465052286784, 0.7963192000000002, 60.0, 375, 113344, 170, 21.18506220000006
171, 3.9910530059233955, 10.496254764859328, 12.694435168410202, 0.7956298000000003, 65.0, 391, 113735, 171, 22.023119899999983
172, 4.479183503239471, 10.498487768386141, 12.723017025778352, 0.7945119999999997, 240.0, 851, 114586, 172, 48.10387509999998
173, 4.091973697495573, 10.497336909244877, 12.692323942139675, 0.7933626999999999, 105.0, 426, 115012, 173, 24.182680900000037
174, 4.308897055914954, 10.504868748508743, 12.711445578106797, 0.7924240000000001, 105.0, 617, 115629, 174, 35.220755300000064
175, 4.397824700948045, 10.496954200970606, 12.68454654865776, 0.7912305999999999, 240.0, 709, 116338, 175, 40.53665669999987
176, 4.025338701015927, 10.482667481549251, 12.668932934499157, 0.7900714, 30.0, 579, 116917, 176, 33.24387550000006
177, 3.723580217183526, 10.459575983303697, 12.632826531823001, 0.7889472999999997, 160.0, 670, 117587, 177, 38.573000900000125
178, 5.058451726682046, 10.503527554343728, 12.733085534151863, 0.7880383000000002, 35.0, 340, 117927, 178, 19.717308100000082
179, 3.915476669300633, 10.482517410452564, 12.6536614478704, 0.7871806, 120.0, 613, 118540, 179, 35.464773599999944
180, 3.983386901297584, 10.476657972842983, 12.640180192973244, 0.7857657999999993, 190.0, 959, 119499, 180, 55.71844319999991
181, 3.517535369115467, 10.595093898109619, 12.760440852788811, 0.7838937999999999, 285.0, 1121, 120620, 181, 65.47865159999992
182, 4.041804859498185, 10.712375913558088, 12.930179615109191, 0.7823026, 110.0, 647, 121267, 182, 37.95622329999992
183, 3.949837431662223, 10.697741867514218, 12.875465680571164, 0.7811083000000003, 105.0, 680, 121947, 183, 40.14362600000004
184, 3.8354025156725022, 10.703944511902638, 12.882771712083082, 0.7800049000000003, 35.0, 546, 122493, 184, 32.367005600000084
185, 4.282172178906738, 10.707354575868637, 12.895581462395885, 0.7786630000000001, 440.0, 945, 123438, 185, 56.00758780000001
186, 4.648409351352364, 10.715214483480784, 12.917652311447116, 0.7773202000000001, 120.0, 547, 123985, 186, 32.707071299999825
187, 3.843773725454437, 10.686117037562013, 12.861721498668953, 0.7761204999999999, 210.0, 786, 124771, 187, 47.01028619999988
188, 4.000139944676628, 10.678903040477648, 12.844983598527307, 0.7748559999999998, 135.0, 619, 125390, 188, 37.17872130000001
189, 3.9606743552574986, 10.686969673006159, 12.858022056127849, 0.7729309000000006, 195.0, 1520, 126910, 189, 92.09014630000001
190, 3.7084519145274357, 10.703016603350315, 12.870306893330504, 0.7712326000000002, 95.0, 367, 127277, 190, 22.503145899999936
191, 4.284781043711241, 10.694202617302418, 12.865355136858318, 0.7701112, 260.0, 879, 128156, 191, 54.015446999999995
192, 3.590637611512521, 10.694337207484205, 12.845130498136454, 0.7687774000000003, 105.0, 603, 128759, 192, 37.161811899999975
193, 3.883983799533752, 10.714203169501722, 12.870576823883425, 0.7678629999999999, 30.0, 413, 129172, 193, 25.52963940000018
194, 3.523106140307352, 10.738938725228403, 12.903887489730236, 0.7665732999999997, 405.0, 1020, 130192, 194, 63.12510350000002
195, 4.153398831949589, 11.02296618958737, 13.278871916710063, 0.7653169, 35.0, 376, 130568, 195, 23.323183799999924
196, 3.8749809181818398, 10.999329322555159, 13.265169519677384, 0.7644763000000003, 60.0, 558, 131126, 196, 34.7000723000001
197, 3.6595437121873644, 10.987274446928431, 13.241295436903231, 0.7633512999999998, 110.0, 692, 131818, 197, 43.357284400000026
198, 2.7291900471417825, 10.986366066322507, 13.233349436267293, 0.7619689, 215.0, 844, 132662, 198, 52.93138040000008
199, 2.791546627172622, 10.98344283679436, 13.222237726737713, 0.7607916999999998, 60.0, 464, 133126, 199, 29.372715900000003
200, 3.5566223372624615, 11.003606552965058, 13.277922900642936, 0.7598025999999999, 150.0, 635, 133761, 200, 40.08895210000037
201, 4.235859101773013, 11.020174439231614, 13.253672897023323, 0.7586218000000001, 135.0, 677, 134438, 201, 43.063072499999635
202, 3.7838210712250016, 11.007289896513287, 13.23477543852383, 0.7574140000000004, 50.0, 665, 135103, 202, 42.461813699999766
203, 3.410499332109653, 10.996476329740931, 13.217962341447564, 0.7558272999999999, 375.0, 1098, 136201, 203, 70.33428200000026
204, 3.99582857947524, 11.006178409588045, 13.239715308677859, 0.7542487, 160.0, 656, 136857, 204, 42.08610970000018
205, 3.290086144113286, 11.004342335855684, 13.243966350793414, 0.7531534000000003, 30.0, 561, 137418, 205, 36.07290400000011
206, 4.1680655283486745, 11.022032313459501, 13.290658629785373, 0.7521912999999997, 105.0, 508, 137926, 206, 32.825089599999956
207, 4.140297210682993, 11.006825729038404, 13.233812833039657, 0.7512165999999999, 95.0, 575, 138501, 207, 37.209023100000195
208, 4.194514442729266, 11.004847608586793, 13.287597463122406, 0.7501969, 155.0, 558, 139059, 208, 36.20402100000001
209, 3.9820607261763095, 10.992014127980719, 13.237278451796614, 0.749206, 65.0, 543, 139602, 209, 35.39282749999984
210, 3.2845319176987715, 10.970239999958515, 13.23748260616133, 0.7480485999999998, 240.0, 743, 140345, 210, 48.57252550000021
211, 4.157722045905133, 11.003015734773852, 13.318826985155415, 0.7466427999999996, 100.0, 819, 141164, 211, 53.79235999999992
212, 3.6947821683519795, 10.986554260949067, 13.269499250859498, 0.7455105999999997, 120.0, 439, 141603, 212, 28.987325399999918
213, 3.1667968271227624, 10.982990510123116, 13.25379029930412, 0.7444225, 130.0, 770, 142373, 213, 50.92523369999981
214, 3.7413591669415527, 10.986197070612741, 13.251482354341492, 0.7433955999999998, 50.0, 371, 142744, 214, 24.70386580000013
215, 3.7595882929005304, 10.994261139661942, 13.303053569630121, 0.7425369999999996, 110.0, 583, 143327, 215, 38.7446160999998
216, 3.8322953509252056, 10.988885153352825, 13.246301054175383, 0.7414615, 105.0, 612, 143939, 216, 40.8353519999996
217, 3.7649199800057844, 10.995321360501377, 13.252471661107927, 0.7405839999999999, 65.0, 363, 144302, 217, 24.318760999999995
218, 3.2092340868717972, 10.989006103840103, 13.240395783078059, 0.7394320000000001, 175.0, 917, 145219, 218, 61.64177769999969
219, 5.117045003233604, 11.023311316057647, 13.364120635510153, 0.7379577999999998, 100.0, 721, 145940, 219, 48.63042640000003
220, 3.56546870744936, 10.981198948086487, 13.247406419553712, 0.7367175999999998, 155.0, 657, 146597, 220, 44.24716189999981
221, 3.3159798328311014, 10.981155821691939, 13.235368583665226, 0.735143499999999, 485.0, 1092, 147689, 221, 74.27192190000005
222, 3.458979426605571, 10.984440150925302, 13.228675886016253, 0.7336504000000005, 125.0, 567, 148256, 222, 38.691070800000034
223, 3.126982403682991, 11.00183933329694, 13.2987059584246, 0.7327566999999997, 55.0, 426, 148682, 223, 29.271276500000113
224, 3.717430327709662, 11.005198739428039, 13.272567805018994, 0.7313923000000003, 485.0, 1090, 149772, 224, 74.84389770000007
225, 3.6412562624442306, 11.095110478664312, 13.389757456721721, 0.7297425999999997, 150.0, 743, 150515, 225, 51.24251920000006
226, 3.536348439880295, 11.138694131623183, 13.439716105669229, 0.7285995999999999, 90.0, 527, 151042, 226, 36.47153990000015
227, 3.808368150806669, 11.14775570758103, 13.469209320048995, 0.7277707, 55.0, 394, 151436, 227, 27.460731300000134
228, 3.4480866970334736, 11.12640047709147, 13.397243788582937, 0.7269435999999996, 10.0, 525, 151961, 228, 36.627054399999906
229, 3.306590675573329, 11.12418032377897, 13.397742236174597, 0.7260327999999999, 105.0, 487, 152448, 229, 34.09380220000003
230, 3.5129722385196547, 11.131522949412016, 13.434783445480218, 0.7248484000000002, 140.0, 829, 153277, 230, 58.12312929999962
231, 3.6384593818306303, 11.13393547876552, 13.419325160201426, 0.7228900000000006, 495.0, 1347, 154624, 231, 94.63073940000004
232, 3.6682320465167657, 11.141751299924955, 13.462137597660004, 0.7209459999999998, 210.0, 813, 155437, 232, 57.438515800000005
233, 3.5213180932356285, 11.136582029668778, 13.414352899264795, 0.7193458, 365.0, 965, 156402, 233, 68.68770229999973
234, 3.5833589082132655, 11.143821347875722, 13.44769756152761, 0.7178716000000002, 120.0, 673, 157075, 234, 48.0700597
235, 2.650144647169804, 11.12609142911607, 13.416502667855525, 0.7169554, 25.0, 345, 157420, 235, 24.819865099999788
236, 3.6486333885551554, 11.130883668376281, 13.388550365920615, 0.7160346999999998, 160.0, 678, 158098, 236, 48.84566249999989
237, 2.789069897080711, 11.133441859339424, 13.409920200511285, 0.7149411999999999, 110.0, 537, 158635, 237, 38.78745909999998
238, 3.6850551052479568, 11.15321288432282, 13.463296926778046, 0.7136353000000002, 145.0, 914, 159549, 238, 66.23582399999987
239, 3.6027999438203064, 11.19203224759193, 13.541935301130744, 0.7122475, 90.0, 628, 160177, 239, 45.523599300000114
240, 4.164406025421963, 11.344888351581714, 13.771097767990803, 0.7112449000000004, 30.0, 486, 160663, 240, 35.64811350000036
241, 4.231391262627662, 11.354269717602019, 13.767465891736618, 0.7103844999999999, 20.0, 470, 161133, 241, 34.271051700000044
242, 4.223830937946063, 11.35843647627214, 13.73543944144941, 0.7096204, 35.0, 379, 161512, 242, 27.66255319999982
243, 3.582463959841792, 11.359503260699572, 13.752975234475592, 0.7084710999999999, 265.0, 898, 162410, 243, 65.92430220000006
244, 3.597224941085988, 11.331210367941443, 13.647492041247888, 0.7071957999999996, 75.0, 519, 162929, 244, 38.3028263999995
245, 4.024281809613353, 11.341752346226427, 13.687012451984844, 0.7061796999999999, 120.0, 610, 163539, 245, 45.211808799999744
246, 3.2546054895396703, 11.333307953568193, 13.716272583952895, 0.7052311000000001, 45.0, 444, 163983, 246, 32.94908639999994
247, 3.211909321049549, 11.337731499686342, 13.68742687968689, 0.7042356999999998, 135.0, 662, 164645, 247, 49.326695600000676
248, 4.212956317421478, 11.356136385013798, 13.743734371460711, 0.703054, 130.0, 651, 165296, 248, 48.6096349999998
249, 3.838171321908325, 11.35620240894091, 13.70078928895699, 0.7021198000000001, 45.0, 387, 165683, 249, 28.996870599999966
250, 3.5540206158261975, 11.328893611093404, 13.679477532368633, 0.7013458000000002, 30.0, 473, 166156, 250, 35.407630900000186
251, 3.3797545591078766, 11.3210004246563, 13.651975764703312, 0.7004295999999998, 105.0, 545, 166701, 251, 40.911689300000035
252, 3.4908374209551214, 11.332095815223445, 13.670973574931176, 0.6994144, 145.0, 583, 167284, 252, 43.81633859999965
253, 3.0915345471362117, 11.31342836565233, 13.66435394887849, 0.6985468000000001, 55.0, 381, 167665, 253, 28.095932600000197
254, 3.0016881135377016, 11.30698465600714, 13.668366808324427, 0.6975603999999999, 215.0, 715, 168380, 254, 49.76336809999975
255, 3.845338863979655, 11.33516239841082, 13.712347769597818, 0.6963012999999998, 210.0, 684, 169064, 255, 47.689471000000594
256, 3.5916466077225064, 11.321454947798516, 13.677122080967717, 0.6953679999999999, 60.0, 353, 169417, 256, 24.74130299999979
257, 3.8468042077406386, 11.431511833804294, 13.820901365532224, 0.6942331, 230.0, 908, 170325, 257, 63.83231169999999
258, 5.166232193018344, 11.667129247583807, 14.160367632932203, 0.6927427000000003, 210.0, 748, 171073, 258, 52.77460969999993
259, 3.7966727684525883, 11.651309524221027, 14.098567321691405, 0.6913504000000001, 140.0, 799, 171872, 259, 56.53227049999987
260, 3.9864033892212145, 11.655795042198825, 14.053627522020454, 0.6902577999999999, 125.0, 415, 172287, 260, 29.409220300000015
261, 4.755185010345512, 11.660707264982047, 14.172071942932343, 0.6893703999999999, 105.0, 571, 172858, 261, 40.58541570000034
262, 3.7294807407708293, 11.635930386264768, 14.055379425881535, 0.6882463, 320.0, 678, 173536, 262, 48.3405445999997
263, 3.881027962895636, 11.646510085993112, 14.040585866788538, 0.6871195000000002, 140.0, 574, 174110, 263, 40.93921910000063
264, 4.648204867293438, 11.695528316497803, 14.179557073116303, 0.6861708999999995, 90.0, 480, 174590, 264, 34.32579009999972
265, 4.213942387673603, 11.663039006932703, 14.104996555061001, 0.6848271999999996, 490.0, 1013, 175603, 265, 72.8289734
266, 4.219193820278723, 11.667813951890547, 14.103873130253383, 0.6830965, 165.0, 910, 176513, 266, 65.70637739999984
267, 4.420151829545261, 11.684463625530517, 14.153562463979739, 0.6818157999999999, 90.0, 513, 177026, 267, 37.22915209999974
268, 4.168797396066185, 11.657115691634733, 14.121848578094154, 0.6807681999999998, 120.0, 651, 177677, 268, 47.720878600000106
269, 3.9887069832043642, 11.6597653549441, 14.083189335752287, 0.6789573999999995, 455.0, 1361, 179038, 269, 99.54866349999975
270, 3.7161702582397935, 11.659828190491579, 14.080980088480537, 0.6771547, 160.0, 642, 179680, 270, 47.22667160000037
271, 3.927412999433603, 12.051903369001733, 14.539488944332156, 0.675865, 290.0, 791, 180471, 271, 58.28847439999936
272, 3.68948881508306, 12.30865854884303, 14.815870367094528, 0.6743791000000003, 190.0, 860, 181331, 272, 63.482055700000274
273, 2.9504170379331036, 12.288057620194316, 14.793204251378983, 0.6729634000000002, 110.0, 713, 182044, 273, 52.89285199999995
274, 3.5993321637527362, 12.29594305193102, 14.810283024762128, 0.6714892000000002, 165.0, 925, 182969, 274, 68.80475269999988
275, 2.9869100660025225, 12.297097937330513, 14.782158021752782, 0.6702130000000003, 30.0, 493, 183462, 275, 36.85169640000004
276, 3.5900197458703342, 12.315148725742247, 14.825681581729796, 0.6694002999999998, 65.0, 410, 183872, 276, 30.80598419999933
277, 3.7099027953647226, 12.299302208502562, 14.815561450080367, 0.6679440999999994, 440.0, 1208, 185080, 277, 90.47589880000032
278, 4.30019067915911, 12.312668832773527, 14.876938909038943, 0.6662215000000001, 165.0, 706, 185786, 278, 53.288584300000366
279, 4.2893452179765035, 12.2931917384713, 14.806516384650134, 0.6651351999999996, 65.0, 501, 186287, 279, 37.99652650000007
280, 3.472026855638712, 12.288540299576107, 14.782883639382844, 0.6643207, 80.0, 404, 186691, 280, 30.708210099999633
281, 3.5470086817150337, 12.297205412238213, 14.82050665252877, 0.6635269000000001, 75.0, 478, 187169, 281, 36.78554499999973
282, 3.5181503517495605, 12.29200653685737, 14.80415158542161, 0.6623982999999997, 155.0, 776, 187945, 282, 59.21948590000011
283, 3.7839935285872537, 12.294157454842015, 14.807422462262606, 0.6610158999999999, 210.0, 760, 188705, 283, 58.0082883999994
284, 3.592011422041729, 12.288491406345255, 14.802577064792736, 0.6595677999999997, 315.0, 849, 189554, 284, 64.9938403999995
285, 2.8328496971598236, 12.283897474247922, 14.771105735532698, 0.6584688999999999, 50.0, 372, 189926, 285, 28.639141699999527
286, 3.9722711973720126, 12.174940529576054, 14.70634917329859, 0.6576481000000002, 160.0, 540, 190466, 286, 41.68627360000028
287, 4.148169967261228, 12.167245879317775, 14.689166843529904, 0.6568650999999998, 40.0, 330, 190796, 287, 25.53173809999953
288, 3.3774976277673567, 12.147057731731518, 14.641727470707249, 0.6562351, 45.0, 370, 191166, 288, 28.76877809999951
289, 3.73144137059698, 12.148562205664001, 14.623087158769664, 0.6549931, 185.0, 1010, 192176, 289, 78.29759060000015
290, 4.285947928361118, 12.162125096532511, 14.65333790379792, 0.6537186999999998, 90.0, 406, 192582, 290, 31.612690299999485
291, 3.4846228591485877, 12.143135830975961, 14.60253497828608, 0.6529807, 50.0, 414, 192996, 291, 32.304838299999574
292, 3.266261477594335, 12.13572452050441, 14.611567315309122, 0.6517684000000001, 130.0, 933, 193929, 292, 72.87848579999991
293, 4.076112958523963, 12.140888027615018, 14.62800459543864, 0.6505236999999999, 80.0, 450, 194379, 293, 35.360615299999154
294, 3.8036719560912795, 12.145644991460417, 14.63314575773634, 0.6491926000000001, 185.0, 1029, 195408, 294, 81.01015139999981
295, 3.3335940531861614, 12.142712543380092, 14.619447259499992, 0.6476275000000002, 155.0, 710, 196118, 295, 56.14427599999999
296, 3.8128147418504437, 12.154913832607878, 14.659392997010114, 0.6465943000000002, 70.0, 438, 196556, 296, 34.684514200000194
297, 3.7975482439879356, 12.177032329845659, 14.696060338840068, 0.6454566999999998, 195.0, 826, 197382, 297, 65.60807569999997
298, 3.8665705719947816, 12.171835922241211, 14.648030053710938, 0.6441507999999998, 65.0, 625, 198007, 298, 49.81459320000067
299, 3.487884769439697, 12.162949429264774, 14.65119534527814, 0.6429807999999999, 105.0, 675, 198682, 299, 53.857743700000356
300, 3.6902854968325274, 12.18091183795026, 14.676255157713355, 0.6411565000000002, 510.0, 1352, 200034, 300, 108.37871600000017
301, 3.7974666984895102, 12.271355337363023, 14.814762551967915, 0.6390037000000005, 415.0, 1040, 201074, 301, 83.70616189999964
302, 3.675543826396539, 12.276682070221526, 14.814822312009893, 0.6371649999999995, 335.0, 1003, 202077, 302, 81.36659119999968
303, 3.362923790322672, 12.286622580915395, 14.79615029250041, 0.6358986999999999, 45.0, 404, 202481, 303, 32.549047900000005
304, 4.113262426757728, 12.282260178671189, 14.806727322819395, 0.6350293, 90.0, 562, 203043, 304, 45.2018336000001
305, 4.5159844047948186, 12.311029544715717, 14.869363390495508, 0.6338943999999999, 180.0, 699, 203742, 305, 56.336329799999476
306, 3.882948851816414, 12.299360454174899, 14.846145174484844, 0.6326847999999998, 95.0, 645, 204387, 306, 52.072451
307, 3.6091238307308506, 12.298755251910235, 14.860295827710951, 0.6312717999999996, 290.0, 925, 205312, 307, 74.56330699999944
308, 3.680367697242628, 12.303391026709363, 14.841568205640725, 0.6300918999999999, 45.0, 386, 205698, 308, 31.164068699999916
309, 3.744549604609043, 12.283666197861297, 14.806058403208286, 0.629389, 80.0, 395, 206093, 309, 31.82496810000066
310, 3.8766509558975537, 12.314206129317842, 14.861967043326944, 0.6280263999999999, 270.0, 1119, 207212, 310, 89.91482410000026
311, 3.8120131206650267, 12.321003946036043, 14.825329397455116, 0.6260850999999997, 285.0, 1038, 208250, 311, 83.41904599999998
312, 3.294479818130294, 12.32057101729327, 14.848198179622887, 0.6243831999999999, 305.0, 853, 209103, 312, 68.58540569999968
313, 4.3511066594515215, 12.345234596150204, 14.91935771673768, 0.6230781999999998, 110.0, 597, 209700, 313, 48.05147450000004
314, 4.983815431709034, 12.457739367186642, 15.052198394200506, 0.6218361999999998, 165.0, 783, 210483, 314, 62.94077500000003
315, 4.6453307616404995, 12.51566245005681, 15.143335736103547, 0.6207805000000001, 20.0, 390, 210873, 315, 31.447723999999653
316, 4.499265214430469, 12.513826010257663, 15.129571707544981, 0.6196546, 90.0, 861, 211734, 316, 69.12624030000006
317, 3.732700319463673, 12.497894150870186, 15.106130772202484, 0.6185458000000001, 105.0, 371, 212105, 317, 29.906453900000088
318, 4.095911199594066, 12.51201480844595, 15.111012004587772, 0.6177187000000001, 65.0, 548, 212653, 318, 44.07695430000058
319, 3.927501338785109, 12.511342942887458, 15.120627108864163, 0.6159835000000004, 265.0, 1380, 214033, 319, 110.6753705000001
320, 4.149085277366894, 12.508396744408492, 15.126561379624436, 0.6144057999999999, 75.0, 373, 214406, 320, 30.142847000000074
321, 4.675554054731092, 12.544740727541054, 15.16822219539333, 0.6131044, 290.0, 1073, 215479, 321, 86.0307315
322, 4.751747425689417, 12.535503271514294, 15.152572117599787, 0.6116796999999997, 140.0, 510, 215989, 322, 40.99777239999912
323, 4.372276445754999, 12.551354126783195, 15.176151146797707, 0.6106077999999998, 190.0, 681, 216670, 323, 54.85372330000064
324, 4.849943484373909, 12.546033061124424, 15.164554996286483, 0.6096582999999999, 50.0, 374, 217044, 324, 30.097485000000233
325, 3.733565475778529, 12.520687634026626, 15.084117995555324, 0.6088122999999996, 65.0, 566, 217610, 325, 45.47972320000008
326, 4.643376868725256, 12.529767266635236, 15.106412608913415, 0.6078069999999999, 110.0, 551, 218161, 326, 44.33038080000006
327, 4.250115635982725, 12.532715016536498, 15.131483347228404, 0.6066703, 140.0, 712, 218873, 327, 57.18363279999903
328, 4.200095193619843, 12.54748358513786, 15.170143510329236, 0.6050611000000004, 500.0, 1076, 219949, 328, 86.37707649999902
329, 4.447034232383189, 12.67344302923783, 15.248681510013082, 0.6036787, 110.0, 460, 220409, 329, 36.70849049999924
330, 4.28027565082928, 12.671857447851272, 15.273130856403688, 0.6027355000000001, 170.0, 588, 220997, 330, 47.6162400000012
331, 4.4529989888135075, 12.659953133644912, 15.275924593922221, 0.6011515000000002, 215.0, 1172, 222169, 331, 94.47392109999964
332, 3.769523949122306, 12.661128476722952, 15.319454673639278, 0.5993982999999998, 215.0, 776, 222945, 332, 62.443490399999064
333, 4.585691686591198, 12.647464020498868, 15.290993345194849, 0.5982822999999999, 95.0, 464, 223409, 333, 37.31738109999969
334, 3.13340040737604, 12.660564312264938, 15.269838393555528, 0.5972113000000002, 160.0, 726, 224135, 334, 58.30454490000011
335, 4.9396114172341, 12.679455557940212, 15.365803185704483, 0.5962131999999998, 60.0, 383, 224518, 335, 30.917956699999195
336, 4.756290021717274, 12.682752218114615, 15.309320113625944, 0.5954778999999999, 40.0, 434, 224952, 336, 34.851897600001394
337, 3.878993565014687, 12.670743024492838, 15.31881406292858, 0.5938921000000007, 465.0, 1328, 226280, 337, 108.78808589999971
338, 3.7300849775202476, 12.68494988445572, 15.265466815943013, 0.5920695999999996, 185.0, 697, 226977, 338, 56.065751699999964
339, 5.158491005216326, 12.726142434428509, 15.36682860869214, 0.5908437999999998, 125.0, 665, 227642, 339, 53.49293189999844
340, 4.718399033886002, 12.721525114856854, 15.439479026093418, 0.5896575999999999, 135.0, 653, 228295, 340, 52.631546399999934
341, 4.3330374240252745, 12.721383174467958, 15.35145529256477, 0.5887252, 85.0, 383, 228678, 341, 31.584748499999478
342, 3.832901488872444, 12.71558862362268, 15.359470571361998, 0.5878080999999996, 120.0, 636, 229314, 342, 50.49472760000026
343, 3.9433961568265845, 12.70065729888444, 15.349614108960653, 0.5868865000000001, 70.0, 388, 229702, 343, 30.770383799999763
344, 4.695243202582036, 12.817504004370033, 15.494450825826197, 0.5857615000000003, 170.0, 862, 230564, 344, 68.95843570000034
345, 3.7670830608553643, 12.877875296160882, 15.563162796813527, 0.5842324, 160.0, 837, 231401, 345, 67.19786340000064
346, 4.391637567602671, 12.880187791258424, 15.580874166383849, 0.5826601, 105.0, 910, 232311, 346, 73.19695719999982
347, 4.565637636564138, 12.903396826524, 15.604239031237697, 0.5815018, 80.0, 377, 232688, 347, 30.357466400000703
348, 3.8577222154278146, 12.873165957929839, 15.52514830293032, 0.5801572000000005, 360.0, 1117, 233805, 348, 89.55583449999904
349, 4.157613620950141, 12.891621581449426, 15.586595457858266, 0.5784201999999999, 395.0, 813, 234618, 349, 65.22051450000072
350, 4.610377749442682, 12.89500566354594, 15.562436649840262, 0.5771116, 170.0, 641, 235259, 350, 51.51113190000069
351, 3.7402863757160056, 12.88633260638352, 15.531831348643584, 0.5762440000000001, 20.0, 323, 235582, 351, 25.96580019999965
352, 3.412557088294375, 12.893261197281426, 15.564366884624976, 0.5753205999999997, 185.0, 703, 236285, 352, 56.42448599999989
353, 3.8600088114027487, 12.894031345042412, 15.566722327818251, 0.5738850999999998, 390.0, 892, 237177, 353, 71.51977290000104
354, 3.858456646791269, 12.904405194968794, 15.566558840106755, 0.5719203999999998, 210.0, 1291, 238468, 354, 103.64245750000009
355, 4.649194740848754, 12.899906549880754, 15.610195734963488, 0.5701555, 145.0, 670, 239138, 355, 53.76301000000058
356, 3.279008215304954, 12.904280659550167, 15.55724529035405, 0.5686903000000001, 295.0, 958, 240096, 356, 77.26394769999933
357, 3.9098680388485945, 13.275378336023401, 16.027445715445058, 0.5672206, 215.0, 675, 240771, 357, 54.32856470000115
358, 3.7968769547162635, 13.265023117354422, 16.040696957617094, 0.5660191, 115.0, 660, 241431, 358, 53.26404259999981
359, 3.5401491097278064, 13.24567646715376, 15.976090195443895, 0.5651011, 30.0, 360, 241791, 359, 29.08865220000007
360, 3.782894931139147, 13.247200894863047, 15.9638662325575, 0.5641002999999997, 130.0, 752, 242543, 360, 60.28748529999939
361, 3.7163149983667174, 13.254461139673005, 15.99172478049482, 0.5628465999999999, 80.0, 641, 243184, 361, 51.554776899998615
362, 5.221076059982884, 13.264784219042998, 16.052931792502537, 0.5615253999999998, 180.0, 827, 244011, 362, 66.36483709999993
363, 5.020397243397615, 13.270036190983408, 16.019667541564115, 0.5599827999999999, 275.0, 887, 244898, 363, 71.36122230000001
364, 3.7017399987789115, 13.23476404373092, 15.955401444675946, 0.5584716999999997, 165.0, 792, 245690, 364, 63.74375270000019
365, 4.124912861342238, 13.258865016644581, 16.01309399176946, 0.5570667999999999, 320.0, 769, 246459, 365, 61.78492379999989
366, 4.595349482799831, 13.278421756119757, 16.039031162596586, 0.5560668999999999, 5.0, 342, 246801, 366, 27.556959699999425
367, 4.269992649991072, 13.259475744620538, 16.0149613315924, 0.5552668000000001, 95.0, 547, 247348, 367, 44.03336979999949
368, 3.7150482382468564, 13.24640402096307, 15.9888263885865, 0.5543253999999999, 70.0, 499, 247847, 368, 40.23019889999887
369, 4.117745639171571, 13.268715538620766, 16.009217306081588, 0.5532885999999999, 170.0, 653, 248500, 369, 52.55578199999945
370, 3.5916931161902985, 13.249927256242284, 15.979934166962245, 0.5522239, 115.0, 530, 249030, 370, 42.6770534999996
371, 4.32767640482238, 13.253059415952533, 16.002187720427276, 0.5507317, 320.0, 1128, 250158, 371, 90.94128590000037
372, 5.509603546207794, 13.112258218321452, 15.866575967778532, 0.5492098, 120.0, 563, 250721, 372, 45.24091299999964
373, 4.964585239793599, 13.088788628938335, 15.798306640901595, 0.5484052, 35.0, 331, 251052, 373, 26.745535800000653
374, 5.280248757716148, 13.087555967351442, 15.797148046185894, 0.5476887999999999, 45.0, 465, 251517, 374, 37.43737429999965
375, 3.9677179940479737, 13.070155811680895, 15.76405337626832, 0.5468077000000001, 105.0, 514, 252031, 375, 41.389836899999864
376, 4.9515697018576725, 13.0814390516809, 15.765287242692335, 0.5458572999999998, 85.0, 542, 252573, 376, 43.62907840000116
377, 4.82980911791007, 13.096367571747747, 15.81597366129738, 0.5448628, 95.0, 563, 253136, 377, 45.329445000001215
378, 4.46917910369815, 13.095622388120928, 15.804110757674945, 0.5437495000000002, 220.0, 674, 253810, 378, 54.19677229999979
379, 4.837066856460173, 13.087585350305368, 15.77599332788297, 0.5417631999999996, 545.0, 1533, 255343, 379, 123.04676739999923
380, 4.822334952407962, 13.099615026220345, 15.810354214669921, 0.5398624, 105.0, 579, 255922, 380, 46.79790940000021
381, 6.224776558623911, 13.135454536218663, 15.83919350077729, 0.5389029999999999, 90.0, 487, 256409, 381, 39.20022909999898
382, 4.750170854765506, 13.092051509267986, 15.788101271550847, 0.5376663999999999, 155.0, 887, 257296, 382, 71.35624360000111
383, 4.711439452127905, 13.1220070226303, 15.826371702926838, 0.5363245, 175.0, 604, 257900, 383, 48.69169729999885
384, 4.45170098358442, 13.10732192966892, 15.821708811872918, 0.5351275000000001, 155.0, 726, 258626, 384, 58.61542339999869
385, 5.293303583450468, 13.12840285979712, 15.877908930948129, 0.5335632999999999, 275.0, 1012, 259638, 385, 81.37113669999962
386, 4.577455716486735, 13.29251869884106, 16.0419510059765, 0.5320639, 90.0, 654, 260292, 386, 52.58150750000095
387, 3.959103756873621, 13.515548905410336, 16.378146026094083, 0.5308380999999999, 140.0, 708, 261000, 387, 57.100634100001116
388, 4.014039799031977, 13.50697547952026, 16.285722629044407, 0.5295043, 230.0, 774, 261774, 388, 62.28616079999847
389, 4.029579671241387, 13.488877112405342, 16.298216773752582, 0.5281921, 110.0, 684, 262458, 389, 55.289938699999766
390, 3.9953581267961096, 13.47786055575209, 16.2639860160084, 0.5270779000000002, 80.0, 554, 263012, 390, 44.53942819999975
391, 3.70633224865899, 13.479678949519018, 16.2637419644712, 0.5260419999999997, 90.0, 597, 263609, 391, 48.11772539999947
392, 3.564954311461062, 13.471416605127466, 16.288645457935047, 0.5249052999999999, 140.0, 666, 264275, 392, 53.61738239999977
393, 3.905242750996893, 13.474241094155746, 16.293692064285278, 0.5235138999999999, 175.0, 880, 265155, 393, 70.79595940000036
394, 4.061073767535294, 13.490366423884524, 16.272534727748436, 0.5220108999999998, 105.0, 790, 265945, 394, 63.49721630000022
395, 4.7087356985850075, 13.516554532527026, 16.328404557682475, 0.520822, 130.0, 531, 266476, 395, 42.80340929999875
396, 4.781390965700149, 13.505195599873861, 16.257184926350913, 0.5200066, 40.0, 375, 266851, 396, 30.2510199999997
397, 4.188645484272971, 13.481134664876379, 16.249334641735818, 0.5191956999999999, 45.0, 526, 267377, 397, 42.27515050000147
398, 3.762259910547215, 13.487414568749028, 16.25301449678946, 0.5181013, 95.0, 690, 268067, 398, 55.4338585000005
399, 3.299471308058964, 13.495737625453286, 16.245062306969466, 0.5168791, 100.0, 668, 268735, 399, 53.67936080000072
400, 3.832918314450872, 13.471296671465877, 16.230980154059726, 0.5154292000000003, 320.0, 943, 269678, 400, 76.25442049999947
401, 4.222541305992207, 13.484720663160603, 16.2125395048345, 0.5142178, 80.0, 403, 270081, 401, 32.51156809999884
402, 4.052613999308505, 13.597664843541592, 16.412553006357417, 0.5125438000000007, 605.0, 1457, 271538, 402, 117.49139769999965
403, 3.209375379551906, 13.611995798331115, 16.407097715157654, 0.5103514, 310.0, 979, 272517, 403, 78.76059370000075
404, 3.175895367189238, 13.612620369122034, 16.414347617774, 0.5091363999999997, 60.0, 371, 272888, 404, 29.859325699999317
405, 3.6474594446914588, 13.608668793770383, 16.399086418924302, 0.5082246999999999, 70.0, 642, 273530, 405, 51.92278439999973
406, 3.6730882919072556, 13.605179241411703, 16.389950690778146, 0.5064742, 310.0, 1303, 274833, 406, 105.12092479999956
407, 3.0996842907330433, 13.605691313743591, 16.390469736867136, 0.5047470999999999, 110.0, 616, 275449, 407, 49.76945530000012
408, 4.053997258995992, 13.628017321424192, 16.432299390456908, 0.5035743999999996, 170.0, 687, 276136, 408, 55.41446179999912
409, 4.2738377629185536, 13.610301011660969, 16.424663846680858, 0.5021118999999998, 290.0, 938, 277074, 409, 75.61660169999959
410, 3.5517764712394553, 13.605539228561076, 16.4436664305342, 0.5002102, 525.0, 1175, 278249, 410, 94.47946009999941
411, 3.3016157374672948, 13.59045197850182, 16.366548312561854, 0.4985478999999999, 125.0, 672, 278921, 411, 54.18806890000087
412, 4.4528836617120655, 13.626531623002421, 16.485373667898894, 0.4974760000000001, 45.0, 519, 279440, 412, 41.969148199999836
413, 3.4105270546747417, 13.622044633074504, 16.43108588893239, 0.4965660999999999, 180.0, 492, 279932, 413, 39.63801749999948
414, 3.5375599739927392, 13.967749502684665, 16.891535531742907, 0.49537539999999985, 305.0, 831, 280763, 414, 67.0575059999992
415, 3.258034570758561, 14.000260518366597, 16.87856581486554, 0.4941757, 95.0, 502, 281265, 415, 40.52259810000032
416, 3.906137171869326, 14.023667053742843, 16.946463204393485, 0.4933675000000001, 80.0, 396, 281661, 416, 32.09055679999983
417, 3.768106741126011, 14.029718026386485, 16.907378294963397, 0.49250439999999984, 190.0, 563, 282224, 417, 45.360284699998374
418, 3.1684197582207716, 14.034401043978605, 16.937056296212333, 0.49165119999999995, 50.0, 385, 282609, 418, 31.049106700000266
419, 3.5553255189226785, 14.034673483906671, 16.90200473224249, 0.49069899999999983, 75.0, 673, 283282, 419, 54.26057369999944
420, 3.4446164959633845, 14.029071508780033, 16.915321501331217, 0.48933279999999996, 205.0, 845, 284127, 420, 68.21019899999919
421, 3.458621346560308, 14.023442229196258, 16.901775333174385, 0.48787119999999984, 235.0, 779, 284906, 421, 62.87230759999875
422, 3.156009158101887, 14.035739632666225, 16.87930532560403, 0.4866957999999998, 70.0, 527, 285433, 422, 42.71708319999925
423, 3.757383409559921, 14.039377405123137, 16.915274394322168, 0.48539259999999984, 250.0, 921, 286354, 423, 74.19825290000153
424, 3.8180018041357897, 14.058648462174634, 16.944281352624174, 0.4833568, 585.0, 1341, 287695, 424, 107.65254240000104
425, 3.435067302713829, 14.059802514065355, 16.935466311277093, 0.4812030999999997, 245.0, 1052, 288747, 425, 84.60344540000006
426, 3.8499755776691726, 14.082678884994692, 16.972393716253887, 0.4799611, 45.0, 328, 289075, 426, 26.564081599999554
427, 3.735171938346604, 14.090860405804985, 16.998303749031226, 0.47876319999999994, 270.0, 1003, 290078, 427, 80.717599900001
428, 3.445683974611333, 14.33960529729696, 17.27656604745294, 0.47738260000000005, 105.0, 531, 290609, 428, 42.842857199999344
429, 3.6316558041883957, 14.358834653337563, 17.305666053504275, 0.47644300000000006, 20.0, 513, 291122, 429, 41.32324359999984
430, 4.087071867783864, 14.359773699442545, 17.3043136138916, 0.4756437999999999, 75.0, 375, 291497, 430, 30.31576160000077
431, 3.696305973427121, 14.362377071269593, 17.300191837084306, 0.47453319999999993, 480.0, 859, 292356, 431, 69.06939000000057
432, 3.954927119958614, 14.37344430599894, 17.32730543613434, 0.47315530000000006, 105.0, 672, 293028, 432, 54.06736979999914
433, 3.6248690757468705, 14.384426201771532, 17.33147838623376, 0.47221660000000004, 45.0, 371, 293399, 433, 29.895866099999694
434, 3.5252487207630856, 14.370990208732158, 17.30656935722481, 0.4714065999999999, 90.0, 529, 293928, 434, 42.75813770000059
435, 3.6793938167717144, 14.37971038127291, 17.329027661033297, 0.47030949999999994, 165.0, 690, 294618, 435, 55.6081252999993
436, 3.710719189955853, 14.368563892319798, 17.312825094908476, 0.46922769999999997, 25.0, 512, 295130, 436, 41.36303940000107
437, 3.7710221671286366, 14.385300812314036, 17.315243261247954, 0.46811350000000007, 425.0, 726, 295856, 437, 58.50861850000001
438, 4.02890350199766, 14.377666224230516, 17.3680602945723, 0.4666609000000001, 285.0, 888, 296744, 438, 71.5372828999989
439, 3.9237560338974, 14.36856157684326, 17.327528518676758, 0.46541170000000004, 105.0, 500, 297244, 439, 40.34432689999994
440, 3.1972111066477233, 14.363843368847222, 17.327792860987632, 0.4646584000000001, 35.0, 337, 297581, 440, 27.223815299999842
441, 3.7959462083938047, 14.369552031118124, 17.30537229363608, 0.46370530000000015, 180.0, 722, 298303, 441, 58.16544880000038
442, 3.7511044265246323, 14.376378417226066, 17.33797893467906, 0.46153000000000033, 600.0, 1695, 299998, 442, 136.5484262000009
443, 4.319024979054139, 14.424806719240935, 17.402859166799736, 0.4595284, 105.0, 529, 300527, 443, 42.69982160000109
444, 4.162748174241611, 14.441195030212402, 17.416508308138166, 0.45842229999999995, 120.0, 700, 301227, 444, 56.49882919999982
445, 4.020108913017516, 14.423795549105494, 17.392082508926688, 0.45732609999999985, 65.0, 518, 301745, 445, 41.899913400000514
446, 3.7573294056710558, 14.420769678980552, 17.41444602379432, 0.45631, 100.0, 611, 302356, 446, 49.318341500000315
447, 4.297838458323588, 14.436526655606484, 17.363877296447754, 0.45536589999999993, 15.0, 438, 302794, 447, 35.305611800000406
448, 3.8785401702503077, 14.445954523685474, 17.41779783681971, 0.45404020000000006, 295.0, 1035, 303829, 448, 83.55583330000081
449, 3.735002743520772, 14.440921786999125, 17.383252319676917, 0.45262540000000007, 130.0, 537, 304366, 449, 43.341110800000024
450, 4.170831478742319, 14.473418348057326, 17.423731027647506, 0.45152289999999984, 135.0, 688, 305054, 450, 55.42733959999896
451, 3.656211261919728, 14.437879579536842, 17.375940815968946, 0.44995330000000006, 230.0, 1056, 306110, 451, 85.29204489999938
452, 3.3989188409680446, 14.430565477122922, 17.34188900332479, 0.4483945000000002, 170.0, 676, 306786, 452, 54.55540380000093
453, 3.6353385961030367, 14.439998923272244, 17.370781505450655, 0.44694100000000014, 490.0, 939, 307725, 453, 76.03639289999956
454, 3.8909791374732117, 14.471588448197664, 17.42808519527764, 0.44564680000000007, 185.0, 499, 308224, 454, 40.2601614999985
455, 4.078829479155923, 14.44991369395293, 17.409574267168068, 0.4445010999999997, 100.0, 774, 308998, 455, 62.66611620000003
456, 3.5715576869924295, 14.42571369882976, 17.352640249322285, 0.4432401999999998, 60.0, 627, 309625, 456, 50.67092919999959
457, 3.6957579962208738, 14.438993052947216, 17.38180048200819, 0.44214939999999997, 215.0, 585, 310210, 457, 47.27142450000065
458, 3.943778415034701, 14.4975363044472, 17.461004761382416, 0.4409793999999999, 385.0, 715, 310925, 458, 57.71167170000081
459, 4.050077872268809, 14.492880233428764, 17.423288735203773, 0.4397634999999999, 150.0, 636, 311561, 459, 51.65731210000013
460, 4.26069780601286, 14.49569102358227, 17.425360014944367, 0.43886439999999993, 35.0, 363, 311924, 460, 29.357600499999535
461, 3.3285867080610467, 14.494809319392791, 17.430967670276853, 0.43765749999999976, 475.0, 978, 312902, 461, 79.15503460000036
462, 4.032690330535238, 14.514440394374773, 17.450394838469077, 0.4359438999999999, 165.0, 926, 313828, 462, 74.61427599999843
463, 4.296974777706026, 14.511653234326621, 17.448351206741933, 0.4347675999999999, 60.0, 381, 314209, 463, 30.781959600000846
464, 4.218649227533662, 14.53433821607072, 17.49190561479657, 0.43378479999999997, 135.0, 711, 314920, 464, 57.60199099999954
465, 3.812175237432574, 14.539405851653129, 17.482422297651116, 0.43219449999999987, 225.0, 1056, 315976, 465, 85.36004719999983
466, 4.048674560475461, 14.548295252250902, 17.47246309982869, 0.4304718999999998, 290.0, 858, 316834, 466, 69.1435349000003
467, 3.712215871812169, 14.560726437101374, 17.526085215448955, 0.4288455999999999, 240.0, 949, 317783, 467, 76.4856140999982
468, 3.503928917198784, 14.55903861456709, 17.520674020719465, 0.42730840000000014, 165.0, 759, 318542, 468, 61.36489480000091
469, 4.047886061663199, 14.591664443976379, 17.550882859965874, 0.4255930000000001, 295.0, 1147, 319689, 469, 92.60233569999764
470, 4.531638604468153, 14.848440722627826, 17.931012787524168, 0.4234977999999999, 400.0, 1181, 320870, 470, 95.20220459999837
471, 4.136058355053399, 14.943619915398148, 17.9871817437888, 0.42163300000000026, 325.0, 891, 321761, 471, 72.23193119999996
472, 4.015664546482139, 14.945619881153107, 18.015613600359124, 0.4199815000000001, 320.0, 944, 322705, 472, 76.3588505000007
473, 3.634449779548605, 14.95535844207186, 17.995747908182075, 0.4182759999999999, 155.0, 951, 323656, 473, 76.88907809999728
474, 3.977449285770472, 14.984212041289489, 18.090269079425823, 0.41686749999999995, 110.0, 614, 324270, 474, 49.64041789999828
475, 4.140114299928395, 14.980767149342956, 18.029317295590644, 0.4157694999999999, 50.0, 606, 324876, 475, 49.018547199997556
476, 4.099474123240202, 14.990296683092227, 18.08992449168501, 0.4145977, 160.0, 696, 325572, 476, 56.183993999999075
477, 4.256048719403823, 14.991992548684388, 18.065254598691318, 0.4133197000000002, 175.0, 724, 326296, 477, 58.51251190000039
478, 3.8181886215314083, 14.990591755525314, 18.059786832268863, 0.41165830000000003, 255.0, 1122, 327418, 478, 90.60632520000217
479, 3.7806546627989612, 14.992541839537456, 18.044722943587605, 0.41020659999999987, 180.0, 491, 327909, 479, 39.840901999999915
480, 3.6472245951672253, 15.011459476656194, 18.065904967218852, 0.4087639000000001, 275.0, 1112, 329021, 480, 90.00796580000315
481, 4.217026332011552, 15.038797214519843, 18.138738704881757, 0.40688919999999984, 400.0, 971, 329992, 481, 78.5854451999985
482, 4.694141238600343, 15.096233043041858, 18.22094197325654, 0.40536009999999995, 150.0, 728, 330720, 482, 58.9867176000007
483, 4.080977955828567, 15.079717203144877, 18.153493881225586, 0.40396149999999986, 385.0, 826, 331546, 483, 66.7523758999996
484, 4.188210891282305, 15.087040915838651, 18.197257607823005, 0.40245669999999983, 190.0, 846, 332392, 484, 68.37341870000091
485, 4.231427352282357, 15.109522538023047, 18.196882652255418, 0.4006890999999999, 250.0, 1118, 333510, 485, 90.32352560000072
486, 4.188130147443525, 15.116463945845688, 18.209483842885994, 0.3992095, 50.0, 526, 334036, 486, 42.606642500002636
487, 4.277338675080731, 15.13222803083878, 18.233007222180927, 0.3979306, 175.0, 895, 334931, 487, 72.31576349999887
488, 3.7594817522867228, 15.116927201070903, 18.245885213216145, 0.39639610000000014, 95.0, 810, 335741, 488, 65.43237189999854
489, 3.6394924915645923, 15.094545302298592, 18.144170578827158, 0.39501730000000007, 225.0, 722, 336463, 489, 58.47929899999872
490, 3.750318162510748, 15.09131504067391, 18.178208124477234, 0.39356470000000016, 240.0, 892, 337355, 490, 72.1175703000008
491, 3.5818688806776358, 15.094200017449065, 18.171064981290407, 0.39208600000000016, 165.0, 751, 338106, 491, 60.90020519999962
492, 3.730872397128762, 15.096604365126376, 18.167385224043205, 0.3910743999999998, 35.0, 373, 338479, 492, 30.23509660000127
493, 3.831269333432022, 15.108115536958268, 18.188116662479143, 0.3902752, 65.0, 515, 338994, 493, 41.65639580000061
494, 3.9394290475146647, 15.121945833511584, 18.20919356101229, 0.3892159000000001, 150.0, 662, 339656, 494, 53.55102149999948
495, 4.004001806457253, 15.257611879180459, 18.39468952627743, 0.38800809999999997, 200.0, 680, 340336, 495, 54.971959600003174
496, 3.783676941921769, 15.39974014457024, 18.552471839514062, 0.38706219999999997, 130.0, 371, 340707, 496, 30.061332099998253
497, 3.664067755778768, 15.382395792172442, 18.526371556582337, 0.38620809999999994, 130.0, 578, 341285, 497, 46.68214390000139
498, 3.702745770333965, 15.394329475335216, 18.54957001036696, 0.3850786000000001, 175.0, 677, 341962, 498, 54.75655559999723
499, 3.354691212311785, 15.3867644047963, 18.524455109102576, 0.3834244000000001, 310.0, 1161, 343123, 499, 93.86198120000336
500, 3.723508844541949, 15.401363045166208, 18.572576248620578, 0.3815280999999998, 180.0, 946, 344069, 500, 76.67175169999973
501, 3.582236268316154, 15.404872154747999, 18.56149669929787, 0.38028790000000007, 95.0, 432, 344501, 501, 35.17845320000197
502, 3.873334561156098, 15.398762088978785, 18.573272806652906, 0.3791386, 195.0, 845, 345346, 502, 68.3633536999987
503, 3.8669047757593127, 15.415753309639337, 18.575737289109156, 0.3775185999999999, 350.0, 955, 346301, 503, 77.47539759999927
504, 3.9018248707994703, 15.413447310605386, 18.56420692308681, 0.37620189999999987, 130.0, 508, 346809, 504, 41.03695499999958
505, 3.3024062043208913, 15.427153795366584, 18.62453354249257, 0.37542699999999996, 50.0, 353, 347162, 505, 28.656790799999726
506, 3.162784762871571, 15.374421952262757, 18.476613677028336, 0.37437219999999977, 220.0, 819, 347981, 506, 66.4281418999999
507, 3.5607641988237138, 15.358245578282316, 18.46390050968654, 0.3733156, 30.0, 355, 348336, 507, 28.7593592000012
508, 3.544302455495429, 15.386795777201836, 18.490601253068686, 0.37241199999999997, 185.0, 649, 348985, 508, 52.68737230000261
509, 3.4863056087615747, 15.361286212069821, 18.471868320055673, 0.3712996, 20.0, 587, 349572, 509, 47.86833750000005
510, 3.4976519771801526, 15.361838953982117, 18.472621638800508, 0.37035280000000004, 105.0, 465, 350037, 510, 37.84179460000087
511, 4.549459517525719, 15.48726575720188, 18.64328024712, 0.36931959999999986, 150.0, 683, 350720, 511, 55.36662190000061
512, 4.239028531188023, 15.499166353020126, 18.66502935729341, 0.3681036999999999, 165.0, 668, 351388, 512, 54.36815209999986
513, 3.186220291763747, 15.485951234207672, 18.626918621452486, 0.366841, 260.0, 735, 352123, 513, 59.66267140000127
514, 4.281404030405336, 15.495530402838703, 18.622094140091207, 0.3653974000000001, 240.0, 869, 352992, 514, 70.61521939999875
515, 3.7852869794524016, 15.477610071166223, 18.622273292862065, 0.3637585, 320.0, 952, 353944, 515, 77.31706439999834
516, 3.8017664404930893, 15.481980163962753, 18.651257824014735, 0.36192969999999985, 370.0, 1080, 355024, 516, 87.43467570000212
517, 3.5730430326363547, 15.491422118466948, 18.653461814189853, 0.35973460000000007, 565.0, 1359, 356383, 517, 109.91897039999822
518, 2.999975615214228, 15.51014205438782, 18.65652901683471, 0.3580317999999999, 50.0, 533, 356916, 518, 43.16317469999922
519, 3.503964613304314, 15.498986065319135, 18.657913069730522, 0.35677, 305.0, 869, 357785, 519, 70.30522630000269
520, 3.3367587236590706, 15.484674679759081, 18.63595829534968, 0.35481069999999976, 415.0, 1308, 359093, 520, 105.98107660000096
521, 2.986660207758893, 15.504944558196016, 18.647326052319873, 0.3532239999999999, 70.0, 455, 359548, 521, 37.24035619999995
522, 3.6111062214118945, 15.567387438407053, 18.724324640364554, 0.35230240000000007, 80.0, 569, 360117, 522, 46.07258500000171
523, 4.2384087724520185, 15.83138991995765, 19.063209602336343, 0.3510901, 355.0, 778, 360895, 523, 63.1482173000004
524, 3.7163184048341855, 15.810014593357943, 19.04078902273762, 0.3496843, 240.0, 784, 361679, 524, 63.679885400000785
525, 3.1567466837855487, 15.79791407318382, 18.996530306089173, 0.3484638999999999, 125.0, 572, 362251, 525, 46.4045815999998
526, 3.842342464742573, 15.810431238693026, 19.03712944610877, 0.3475584999999998, 20.0, 434, 362685, 526, 35.45310170000084
527, 3.9594199536236405, 15.811046235809915, 19.051118784429484, 0.3464685999999999, 140.0, 777, 363462, 527, 63.060060600000725
528, 3.7977295412076426, 15.831356478806569, 19.081458740918627, 0.3447657999999998, 330.0, 1115, 364577, 528, 90.30075079999733
529, 3.549509055576883, 15.819843226366931, 19.040418057828337, 0.34316289999999994, 215.0, 666, 365243, 529, 54.03961730000083
530, 3.7655044423935076, 15.85731467155561, 19.084783473515618, 0.34177510000000005, 280.0, 876, 366119, 530, 71.5496813000027
531, 3.2628684280061457, 15.861730730965277, 19.07526235925786, 0.3403404999999999, 120.0, 718, 366837, 531, 58.37398490000123
532, 3.7356025093732894, 15.873705026133896, 19.090120966782045, 0.3389904999999999, 205.0, 782, 367619, 532, 63.409028100002615
533, 3.6131498877881865, 15.858014760031978, 19.08387171602395, 0.33769809999999995, 335.0, 654, 368273, 533, 53.03816480000023
534, 3.588646098316794, 15.877769622999876, 19.08998487901318, 0.3367612, 70.0, 387, 368660, 534, 31.526022599999123
535, 3.412282439820775, 15.866951990663335, 19.09499163752638, 0.33593229999999996, 105.0, 534, 369194, 535, 43.40553910000017
536, 3.8891010896412848, 15.918359438852569, 19.158914233611718, 0.33440860000000006, 560.0, 1159, 370353, 536, 94.20862869999837
537, 4.371634118508742, 16.041996348386554, 19.315408186278592, 0.3325869999999999, 325.0, 865, 371218, 537, 70.16065860000163
538, 3.3447042356846164, 16.024635858856573, 19.280660877169453, 0.3312198999999999, 70.0, 654, 371872, 538, 53.28467950000049
539, 4.429334550431119, 16.03277265805856, 19.310670645461283, 0.3297033999999998, 310.0, 1031, 372903, 539, 83.75080249999883
540, 3.77207763022057, 16.040743079040666, 19.296315996665655, 0.32797539999999986, 230.0, 889, 373792, 540, 72.0097695000004
541, 4.113537699416455, 16.043027940060156, 19.296625000719363, 0.32618260000000004, 590.0, 1103, 374895, 541, 89.46818340000027
542, 3.8056102489137698, 16.047278591405565, 19.316146993191442, 0.3243232, 260.0, 963, 375858, 542, 77.89178159999938
543, 3.78579113743828, 16.073171713819537, 19.33965012243024, 0.32291469999999994, 95.0, 602, 376460, 543, 48.84126819999801
544, 4.002330912099143, 16.079163094235074, 19.33949134911701, 0.3218076999999999, 65.0, 628, 377088, 544, 50.95607120000204
545, 3.940980942072515, 16.05760569562893, 19.298935777438665, 0.3207933999999999, 125.0, 499, 377587, 545, 40.46856639999896
546, 4.120554642866705, 16.082591497118226, 19.345478863582432, 0.3198628000000001, 35.0, 535, 378122, 546, 43.34217769999668
547, 3.9052976186067374, 16.073452298962415, 19.334160746840418, 0.3184326999999999, 350.0, 1054, 379176, 547, 85.40868979999868
548, 4.344598917245452, 16.08153180927554, 19.378724835735703, 0.3164437, 260.0, 1156, 380332, 548, 93.55381520000083
549, 3.7371295303617935, 16.052613208222287, 19.294646844331798, 0.31456449999999997, 240.0, 932, 381264, 549, 75.67041949999839
550, 3.5507807493775196, 16.050389504368066, 19.30232448371122, 0.3130615, 225.0, 738, 382002, 550, 59.87914570000066
551, 4.13609585933069, 16.05513314166701, 19.336231814548455, 0.31157559999999995, 345.0, 913, 382915, 551, 73.956399900002
552, 4.121932794335582, 16.088665942071188, 19.385328895049476, 0.30998709999999996, 200.0, 852, 383767, 552, 68.85624529999768
553, 4.312777687046023, 16.096155464972554, 19.390443529401505, 0.3087226, 45.0, 553, 384320, 553, 44.91531380000015
554, 3.870308478911718, 16.068848433176676, 19.35726619466146, 0.3075499, 270.0, 750, 385070, 554, 61.22521189999679
555, 4.457384304899538, 16.070458361977025, 19.32996309697153, 0.30631059999999993, 165.0, 627, 385697, 555, 50.994728900001064
556, 3.7338388249319348, 16.089170877292876, 19.351066436133557, 0.3050965, 195.0, 722, 386419, 556, 58.70169100000203
557, 5.007165850903751, 16.101197946316447, 19.402902485635042, 0.30387699999999995, 90.0, 633, 387052, 557, 51.533984800000326
558, 3.4122086562630205, 16.08316043847137, 19.349227544334198, 0.3027888999999999, 35.0, 576, 387628, 558, 46.716976700001396
559, 4.311890685009061, 16.093755604870896, 19.37590940820479, 0.3017431, 120.0, 586, 388214, 559, 47.4888099000018
560, 3.487128474491479, 16.083085401865095, 19.352953152853715, 0.30062799999999984, 85.0, 653, 388867, 560, 53.04581749999852
561, 3.885234856275888, 16.077211849307368, 19.34533609816506, 0.2992429, 275.0, 886, 389753, 561, 71.59483829999954
562, 3.287513315173231, 16.11557671986783, 19.37500334122285, 0.2978073999999999, 275.0, 709, 390462, 562, 57.463510400000814
563, 3.608688416346064, 16.140940335561645, 19.4117315220383, 0.2967876999999999, 75.0, 424, 390886, 563, 34.3354834999991
564, 4.407697975977727, 16.173898750655585, 19.46271542567052, 0.2955438999999999, 270.0, 958, 391844, 564, 77.58040180000171
565, 3.750334246959596, 16.141048283983103, 19.418171037258787, 0.2941110999999999, 190.0, 634, 392478, 565, 51.36144649999915
566, 4.295653785851742, 16.18201362954082, 19.46054052864518, 0.2928123999999999, 255.0, 809, 393287, 566, 65.45281819999946
567, 4.065801815536922, 16.158867627560735, 19.442781528313002, 0.29148309999999983, 105.0, 668, 393955, 567, 54.04669109999668
568, 4.439419551855988, 16.19689432779948, 19.4826277980098, 0.2905903, 50.0, 324, 394279, 568, 26.35206389999803
569, 4.050768058959061, 16.174047702696264, 19.444945702901702, 0.2897452000000001, 170.0, 615, 394894, 569, 49.990379900002154
570, 3.4870638939584553, 16.159174382785793, 19.42947872307852, 0.2886507999999999, 105.0, 601, 395495, 570, 48.66964150000058
571, 3.9546266992483035, 16.142969765960363, 19.405399622309822, 0.2874457, 285.0, 738, 396233, 571, 59.87883789999978
572, 3.4490200079139606, 16.13353857950599, 19.391045781979084, 0.2861893, 190.0, 658, 396891, 572, 53.25609659999827
573, 3.4630033989726363, 16.142004423363264, 19.42163709354199, 0.2847456999999999, 435.0, 946, 397837, 573, 76.34515800000008
574, 3.627822811202127, 16.176486196323317, 19.451048043958185, 0.2825713, 630.0, 1470, 399307, 574, 118.65006189999986
575, 4.530739057482335, 16.197907667178626, 19.473209581877057, 0.2807865999999999, 80.0, 513, 399820, 575, 41.48494230000142
576, 3.8697706462655748, 16.479313524791174, 19.816067404065812, 0.27969489999999986, 210.0, 700, 400520, 576, 56.70478209999783
577, 3.5264968796433727, 16.56211572955873, 19.916889238920422, 0.27799749999999995, 365.0, 1186, 401706, 577, 95.72219269999914
578, 3.7642843135860233, 16.55792737642924, 19.913999955919053, 0.2761200999999999, 135.0, 900, 402606, 578, 72.8533348000019
579, 4.176827737534266, 16.5842628159515, 19.9298759696871, 0.27477280000000004, 100.0, 597, 403203, 579, 48.456972800002404
580, 4.086744869561129, 16.562496058272558, 19.928624943757864, 0.2737827999999999, 155.0, 503, 403706, 580, 42.48116019999725
581, 4.192108748078794, 16.567239453600227, 19.9622245738475, 0.27237069999999997, 335.0, 1066, 404772, 581, 88.64156670000011
582, 4.155136798383199, 16.56504754434552, 19.909998305359778, 0.2707957000000001, 150.0, 684, 405456, 582, 55.402673500000674
583, 3.7674442807833355, 16.580720456441245, 19.944180919505932, 0.2698156, 40.0, 405, 405861, 583, 33.03619679999974
584, 3.9701097617623726, 16.557497659086874, 19.8885265271485, 0.2687545, 225.0, 774, 406635, 584, 62.54265700000178
585, 3.896644323326338, 16.543931467464557, 19.894789124449222, 0.26693110000000003, 350.0, 1252, 407887, 585, 101.21002130000124
586, 4.166406079413701, 16.55251333318605, 19.908054524989215, 0.26507079999999994, 370.0, 815, 408702, 586, 66.09826850000172
587, 4.627599963717964, 16.551702112790597, 19.898084461926462, 0.2634336999999999, 180.0, 1004, 409706, 587, 81.05527939999956
588, 3.3806131917632247, 16.607922676075695, 19.958745454769428, 0.26189019999999985, 135.0, 711, 410417, 588, 57.42792969999937
589, 4.5663857993025045, 16.686366918322804, 20.082426605643807, 0.2605950999999999, 75.0, 728, 411145, 589, 58.97964240000147
590, 4.634756430451359, 16.667424140941527, 20.054641317753564, 0.25933509999999993, 215.0, 672, 411817, 590, 54.200342800002545
591, 3.4378682644567755, 16.641735436983197, 19.995414634062865, 0.25824880000000006, 85.0, 535, 412352, 591, 43.233425200000056
592, 4.058480370414349, 16.676449866873966, 20.043732226665014, 0.25741899999999995, 50.0, 387, 412739, 592, 31.499195899999904
593, 4.165409744786969, 16.65986010455346, 20.02492853652599, 0.2563740999999999, 150.0, 774, 413513, 593, 62.62563070000033
594, 3.898464304770475, 16.656692547323818, 20.03390022098082, 0.2553336999999999, 55.0, 382, 413895, 594, 30.990335399998003
595, 3.91194519872621, 16.6575438931862, 20.025613959531608, 0.2544102999999999, 135.0, 644, 414539, 595, 52.162972699999955
596, 3.114180760578511, 16.629697522283053, 19.977838284162512, 0.2533572999999999, 40.0, 526, 415065, 596, 42.51525970000148
597, 4.675753949379885, 16.630747058110032, 20.011650598637193, 0.25228179999999994, 195.0, 669, 415734, 597, 53.90422629999739
598, 3.798227823158195, 16.65026278661207, 20.020540430175412, 0.251083, 165.0, 663, 416397, 598, 53.61388380000062
599, 3.986430271154678, 16.653950563846003, 20.01601869296945, 0.24944859999999983, 415.0, 1153, 417550, 599, 93.2007025999992
600, 4.116512075090181, 16.68795313888042, 20.07859051246462, 0.24727510000000003, 320.0, 1262, 418812, 600, 101.98159959999975
601, 3.569439746998459, 16.65132921567022, 20.019912277597594, 0.24533559999999996, 250.0, 893, 419705, 601, 71.9745726000001
602, 4.584575356267463, 16.67399366372805, 20.0413601166776, 0.24395769999999994, 110.0, 638, 420343, 602, 51.58119519999673
603, 3.7958552882543555, 16.682411119810094, 20.07850312393386, 0.24289659999999993, 110.0, 541, 420884, 603, 43.757512100000895
604, 3.9439894040115178, 16.67258059978485, 20.05936814347903, 0.24206410000000003, 25.0, 384, 421268, 604, 30.993747399999847
605, 4.196573747492232, 16.654256147030647, 20.040911138222818, 0.2413935999999999, 40.0, 361, 421629, 605, 29.31003409999903
606, 4.172357929318319, 16.669337653359875, 20.03041472453845, 0.2406132999999999, 105.0, 506, 422135, 606, 40.93387879999864
607, 3.891719197569716, 16.65340793497177, 20.033600003438224, 0.2393334999999999, 180.0, 916, 423051, 607, 74.14096119999886
608, 3.909057509976548, 16.654349754383038, 20.015717241361543, 0.23781609999999995, 165.0, 770, 423821, 608, 62.37983829999939
609, 3.1530371428523933, 16.64907235466973, 20.024552092367774, 0.2367972999999998, 70.0, 362, 424183, 609, 29.349734499999613
610, 4.0932790312977785, 16.669548767047694, 20.046068233679673, 0.23565699999999995, 480.0, 905, 425088, 610, 73.11196270000073
611, 5.237602167265125, 16.69471025466919, 20.09020441045206, 0.23450229999999989, 90.0, 378, 425466, 611, 30.625946500000282
612, 4.451427678025678, 16.63754647375652, 19.994826666167675, 0.23308839999999997, 495.0, 1193, 426659, 612, 96.47548050000114
613, 3.9930298907780335, 16.650374752910512, 20.0251424438075, 0.23146750000000002, 55.0, 608, 427267, 613, 49.280756300002395
614, 4.259152441082664, 16.655677759115463, 20.020476691679065, 0.23023449999999998, 175.0, 762, 428029, 614, 61.73703380000006
615, 4.618262649493085, 16.637187263700696, 20.026705810758802, 0.22922469999999992, 55.0, 360, 428389, 615, 29.09949659999984
616, 3.901523240512338, 16.646184978681163, 20.002193386509205, 0.22828779999999987, 195.0, 681, 429070, 616, 55.203667900001165
617, 4.115948769921178, 16.666642903631974, 20.041120160178203, 0.22701429999999992, 235.0, 734, 429804, 617, 59.27617939999982
618, 4.017509332573664, 16.78832276302701, 20.194907282396358, 0.22579659999999993, 95.0, 619, 430423, 618, 50.13456049999877
619, 4.366327391717142, 16.85248270971264, 20.255354279267763, 0.2247903999999999, 20.0, 499, 430922, 619, 40.31577879999895
620, 3.81255553469123, 16.83339572442051, 20.238623949147446, 0.2236834, 360.0, 731, 431653, 620, 59.11249889999817
621, 4.774834133613376, 16.849212253258408, 20.253004288952106, 0.22217859999999998, 145.0, 941, 432594, 621, 75.88826590000099
622, 4.263098470458636, 16.833219156787553, 20.23651371427772, 0.22088799999999995, 70.0, 493, 433087, 622, 39.85332969999945
623, 4.030572183059212, 16.819873291427168, 20.215362058140926, 0.21957669999999993, 345.0, 964, 434051, 623, 77.72549480000089
624, 4.324282626282148, 16.816776121994927, 20.215518334088372, 0.21808899999999998, 135.0, 689, 434740, 624, 55.67436660000021
625, 4.7239942527771, 16.827405535888673, 20.213380294799805, 0.21690639999999986, 125.0, 625, 435365, 625, 50.54224710000199
626, 4.666276136522586, 16.81718303539135, 20.22775085228676, 0.2153475999999999, 310.0, 1107, 436472, 626, 89.36659409999993
627, 3.8076558868524804, 16.800427343925946, 20.179185465363336, 0.21389859999999994, 25.0, 503, 436975, 627, 40.67109499999788
628, 4.094878071593487, 16.79830608818475, 20.206032436100518, 0.21287439999999994, 110.0, 635, 437610, 628, 51.279875000000175
629, 4.380953215900907, 16.804300791582975, 20.19669930290599, 0.2114469999999999, 280.0, 951, 438561, 629, 76.88041249999878
630, 4.468216417757072, 16.804519827507402, 20.201054864822456, 0.20980269999999995, 295.0, 876, 439437, 630, 70.79677810000067
631, 4.226721442239719, 16.98568132305672, 20.42390090984534, 0.20819979999999996, 295.0, 905, 440342, 631, 73.02862190000087
632, 4.537276196158508, 17.28644646144711, 20.780206634209502, 0.20641689999999996, 180.0, 1076, 441418, 632, 87.08238070000152
633, 4.497915105125226, 17.28417367964345, 20.80533107559251, 0.20485989999999996, 110.0, 654, 442072, 633, 52.783574000000954
634, 4.107331193676163, 17.29049560456941, 20.79270945550885, 0.20381319999999994, 65.0, 509, 442581, 634, 41.12528799999927
635, 4.808841840796907, 17.292147606191502, 20.785131135457, 0.2028439, 95.0, 568, 443149, 635, 45.91497099999833
636, 4.223016162993202, 17.286151885986328, 20.789390974601268, 0.20188539999999994, 180.0, 497, 443646, 636, 40.13603990000047
637, 4.600599127318928, 17.295477971292378, 20.794045934747917, 0.20058939999999995, 260.0, 943, 444589, 637, 76.21777549999751
638, 4.174280702011495, 17.266171438482743, 20.768363184868534, 0.19938519999999996, 105.0, 395, 444984, 638, 31.973372999997082
639, 3.8152816564123206, 17.28653716327988, 20.782917885468386, 0.19854819999999987, 90.0, 535, 445519, 639, 43.30710250000266
640, 4.173946024551722, 17.27571805770711, 20.78750903071882, 0.1970550999999999, 315.0, 1124, 446643, 640, 90.8435344999998
641, 4.124411257241062, 17.290014878809036, 20.785137945305518, 0.19539819999999994, 165.0, 717, 447360, 641, 58.06476889999976
642, 4.222384618538323, 17.30567791439334, 20.8122871045192, 0.1938987999999999, 255.0, 949, 448309, 642, 76.99037939999835
643, 4.71323575303492, 17.300547021670102, 20.798979090051038, 0.19229049999999995, 175.0, 838, 449147, 643, 67.7687814000019
644, 4.5154513586651195, 17.329245115473945, 20.84472518349714, 0.19069479999999997, 345.0, 935, 450082, 644, 75.59047350000037
645, 4.437245906002066, 17.62093620300293, 21.204063361950134, 0.1890522999999999, 455.0, 890, 450972, 645, 71.76508589999867
646, 4.3626480914919945, 17.64430510479471, 21.196865957941586, 0.1877752, 155.0, 529, 451501, 646, 42.70323339999959
647, 3.8764179706172106, 17.628037156213146, 21.190858943695172, 0.18649719999999997, 205.0, 891, 452392, 647, 72.00469010000234
648, 4.592584525805383, 17.63995096403605, 21.22246502413608, 0.1850589999999999, 195.0, 707, 453099, 648, 57.12046209999971
649, 4.092059274419339, 17.623019804354914, 21.197664758830726, 0.18367119999999995, 200.0, 835, 453934, 649, 67.46948490000068
650, 3.7732004647266897, 17.627907339492836, 21.200979968957732, 0.18256059999999993, 105.0, 399, 454333, 650, 32.261747299999115
651, 4.030108353734325, 17.615076365704994, 21.178550493501568, 0.1818531999999999, 95.0, 387, 454720, 651, 31.63507739999841
652, 4.079108041269438, 17.584616377694267, 21.153536393301827, 0.1811898999999999, 65.0, 350, 455070, 652, 28.436147899999924
653, 4.16512570798517, 17.59257204527826, 21.15936326117103, 0.18042759999999994, 120.0, 497, 455567, 653, 40.310600000000704
654, 4.0495896832148235, 17.591412346579812, 21.15066973368327, 0.1792377999999999, 255.0, 825, 456392, 654, 66.63929619999908
655, 4.110119601221979, 17.596598434952167, 21.166406951460846, 0.1778139999999999, 150.0, 757, 457149, 655, 61.26809250000224
656, 4.198138919627169, 17.586337281237963, 21.148320252313624, 0.17642079999999988, 160.0, 791, 457940, 656, 64.04694400000153
657, 4.086606477368746, 17.5696641877787, 21.1531742582258, 0.17516529999999997, 140.0, 604, 458544, 657, 48.96178730000247
658, 4.375251442743843, 17.612797533014163, 21.188086734926568, 0.17413389999999998, 135.0, 542, 459086, 658, 43.94220679999853
659, 4.691824168862191, 17.61411006911118, 21.20108492446048, 0.1725975999999999, 400.0, 1165, 460251, 659, 94.10572619999948
660, 4.122935734410337, 17.621129627533776, 21.20303659388088, 0.17087589999999997, 130.0, 748, 460999, 660, 60.364845900003274
661, 4.299564780566145, 17.64336543838465, 21.222179340696222, 0.16944129999999988, 155.0, 846, 461845, 661, 72.20365469999888
662, 4.443088113927841, 17.65614091796875, 21.25434542541504, 0.16811739999999994, 125.0, 625, 462470, 662, 65.14435369999774
663, 4.182624132282442, 17.645771339325382, 21.220858577020007, 0.16672599999999996, 410.0, 921, 463391, 663, 82.15602780000336
664, 4.538503910135673, 17.65735060014065, 21.252861018950583, 0.1654677999999999, 105.0, 477, 463868, 664, 42.22050339999987
665, 3.9590883047225027, 17.6404568603155, 21.224874327418725, 0.1644291999999999, 70.0, 677, 464545, 665, 60.09065779999946
666, 3.8195450051876776, 17.627780632954448, 21.227781807325808, 0.16335009999999991, 145.0, 522, 465067, 666, 48.25931209999908
667, 4.1981879134938005, 17.63159614576385, 21.207102285758562, 0.16185519999999995, 315.0, 1139, 466206, 667, 101.49717469999814
668, 4.821732915055773, 17.67218184340847, 21.26627970002388, 0.16033599999999995, 75.0, 549, 466755, 668, 47.657090299999254
669, 4.913500690422378, 17.691298708738465, 21.267880212363607, 0.1588491999999999, 575.0, 1103, 467858, 669, 95.776387599999
670, 4.892340122606492, 17.673956348410254, 21.253423143605715, 0.15708789999999992, 180.0, 854, 468712, 670, 74.64408039999762
671, 4.215081524177893, 17.668091597146546, 21.26532017579405, 0.15550389999999992, 325.0, 906, 469618, 671, 79.10014029999729
672, 4.472852885484058, 17.74151467766991, 21.33088268188232, 0.15401529999999997, 135.0, 748, 470366, 672, 65.01018629999817
673, 4.115266004676561, 17.751882879337625, 21.3585061412438, 0.15221079999999992, 410.0, 1257, 471623, 673, 109.4403091000022
674, 4.52828111136771, 17.74088703108916, 21.35461343229337, 0.15056379999999994, 70.0, 573, 472196, 674, 49.76296490000095
675, 4.370114977102457, 17.752130270406326, 21.358019991226584, 0.14951439999999996, 170.0, 593, 472789, 675, 51.37682439999844
676, 4.49747602177154, 17.74630939515776, 21.34442728549852, 0.1482327999999999, 450.0, 831, 473620, 676, 72.25572620000094
677, 4.542748574936625, 17.75990131898671, 21.37959255992403, 0.14648229999999993, 540.0, 1114, 474734, 677, 96.64052079999965
678, 4.794390342745089, 17.787409514765585, 21.372714061121787, 0.1449216999999999, 160.0, 620, 475354, 678, 53.95928410000124
679, 4.358933302556506, 17.75975913685548, 21.404097085166914, 0.1439289999999999, 60.0, 483, 475837, 679, 44.04113330000109
680, 4.18668332727822, 17.761144065543224, 21.378854555519002, 0.14239989999999994, 295.0, 1216, 477053, 680, 110.78690009999991
681, 4.818052909162424, 17.783746487916098, 21.402384258943933, 0.14047479999999996, 345.0, 923, 477976, 681, 87.49998649999907
682, 4.462455344271731, 17.78853455391732, 21.40024779150794, 0.13934439999999995, 75.0, 333, 478309, 682, 35.244853899999725
683, 4.3885036565898625, 17.779020420365892, 21.386113672463082, 0.13825539999999992, 155.0, 877, 479186, 683, 84.19127520000256
684, 4.995806101483206, 17.790354942089945, 21.404029751350865, 0.13681449999999995, 175.0, 724, 479910, 684, 64.76648909999858
685, 5.481233413060253, 17.58244581783519, 21.22291792974184, 0.13559679999999996, 130.0, 629, 480539, 685, 53.745005000000674
686, 4.7729768023080865, 17.5236990448506, 21.09744003444042, 0.13438179999999994, 210.0, 721, 481260, 686, 61.51056759999847
687, 5.089576063048644, 17.54780065974251, 21.133827146936635, 0.13263489999999994, 270.0, 1220, 482480, 687, 108.72540710000249
688, 5.443636972989355, 17.551193299087576, 21.1396561841236, 0.13045329999999994, 595.0, 1204, 483684, 688, 105.60742889999892
689, 4.921017504431298, 17.55332268496958, 21.131075631044656, 0.12800709999999996, 515.0, 1514, 485198, 689, 132.87126660000285
690, 4.902676119796955, 17.570949108801155, 21.16539064448942, 0.1260666999999999, 170.0, 642, 485840, 690, 53.651794899997185
691, 4.739219416376508, 17.562729516706643, 21.15922517379695, 0.1248615999999999, 155.0, 697, 486537, 691, 58.44563129999733
692, 4.954591124791365, 17.56174515944261, 21.144535342600552, 0.12323979999999993, 450.0, 1105, 487642, 692, 93.77296719999867
693, 4.613570870106, 17.549609804727947, 21.13143112573279, 0.12134889999999995, 185.0, 996, 488638, 693, 82.85912649999955
694, 4.592164741417804, 17.54205430947341, 21.1208556534408, 0.11989809999999997, 120.0, 616, 489254, 694, 51.487363899999764
695, 4.904852611978122, 17.551446942062977, 21.122386421920737, 0.11865429999999991, 205.0, 766, 490020, 695, 63.4687748000033
696, 5.050527085345569, 17.732346215970193, 21.348297878957542, 0.11730519999999996, 140.0, 733, 490753, 696, 60.689539899998636
697, 4.626245179438386, 17.74953158970537, 21.344704040165606, 0.11622789999999998, 80.0, 464, 491217, 697, 38.239550899997994
698, 5.634327770493995, 17.779994405549147, 21.38686024955821, 0.11523609999999994, 115.0, 638, 491855, 698, 54.47843970000031
699, 4.830722359100673, 17.749219777483592, 21.352436526068324, 0.11395719999999994, 175.0, 783, 492638, 699, 65.36880929999825
700, 5.208273531818712, 17.750708017263328, 21.362845790278804, 0.11245329999999992, 520.0, 888, 493526, 700, 74.30159889999777
701, 5.045346604023024, 17.743182398002837, 21.359192286696388, 0.11069109999999997, 535.0, 1070, 494596, 701, 93.83183469999858
702, 5.361341657117009, 17.782095324993133, 21.408121484518052, 0.10944009999999993, 25.0, 320, 494916, 702, 30.381166600000142
703, 4.88166865123255, 17.74634548769159, 21.348134580121386, 0.10856799999999987, 165.0, 649, 495565, 703, 55.54618250000203
704, 4.958789386562296, 17.799188840639342, 21.429346507603114, 0.10708299999999991, 295.0, 1001, 496566, 704, 82.8288520999995
705, 4.41748859623676, 17.787128489006633, 21.384160908654174, 0.10558899999999989, 190.0, 659, 497225, 705, 54.80539929999941
706, 5.24111434123954, 17.804103111734197, 21.393375743165308, 0.10455489999999991, 30.0, 490, 497715, 706, 40.55746600000202
707, 4.243198598303446, 17.793792222185832, 21.415434382989154, 0.10356039999999994, 120.0, 615, 498330, 707, 51.10593940000035
708, 5.48727776119505, 17.812760643769902, 21.457242876104623, 0.10214469999999994, 340.0, 958, 499288, 708, 79.60778390000269
709, 4.790073489466659, 17.853447240460362, 21.482078623158007, 0.1004355485224004, 430.0, 1049, 500337, 709, 86.99769469999956
710, 5.4726340217334375, 17.923052865515647, 21.565902782007903, 0.10000000000000088, 75.0, 503, 500840, 710, 41.59623179999835
711, 4.999774992465973, 17.919888270419577, 21.55798095620197, 0.09999999999999896, 135.0, 920, 501760, 711, 77.17660380000234
712, 4.8538166754412515, 17.9114215504695, 21.56216270576578, 0.10000000000000091, 105.0, 529, 502289, 712, 43.9424134999972
713, 5.940768698912213, 17.92420113452373, 21.563511694379624, 0.10000000000000087, 110.0, 489, 502778, 713, 40.71478239999851
714, 4.7395519795690495, 17.90566604652758, 21.562699291463456, 0.09999999999999791, 385.0, 1189, 503967, 714, 99.23598929999935
715, 4.747290461623987, 17.94730210320557, 21.583133393742006, 0.09999999999999724, 525.0, 1463, 505430, 715, 120.73614850000013
716, 4.653713990503283, 17.936096291043864, 21.588482378489935, 0.1000000000000007, 105.0, 670, 506100, 716, 55.18012480000107
717, 5.030721377124235, 17.94999728989702, 21.590820467186244, 0.09999999999999734, 500.0, 1418, 507518, 717, 116.66060800000196
718, 4.694663954113334, 17.97794928881964, 21.626960302978418, 0.09999999999999777, 380.0, 1238, 508756, 718, 101.94662959999914
719, 5.03800713168535, 18.000086063125227, 21.67162316161672, 0.09999999999999942, 315.0, 837, 509593, 719, 69.28241780000099
720, 5.379619950287948, 18.160074825417805, 21.865900674728287, 0.09999999999999921, 150.0, 874, 510467, 720, 74.46397170000273
721, 5.512717713199354, 18.246934303636568, 21.966115981958318, 0.10000000000000099, 105.0, 627, 511094, 721, 51.60457630000019
722, 4.618891211980987, 18.242391456412584, 21.9531234942884, 0.09999999999999815, 550.0, 1116, 512210, 722, 91.50371829999858
723, 4.598188911136514, 18.24674855512604, 21.952208065418326, 0.09999999999999917, 275.0, 881, 513091, 723, 74.26444940000147
724, 4.634100416846002, 18.244807057138914, 21.947643395252083, 0.09999999999999892, 375.0, 927, 514018, 724, 81.14181660000031
725, 5.263128604437854, 18.219835808327247, 21.876648974490237, 0.10000000000000062, 45.0, 333, 514351, 725, 29.603232299999945
726, 4.678830466729815, 18.22142302359137, 21.92355783014802, 0.10000000000000012, 225.0, 737, 515088, 726, 64.98308159999942
727, 5.0142443793422125, 18.210635149438225, 21.930517945273337, 0.09999999999999797, 285.0, 1172, 516260, 727, 102.98268739999912
728, 4.810582324760184, 18.22455733100664, 21.92636447094671, 0.1000000000000008, 65.0, 437, 516697, 728, 38.51313610000216
729, 4.59671605593289, 18.205243084126998, 21.896100425440956, 0.10000000000000057, 110.0, 683, 517380, 729, 59.95179160000407
730, 4.747064990747565, 18.203412032844255, 21.90416123124723, 0.09999999999999847, 220.0, 1031, 518411, 730, 90.38480920000438
731, 4.568533069984888, 18.2152769547834, 21.92118374782717, 0.09999999999999785, 490.0, 1209, 519620, 731, 105.98155150000093
732, 4.625842925219572, 18.389232896951288, 22.14930235424089, 0.09999999999999785, 470.0, 1211, 520831, 732, 106.02976460000355
733, 4.917193068930851, 18.45887383024896, 22.177820061918478, 0.10000000000000074, 55.0, 398, 521229, 733, 34.988137500004086
734, 4.709061287357914, 18.4203068679721, 22.14899069751024, 0.1000000000000009, 95.0, 517, 521746, 734, 45.31296199999633
735, 4.8260871657564595, 18.421428008752365, 22.175085999190443, 0.09999999999999956, 190.0, 815, 522561, 735, 71.60680000000139
736, 4.531621557412869, 18.425196688255724, 22.178306251895584, 0.1000000000000006, 305.0, 681, 523242, 736, 59.86336719999963
737, 5.605599790537404, 18.419374483486983, 22.199092882534835, 0.09999999999999994, 170.0, 761, 524003, 737, 66.76847909999924
738, 4.86270803557655, 18.4182729776195, 22.157625235114715, 0.10000000000000091, 165.0, 519, 524522, 738, 45.63987620000262
739, 4.370720658660605, 18.381149211626376, 22.1262478908796, 0.10000000000000032, 145.0, 712, 525234, 739, 62.63709870000457
740, 5.0962003546989765, 18.415367353474437, 22.148677416374348, 0.09999999999999956, 185.0, 815, 526049, 740, 71.81297439999616
741, 4.579294317411388, 18.409692296674173, 22.141158205023558, 0.09999999999999826, 140.0, 1085, 527134, 741, 95.52380779999658
742, 5.532960977160486, 18.411226862065533, 22.165842317137372, 0.09999999999999812, 435.0, 1126, 528260, 742, 98.98501860000397
743, 4.832359642439835, 18.395509059434943, 22.123551925215825, 0.10000000000000077, 80.0, 413, 528673, 743, 36.465637699999206
744, 5.013312576530136, 18.364957496225436, 22.098866435968986, 0.10000000000000003, 250.0, 749, 529422, 744, 65.86870009999984
745, 5.06162843454097, 18.33221380199705, 22.03447896809805, 0.10000000000000069, 120.0, 672, 530094, 745, 59.66208620000543
746, 4.774880131070143, 18.29671705180201, 22.001044389969877, 0.09999999999999767, 215.0, 1276, 531370, 746, 105.0180051999996
747, 4.812500503005051, 18.29623208394865, 21.999257268733714, 0.09999999999999885, 205.0, 943, 532313, 747, 76.60108089999994
748, 5.171455514401272, 18.271207583515423, 21.964828859838168, 0.09999999999999964, 150.0, 802, 533115, 748, 69.0372317999936
749, 4.824085113763227, 18.28269512204494, 22.002171276251087, 0.10000000000000075, 105.0, 409, 533524, 749, 35.93922770000063
750, 4.547830207089621, 18.2579154746906, 21.962163867987332, 0.09999999999999845, 275.0, 1034, 534558, 750, 91.02744679999887
751, 5.14005638973133, 18.27231845855713, 21.957315048011573, 0.10000000000000069, 30.0, 370, 534928, 751, 32.34954299999663
752, 4.224297959250328, 18.262246258102433, 21.961681888347666, 0.09999999999999924, 440.0, 869, 535797, 752, 75.78549120000389
753, 3.9521910437050356, 18.264260190859485, 21.942981726103657, 0.10000000000000055, 20.0, 311, 536108, 753, 27.248921300000802
754, 4.441605458436888, 18.234415507014795, 21.926877477501012, 0.10000000000000099, 80.0, 632, 536740, 754, 55.105007600002864
755, 4.710264686928239, 18.266444763471913, 21.949937446172846, 0.10000000000000053, 155.0, 688, 537428, 755, 60.114682999999786
756, 4.598727469699862, 18.254042104106098, 21.950733445475027, 0.09999999999999781, 270.0, 1222, 538650, 756, 106.5488897000032
757, 4.625915411289338, 18.287940027132375, 21.970543506240123, 0.10000000000000091, 110.0, 529, 539179, 757, 46.16584839999996
758, 4.290660007547986, 18.26939026745654, 21.966983790126786, 0.09999999999999996, 110.0, 757, 539936, 758, 66.17555670000002
759, 4.88416017163759, 18.57002426289964, 22.353946715935894, 0.10000000000000046, 95.0, 696, 540632, 759, 60.81074549999903
760, 4.613531951712098, 18.619537251009366, 22.355896003415626, 0.10000000000000091, 65.0, 521, 541153, 760, 45.462085399994976
761, 4.723388962627416, 18.600296654586177, 22.34664771256434, 0.10000000000000005, 95.0, 746, 541899, 761, 65.35369270000228
762, 4.683036023360526, 18.586572698490347, 22.339469646979236, 0.10000000000000071, 90.0, 668, 542567, 762, 58.32995189999929
763, 4.484098354768753, 18.592092539978026, 22.34573302459717, 0.09999999999999774, 410.0, 1250, 543817, 763, 109.21029569999519
764, 4.4354791683810095, 18.61622689229361, 22.376730631597294, 0.10000000000000096, 55.0, 644, 544461, 764, 56.442081200002576
765, 4.271027182370612, 18.586962370002794, 22.338702754854406, 0.0999999999999997, 200.0, 795, 545256, 765, 69.64270709999983
766, 4.710826002512917, 18.607889076073963, 22.36459676063422, 0.09999999999999837, 460.0, 1056, 546312, 766, 92.35521130000416
767, 5.08783285590424, 18.6292850143608, 22.47064559761135, 0.1000000000000008, 35.0, 435, 546747, 767, 38.16072310000163
768, 4.536902358006681, 18.643073528109703, 22.42765547243481, 0.10000000000000044, 120.0, 699, 547446, 768, 61.23952439999994
769, 4.473112067500846, 18.603054088195357, 22.3397256929707, 0.10000000000000077, 40.0, 413, 547859, 769, 36.22680609999952
770, 4.458251326095472, 18.615353431641207, 22.3771075930346, 0.10000000000000099, 85.0, 631, 548490, 770, 55.361550100002205
771, 4.372648107516102, 18.6395524715748, 22.393070211624934, 0.09999999999999849, 275.0, 1023, 549513, 771, 89.66015860000334
772, 4.482086723475563, 18.771790167139503, 22.583665184352707, 0.09999999999999934, 190.0, 851, 550364, 772, 74.59509239999898
773, 4.3619852023966175, 18.93795945410635, 22.790171443714815, 0.1000000000000009, 85.0, 510, 550874, 773, 44.72130499999912
774, 4.322422118613402, 18.941112603882267, 22.765058839475955, 0.09999999999999937, 215.0, 847, 551721, 774, 74.19958539999789
775, 5.03471648682138, 18.947913030619134, 22.801696211619593, 0.09999999999999824, 205.0, 1089, 552810, 775, 95.37360810000246
776, 3.834264891598509, 18.942345416607633, 22.768855534686942, 0.10000000000000073, 85.0, 386, 553196, 776, 33.865673200001766
777, 4.757776885421167, 18.937217249540485, 22.77047313810932, 0.09999999999999933, 335.0, 853, 554049, 777, 74.71525399999518
778, 4.703991956338286, 18.960155959129334, 22.809046506881714, 0.09999999999999966, 140.0, 800, 554849, 778, 70.00828620000539
779, 4.506499111113778, 18.940852573119013, 22.76972242148526, 0.10000000000000075, 130.0, 664, 555513, 779, 58.22126969999954
780, 4.468974166592275, 18.91715347710557, 22.74492585490069, 0.10000000000000099, 120.0, 635, 556148, 780, 55.635790300002554
781, 4.389467043306198, 18.90525176159443, 22.722779338345205, 0.09999999999999956, 240.0, 815, 556963, 781, 71.44000969999615
782, 4.839116008826216, 18.91654749920494, 22.76699907976882, 0.10000000000000091, 120.0, 532, 557495, 782, 46.63486209999974
783, 5.02750988205555, 18.919280709100747, 22.76282434045341, 0.10000000000000037, 130.0, 707, 558202, 783, 62.061382500003674
784, 4.999365074265945, 18.897801797640952, 22.728435484986555, 0.10000000000000098, 185.0, 608, 558810, 784, 53.32628280000063
785, 4.231484579685189, 18.8863612311227, 22.718582350867134, 0.09999999999999941, 145.0, 840, 559650, 785, 73.6425784000021
786, 4.961926688695821, 19.364870203895105, 23.295483081317133, 0.09999999999999903, 135.0, 907, 560557, 786, 83.36824499999784
787, 5.268297363815424, 19.698392740304794, 23.75386499669091, 0.10000000000000082, 215.0, 657, 561214, 787, 57.71615380000003
788, 4.459583456389351, 19.675917148952703, 23.677245072629514, 0.09999999999999758, 435.0, 1315, 562529, 788, 108.89454950000072
789, 4.8239084312669664, 19.72444143951663, 23.721817904638375, 0.09999999999999865, 310.0, 988, 563517, 789, 81.85924969999905
790, 4.475143164351871, 19.699475781572914, 23.679764191901807, 0.10000000000000069, 135.0, 671, 564188, 790, 59.71498050000082
791, 4.028730475698282, 19.719411672547807, 23.71210355069967, 0.09999999999999955, 420.0, 817, 565005, 791, 75.03374990000157
792, 4.058640844055584, 19.721720371927535, 23.754350503285725, 0.10000000000000062, 35.0, 336, 565341, 792, 29.598193300000275
793, 4.981580781070053, 19.70446408724954, 23.699188702495384, 0.10000000000000095, 115.0, 564, 565905, 793, 46.11871609999798
794, 4.4544211725886935, 19.703178836453347, 23.721154210585222, 0.09999999999999962, 215.0, 806, 566711, 794, 65.68173799999931
795, 4.433662671816073, 19.70965945873898, 23.680089264112144, 0.10000000000000073, 85.0, 389, 567100, 795, 31.88581829999748
796, 4.541357573914286, 19.69669718818278, 23.71968127470113, 0.1000000000000005, 155.0, 691, 567791, 796, 56.729942799996934
797, 4.6278417276665795, 19.713401345134145, 23.71529037249487, 0.09999999999999758, 420.0, 1316, 569107, 797, 111.51598460000241
798, 4.620175391847095, 19.717143288260615, 23.7230087483423, 0.09999999999999853, 335.0, 1014, 570121, 798, 90.33233100000507
799, 4.030567313138122, 19.787859734421072, 23.787838689148657, 0.09999999999999845, 320.0, 1036, 571157, 799, 92.3032349999994
800, 4.691862872713163, 19.811967935432584, 23.842262875946588, 0.09999999999999878, 160.0, 957, 572114, 800, 85.1383707999994
801, 4.506273256391099, 19.796581123631764, 23.81828804353697, 0.09999999999999973, 125.0, 791, 572905, 801, 70.55783579999843
802, 4.729289516715184, 19.83822351291867, 23.85769630502338, 0.10000000000000088, 75.0, 652, 573557, 802, 54.04159059999802
803, 4.757619574786055, 19.80914024159878, 23.820940476429612, 0.09999999999999924, 455.0, 869, 574426, 803, 77.1842747999981
804, 4.603651380692934, 19.80931279724492, 23.83675750338198, 0.10000000000000081, 210.0, 658, 575084, 804, 56.35301270000491
805, 4.585326178541273, 19.789472402944554, 23.827154501635537, 0.09999999999999877, 130.0, 959, 576043, 805, 83.26139340000373
806, 3.9543912121470446, 19.770290653300094, 23.793552109946763, 0.09999999999999812, 235.0, 1123, 577166, 806, 95.77947259999928
807, 4.418954188793098, 19.794385022015387, 23.80893109476274, 0.09999999999999931, 235.0, 857, 578023, 807, 72.45439510000142
808, 4.213835315944495, 19.829927846005088, 23.876231693745524, 0.0999999999999982, 430.0, 1102, 579125, 808, 93.0958912999995
809, 4.441559113121177, 19.80272401916782, 23.814951689724495, 0.10000000000000081, 250.0, 659, 579784, 809, 55.549934000002395
810, 4.8871219112175455, 19.78431823399289, 23.82790777077629, 0.10000000000000099, 145.0, 622, 580406, 810, 51.971523300002445
811, 4.261745860372536, 19.755775607513545, 23.783055322179536, 0.09999999999999848, 505.0, 1028, 581434, 811, 85.55291260000376
812, 5.2416776784694346, 19.747515671564482, 23.767586452205006, 0.10000000000000045, 205.0, 697, 582131, 812, 58.22542610000528
813, 4.345173790635942, 19.71684291694738, 23.71160005497027, 0.10000000000000074, 25.0, 395, 582526, 813, 32.74924260000262
814, 3.781165180032345, 19.725299061623765, 23.740457309673783, 0.10000000000000084, 45.0, 466, 582992, 814, 38.03401400000439
815, 4.543700050702993, 19.73619697957799, 23.755639659494594, 0.10000000000000052, 95.0, 690, 583682, 815, 57.1158276999995
816, 4.6655852065795855, 19.739924773708932, 23.778524413209666, 0.09999999999999756, 340.0, 1324, 585006, 816, 108.44331099999545
817, 5.021963396154601, 19.72334185633166, 23.755889611956718, 0.1000000000000008, 80.0, 435, 585441, 817, 35.656329400000686
818, 4.642430213364688, 19.759643004446318, 23.763207769682914, 0.0999999999999995, 185.0, 825, 586266, 818, 68.08645620000607
819, 4.474060533048888, 19.773894719705055, 23.78687587810797, 0.0999999999999982, 140.0, 1101, 587367, 819, 91.4224424999993
820, 4.612815707399134, 19.76624013666521, 23.78758732756676, 0.1000000000000009, 95.0, 513, 587880, 820, 42.558708900003694
821, 4.860699375498761, 19.808514174872023, 23.841422581248437, 0.09999999999999737, 820.0, 1405, 589285, 821, 119.78716420000274
822, 4.22274981960522, 19.752522402504198, 23.770581292851993, 0.09999999999999812, 325.0, 1126, 590411, 822, 96.60592370000086
823, 4.567926193183879, 19.73515801462699, 23.747901846837667, 0.09999999999999853, 365.0, 1013, 591424, 823, 87.24493029999576
824, 4.936055779098028, 19.71971874543462, 23.720704653176917, 0.10000000000000088, 15.0, 498, 591922, 824, 43.001420900000085
825, 5.248022924373525, 19.722071066135314, 23.741230129402652, 0.10000000000000082, 110.0, 451, 592373, 825, 38.98574309999822
826, 4.44494731373126, 19.707182736916117, 23.708846505797734, 0.09999999999999855, 215.0, 1010, 593383, 826, 86.9166327999992
827, 4.698005939188179, 19.72827284175194, 23.74694295309804, 0.10000000000000087, 35.0, 489, 593872, 827, 42.01112959999591
828, 5.162118798141379, 19.744959314778065, 23.75139855108835, 0.0999999999999984, 510.0, 1047, 594919, 828, 89.90339220000169
829, 4.512297047569847, 19.730853007838633, 23.73421793829775, 0.10000000000000085, 150.0, 654, 595573, 829, 56.29175039999973
830, 4.79990002148187, 19.7411008806371, 23.749236829956967, 0.1000000000000007, 125.0, 670, 596243, 830, 57.496862499996496
831, 3.9777629592560775, 19.733487239736593, 23.759850220964445, 0.10000000000000098, 155.0, 604, 596847, 831, 51.77388459999929
832, 5.011758879300148, 19.744492964769798, 23.763422870131397, 0.10000000000000071, 75.0, 378, 597225, 832, 33.58417489999556
833, 4.803591205778754, 19.725611268212845, 23.74433800487641, 0.09999999999999826, 300.0, 1087, 598312, 833, 93.68126270000357
834, 4.531525010915146, 19.70509120472816, 23.689323682704593, 0.09999999999999833, 715.0, 1067, 599379, 834, 94.10392380000121
835, 4.677842773199082, 19.757407970428467, 23.78757264137268, 0.09999999999999966, 260.0, 800, 600179, 835, 74.5830386000016
836, 5.549857710986524, 20.002624960203427, 24.15422082849451, 0.10000000000000069, 15.0, 370, 600549, 836, 33.60798739999882
837, 5.474128319407409, 19.997118228136618, 24.075891690684063, 0.10000000000000085, 60.0, 477, 601026, 837, 53.654825000005076
838, 4.8475975630113055, 19.988156149727956, 24.06442251750401, 0.10000000000000042, 380.0, 700, 601726, 838, 76.24380989999918
839, 5.183406699098583, 19.957241924400005, 24.014635461008446, 0.09999999999999888, 270.0, 936, 602662, 839, 102.77056289999746
840, 5.291901414922203, 19.97726211490401, 24.047268264264947, 0.10000000000000075, 80.0, 664, 603326, 840, 66.17026750000514
841, 5.147434474268091, 19.97457072931692, 24.062447092948705, 0.10000000000000085, 155.0, 654, 603980, 841, 60.693828499999654
842, 4.5060684503442445, 19.95137240207707, 24.033374091893705, 0.09999999999999988, 125.0, 769, 604749, 842, 71.41256299999804
843, 5.264035832000816, 20.015213472117548, 24.109297868479853, 0.09999999999999803, 340.0, 1150, 605899, 843, 106.15179720000015
844, 5.230739438607046, 20.00390874345225, 24.08162397831757, 0.09999999999999808, 315.0, 1139, 607038, 844, 105.15496739999799
845, 5.905159383842891, 20.002119161865927, 24.076124250888824, 0.10000000000000066, 80.0, 352, 607390, 845, 32.77441729999555
846, 4.594561605575757, 19.9512455475636, 24.00897919092423, 0.10000000000000073, 60.0, 390, 607780, 846, 36.06861729999946
847, 5.456846355336957, 19.956258413714295, 24.02851207699396, 0.10000000000000063, 130.0, 678, 608458, 847, 62.879167499995674
848, 4.160884023577203, 19.93944024530076, 24.00880220427768, 0.10000000000000085, 150.0, 655, 609113, 848, 60.37070279999898
849, 5.193624156847313, 19.957534104843006, 24.05688802030626, 0.10000000000000095, 200.0, 579, 609692, 849, 53.77197239999805
850, 5.185400049110036, 20.038438367319632, 24.126105574024464, 0.10000000000000092, 110.0, 546, 610238, 850, 50.626577799994266
851, 5.00507726221786, 20.208188430668887, 24.311149921689417, 0.099999999999999, 265.0, 911, 611149, 851, 84.16811939999752
852, 5.2497987026836785, 20.208377353647812, 24.326906326620335, 0.1000000000000007, 90.0, 374, 611523, 852, 34.62082250000094
853, 5.3542143847092545, 20.24513177159238, 24.39980599946744, 0.09999999999999816, 475.0, 1111, 612634, 853, 102.12793809999857
854, 5.203466141967467, 20.252495736903107, 24.383182905569402, 0.10000000000000088, 20.0, 497, 613131, 854, 45.72831260000385
855, 5.111406238427323, 20.256460764167013, 24.392102940162914, 0.09999999999999912, 205.0, 890, 614021, 855, 82.43349499999749
856, 5.608074720800439, 20.3018411077701, 24.438734790068153, 0.09999999999999802, 555.0, 1154, 615175, 856, 106.90383460000157
857, 5.137559459026043, 20.25511989886944, 24.38045432457557, 0.10000000000000059, 15.0, 325, 615500, 857, 30.10450800000399
858, 5.148743460636685, 20.245627803061392, 24.3682075843733, 0.10000000000000087, 110.0, 489, 615989, 858, 45.19006210000225
859, 5.156223554068832, 20.258271558137867, 24.369547434440722, 0.09999999999999837, 335.0, 1055, 617044, 859, 97.0988870000001
860, 5.456645809188485, 20.270524990558624, 24.396159224510193, 0.09999999999999966, 185.0, 800, 617844, 860, 74.06097049999516
861, 5.530144440299632, 20.260791487406117, 24.398551538177994, 0.09999999999999823, 205.0, 1094, 618938, 861, 100.77097469999717
862, 5.885817402235509, 20.275058449006593, 24.40246281853165, 0.10000000000000098, 105.0, 603, 619541, 862, 55.47898870000063
863, 5.277704491143924, 20.34725098486958, 24.503799984994796, 0.10000000000000045, 155.0, 698, 620239, 863, 65.68077320000157
864, 5.125404073091081, 20.525510585624232, 24.6998065793756, 0.10000000000000099, 145.0, 641, 620880, 864, 59.023839900000894
865, 5.229573059636808, 20.521904552429408, 24.697481326429042, 0.09999999999999917, 235.0, 881, 621761, 865, 81.22456989999773
866, 5.256868659712985, 20.540211991512056, 24.729704814126723, 0.10000000000000092, 120.0, 647, 622408, 866, 59.6716121999998
867, 4.634555646846461, 20.509859356769297, 24.6626448132271, 0.10000000000000063, 35.0, 344, 622752, 867, 31.9118010999955
868, 5.997109473860541, 20.5260851749154, 24.71755090166432, 0.10000000000000095, 170.0, 645, 623397, 868, 59.49355050000304
869, 5.475373008671929, 20.49820695931096, 24.708815227666452, 0.10000000000000084, 105.0, 459, 623856, 869, 42.7956617000018
870, 5.135815713565653, 20.486814246596612, 24.685694979774045, 0.09999999999999853, 250.0, 1013, 624869, 870, 93.01690589999635
871, 4.545462507293338, 20.477131053379605, 24.657907043184554, 0.09999999999999941, 270.0, 840, 625709, 871, 77.68225399999938
872, 5.117749195207249, 20.455887052145872, 24.647890654477205, 0.1000000000000004, 120.0, 704, 626413, 872, 65.76567519999662
873, 4.857112023724269, 20.4484061280342, 24.611559969105134, 0.10000000000000096, 180.0, 584, 626997, 873, 53.981413800000155
874, 5.349907499712867, 20.464310693058565, 24.66864148914719, 0.10000000000000099, 160.0, 629, 627626, 874, 58.25061149999965
875, 5.342004338517642, 20.44037564682993, 24.620980059428263, 0.1000000000000002, 190.0, 727, 628353, 875, 67.26253500000166
876, 4.993280745223983, 20.46310339655195, 24.638199041177938, 0.10000000000000019, 140.0, 728, 629081, 876, 66.86787230000482
877, 5.013257466143731, 20.449488196710142, 24.625791778468123, 0.09999999999999971, 380.0, 792, 629873, 877, 72.86747450000257
878, 5.279766824177947, 20.684506132796002, 24.891601353845388, 0.09999999999999983, 150.0, 777, 630650, 878, 71.37130639999668
879, 5.092028766248935, 20.732029861466945, 24.94518132215012, 0.099999999999999, 260.0, 911, 631561, 879, 83.77063050000288
880, 5.016245222078385, 20.71072884201339, 24.94194903208925, 0.09999999999999909, 280.0, 897, 632458, 880, 82.52825879999727
881, 5.116267933018614, 20.740062446973084, 24.95987244031191, 0.09999999999999759, 435.0, 1309, 633767, 881, 120.3978810999979
882, 5.339460360851313, 20.777916296330154, 25.009818384316993, 0.09999999999999809, 200.0, 1133, 634900, 882, 103.95588150000549
883, 5.1167718802833795, 20.809563619053495, 25.08820924912539, 0.09999999999999962, 265.0, 807, 635707, 883, 84.30388830000447
884, 4.906179970931545, 20.806999515201046, 25.060254591629217, 0.10000000000000023, 195.0, 723, 636430, 884, 85.37810259999969
885, 5.474201235632178, 20.807493142150957, 25.07356255921725, 0.09999999999999974, 170.0, 789, 637219, 885, 93.27229399999487
886, 5.914750110211774, 20.846060565698927, 25.108143740502474, 0.10000000000000092, 80.0, 535, 637754, 886, 63.03302000000258
887, 5.378074953054127, 20.81936279296875, 25.05772217198422, 0.10000000000000085, 80.0, 475, 638229, 887, 54.05765409999731
888, 5.40012044653748, 20.814817725287543, 25.051500451444376, 0.10000000000000088, 90.0, 495, 638724, 888, 57.37440020000213
889, 5.467354555758992, 20.840782716450775, 25.086332810434733, 0.09999999999999877, 225.0, 959, 639683, 889, 109.91586529999768
890, 5.232705444030847, 20.887159202456207, 25.158897984481232, 0.10000000000000081, 90.0, 447, 640130, 890, 51.568060600002354
891, 6.0854709683571, 21.057624650933555, 25.374477227729326, 0.09999999999999971, 250.0, 793, 640923, 891, 91.67926730000181
892, 5.219147368232803, 21.044763857775397, 25.312485927166325, 0.09999999999999855, 220.0, 1010, 641933, 892, 117.64233300000342
893, 4.810983855993912, 21.052608033458917, 25.332031849372406, 0.1000000000000006, 170.0, 681, 642614, 893, 82.07723139999871
894, 5.022691630875623, 21.054382267704717, 25.326718934377034, 0.10000000000000092, 80.0, 540, 643154, 894, 61.82898120000027
895, 5.461941988844621, 21.047126862211464, 25.348241402434482, 0.09999999999999891, 210.0, 931, 644085, 895, 100.72453629999654
896, 4.646552008349958, 21.051455417266755, 25.349586642216295, 0.09999999999999847, 190.0, 1031, 645116, 896, 106.32608959999925
897, 5.671441002015056, 21.0516914105347, 25.409074597508997, 0.10000000000000064, 45.0, 349, 645465, 897, 39.65983690000576
898, 5.056902032607311, 21.030028142155828, 25.29314255070042, 0.10000000000000069, 55.0, 370, 645835, 898, 41.24109210000461
899, 4.968286863019911, 21.027690314168986, 25.320765925261934, 0.09999999999999915, 225.0, 885, 646720, 899, 100.38713709999865
900, 5.4363038170292235, 21.059948711564914, 25.35413823254984, 0.09999999999999976, 215.0, 787, 647507, 900, 92.11155119999603
901, 5.27797927913741, 21.026334962338595, 25.313247133361727, 0.10000000000000045, 170.0, 697, 648204, 901, 76.87042680000013
902, 5.065377984377329, 21.0109898689832, 25.298775012127024, 0.09999999999999966, 160.0, 801, 649005, 902, 91.18546310000238
903, 5.529128319122398, 21.00600561256201, 25.283653510244267, 0.0999999999999982, 490.0, 1102, 650107, 903, 125.0688308999961
904, 5.634478375744611, 21.014536469689897, 25.297156745710122, 0.09999999999999967, 195.0, 799, 650906, 904, 90.31404830000247
905, 5.565392369899133, 21.005850833778293, 25.278063432724316, 0.09999999999999926, 235.0, 866, 651772, 905, 97.20427280000149
906, 4.941001174031855, 21.01376811733997, 25.29424301884226, 0.09999999999999976, 255.0, 787, 652559, 906, 88.65190119999897
907, 5.282559170737499, 21.0113398226296, 25.260980199022992, 0.09999999999999953, 350.0, 820, 653379, 907, 93.15952790000301
908, 5.040466093247937, 20.98750106116626, 25.239590668361597, 0.10000000000000091, 55.0, 527, 653906, 908, 59.526027399995655
909, 4.932524862308656, 21.01359643731066, 25.31784749287431, 0.1000000000000007, 65.0, 372, 654278, 909, 42.2361366000041
910, 4.6845684536784855, 20.99416043363126, 25.2632727436682, 0.09999999999999883, 310.0, 947, 655225, 910, 109.20855460000166
911, 5.01510147292305, 21.01274098996763, 25.27073782108448, 0.10000000000000092, 80.0, 540, 655765, 911, 61.22048790000554
912, 5.155010493419, 21.00317441735949, 25.296415397099086, 0.09999999999999813, 210.0, 1120, 656885, 912, 126.64085400000477
913, 4.528566867080825, 21.03193228319691, 25.290997444227227, 0.09999999999999895, 480.0, 923, 657808, 913, 103.02675730000192
914, 5.171491300331727, 21.05046290113726, 25.326840779253544, 0.0999999999999984, 630.0, 1048, 658856, 914, 116.93999650000478
915, 5.973809461910791, 21.06748936854371, 25.346788833338188, 0.10000000000000092, 120.0, 545, 659401, 915, 61.10972729999776
916, 6.185284008582433, 21.093483358664233, 25.411050616415785, 0.10000000000000044, 160.0, 699, 660100, 916, 78.7627066999994
917, 5.436395395293976, 21.185178151794236, 25.50125669429989, 0.09999999999999777, 710.0, 1236, 661336, 917, 142.12070929999754
918, 5.4388340186396755, 21.1643906388444, 25.47166062441361, 0.09999999999999898, 225.0, 917, 662253, 918, 102.62862390000373
919, 5.348189899517644, 21.19189826596168, 25.50797223737163, 0.10000000000000099, 100.0, 620, 662873, 919, 69.11199579999811
920, 5.92986807293573, 21.19344505686669, 25.52689945318137, 0.10000000000000099, 110.0, 628, 663501, 920, 69.67466189999686
921, 5.23093409311365, 21.153054611249402, 25.470100543715738, 0.10000000000000066, 55.0, 352, 663853, 921, 39.74403439999878
922, 5.5665951384215795, 21.168879481724332, 25.47324107835273, 0.10000000000000096, 65.0, 595, 664448, 922, 67.92014070000005
923, 5.251790469162925, 21.177278311601242, 25.478018408511907, 0.09999999999999748, 390.0, 1354, 665802, 923, 152.04812330000277
924, 5.5482230994886566, 21.207112010474344, 25.54287617137131, 0.09999999999999847, 265.0, 1030, 666832, 924, 117.36427759999788
925, 4.800165473916459, 21.2355345403869, 25.55716738812501, 0.10000000000000096, 120.0, 598, 667430, 925, 69.20783410000149
926, 5.414187014309181, 21.237161171725052, 25.56433434535888, 0.09999999999999729, 525.0, 1445, 668875, 926, 167.7533001999982
927, 5.190610575070808, 21.243400936043418, 25.581908057350258, 0.09999999999999898, 165.0, 916, 669791, 927, 95.45637900000293
928, 5.652170037897939, 21.173501544528538, 25.454910783972192, 0.1000000000000009, 140.0, 513, 670304, 928, 44.34361150000041
929, 5.016655007976122, 21.102090778477706, 25.38149409706471, 0.09999999999999906, 295.0, 902, 671206, 929, 77.7238021000012
930, 5.417615826412574, 21.10611273185494, 25.386069307622222, 0.09999999999999873, 245.0, 970, 672176, 930, 87.04523889999837
931, 5.125148294694748, 21.107757287019915, 25.403413617514012, 0.09999999999999928, 170.0, 861, 673037, 931, 79.95429420000437
932, 5.891839493723476, 21.094141968158112, 25.392790636762516, 0.10000000000000031, 60.0, 714, 673751, 932, 66.0659936000011
933, 5.3821579659565275, 21.08720632100966, 25.375394928960635, 0.10000000000000099, 160.0, 637, 674388, 933, 59.27996279999934
934, 5.1974834954330005, 21.094730536379863, 25.41142660956802, 0.10000000000000069, 175.0, 671, 675059, 934, 62.325736699996924
935, 4.934626435371767, 21.05557386099574, 25.306228752595832, 0.10000000000000077, 50.0, 415, 675474, 935, 38.61920890000329
936, 4.6877272811789, 21.04088691456131, 25.31500513182337, 0.09999999999999983, 210.0, 777, 676251, 936, 72.27390879999439
937, 4.883341642455284, 21.05405371233543, 25.345048907380665, 0.10000000000000096, 155.0, 644, 676895, 937, 59.72374899999704
938, 4.9878854859451796, 21.045817340963904, 25.332228165148944, 0.10000000000000099, 115.0, 641, 677536, 938, 59.675949099997524
939, 5.352010604370846, 21.049437123355283, 25.314391633672088, 0.10000000000000099, 105.0, 623, 678159, 939, 57.80774290000409
940, 5.068790621227688, 21.0490421407363, 25.34444779352425, 0.10000000000000098, 55.0, 612, 678771, 940, 56.86916960000235
941, 5.2545355031260454, 21.06294017928452, 25.35942140781025, 0.09999999999999797, 370.0, 1172, 679943, 941, 108.46820809999917
942, 4.960575492161292, 20.975200686984593, 25.23853706077293, 0.0999999999999975, 475.0, 1350, 681293, 942, 125.05670889999601
943, 5.558944508769458, 20.981429788403045, 25.241739846709976, 0.10000000000000091, 100.0, 532, 681825, 943, 49.41681239999889
944, 4.947563978476894, 20.97562611910265, 25.23474597837319, 0.0999999999999985, 275.0, 1019, 682844, 944, 94.4174320999955
945, 5.268872307702059, 20.987969032237366, 25.23120637208594, 0.09999999999999745, 350.0, 1367, 684211, 945, 126.75585170000704
946, 5.0007451650090315, 20.923812584902244, 25.16718876172626, 0.09999999999999716, 290.0, 1512, 685723, 946, 140.2352944000013
947, 4.561877856758433, 20.916638834370588, 25.156203452514834, 0.10000000000000087, 155.0, 653, 686376, 947, 60.63575860000128
948, 5.045608334650878, 20.891431674915538, 25.13803530469765, 0.09999999999999899, 175.0, 914, 687290, 948, 84.55391170000075
949, 4.713693788858737, 20.880124214602834, 25.129656417315463, 0.09999999999999945, 140.0, 833, 688123, 949, 77.21222810000472
950, 4.971872225338142, 20.86706157717936, 25.10349345102184, 0.10000000000000082, 110.0, 454, 688577, 950, 42.11179300000367
951, 4.973521816194727, 20.87918061245693, 25.13363491015488, 0.10000000000000081, 65.0, 445, 689022, 951, 41.282603499996185
952, 4.805227143054413, 20.863549157242332, 25.11542431607519, 0.09999999999999853, 325.0, 1014, 690036, 952, 94.24373230000492
953, 3.992009399812433, 20.74613368843175, 24.943387058113196, 0.10000000000000074, 30.0, 395, 690431, 953, 36.92113219999737
954, 5.3523355781901305, 20.73487008245368, 24.942960289486667, 0.099999999999999, 385.0, 912, 691343, 954, 84.52147269999841
955, 5.225040062563968, 20.782957438296066, 25.004900862388844, 0.09999999999999867, 240.0, 982, 692325, 955, 90.9969179999971
956, 5.2340002354846495, 20.77792707263914, 25.005233960273937, 0.09999999999999838, 295.0, 1053, 693378, 956, 97.5565859000053
957, 4.365257903419692, 20.76923963791898, 24.990646443023202, 0.100000000000001, 40.0, 638, 694016, 957, 59.36076559999492
958, 5.243614708858497, 20.770042675671537, 24.989665748718895, 0.09999999999999837, 245.0, 1057, 695073, 958, 97.79073739999876
959, 5.1904203701310045, 20.74458632120272, 24.979037857055665, 0.10000000000000077, 65.0, 410, 695483, 959, 38.19682489999832
960, 4.746453648971763, 20.74193180562727, 24.953634873499855, 0.09999999999999803, 225.0, 1148, 696631, 960, 106.41986039999756
961, 5.413148836228679, 20.729400756217636, 24.963369143164453, 0.1000000000000005, 190.0, 691, 697322, 961, 64.12593059999926
962, 5.142466945118374, 20.76458370732326, 25.00065286424425, 0.09999999999999991, 160.0, 765, 698087, 962, 70.98320120000426
963, 4.679860692867574, 20.740251454901188, 24.952191980172557, 0.0999999999999981, 295.0, 1128, 699215, 963, 104.55293379999785
964, 4.517131648834487, 20.72430748903662, 24.929264688133298, 0.10000000000000074, 165.0, 665, 699880, 964, 61.461136999998416
965, 4.668081724583118, 20.826166366228154, 25.061159035756596, 0.09999999999999704, 435.0, 1574, 701454, 965, 145.65016539999488
966, 4.726369313659426, 20.83076363335704, 25.085831619972407, 0.10000000000000085, 80.0, 473, 701927, 966, 43.773666400004004
967, 5.720909889573636, 20.870750868424125, 25.112101175059443, 0.10000000000000095, 160.0, 575, 702502, 967, 53.40749700000015
968, 5.343680060348627, 20.840905511306108, 25.07898295388875, 0.09999999999999869, 195.0, 978, 703480, 968, 90.52751110000099
969, 5.2107926494894965, 20.87151553525394, 25.09719807819361, 0.10000000000000042, 65.0, 701, 704181, 969, 65.04888070000015
970, 5.302895747563419, 20.827121659176346, 25.05476722562531, 0.09999999999999866, 525.0, 986, 705167, 970, 91.45271190000494
971, 4.881655450560089, 20.81640792640186, 25.0463148453976, 0.10000000000000041, 160.0, 702, 705869, 971, 65.04481330000272
972, 4.81938342077022, 20.802831040331597, 25.010040674454128, 0.1000000000000009, 95.0, 507, 706376, 972, 47.14638539999578
973, 5.551968754327605, 20.812224592229978, 25.037217048701326, 0.10000000000000092, 65.0, 542, 706918, 973, 50.459261299998616
974, 4.50275644670453, 20.768702532115736, 24.99965331763552, 0.09999999999999806, 300.0, 1140, 708058, 974, 105.70488819999446
975, 4.213163688410645, 20.75637367726158, 24.969188683901038, 0.10000000000000098, 150.0, 607, 708665, 975, 56.85881519999384
976, 5.14924128650653, 20.74815239125751, 24.94272951716542, 0.10000000000000098, 185.0, 617, 709282, 976, 57.45413600000029
977, 4.358839705307907, 20.73885254770796, 24.96684158405411, 0.09999999999999931, 320.0, 856, 710138, 977, 79.6996325
978, 4.978346872958163, 20.93304244140424, 25.156722196047937, 0.10000000000000098, 25.0, 607, 710745, 978, 56.41900599999644
979, 5.235269352839827, 20.8961442793855, 25.12526823935494, 0.10000000000000094, 140.0, 646, 711391, 979, 60.05181579999771
980, 5.517261887263787, 20.87995275325729, 25.093921466465414, 0.10000000000000077, 120.0, 411, 711802, 980, 39.03235929999937
981, 5.46519277151674, 20.878566184214183, 25.133645870855876, 0.10000000000000082, 100.0, 448, 712250, 981, 37.41637900000205
982, 5.0453746645172295, 20.872332039292537, 25.096237554446883, 0.09999999999999946, 250.0, 831, 713081, 982, 69.42359320000105
983, 5.428552919830724, 20.86117730146745, 25.12059923533109, 0.09999999999999976, 90.0, 787, 713868, 983, 65.5700066999998
984, 5.117130916553522, 20.90158017062209, 25.137589960999133, 0.09999999999999896, 215.0, 921, 714789, 984, 76.9100335999974
985, 5.042299275658767, 20.91914545747749, 25.179839718556174, 0.10000000000000023, 215.0, 723, 715512, 985, 61.32786849999684
986, 4.917320246334157, 20.908741043934025, 25.152610987583206, 0.09999999999999887, 235.0, 941, 716453, 986, 78.96167109999806
987, 4.6340102262148575, 20.905921999903757, 25.134632406713756, 0.10000000000000082, 175.0, 657, 717110, 987, 55.574398899996595
988, 4.992377230425776, 20.896389708148483, 25.1354377892857, 0.09999999999999863, 295.0, 991, 718101, 988, 82.89375039999868
989, 4.927800677098562, 20.89746327171159, 25.130561649539064, 0.09999999999999898, 245.0, 916, 719017, 989, 76.41222030000063
990, 4.721792128191775, 20.81977570388301, 25.055452799635844, 0.09999999999999754, 310.0, 1331, 720348, 990, 111.27079180000146
991, 5.131354367355558, 20.827653834561875, 25.047230104028706, 0.09999999999999996, 130.0, 758, 721106, 991, 63.164449500000046
992, 5.269571967223256, 20.831123705991764, 25.07785566270966, 0.10000000000000087, 85.0, 485, 721591, 992, 40.430648499997915
993, 5.442972131892913, 20.82808255423144, 25.06534207855586, 0.10000000000000096, 35.0, 591, 722182, 993, 48.990122499999416
994, 5.055156283424451, 20.79367291377141, 24.98065805068383, 0.10000000000000091, 70.0, 520, 722702, 994, 43.31216590000258
995, 5.368810144354337, 20.79691417512996, 25.00623476925159, 0.10000000000000087, 125.0, 653, 723355, 995, 54.50899579999532
996, 5.316496405399071, 20.797239858399397, 25.007650849204392, 0.10000000000000099, 95.0, 636, 723991, 996, 53.13028920000215
997, 5.282866648941824, 20.787859362772068, 25.011287401800285, 0.10000000000000017, 120.0, 730, 724721, 997, 64.43237899999804
998, 4.633530765491241, 20.813589322364937, 25.015269396219775, 0.10000000000000091, 30.0, 531, 725252, 998, 45.33643799999845
999, 5.775936019256131, 20.825839785786417, 25.04922188876511, 0.09999999999999779, 295.0, 1232, 726484, 999, 103.01471139999921
1000, 5.211667400284029, 20.797241222918334, 25.031507590308262, 0.09999999999999969, 175.0, 796, 727280, 1000, 66.4955445999949
1001, 4.898307532494463, 20.781806324035163, 24.988031483447458, 0.10000000000000099, 215.0, 635, 727915, 1001, 52.98520979999739
1002, 4.284475929660884, 20.76275287262381, 24.98668945289275, 0.10000000000000082, 95.0, 657, 728572, 1002, 55.03823329999432
1003, 5.034149895454275, 20.805401289688465, 25.019234161886146, 0.09999999999999908, 425.0, 899, 729471, 1003, 75.11733209999511
1004, 5.574596707531102, 20.825692281143443, 25.040665267185613, 0.09999999999999905, 195.0, 905, 730376, 1004, 75.99957490000088
1005, 6.122480707949605, 20.73485376329845, 24.971061161586217, 0.10000000000000075, 110.0, 406, 730782, 1005, 34.020192800002405
1006, 5.913642809091025, 20.74182125748388, 24.95375954394309, 0.10000000000000098, 100.0, 604, 731386, 1006, 50.579174300000886
1007, 5.385925169995947, 20.710989310032, 24.920550398310997, 0.09999999999999769, 475.0, 1267, 732653, 1007, 105.9642107000036
1008, 6.150426580003027, 20.75729004447982, 24.964227740346093, 0.1000000000000009, 50.0, 507, 733160, 1008, 42.39840179999737
1009, 5.257941683087022, 20.746940851954285, 24.966556779320737, 0.09999999999999766, 610.0, 1284, 734444, 1009, 107.26390590000665
1010, 5.630781307481648, 20.76399255066775, 24.992887287997128, 0.10000000000000066, 15.0, 356, 734800, 1010, 29.922874700001557
1011, 5.472234415504596, 20.786210545953715, 25.021088285694653, 0.09999999999999816, 260.0, 1113, 735913, 1011, 92.89832749999914
1012, 4.66321886121429, 20.80536010479608, 25.031106288756742, 0.10000000000000091, 100.0, 523, 736436, 1012, 43.70028309999907
1013, 5.157339605492801, 20.78616495994112, 25.030457416318278, 0.10000000000000087, 95.0, 653, 737089, 1013, 54.43675610000355
1014, 5.029775300483012, 20.80368731306007, 25.022161681417355, 0.10000000000000073, 125.0, 386, 737475, 1014, 32.49436450000212
1015, 5.155891063213349, 20.765760240908023, 24.99285320988408, 0.10000000000000066, 155.0, 675, 738150, 1015, 56.485891999996966
1016, 5.031068348354994, 20.758514716650136, 24.98220248006362, 0.09999999999999803, 455.0, 1148, 739298, 1016, 95.74757529999624
1017, 5.321433760340398, 20.77280693420997, 25.00516345317547, 0.10000000000000091, 95.0, 520, 739818, 1017, 43.485540100002254
1018, 4.9992140970072585, 20.504329045613606, 24.687913980569924, 0.10000000000000074, 175.0, 666, 740484, 1018, 55.590614699998696
1019, 5.241232510631004, 20.415206742018796, 24.57686270810245, 0.10000000000000081, 115.0, 445, 740929, 1019, 37.36370909999823
1020, 5.554835553485227, 20.412309754612934, 24.576979005193134, 0.09999999999999946, 410.0, 830, 741759, 1020, 69.35305830000289
1021, 5.615333368076137, 20.420870158813727, 24.576171711178645, 0.09999999999999869, 245.0, 978, 742737, 1021, 81.73994419999508
1022, 5.445586482634271, 20.43794074498507, 24.609940141216477, 0.09999999999999964, 270.0, 802, 743539, 1022, 66.96381229999679
1023, 5.700707756721221, 20.38989444423366, 24.543376334937843, 0.10000000000000094, 85.0, 555, 744094, 1023, 46.55246750000515
1024, 5.304722047338949, 20.411575365803362, 24.567519796341987, 0.09999999999999903, 240.0, 906, 745000, 1024, 75.8498458000031
1025, 4.949265738225033, 20.418931227463943, 24.56175880868321, 0.09999999999999876, 275.0, 962, 745962, 1025, 80.70410919999995
1026, 5.213567412119698, 20.418281744826924, 24.606298584829677, 0.1000000000000004, 150.0, 704, 746666, 1026, 58.91872229999717
1027, 4.872851925987488, 20.436485034062834, 24.58697899897398, 0.09999999999999812, 270.0, 1123, 747789, 1027, 93.65339200000017
1028, 5.994681286191216, 20.428185262287, 24.572183596596542, 0.10000000000000084, 35.0, 461, 748250, 1028, 38.681123500005924
1029, 5.74273490813172, 20.441685204367037, 24.603342815510278, 0.1000000000000009, 95.0, 515, 748765, 1029, 43.06240129999787
1030, 5.723751221358596, 20.38764747319985, 24.536678602328113, 0.10000000000000078, 220.0, 662, 749427, 1030, 55.54335970000102
1031, 5.390091435481279, 20.553712856455217, 24.755137961969897, 0.09999999999999866, 185.0, 986, 750413, 1031, 82.79592309999862
1032, 5.487062905391637, 20.740830503589045, 24.965094990973924, 0.10000000000000056, 125.0, 685, 751098, 1032, 57.37486900000658
1033, 5.553895542496129, 20.771570158632176, 25.00180738536935, 0.10000000000000098, 80.0, 608, 751706, 1033, 50.8514148999966
1034, 5.380809317627627, 20.7436945778983, 24.960858246880925, 0.10000000000000088, 370.0, 651, 752357, 1034, 54.76184849999845
1035, 5.847434628638564, 20.76951626632904, 24.975237418298956, 0.09999999999999892, 455.0, 929, 753286, 1035, 77.89886480000132
1036, 4.637248231020779, 20.759789241741654, 24.996939013785386, 0.10000000000000044, 360.0, 699, 753985, 1036, 58.56859480000276
1037, 4.745987841884837, 20.751817755218422, 24.961475759501027, 0.10000000000000014, 190.0, 734, 754719, 1037, 61.58579789999931
1038, 5.638823793377987, 20.809052676809543, 25.04362108951802, 0.099999999999998, 255.0, 1161, 755880, 1038, 97.01352639999823
1039, 5.985597708730987, 20.830580228747742, 25.041672455180777, 0.1000000000000008, 175.0, 660, 756540, 1039, 55.44409560000349
1040, 5.549844974722744, 20.805179621168403, 25.039882786017802, 0.10000000000000098, 60.0, 605, 757145, 1040, 50.98363100000279
1041, 4.5053259388825495, 20.800373900687458, 25.010651088896253, 0.10000000000000088, 140.0, 651, 757796, 1041, 54.70347050000419
1042, 5.727268526538873, 20.85139012260559, 25.100276977490314, 0.10000000000000099, 65.0, 626, 758422, 1042, 52.4644976999989
1043, 5.9219485348056855, 20.83674438805507, 25.07097014266692, 0.10000000000000027, 195.0, 719, 759141, 1043, 60.17325520000304
1044, 5.246187914020093, 20.78098354106996, 25.004729525137446, 0.09999999999999803, 265.0, 1148, 760289, 1044, 96.2436583000017
1045, 5.544147608718093, 20.654495119367326, 24.84744092513104, 0.09999999999999781, 340.0, 1225, 761514, 1045, 102.64580650000426
1046, 5.84140930469934, 20.691564452596555, 24.903255326407297, 0.10000000000000084, 65.0, 462, 761976, 1046, 38.7217942999996
1047, 5.671598218718287, 20.667442464176663, 24.880730589857613, 0.09999999999999881, 260.0, 951, 762927, 1047, 79.68916499999614
1048, 5.013055349629088, 20.638618480728333, 24.834687338296668, 0.0999999999999986, 305.0, 996, 763923, 1048, 83.67553300000145
1049, 5.062829121531055, 20.666982586823362, 24.905597711630595, 0.10000000000000092, 170.0, 537, 764460, 1049, 44.82358039999963
1050, 4.609533715248108, 20.634578217132184, 24.842815191534502, 0.10000000000000074, 55.0, 395, 764855, 1050, 33.25821040000301
1051, 5.504501923227109, 20.66247011136405, 24.876409667453686, 0.09999999999999883, 190.0, 948, 765803, 1051, 80.06389990000025
1052, 6.102765809684186, 20.636107857162887, 24.872770051698428, 0.10000000000000069, 55.0, 370, 766173, 1052, 31.14212449999468
1053, 5.2115037851820505, 20.68739749469479, 24.918736907612757, 0.10000000000000098, 135.0, 617, 766790, 1053, 51.7757380999974
1054, 6.234969856680296, 20.67864277426467, 24.903711794827753, 0.0999999999999987, 195.0, 974, 767764, 1054, 82.011256400001
1055, 5.8846726331652865, 20.685976670848, 24.862988140847946, 0.10000000000000095, 165.0, 576, 768340, 1055, 48.33887130000221
1056, 4.899043467494638, 20.657442533425268, 24.860090925407086, 0.09999999999999794, 415.0, 1182, 769522, 1056, 99.22786530000303
1057, 5.20716832340853, 20.650772617628927, 24.865629968070486, 0.10000000000000071, 60.0, 383, 769905, 1057, 32.28211420000298
1058, 5.899253570108751, 20.88714380569844, 25.144462492172472, 0.10000000000000096, 80.0, 593, 770498, 1058, 50.01661380000587
1059, 5.288329296560917, 20.900314762423267, 25.131668312333908, 0.09999999999999955, 370.0, 818, 771316, 1059, 68.53656459999911
1060, 5.985059023344142, 20.894040428556487, 25.137156005267073, 0.09999999999999827, 310.0, 1082, 772398, 1060, 90.86715330000152
1061, 5.698848008063802, 20.931617315585644, 25.190720620170097, 0.09999999999999873, 175.0, 969, 773367, 1061, 81.05278220000037
1062, 5.593333806879025, 20.932758840803587, 25.171311922572986, 0.09999999999999679, 800.0, 1737, 775104, 1062, 145.03316220000124
1063, 5.706316597137964, 20.97419039228512, 25.227300193387347, 0.10000000000000037, 175.0, 707, 775811, 1063, 59.12696270000015
1064, 5.364215757628405, 20.948202065059117, 25.203116485050746, 0.10000000000000096, 145.0, 644, 776455, 1064, 53.94982490000257
1065, 5.836520507522658, 20.914261628693225, 25.1591455078125, 0.09999999999999767, 400.0, 1275, 777730, 1065, 106.79595279999921
1066, 5.805773329419585, 20.933524725528862, 25.191945277727566, 0.09999999999999945, 220.0, 832, 778562, 1066, 69.73351530000218
1067, 5.232029270719398, 20.874184229157187, 25.099495524709877, 0.10000000000000066, 60.0, 352, 778914, 1067, 29.571181399995112
1068, 5.673460433804423, 20.915453810056537, 25.159282155643012, 0.10000000000000087, 85.0, 653, 779567, 1068, 54.790397100005066
1069, 5.910964335786776, 21.025447043793477, 25.29847848483236, 0.09999999999999837, 320.0, 1054, 780621, 1069, 88.28852929999994
1070, 4.9103444886582714, 21.078030802986838, 25.379987966764222, 0.10000000000000095, 85.0, 572, 781193, 1070, 48.027257000001555
1071, 5.663666168868248, 21.07663541521345, 25.350527136666432, 0.09999999999999853, 315.0, 1015, 782208, 1071, 84.73392529999546
1072, 4.974225929023418, 21.10922198801969, 25.397271152091236, 0.09999999999999905, 370.0, 904, 783112, 1072, 75.6557352000018
1073, 5.304157651489616, 21.151513039352547, 25.450932044656867, 0.10000000000000096, 80.0, 585, 783697, 1073, 48.89186350000091
1074, 4.839096563412246, 21.139193439303362, 25.428539889070624, 0.10000000000000091, 130.0, 529, 784226, 1074, 44.339817899999616
1075, 5.616317905723185, 21.123034032185874, 25.40928147357443, 0.10000000000000052, 65.0, 690, 784916, 1075, 57.73523330000171
1076, 4.790912070488145, 21.076311841048934, 25.35985741848031, 0.09999999999999917, 255.0, 881, 785797, 1076, 73.63421930000186
1077, 5.737987716289962, 21.111713786600486, 25.39409921406933, 0.10000000000000099, 120.0, 622, 786419, 1077, 51.864572400001634
1078, 6.010679089606054, 21.092636909013912, 25.344479886592662, 0.10000000000000087, 150.0, 486, 786905, 1078, 40.71021529999416
1079, 5.047253345781983, 21.08160413770069, 25.38160734503343, 0.10000000000000098, 125.0, 613, 787518, 1079, 51.26502220000111
1080, 5.454749808961447, 21.083041585461245, 25.347101960941416, 0.09999999999999921, 240.0, 873, 788391, 1080, 72.86619879999489
1081, 5.069091262983128, 21.04371484970664, 25.3104320342528, 0.0999999999999989, 245.0, 935, 789326, 1081, 78.17750529999466
1082, 5.8247222457781875, 21.051052974789055, 25.352643312007288, 0.10000000000000098, 100.0, 606, 789932, 1082, 50.62283809999644
1083, 5.245731412020863, 21.415006476021855, 25.779328119559366, 0.09999999999999724, 580.0, 1464, 791396, 1083, 122.01877149999927
1084, 5.914254179601654, 21.47182157355252, 25.810917153122702, 0.10000000000000099, 155.0, 627, 792023, 1084, 52.34522289999586
1085, 5.366326550751816, 21.458573652274442, 25.82222156734257, 0.10000000000000092, 90.0, 546, 792569, 1085, 45.533301200004644
1086, 5.0219009352912165, 21.43392321981233, 25.77728481128298, 0.10000000000000084, 50.0, 464, 793033, 1086, 38.7718265999938
1087, 5.1664337619158465, 21.385840720579292, 25.710506491255416, 0.10000000000000099, 125.0, 623, 793656, 1087, 52.11677670000063
1088, 5.47592974070005, 21.426105499267578, 25.772398144768, 0.09999999999999837, 175.0, 1057, 794713, 1088, 88.15801179999835
1089, 5.91594615904223, 21.350984696246663, 25.69813302518273, 0.10000000000000067, 20.0, 357, 795070, 1089, 29.860320200001297
1090, 4.737583525761123, 21.417315232356845, 25.759698125442874, 0.09999999999999923, 330.0, 871, 795941, 1090, 72.6921269999948
1091, 5.256851821030763, 21.417512100129034, 25.73521256694822, 0.10000000000000067, 105.0, 673, 796614, 1091, 56.232348400000774
1092, 5.365783501098307, 21.45013626350844, 25.791517178874372, 0.10000000000000067, 55.0, 363, 796977, 1092, 30.344171099997766
1093, 4.830667465834815, 21.42152067865231, 25.746835382691046, 0.09999999999999865, 375.0, 989, 797966, 1093, 82.3233801000024
1094, 5.4174619085327755, 21.41188912381749, 25.768394069711285, 0.09999999999999876, 330.0, 962, 798928, 1094, 80.33200420000503
1095, 4.843648422190784, 21.36949128941466, 25.694549329173324, 0.10000000000000096, 70.0, 643, 799571, 1095, 53.68421989999479
1096, 4.928417874427585, 21.52182856473056, 25.86673444586915, 0.10000000000000098, 150.0, 616, 800187, 1096, 51.54395540000405
1097, 4.643508308320153, 21.88905886017057, 26.312213398554917, 0.09999999999999802, 490.0, 1154, 801341, 1097, 95.9851903000017
1098, 4.615465611773352, 21.904774137589126, 26.331750997380254, 0.09999999999999962, 245.0, 807, 802148, 1098, 67.29837560000306
1099, 4.609898313758819, 21.91069238295723, 26.326895907642395, 0.10000000000000012, 170.0, 738, 802886, 1099, 61.648711300003924
1100, 4.6352590106454565, 21.899760160205165, 26.32838919464001, 0.09999999999999741, 510.0, 1385, 804271, 1100, 115.7032318000056
1101, 4.617075050996645, 21.946016384260304, 26.364344437110244, 0.10000000000000074, 90.0, 394, 804665, 1101, 32.84460039999976
1102, 5.241098454365363, 21.89903088293132, 26.34010979409754, 0.10000000000000064, 150.0, 676, 805341, 1102, 56.365504500005045
1103, 4.971304272958474, 21.878584906112316, 26.27672539570535, 0.1000000000000009, 120.0, 516, 805857, 1103, 43.0966660999984
1104, 4.999705100140604, 21.87457987402572, 26.304367156255815, 0.10000000000000096, 115.0, 588, 806445, 1104, 49.07015450000472
1105, 4.409939156296941, 21.914426486012484, 26.345258450011904, 0.09999999999999855, 285.0, 1009, 807454, 1105, 84.25930109999899
1106, 4.8874363944820916, 21.9510628022148, 26.399767316434605, 0.10000000000000038, 165.0, 706, 808160, 1106, 58.90083290000621
1107, 5.107170983205868, 21.914165869328254, 26.34164745337709, 0.10000000000000094, 85.0, 553, 808713, 1107, 46.28548540000338
1108, 5.149767361296495, 21.9387888994735, 26.404861645919215, 0.10000000000000088, 95.0, 497, 809210, 1108, 41.368185999999696
1109, 4.4331680703385965, 21.90065799249667, 26.325546962821225, 0.10000000000000098, 180.0, 642, 809852, 1109, 53.65538650000235
1110, 4.742671951240963, 22.01037947760688, 26.45610166592068, 0.09999999999999812, 345.0, 1125, 810977, 1110, 94.0338030999992
1111, 5.710236458631044, 22.066357023260565, 26.528387048271266, 0.10000000000000066, 85.0, 356, 811333, 1111, 29.75853719999577
1112, 4.521991867168359, 22.035268279424322, 26.480231354835276, 0.09999999999999809, 285.0, 1135, 812468, 1112, 94.44624929999554
1113, 4.63739410452003, 22.05586508595308, 26.500490931201252, 0.10000000000000099, 55.0, 619, 813087, 1113, 51.70586920000642
1114, 4.539827488386292, 22.033808816494627, 26.48614632218418, 0.10000000000000099, 170.0, 634, 813721, 1114, 52.90644710000197
1115, 5.022494894351184, 22.0551336897715, 26.495196986276937, 0.099999999999999, 290.0, 911, 814632, 1115, 76.05905360000179
1116, 4.413441621972358, 22.0769780663883, 26.53404536667992, 0.10000000000000092, 70.0, 544, 815176, 1116, 45.42917429999943
1117, 4.23376651006805, 22.090156027877594, 26.55254793049763, 0.09999999999999783, 370.0, 1219, 816395, 1117, 101.49494520000007
1118, 4.485354404044307, 22.087087814065107, 26.55901339163188, 0.10000000000000084, 65.0, 459, 816854, 1118, 39.025502899996354
1119, 4.781474167871686, 22.06756459166672, 26.525614355310434, 0.09999999999999903, 555.0, 906, 817760, 1119, 75.51144550000026
1120, 4.569603518616382, 22.06520461006988, 26.511551805537383, 0.09999999999999816, 320.0, 1112, 818872, 1120, 92.56136010000046
1121, 4.495757591362311, 22.109370151412822, 26.586702961788, 0.1000000000000008, 50.0, 428, 819300, 1121, 35.76844229999551
1122, 4.508520596354239, 22.09919525577176, 26.54771870643862, 0.10000000000000099, 45.0, 620, 819920, 1122, 51.661385600003996
1123, 5.582041344605386, 22.2302088201046, 26.71346001625061, 0.100000000000001, 150.0, 640, 820560, 1123, 53.38269080000464
1124, 4.946792095023043, 22.169777382121367, 26.65112631741692, 0.10000000000000063, 50.0, 340, 820900, 1124, 29.423894900006417
1125, 4.7378538182306125, 22.202151491879597, 26.676444800858643, 0.10000000000000096, 80.0, 582, 821482, 1125, 49.310135300002
1126, 5.336138799642827, 22.239364290799614, 26.727257594673837, 0.0999999999999989, 360.0, 933, 822415, 1126, 78.07689329999994
1127, 4.811449995702901, 22.233167333622095, 26.73342273796588, 0.10000000000000088, 35.0, 497, 822912, 1127, 41.76505810000526
1128, 4.801335867394738, 22.221695563372442, 26.677563723395853, 0.1000000000000007, 55.0, 374, 823286, 1128, 31.37966530000267
1129, 4.579744908287658, 22.228189355838374, 26.704267045725945, 0.10000000000000096, 105.0, 644, 823930, 1129, 53.94786020000174
1130, 4.720785561285179, 22.229798484898215, 26.717529510801942, 0.0999999999999988, 275.0, 954, 824884, 1130, 79.60932879999746
1131, 4.746353676779703, 22.30314350128174, 26.812849751385777, 0.10000000000000081, 45.0, 440, 825324, 1131, 36.73105050000595
1132, 4.6428301923373745, 22.246142083794407, 26.748141328258626, 0.09999999999999938, 265.0, 845, 826169, 1132, 70.27033870000014
1133, 5.565381117608405, 22.27462223074944, 26.761467917180564, 0.10000000000000091, 50.0, 521, 826690, 1133, 43.42796499999531
1134, 4.795465666544242, 22.29740272897189, 26.797415252435403, 0.09999999999999713, 430.0, 1525, 828215, 1134, 126.53107579999778
1135, 4.165661729338888, 22.28703364374322, 26.806768946947606, 0.10000000000000084, 45.0, 461, 828676, 1135, 38.47415870000259
1136, 4.652160082812512, 22.324275507320294, 26.837887076444403, 0.09999999999999726, 625.0, 1462, 830138, 1136, 121.05044059999636
1137, 4.825954550316611, 22.496171062432445, 27.043805895499812, 0.0999999999999995, 175.0, 824, 830962, 1137, 68.33041609999782
1138, 5.03169459724478, 22.502732499061658, 27.040311896013154, 0.09999999999999895, 210.0, 923, 831885, 1138, 76.70148830000107
1139, 4.49314090051532, 22.489758553683508, 27.0264267015391, 0.10000000000000024, 170.0, 721, 832606, 1139, 59.8215418999971
1140, 4.505755894796201, 22.483132968531386, 27.02767332641728, 0.10000000000000087, 95.0, 483, 833089, 1140, 40.22524410000187
1141, 4.914579885158258, 22.447377120540533, 26.97645955706697, 0.09999999999999958, 170.0, 814, 833903, 1141, 67.71049470000435
1142, 4.982457201342163, 22.43506669998169, 26.958361244801456, 0.10000000000000099, 135.0, 636, 834539, 1142, 52.94032590000279
1143, 5.578232599693594, 22.439372216382072, 26.98686698987646, 0.1000000000000009, 125.0, 515, 835054, 1143, 42.9698786999943
1144, 5.058398050061208, 22.383227578145256, 26.89374233977963, 0.10000000000000049, 205.0, 693, 835747, 1144, 57.67948199999955
1145, 4.557630713756492, 22.375303539803358, 26.904358255184764, 0.10000000000000087, 55.0, 492, 836239, 1145, 41.20619490000536
1146, 4.992185308019051, 22.37353379339785, 26.893871339591772, 0.10000000000000096, 165.0, 592, 836831, 1146, 49.227595800002746
1147, 4.965542505359092, 22.359964593809252, 26.875386339600322, 0.09999999999999931, 460.0, 855, 837686, 1147, 70.9842964000054
1148, 4.8087774385503455, 22.39281128310439, 26.91757601757732, 0.09999999999999834, 400.0, 1062, 838748, 1148, 88.6364012999984
1149, 5.126460556575595, 22.35185412186581, 26.861079463567403, 0.09999999999999813, 250.0, 1121, 839869, 1149, 93.50766049999947
1150, 5.226974253645118, 22.41317452186065, 26.953423934457188, 0.09999999999999991, 205.0, 764, 840633, 1150, 63.88570199999958
1151, 5.075896885139602, 22.39472561336699, 26.9250557808649, 0.10000000000000078, 80.0, 420, 841053, 1151, 34.98732110000128
1152, 5.345589658740077, 22.394870150252068, 26.926014919020517, 0.10000000000000081, 185.0, 659, 841712, 1152, 54.93729859999439
1153, 5.455090051436975, 22.38782179552336, 26.92259660097632, 0.09999999999999902, 265.0, 909, 842621, 1153, 75.65472269999736
1154, 5.5443895769551625, 22.391241730803653, 26.91945853752176, 0.10000000000000073, 35.0, 386, 843007, 1154, 32.23186960000021
1155, 4.857871111879494, 22.3841077252693, 26.90468653325502, 0.09999999999999974, 125.0, 788, 843795, 1155, 65.58603339999536
1156, 4.656690418720245, 22.365092869771132, 26.869987888586678, 0.10000000000000091, 110.0, 533, 844328, 1156, 44.315533900000446
1157, 4.828105049615422, 22.352143998291353, 26.872708460630804, 0.10000000000000024, 210.0, 722, 845050, 1157, 60.04785550000088
1158, 4.460365592803412, 22.411637127884035, 26.951747472499445, 0.0999999999999978, 240.0, 1230, 846280, 1158, 102.30134899999393
1159, 5.629994959318185, 22.445698697053935, 26.98457349463354, 0.10000000000000074, 70.0, 395, 846675, 1159, 32.92040120000456
1160, 5.168758151875703, 22.447402384797883, 26.96732170409576, 0.10000000000000091, 65.0, 526, 847201, 1160, 44.00828850000107
1161, 5.031544581434732, 22.4255970060942, 26.946696570708095, 0.1000000000000009, 65.0, 511, 847712, 1161, 42.532797600004415
1162, 5.041183186284567, 22.427971137926598, 26.98567584178638, 0.09999999999999949, 230.0, 826, 848538, 1162, 68.55255300000135
1163, 4.7408342724486205, 22.426581045835636, 26.980478432187702, 0.09999999999999845, 225.0, 1036, 849574, 1163, 86.31990330000554
1164, 4.742415778448155, 22.494649907594088, 27.045527552346446, 0.09999999999999849, 290.0, 1023, 850597, 1164, 85.0464604000008
1165, 4.609716790486918, 22.564438882718846, 27.1464181902817, 0.10000000000000057, 170.0, 683, 851280, 1165, 56.78430749999825
1166, 5.8665723957513505, 22.56804447006761, 27.140293054413377, 0.10000000000000082, 60.0, 456, 851736, 1166, 38.002867700000934
1167, 4.737487070066019, 22.55724838203202, 27.121237112893372, 0.09999999999999808, 390.0, 1138, 852874, 1167, 94.67521240000497
1168, 4.36293914147231, 22.591366777202595, 27.1543768655982, 0.09999999999999896, 365.0, 921, 853795, 1168, 76.7289196999991
1169, 4.257478198244982, 22.585437828863494, 27.128267913262754, 0.09999999999999812, 225.0, 1126, 854921, 1169, 93.41076900000189
1170, 4.383353612444422, 22.600327888204017, 27.16427549708304, 0.09999999999999983, 140.0, 777, 855698, 1170, 64.52135690000432
1171, 4.691902606498609, 22.590981107128403, 27.164288416528475, 0.10000000000000099, 195.0, 631, 856329, 1171, 52.79204459999892
1172, 4.348255116590031, 22.559047356117873, 27.121449022809042, 0.10000000000000095, 125.0, 573, 856902, 1172, 47.84503350000159
1173, 4.535398125163415, 22.55090995625586, 27.112848673807882, 0.09999999999999867, 250.0, 983, 857885, 1173, 81.96298820000084
1174, 4.150981706294313, 22.55911497577045, 27.108460884843495, 0.09999999999999797, 250.0, 1171, 859056, 1174, 97.50144239999645
1175, 4.574204459005432, 22.59481543814861, 27.16012025429268, 0.0999999999999988, 275.0, 954, 860010, 1175, 80.04146030000265
1176, 4.3356830582388035, 22.384374354358062, 26.90794383681634, 0.09999999999999716, 550.0, 1509, 861519, 1176, 125.34042760000011
1177, 4.431271591496687, 22.386207222155296, 26.919812261353343, 0.09999999999999994, 250.0, 761, 862280, 1177, 63.31112540000322
1178, 4.202567420284118, 22.44298529624939, 26.96078177720062, 0.09999999999999873, 195.0, 968, 863248, 1178, 80.52492499999789
1179, 4.691684713121504, 22.48090854883194, 27.01023496389389, 0.100000000000001, 195.0, 640, 863888, 1179, 53.378286600003776
1180, 4.662210945933186, 22.478238819635404, 27.009709486487317, 0.10000000000000057, 370.0, 684, 864572, 1180, 56.83676890000061
1181, 4.765801571673817, 22.47134081310696, 27.01329248216417, 0.09999999999999906, 305.0, 900, 865472, 1181, 75.03109360000235
1182, 4.449126284481503, 22.48526444773036, 27.01353426054707, 0.09999999999999852, 370.0, 1016, 866488, 1182, 84.58615830000053
1183, 4.662110252682272, 22.479416260797876, 27.016472855342126, 0.09999999999999802, 665.0, 1153, 867641, 1183, 96.17703009999968
1184, 4.529215648548528, 22.456222242528273, 27.023383810329825, 0.1000000000000001, 180.0, 739, 868380, 1184, 61.50914689999627
1185, 4.160559752010183, 22.429344727633524, 26.968458714476906, 0.09999999999999802, 360.0, 1154, 869534, 1185, 95.95438999999897
1186, 4.794375156085503, 22.48589752410269, 27.0512179311762, 0.10000000000000074, 75.0, 394, 869928, 1186, 32.73967779999657
1187, 4.936346734626384, 22.579985167909776, 27.163366245318063, 0.10000000000000085, 75.0, 474, 870402, 1187, 39.45637159999751
1188, 4.860651600028053, 22.536957098546164, 27.10130077045783, 0.09999999999999794, 460.0, 1182, 871584, 1188, 98.15476869999839
1189, 4.847337662615319, 22.566981914171848, 27.110138770288827, 0.09999999999999933, 225.0, 854, 872438, 1189, 71.20310649999738
1190, 4.629978497357204, 22.559476697198274, 27.12718642925394, 0.10000000000000021, 195.0, 725, 873163, 1190, 60.42548240000178
1191, 5.384050544193297, 22.579823170286236, 27.179759496631043, 0.1000000000000008, 65.0, 660, 873823, 1191, 54.906312300001446
1192, 3.964519876275486, 22.506872667482085, 27.042214698286724, 0.10000000000000091, 130.0, 529, 874352, 1192, 44.02975090000109
1193, 5.421602768335736, 22.561404848902004, 27.140926279298743, 0.10000000000000087, 75.0, 653, 875005, 1193, 54.35620120000385
1194, 4.750644111747681, 22.554061887615017, 27.10677164195697, 0.09999999999999888, 190.0, 938, 875943, 1194, 78.13655679999647
1195, 4.724446774986775, 22.578145747599393, 27.13642217542814, 0.10000000000000013, 410.0, 736, 876679, 1195, 61.27325959999871
1196, 4.221646225702221, 22.567285029241454, 27.12925117368332, 0.0999999999999993, 260.0, 859, 877538, 1196, 71.46247239999502
1197, 5.2366768694033485, 22.571696277051753, 27.152876253697627, 0.10000000000000087, 100.0, 653, 878191, 1197, 54.57799890000024
1198, 4.444536430835724, 22.566173304507608, 27.138143161974455, 0.10000000000000085, 45.0, 475, 878666, 1198, 39.66341889999603
1199, 4.645237388625053, 22.550131242072705, 27.116377226464262, 0.10000000000000069, 190.0, 671, 879337, 1199, 56.033504700004414
1200, 5.060578594958515, 22.465563343133535, 27.00879195744812, 0.09999999999999995, 175.0, 759, 880096, 1200, 63.35742279999977
1201, 4.16033114328944, 22.284070369375364, 26.77477719323268, 0.09999999999999955, 420.0, 818, 880914, 1201, 68.10030019999977
1202, 4.437995222037091, 22.318761294140415, 26.844968457973803, 0.09999999999999894, 245.0, 926, 881840, 1202, 77.37512769999739
1203, 4.88100411879584, 22.297064345364742, 26.800827117287433, 0.09999999999999874, 105.0, 965, 882805, 1203, 80.62225780000153
1204, 4.895898969556792, 22.313850350316926, 26.820003833014535, 0.09999999999999902, 265.0, 908, 883713, 1204, 76.09913210000377
1205, 5.195562697589137, 22.293147572263358, 26.808215480704494, 0.09999999999999898, 270.0, 916, 884629, 1205, 76.33219900000404
1206, 4.603455019943768, 22.309261764545298, 26.796822365696908, 0.09999999999999962, 165.0, 806, 885435, 1206, 67.0486055999936
1207, 4.64735144522132, 22.314992334172416, 26.8398443302845, 0.09999999999999981, 160.0, 779, 886214, 1207, 65.00194909999846
1208, 4.9591398786967416, 22.34542841313173, 26.87256325367327, 0.09999999999999933, 240.0, 853, 887067, 1208, 70.87761939999473
1209, 4.894323690720269, 22.348637856345363, 26.865623557992375, 0.09999999999999756, 650.0, 1319, 888386, 1209, 109.66301560000284
1210, 5.0886698832852, 22.40347856413329, 26.927323476022334, 0.10000000000000055, 200.0, 687, 889073, 1210, 57.37534549999691
1211, 5.28734421466931, 22.385651593297364, 26.92368794944776, 0.10000000000000096, 155.0, 589, 889662, 1211, 49.183297700001276
1212, 5.052642711149753, 22.649370239344144, 27.23626127337465, 0.10000000000000037, 135.0, 707, 890369, 1212, 59.10237639999832
1213, 5.458081619198745, 22.918862098192545, 27.561330342056728, 0.09999999999999816, 135.0, 1111, 891480, 1213, 92.53932739999436
1214, 4.876570936000865, 22.96235716861227, 27.592249708590302, 0.09999999999999896, 230.0, 920, 892400, 1214, 77.00933670000813
1215, 4.33188570795622, 22.9176244745767, 27.536090398613595, 0.09999999999999883, 290.0, 949, 893349, 1215, 79.21373719999974
1216, 4.87753766049069, 22.958089880722664, 27.605106220479502, 0.09999999999999835, 200.0, 1059, 894408, 1216, 88.17861020000419
1217, 4.701326467821318, 22.946383765543146, 27.57262599485533, 0.10000000000000052, 140.0, 689, 895097, 1217, 57.26088479999453
1218, 4.91887998933772, 22.9705439541355, 27.603868474415947, 0.09999999999999884, 270.0, 946, 896043, 1218, 78.89554189999762
1219, 5.130147808277769, 23.00706848731408, 27.640105271950745, 0.10000000000000077, 95.0, 663, 896706, 1219, 56.47211790000438
1220, 5.661628727826122, 22.995956234548284, 27.67180659122394, 0.10000000000000091, 110.0, 522, 897228, 1220, 46.17574069999682
1221, 4.86785054427921, 22.974425913093775, 27.629532622202657, 0.10000000000000042, 130.0, 701, 897929, 1221, 58.36639140000625
1222, 4.9777490383014085, 22.971130973100664, 27.620719295740127, 0.100000000000001, 75.0, 640, 898569, 1222, 53.2087923999934
1223, 5.076717323948892, 22.93037416071793, 27.55189804673385, 0.10000000000000099, 140.0, 627, 899196, 1223, 52.41483090000111
1224, 4.990207283679708, 22.97299721136511, 27.617037982104783, 0.09999999999999858, 255.0, 1004, 900200, 1224, 83.55947009999363
1225, 4.829774145118038, 23.151911072530318, 27.81779506832837, 0.10000000000000052, 180.0, 689, 900889, 1225, 57.241241200012155
1226, 4.191494327771735, 23.11758668569637, 27.801713935897553, 0.10000000000000088, 100.0, 503, 901392, 1226, 42.49846139999863
1227, 4.774670522045671, 23.157004476848403, 27.839796404252972, 0.10000000000000095, 105.0, 570, 901962, 1227, 47.50316359999124
1228, 4.801137768599881, 23.12995221241411, 27.82295033762573, 0.10000000000000005, 205.0, 747, 902709, 1228, 62.076979999998
1229, 4.489803299689904, 23.155043404141228, 27.84600075363835, 0.0999999999999993, 250.0, 858, 903567, 1229, 71.55687130001024
1230, 5.1202726013469, 23.168744954575587, 27.8474997861542, 0.10000000000000056, 155.0, 685, 904252, 1230, 56.95570599999337
1231, 4.510375794600674, 23.128115379167067, 27.815840166006517, 0.09999999999999923, 150.0, 871, 905123, 1231, 72.52874159999192
1232, 4.6355055259621665, 23.172565231165283, 27.84568520855953, 0.10000000000000087, 80.0, 483, 905606, 1232, 40.051577699996415
1233, 4.297751737632781, 23.153674357727148, 27.82376040244589, 0.10000000000000099, 160.0, 637, 906243, 1233, 53.075553200003924
1234, 4.486094774001867, 23.19398819747849, 27.88592463820728, 0.09999999999999787, 535.0, 1206, 907449, 1234, 100.47683939999843
1235, 5.358553355711478, 23.2360897064209, 27.967454818443017, 0.10000000000000092, 125.0, 540, 907989, 1235, 45.084892700004275
1236, 4.9990176083783915, 23.16723811338731, 27.855840036526306, 0.0999999999999988, 360.0, 953, 908942, 1236, 79.53672299999744
1237, 5.155599319152229, 23.198556958161653, 27.896951829702324, 0.09999999999999933, 325.0, 853, 909795, 1237, 71.13794619998953
1238, 4.865085042771839, 23.37382104782831, 28.094571843828472, 0.0999999999999984, 350.0, 1050, 910845, 1238, 87.41439810000884
1239, 4.979240264515941, 23.435383570709455, 28.18410604223942, 0.10000000000000069, 155.0, 671, 911516, 1239, 56.19484870000451
1240, 4.70720763784824, 23.390509988765906, 28.141552405782264, 0.10000000000000088, 25.0, 505, 912021, 1240, 42.21057350000774
1241, 4.852122718227399, 23.432756129123437, 28.176401899440055, 0.10000000000000099, 95.0, 634, 912655, 1241, 52.83197349999682
1242, 5.080758548348823, 23.4159385424113, 28.16437815013377, 0.10000000000000087, 140.0, 653, 913308, 1242, 54.04586370001198
1243, 4.893501020755086, 23.414000838143483, 28.149520980290003, 0.10000000000000042, 65.0, 700, 914008, 1243, 58.112653000003775
1244, 4.446345409750938, 23.37621362686157, 28.092732765197756, 0.10000000000000088, 35.0, 500, 914508, 1244, 41.57696669999859
1245, 5.045753727605905, 23.38175391782665, 28.114562078792616, 0.09999999999999845, 320.0, 1036, 915544, 1245, 85.83732869999949
1246, 5.143176277678217, 23.46665606307025, 28.206852632551335, 0.09999999999999701, 405.0, 1592, 917136, 1246, 131.66256320000684
1247, 4.482625429306331, 23.452471509489424, 28.177244712620997, 0.09999999999999785, 470.0, 1207, 918343, 1247, 100.25994669999636
1248, 4.998670694287236, 23.513665603837374, 28.27904785472408, 0.09999999999999898, 250.0, 917, 919260, 1248, 76.24601709999843
1249, 4.819141603829279, 23.494610660791913, 28.259907839880135, 0.10000000000000084, 35.0, 463, 919723, 1249, 38.83408000000054
1250, 5.243797335746515, 23.958040716352254, 28.8053152877919, 0.10000000000000056, 155.0, 685, 920408, 1250, 57.117887699991115
1251, 5.0615525020411, 24.304648994101708, 29.239301301828625, 0.10000000000000096, 135.0, 643, 921051, 1251, 53.83326079999097
1252, 5.047130448160639, 24.347900495513038, 29.265129291063236, 0.09999999999999794, 365.0, 1182, 922233, 1252, 98.27827419999812
1253, 4.920774196066073, 24.408571752861363, 29.330135889195684, 0.1000000000000007, 140.0, 670, 922903, 1253, 55.83687970000028
1254, 5.238926085381726, 24.446969975573303, 29.383423470723603, 0.09999999999999898, 310.0, 918, 923821, 1254, 76.39397689999896
1255, 4.531797098564324, 24.46797158210154, 29.38653435222018, 0.10000000000000091, 60.0, 521, 924342, 1255, 43.485074299998814
1256, 4.761616898662462, 24.46035743773453, 29.406939632686104, 0.09999999999999769, 515.0, 1270, 925612, 1256, 105.8503178999963
1257, 5.484846841417467, 24.48487730499347, 29.432015630657304, 0.0999999999999999, 195.0, 766, 926378, 1257, 64.00489569999627
1258, 5.762241838962831, 24.48296046396991, 29.43705518091728, 0.1000000000000009, 105.0, 511, 926889, 1258, 42.72676729998784
1259, 4.541818415482988, 24.47434874624711, 29.426820803179265, 0.09999999999999831, 470.0, 1069, 927958, 1259, 89.05681620001269
1260, 5.130683761406998, 24.489854129770183, 29.42964115669714, 0.09999999999999905, 145.0, 905, 928863, 1260, 75.55192450000322
1261, 4.985427585841788, 24.480843865230856, 29.457070649373264, 0.09999999999999992, 165.0, 763, 929626, 1261, 63.66225869998743
1262, 5.356648567002579, 24.56962378375801, 29.543191952412354, 0.10000000000000092, 50.0, 537, 930163, 1262, 44.862491400010185
1263, 5.267680102396011, 24.7052983291626, 29.69355394592285, 0.09999999999999774, 285.0, 1250, 931413, 1263, 104.16288439999335
1264, 5.319107449105517, 24.75397074764425, 29.776500206102025, 0.1000000000000004, 95.0, 704, 932117, 1264, 58.67743779999728
1265, 5.946439165873262, 24.71851784043298, 29.739339291525027, 0.10000000000000063, 50.0, 341, 932458, 1265, 28.855089400007273
1266, 4.888644296193583, 24.710529135606834, 29.712926969712104, 0.10000000000000021, 95.0, 726, 933184, 1266, 60.637302500006626
1267, 4.67670961186147, 24.715940841089804, 29.71020206475791, 0.10000000000000099, 70.0, 626, 933810, 1267, 52.38576350000221
1268, 4.882786563094358, 24.719973727042632, 29.7185208753029, 0.09999999999999765, 370.0, 1288, 935098, 1268, 107.47505159999127
1269, 6.086058414127474, 24.748279521238008, 29.757754494162167, 0.10000000000000088, 70.0, 493, 935591, 1269, 41.31341479999537
1270, 5.2446269232129294, 24.6946795899191, 29.694237000938024, 0.10000000000000095, 65.0, 567, 936158, 1270, 47.56724339998618
1271, 4.9569537714346135, 24.74080189757086, 29.723663954473846, 0.09999999999999858, 280.0, 1005, 937163, 1271, 83.61792119999882
1272, 5.0406382553345335, 24.78464874053775, 29.78978369721269, 0.10000000000000063, 125.0, 678, 937841, 1272, 56.35760119999759
1273, 4.69432496020547, 24.809750701889527, 29.82498466956996, 0.09999999999999845, 255.0, 1033, 938874, 1273, 86.49775289998797
1274, 4.9804051450912326, 24.803245772047706, 29.811638388388825, 0.10000000000000078, 110.0, 662, 939536, 1274, 55.37546389999625
1275, 4.6731667515665, 24.82946550255955, 29.876964356639597, 0.10000000000000075, 70.0, 404, 939940, 1275, 33.84054289999767
1276, 4.897870531391005, 24.942127520062535, 29.990834981909295, 0.10000000000000099, 150.0, 633, 940573, 1276, 52.93028100000811
1277, 4.571270887316434, 24.89923880490787, 29.929021940198552, 0.09999999999999921, 150.0, 873, 941446, 1277, 72.421548600003
1278, 5.039665604044446, 24.916317466675768, 29.979654397238583, 0.10000000000000071, 50.0, 381, 941827, 1278, 31.69132559999707
1279, 4.847415146208902, 24.90501571538794, 29.94428388289823, 0.10000000000000085, 160.0, 655, 942482, 1279, 54.7034549999953
1280, 4.542751033875075, 24.936909228771718, 30.00153149591459, 0.09999999999999805, 380.0, 1144, 943626, 1280, 95.43147480000334
1281, 4.90351091712093, 25.013640218862175, 30.063099036994927, 0.099999999999999, 305.0, 913, 944539, 1281, 76.27107420000539
1282, 4.493375043234518, 24.99352211721482, 30.049595511728718, 0.09999999999999863, 255.0, 992, 945531, 1282, 83.04140829999233
1283, 4.8818629239678915, 24.973669908021925, 30.052729177262417, 0.10000000000000067, 160.0, 673, 946204, 1283, 56.178745600002
1284, 4.4902255025931765, 24.959202744620185, 30.00705184664045, 0.10000000000000042, 180.0, 700, 946904, 1284, 58.28107810000074
1285, 4.506873158650248, 24.944005818891277, 29.999809831848943, 0.09999999999999991, 175.0, 764, 947668, 1285, 64.00266840000404
1286, 4.023520878097355, 24.99343224339837, 30.060903456387102, 0.10000000000000096, 100.0, 596, 948264, 1286, 49.85485869999684
1287, 5.204755625405977, 24.986789728319923, 30.058436183042303, 0.10000000000000053, 120.0, 688, 948952, 1287, 57.52339770000253
1288, 5.0796569915431915, 24.991681736785097, 30.06736522732359, 0.09999999999999895, 215.0, 924, 949876, 1288, 77.38060509999923
1289, 5.45024934388124, 24.795076969342354, 29.819601570031583, 0.0999999999999998, 195.0, 780, 950656, 1289, 65.45372570000472
1290, 4.353779964341871, 24.78659098763251, 29.78884001866283, 0.09999999999999842, 365.0, 1043, 951699, 1290, 87.45675370001118
1291, 4.928097817602508, 24.80273740663441, 29.812103901434384, 0.1000000000000008, 105.0, 436, 952135, 1291, 36.56602389999898
1292, 4.689136075735931, 24.795195692449216, 29.807184299858065, 0.09999999999999933, 275.0, 853, 952988, 1292, 71.39497259999916
1293, 4.453593355662814, 24.807308480385387, 29.825406685304106, 0.09999999999999966, 210.0, 801, 953789, 1293, 67.12229579999985
1294, 5.059424802867329, 24.80634572037039, 29.833639837037822, 0.10000000000000067, 15.0, 361, 954150, 1294, 30.342211700000917
1295, 5.169302549847418, 24.796848957785887, 29.812253795257988, 0.1000000000000009, 5.0, 511, 954661, 1295, 43.018978699998115
1296, 4.413988275699458, 24.79210715698746, 29.790014246724688, 0.09999999999999935, 205.0, 848, 955509, 1296, 71.05628279999655
1297, 4.362180218378901, 24.735541964824293, 29.729395487537122, 0.09999999999999964, 230.0, 803, 956312, 1297, 67.32364850000886
1298, 4.178027958486432, 24.784838247668837, 29.84667600587357, 0.1000000000000009, 45.0, 516, 956828, 1298, 43.25712829999975
1299, 4.888865360202963, 24.845867844024777, 29.88434412823542, 0.09999999999999988, 260.0, 769, 957597, 1299, 64.279850299994
1300, 4.4958313393833125, 24.773221170782108, 29.762523704520266, 0.0999999999999991, 310.0, 893, 958490, 1300, 74.64200100000016
1301, 4.307984354572558, 24.83568879807032, 29.83505041956537, 0.10000000000000085, 195.0, 654, 959144, 1301, 54.83005649999541
1302, 4.840850472342667, 24.830540691472134, 29.8591448615174, 0.10000000000000094, 135.0, 554, 959698, 1302, 46.31181810000271
1303, 4.0145115107510465, 24.749562643053867, 29.744221389378698, 0.10000000000000042, 225.0, 701, 960399, 1303, 58.81206129999191
1304, 4.227658528658744, 24.75141413675051, 29.766075377145008, 0.099999999999999, 300.0, 911, 961310, 1304, 76.22029920000932
1305, 4.383854000438777, 24.784664620657335, 29.773879195828634, 0.09999999999999738, 390.0, 1398, 962708, 1305, 116.81232110000565
1306, 4.806064195040637, 24.804689650265676, 29.822338683050383, 0.10000000000000099, 125.0, 636, 963344, 1306, 53.463102299996535
1307, 4.456054900066723, 24.811740774112188, 29.84541955302654, 0.09999999999999885, 200.0, 943, 964287, 1307, 79.23096929999883
1308, 4.490830524825335, 24.82927349862409, 29.865326945728107, 0.09999999999999788, 285.0, 1201, 965488, 1308, 100.59287800001039
1309, 4.829751105465516, 24.829790654332875, 29.855811829429594, 0.10000000000000019, 195.0, 729, 966217, 1309, 61.10139409999829
1310, 4.55714940971403, 24.846593310228034, 29.89276596752565, 0.1000000000000007, 125.0, 670, 966887, 1310, 56.02064440000686
1311, 4.160416014870601, 24.8481475089913, 29.874847560142403, 0.1000000000000007, 145.0, 670, 967557, 1311, 55.92293739999877
1312, 4.440093382132256, 24.856810750799664, 29.893322666620804, 0.10000000000000096, 80.0, 590, 968147, 1312, 49.37231690000044
1313, 4.614721751304773, 24.89489894573505, 29.934328302236704, 0.1000000000000009, 125.0, 650, 968797, 1313, 54.38721119999536
1314, 4.7103498255057685, 24.839381226311637, 29.854263556316887, 0.09999999999999967, 155.0, 799, 969596, 1314, 67.27320569999574
1315, 4.641773958214046, 24.96051199548971, 30.00155461922993, 0.09999999999999902, 360.0, 909, 970505, 1315, 76.07771810000122
1316, 4.133303311166413, 25.0256452910397, 30.103680228603725, 0.10000000000000085, 150.0, 654, 971159, 1316, 54.86565759999212
1317, 4.358138919627967, 25.016366916544296, 30.07095024565689, 0.09999999999999881, 225.0, 952, 972111, 1317, 79.69069600000512
1318, 4.127243558074223, 25.037326831010848, 30.1211285830876, 0.09999999999999773, 645.0, 1253, 973364, 1318, 106.3555567000003
1319, 4.311556985632318, 25.032325898884423, 30.094327411755838, 0.09999999999999899, 175.0, 915, 974279, 1319, 76.51031520000834
1320, 4.040669079093415, 25.029399387786036, 30.099354257036193, 0.10000000000000078, 130.0, 662, 974941, 1320, 55.50803359999554
1321, 4.389947135057987, 25.038814670868913, 30.086658450890003, 0.09999999999999895, 340.0, 922, 975863, 1321, 77.06029860000126
1322, 4.633543392392092, 25.067328173615213, 30.1557417359463, 0.09999999999999928, 175.0, 860, 976723, 1322, 71.98623589999625
1323, 4.145413689401353, 25.051185167413937, 30.096966309580463, 0.09999999999999926, 230.0, 866, 977589, 1323, 72.55829339999764
1324, 4.34931706474396, 25.062683288941162, 30.127597353979198, 0.10000000000000088, 70.0, 499, 978088, 1324, 41.88715009999578
1325, 4.439583114740111, 25.062723397841257, 30.148046758031626, 0.10000000000000091, 160.0, 649, 978737, 1325, 54.50695500000438
1326, 4.4422806624938795, 25.084790948392296, 30.159837826070778, 0.09999999999999831, 570.0, 1071, 979808, 1326, 89.68181999999797
1327, 4.647613115883237, 25.43676292972007, 30.589580926083247, 0.09999999999999976, 285.0, 787, 980595, 1327, 65.92876390001038
1328, 4.306504452916292, 25.53663162451524, 30.685688807414127, 0.10000000000000091, 90.0, 520, 981115, 1328, 43.62555679999059
1329, 4.7622188563142425, 25.56276472363522, 30.73044190788048, 0.09999999999999927, 245.0, 863, 981978, 1329, 72.51565760000085
1330, 5.008369620103575, 25.513982554756694, 30.68226158522945, 0.10000000000000099, 185.0, 621, 982599, 1330, 52.03956889999972
1331, 4.430606240811556, 25.465262209309973, 30.596086462413883, 0.10000000000000091, 145.0, 529, 983128, 1331, 44.378902000011294
1332, 4.1813608688522255, 25.491051031557014, 30.64987986968172, 0.10000000000000099, 175.0, 631, 983759, 1332, 52.60400259999733
1333, 4.402415674153822, 25.52296316115825, 30.682960842673303, 0.09999999999999765, 390.0, 1291, 985050, 1333, 107.67433180000808
1334, 4.401734778697674, 25.55660932981051, 30.713918251624474, 0.1000000000000009, 140.0, 650, 985700, 1334, 54.44870979999541
1335, 4.869369640202238, 25.557141988199028, 30.73423992440413, 0.09999999999999952, 85.0, 821, 986521, 1335, 68.71201909999945
1336, 4.235863195466144, 25.618725362278166, 30.788293191364833, 0.09999999999999856, 390.0, 1008, 987529, 1336, 84.45388859999366
1337, 4.333130610199311, 25.619812971506363, 30.806074438950954, 0.10000000000000099, 160.0, 624, 988153, 1337, 52.35918610000226
1338, 4.675119183604035, 25.61594378801557, 30.79894533475799, 0.10000000000000095, 230.0, 569, 988722, 1338, 47.6123615999968
1339, 4.877109872048658, 25.588710122795028, 30.76941779473359, 0.1000000000000009, 55.0, 507, 989229, 1339, 42.40286339999875
1340, 4.012885263522369, 25.558383341403374, 30.731097871448984, 0.09999999999999952, 80.0, 823, 990052, 1340, 68.70492439999362
1341, 4.419294962476443, 25.436149434547204, 30.56191857563967, 0.10000000000000049, 145.0, 692, 990744, 1341, 57.932364300009795
1342, 4.665958491894564, 25.433495324417198, 30.592747626135914, 0.10000000000000092, 65.0, 537, 991281, 1342, 45.11454739999317
1343, 4.72303527325343, 25.456823113311916, 30.6187098077003, 0.09999999999999781, 490.0, 1222, 992503, 1343, 102.3956223000132
1344, 4.3830215597613496, 25.49561455838401, 30.63273936197942, 0.09999999999999964, 215.0, 802, 993305, 1344, 67.13114489999134
1345, 5.09580714076591, 25.49052382162449, 30.653098630790986, 0.09999999999999773, 340.0, 1253, 994558, 1345, 104.60604949999833
1346, 4.377895541024624, 25.565375958297615, 30.72911251096654, 0.10000000000000074, 20.0, 401, 994959, 1346, 33.54644130000088
1347, 4.772623657514601, 25.522288395063526, 30.66848231669005, 0.09999999999999866, 300.0, 985, 995944, 1347, 82.25232779998623
1348, 5.107062822894046, 25.499617517801155, 30.659707535478404, 0.10000000000000074, 170.0, 665, 996609, 1348, 55.67138080000586
1349, 4.674630639810418, 25.54089925291281, 30.695046895322367, 0.09999999999999813, 170.0, 1121, 997730, 1349, 93.88311290000274
1350, 4.383107171788559, 25.54750721131341, 30.697944439063637, 0.09999999999999885, 185.0, 944, 998674, 1350, 79.19529629999306
1351, 4.679883171702091, 25.568383049279355, 30.7359031437558, 0.09999999999999887, 210.0, 939, 999613, 1351, 78.41804770000454
