,loss,mae,mean_q,mean_eps,episode_reward,nb_episode_steps,nb_steps,episode,duration
0,0,0,0,0,55.0,380,380,0,1.2464051000000005
1, 0, 0, 0, 0, 105.0, 431, 811, 1, 1.3397003999999981
2, 0, 0, 0, 0, 305.0, 733, 1544, 2, 1.7212530000000008
3, 0, 0, 0, 0, 215.0, 843, 2387, 3, 1.9512056999999992
4, 0, 0, 0, 0, 135.0, 662, 3049, 4, 1.3901166000000025
5, 0, 0, 0, 0, 55.0, 403, 3452, 5, 0.8552876000000005
6, 0, 0, 0, 0, 50.0, 580, 4032, 6, 1.2045591000000009
7, 0, 0, 0, 0, 260.0, 928, 4960, 7, 1.918732300000002
8, 0, 0, 0, 0, 110.0, 646, 5606, 8, 1.5059324000000025
9, 0, 0, 0, 0, 315.0, 1085, 6691, 9, 2.2172871999999977
10, 0, 0, 0, 0, 225.0, 936, 7627, 10, 1.9390897000000038
11, 0, 0, 0, 0, 105.0, 653, 8280, 11, 1.4824234000000018
12, 0, 0, 0, 0, 80.0, 453, 8733, 12, 0.9726586999999967
13, 0, 0, 0, 0, 45.0, 444, 9177, 13, 0.9224854000000065
14, 0, 0, 0, 0, 105.0, 490, 9667, 14, 1.014111100000001
15, 0, 0, 0, 0, 165.0, 736, 10403, 15, 1.5837464000000026
16, 0, 0, 0, 0, 180.0, 414, 10817, 16, 0.9172214999999966
17, 0, 0, 0, 0, 75.0, 605, 11422, 17, 1.409249899999999
18, 0, 0, 0, 0, 50.0, 690, 12112, 18, 1.4437818999999976
19, 0, 0, 0, 0, 215.0, 822, 12934, 19, 1.6771065000000007
20, 0, 0, 0, 0, 255.0, 886, 13820, 20, 1.8249372000000008
21, 0, 0, 0, 0, 90.0, 509, 14329, 21, 1.0758706999999958
22, 0, 0, 0, 0, 105.0, 630, 14959, 22, 1.340344100000003
23, 0, 0, 0, 0, 80.0, 638, 15597, 23, 1.2991506000000044
24, 0, 0, 0, 0, 85.0, 492, 16089, 24, 1.058450300000004
25, 0, 0, 0, 0, 90.0, 481, 16570, 25, 1.0096038000000007
26, 0, 0, 0, 0, 330.0, 1331, 17901, 26, 2.619168199999997
27, 0, 0, 0, 0, 125.0, 784, 18685, 27, 1.636542200000001
28, 0, 0, 0, 0, 210.0, 810, 19495, 28, 1.680578600000004
29, 0, 0, 0, 0, 105.0, 521, 20016, 29, 1.0690124999999995
30, 0, 0, 0, 0, 110.0, 722, 20738, 30, 1.4759768999999991
31, 0, 0, 0, 0, 120.0, 694, 21432, 31, 1.4724501999999973
32, 0, 0, 0, 0, 160.0, 748, 22180, 32, 1.5455729000000034
33, 0, 0, 0, 0, 105.0, 491, 22671, 33, 1.0152280000000076
34, 0, 0, 0, 0, 55.0, 560, 23231, 34, 1.1870604000000071
35, 0, 0, 0, 0, 120.0, 643, 23874, 35, 1.3474133999999935
36, 0, 0, 0, 0, 45.0, 470, 24344, 36, 0.9898517999999967
37, 0, 0, 0, 0, 155.0, 733, 25077, 37, 1.554354900000007
38, 0, 0, 0, 0, 160.0, 951, 26028, 38, 2.0526742999999925
39, 0, 0, 0, 0, 135.0, 781, 26809, 39, 1.8105481999999995
40, 0, 0, 0, 0, 70.0, 375, 27184, 40, 0.8990660000000048
41, 0, 0, 0, 0, 45.0, 476, 27660, 41, 1.0018136000000055
42, 0, 0, 0, 0, 620.0, 1368, 29028, 42, 3.0036625000000043
43, 0, 0, 0, 0, 210.0, 1421, 30449, 43, 2.9863009999999974
44, 0, 0, 0, 0, 135.0, 702, 31151, 44, 1.9112043999999884
45, 0, 0, 0, 0, 315.0, 1180, 32331, 45, 3.2946191999999996
46, 0, 0, 0, 0, 180.0, 777, 33108, 46, 2.3016100999999907
47, 0, 0, 0, 0, 155.0, 732, 33840, 47, 1.9548009000000093
48, 0, 0, 0, 0, 150.0, 775, 34615, 48, 1.6617523999999975
49, 0, 0, 0, 0, 135.0, 651, 35266, 49, 1.4356772999999947
50, 0, 0, 0, 0, 120.0, 699, 35965, 50, 1.5123609000000044
51, 0, 0, 0, 0, 240.0, 930, 36895, 51, 2.539338900000004
52, 0, 0, 0, 0, 50.0, 498, 37393, 52, 1.2165284000000014
53, 0, 0, 0, 0, 120.0, 638, 38031, 53, 1.4176485999999926
54, 0, 0, 0, 0, 105.0, 505, 38536, 54, 1.0981378000000035
55, 0, 0, 0, 0, 35.0, 386, 38922, 55, 0.8926567000000034
56, 0, 0, 0, 0, 75.0, 418, 39340, 56, 0.8829329999999942
57, 0, 0, 0, 0, 135.0, 817, 40157, 57, 1.7717628999999988
58, 0, 0, 0, 0, 155.0, 602, 40759, 58, 1.3090978000000035
59, 0, 0, 0, 0, 120.0, 641, 41400, 59, 1.4957532999999898
60, 0, 0, 0, 0, 105.0, 645, 42045, 60, 1.4214405000000028
61, 0, 0, 0, 0, 135.0, 856, 42901, 61, 1.8606604000000004
62, 0, 0, 0, 0, 65.0, 393, 43294, 62, 0.8302185999999949
63, 0, 0, 0, 0, 155.0, 809, 44103, 63, 1.6615663999999981
64, 0, 0, 0, 0, 105.0, 739, 44842, 64, 1.5613331999999929
65, 0, 0, 0, 0, 145.0, 731, 45573, 65, 1.5906759999999878
66, 0, 0, 0, 0, 50.0, 403, 45976, 66, 0.9626717000000014
67, 0, 0, 0, 0, 310.0, 1005, 46981, 67, 2.269325600000002
68, 0, 0, 0, 0, 210.0, 867, 47848, 68, 2.316993300000007
69, 0, 0, 0, 0, 620.0, 1420, 49268, 69, 3.2139027000000056
70, 0, 0, 0, 0, 240.0, 1070, 50338, 70, 2.3742889000000105
71, 0, 0, 0, 0, 180.0, 819, 51157, 71, 1.741986799999978
72, 0, 0, 0, 0, 150.0, 801, 51958, 72, 1.6901385999999832
73, 0, 0, 0, 0, 180.0, 785, 52743, 73, 1.84682380000001
74, 0, 0, 0, 0, 125.0, 409, 53152, 74, 0.8698230999999907
75, 0, 0, 0, 0, 160.0, 772, 53924, 75, 1.5805620000000147
76, 0, 0, 0, 0, 180.0, 799, 54723, 76, 1.6982821999999942
77, 0, 0, 0, 0, 155.0, 824, 55547, 77, 1.6857584999999915
78, 0, 0, 0, 0, 90.0, 633, 56180, 78, 1.3226835999999764
79, 0, 0, 0, 0, 180.0, 809, 56989, 79, 1.7389928999999995
80, 0, 0, 0, 0, 110.0, 734, 57723, 80, 1.537119400000023
81, 0, 0, 0, 0, 35.0, 374, 58097, 81, 0.801669099999998
82, 0, 0, 0, 0, 185.0, 819, 58916, 82, 1.7229520000000207
83, 0, 0, 0, 0, 105.0, 656, 59572, 83, 1.3495171000000141
84, 0, 0, 0, 0, 210.0, 1030, 60602, 84, 2.1425059000000033
85, 0, 0, 0, 0, 145.0, 781, 61383, 85, 1.643217600000014
86, 0, 0, 0, 0, 140.0, 818, 62201, 86, 1.6865900000000238
87, 0, 0, 0, 0, 180.0, 785, 62986, 87, 1.6494672000000037
88, 0, 0, 0, 0, 135.0, 737, 63723, 88, 1.529062200000027
89, 0, 0, 0, 0, 110.0, 650, 64373, 89, 1.3338430000000017
90, 0, 0, 0, 0, 105.0, 652, 65025, 90, 1.3588502000000062
91, 0, 0, 0, 0, 50.0, 515, 65540, 91, 1.0670879000000184
92, 0, 0, 0, 0, 105.0, 638, 66178, 92, 1.3432203999999786
93, 0, 0, 0, 0, 75.0, 523, 66701, 93, 1.104426200000006
94, 0, 0, 0, 0, 210.0, 826, 67527, 94, 1.700162199999994
95, 0, 0, 0, 0, 60.0, 606, 68133, 95, 1.2957351000000017
96, 0, 0, 0, 0, 140.0, 775, 68908, 96, 1.5898502000000008
97, 0, 0, 0, 0, 205.0, 829, 69737, 97, 1.7087649000000056
98, 0, 0, 0, 0, 75.0, 677, 70414, 98, 1.4200257999999906
99, 0, 0, 0, 0, 165.0, 779, 71193, 99, 1.6076747999999839
100, 0, 0, 0, 0, 120.0, 759, 71952, 100, 1.6146296999999947
101, 0, 0, 0, 0, 155.0, 774, 72726, 101, 1.585078100000004
102, 0, 0, 0, 0, 125.0, 786, 73512, 102, 1.6471812000000057
103, 0, 0, 0, 0, 210.0, 865, 74377, 103, 1.7636846999999989
104, 0, 0, 0, 0, 260.0, 953, 75330, 104, 1.9474246999999991
105, 0, 0, 0, 0, 180.0, 854, 76184, 105, 1.7441313999999863
106, 0, 0, 0, 0, 105.0, 590, 76774, 106, 1.2230193999999983
107, 0, 0, 0, 0, 155.0, 763, 77537, 107, 1.591179000000011
108, 0, 0, 0, 0, 210.0, 866, 78403, 108, 1.800249199999996
109, 0, 0, 0, 0, 80.0, 412, 78815, 109, 0.8600498999999786
110, 0, 0, 0, 0, 50.0, 520, 79335, 110, 1.0746233999999788
111, 0, 0, 0, 0, 180.0, 778, 80113, 111, 1.6007285000000024
112, 0, 0, 0, 0, 180.0, 805, 80918, 112, 1.6308486000000073
113, 0, 0, 0, 0, 120.0, 622, 81540, 113, 1.2941457000000014
114, 0, 0, 0, 0, 315.0, 1100, 82640, 114, 2.265121399999998
115, 0, 0, 0, 0, 340.0, 1078, 83718, 115, 2.2401538000000016
116, 0, 0, 0, 0, 110.0, 587, 84305, 116, 1.242763000000025
117, 0, 0, 0, 0, 110.0, 701, 85006, 117, 1.4624528000000225
118, 0, 0, 0, 0, 210.0, 864, 85870, 118, 1.7735632000000123
119, 0, 0, 0, 0, 155.0, 808, 86678, 119, 2.0164086999999995
120, 0, 0, 0, 0, 130.0, 825, 87503, 120, 1.761663900000002
121, 0, 0, 0, 0, 185.0, 821, 88324, 121, 1.8380131999999776
122, 0, 0, 0, 0, 105.0, 662, 88986, 122, 1.3912917000000107
123, 0, 0, 0, 0, 210.0, 885, 89871, 123, 1.926922000000019
124, 0, 0, 0, 0, 180.0, 800, 90671, 124, 1.9199079999999924
125, 0, 0, 0, 0, 75.0, 403, 91074, 125, 0.8814298000000065
126, 0, 0, 0, 0, 110.0, 763, 91837, 126, 1.8115979000000095
127, 0, 0, 0, 0, 120.0, 674, 92511, 127, 1.6686419000000114
128, 0, 0, 0, 0, 265.0, 960, 93471, 128, 2.1885235999999963
129, 0, 0, 0, 0, 355.0, 827, 94298, 129, 1.9630362999999988
130, 0, 0, 0, 0, 180.0, 823, 95121, 130, 2.1983570000000157
131, 0, 0, 0, 0, 410.0, 896, 96017, 131, 3.5238634000000104
132, 0, 0, 0, 0, 355.0, 800, 96817, 132, 2.6042990999999915
133, 0, 0, 0, 0, 210.0, 790, 97607, 133, 2.0664840000000027
134, 0, 0, 0, 0, 105.0, 623, 98230, 134, 1.5096206999999993
135, 0, 0, 0, 0, 105.0, 635, 98865, 135, 1.5370187999999985
136, 0, 0, 0, 0, 210.0, 816, 99681, 136, 1.8911094000000048
137, 18.44033510501568, 38.15016615312178, 48.30093190119817, 0.8195895999999999, 135.0, 775, 100456, 137, 5.381338599999992
138, 10.838183581281234, 38.06106979882016, 46.89575178833569, 0.8182009000000002, 280.0, 1088, 101544, 138, 10.114928599999985
139, 12.977447234817797, 37.98523250324129, 46.571462273760794, 0.8165637999999998, 155.0, 731, 102275, 139, 7.158126899999985
140, 9.749712256730096, 38.055753999505164, 46.43495820573539, 0.8150346999999999, 355.0, 968, 103243, 140, 9.307405599999981
141, 11.412024699093218, 38.024783568762835, 46.35559095761772, 0.8135884000000003, 105.0, 639, 103882, 141, 6.12674770000001
142, 12.32171675814473, 38.107522252353, 46.51003113651812, 0.8125335999999999, 80.0, 533, 104415, 142, 5.232655700000009
143, 10.605846261735278, 37.93601475506768, 46.106384141335866, 0.8115237999999997, 110.0, 589, 105004, 143, 5.985906699999987
144, 8.539815149809185, 37.994643445023605, 46.15359553148439, 0.8104978, 105.0, 551, 105555, 144, 5.494186000000013
145, 8.628301000193828, 38.0152938650166, 46.03619010251167, 0.8093602000000003, 170.0, 713, 106268, 145, 8.081071199999997
146, 9.525322725670566, 37.94312774020322, 45.97030249365879, 0.8079004000000002, 235.0, 909, 107177, 146, 10.840583800000047
147, 8.96116235469225, 37.90866818188746, 45.94809454424145, 0.806347, 410.0, 817, 107994, 147, 9.140567900000008
148, 8.825892966810965, 37.925353360875036, 45.89820117515539, 0.8045065000000008, 225.0, 1228, 109222, 148, 13.312294800000018
149, 8.547047117502682, 37.93105907591964, 45.88063892192486, 0.8027226999999997, 135.0, 754, 109976, 149, 8.216646400000002
150, 8.493825764320363, 37.4714324556548, 45.341114449775084, 0.8014176999999998, 120.0, 696, 110672, 150, 7.969003799999996
151, 9.105410290979485, 37.39663111999344, 45.2380820975816, 0.8004646000000002, 50.0, 363, 111035, 151, 4.0709971
152, 7.539697532452843, 37.47075617024116, 45.34952288904105, 0.7994332000000002, 155.0, 783, 111818, 152, 8.634587699999997
153, 7.204143529455961, 37.36726155023448, 45.25387486137989, 0.7978456, 240.0, 981, 112799, 153, 10.404772200000025
154, 6.094192460241677, 37.43606892988772, 45.31744453398254, 0.7965325, 35.0, 478, 113277, 154, 5.026283700000022
155, 9.939889888090143, 37.48054277751149, 45.4394821596029, 0.7953661000000003, 215.0, 818, 114095, 155, 8.658434900000032
156, 8.676267531517935, 37.46301672220532, 45.44550805266678, 0.793918, 210.0, 791, 114886, 156, 8.394623700000011
157, 8.01076287961131, 37.4338575433062, 45.27938009931155, 0.7923466000000001, 180.0, 955, 115841, 157, 10.17788109999998
158, 9.962607235388017, 37.388705815060035, 45.31857597458531, 0.7908481000000002, 130.0, 710, 116551, 158, 7.635852299999954
159, 6.238927593841305, 37.39977534312122, 45.192811956945455, 0.7898275000000001, 50.0, 424, 116975, 159, 4.653585599999985
160, 4.751091817165396, 37.469175494736454, 45.20968946293827, 0.7889616999999995, 150.0, 538, 117513, 160, 5.587139300000047
161, 7.480788473137899, 37.47016901091526, 45.36458482240376, 0.7879303000000001, 135.0, 608, 118121, 161, 6.270896300000004
162, 4.6249606711757965, 37.34750813880737, 45.07658458985004, 0.7868593000000003, 120.0, 582, 118703, 162, 5.945120800000041
163, 7.415375861931086, 37.357956699366575, 45.199208939417765, 0.7856145999999997, 150.0, 801, 119504, 163, 8.094087400000035
164, 6.411637509511067, 37.68969705434946, 45.42242916400616, 0.7843087000000002, 90.0, 650, 120154, 164, 6.496016499999996
165, 7.142419101018668, 38.19859199007262, 46.034938342953375, 0.7829262999999994, 345.0, 886, 121040, 165, 8.718084900000008
166, 7.112328584608824, 38.161813102390454, 46.03875874394956, 0.7816114000000001, 90.0, 575, 121615, 166, 5.913200500000016
167, 9.046072255226713, 38.220403765885074, 46.294876267953576, 0.7807491999999999, 60.0, 383, 121998, 167, 3.8106627999999887
168, 6.556986014562313, 38.13983197230725, 46.00638476195341, 0.7797088000000004, 380.0, 773, 122771, 168, 7.612678999999957
169, 6.639356457226945, 38.20402822933436, 46.04822365509416, 0.7785829000000003, 70.0, 478, 123249, 169, 4.815456400000016
170, 5.806499038339837, 38.21172130366519, 46.13178725684653, 0.7776963999999997, 110.0, 507, 123756, 170, 5.033543399999985
171, 7.248944937976109, 38.16252971935823, 46.063254930793896, 0.7764616000000004, 375.0, 865, 124621, 171, 8.579729799999996
172, 7.2133140683174135, 38.11393378952802, 46.04530033822787, 0.7751521, 105.0, 590, 125211, 172, 5.892351700000006
173, 5.633953513075476, 38.2133822399637, 46.0363632865574, 0.7742071000000001, 30.0, 460, 125671, 173, 4.571697400000005
174, 6.808931737398579, 38.11865046146142, 46.03568047850671, 0.7731765999999999, 155.0, 685, 126356, 174, 6.9911731999999915
175, 8.943823783311695, 38.21521907382541, 46.20281269304004, 0.7716366999999995, 290.0, 1026, 127382, 175, 10.669458500000019
176, 5.512246689757505, 38.0973234782418, 45.98776031881841, 0.7702174000000003, 135.0, 551, 127933, 176, 5.768858499999965
177, 6.32118428222249, 38.14813026685393, 46.011987819028704, 0.7693209999999998, 90.0, 445, 128378, 177, 5.178961700000059
178, 4.909629268676807, 38.12721542456211, 45.948165595225795, 0.7682185000000002, 170.0, 780, 129158, 178, 8.278513800000042
179, 7.453303408433144, 38.16709029271636, 46.11720267536626, 0.7670638000000001, 110.0, 503, 129661, 179, 5.026665900000012
180, 5.913175380661198, 38.51016724263667, 46.45692016049565, 0.7659144999999998, 210.0, 774, 130435, 180, 7.7663151000000425
181, 7.330413054748877, 38.8678451879135, 46.94997781159862, 0.7646742999999999, 135.0, 604, 131039, 181, 6.162555099999963
182, 6.853014205111546, 38.75537972503834, 46.84996314530962, 0.7634898999999998, 75.0, 712, 131751, 182, 7.244056399999977
183, 7.488847190036183, 38.83975542119119, 46.9482611175132, 0.7624423, 45.0, 452, 132203, 183, 4.5943097000000535
184, 7.213941186277425, 38.79353753331436, 46.84271568417861, 0.7613461, 105.0, 766, 132969, 184, 7.859125099999915
185, 9.887884789008996, 39.010350713374834, 47.19789133818679, 0.7599556000000005, 180.0, 779, 133748, 185, 8.068432799999982
186, 7.630477426937839, 38.827584527724284, 46.97390212160249, 0.7589323, 30.0, 358, 134106, 186, 3.706492400000002
187, 12.407193310009806, 38.86421747709576, 47.06992878160979, 0.7582681, 70.0, 380, 134486, 187, 3.86167219999993
188, 6.0526487202024155, 38.78592662363927, 46.859945402979086, 0.7570819000000005, 175.0, 938, 135424, 188, 9.544139700000073
189, 7.280418342001298, 38.84355503755457, 46.884683048023895, 0.7554727, 165.0, 850, 136274, 189, 8.806716499999993
190, 6.721913370179992, 38.73558226348348, 46.79198413915028, 0.7540849000000001, 210.0, 692, 136966, 190, 7.169630200000029
191, 8.130575098517147, 38.75448069472096, 46.8053800242334, 0.7521363999999992, 415.0, 1473, 138439, 191, 15.605443300000047
192, 8.129576525054716, 38.8066980888654, 46.86728765974484, 0.7499502999999998, 220.0, 956, 139395, 192, 10.064753200000041
193, 9.902694351620534, 38.758154128579534, 46.75506190131692, 0.7484779, 110.0, 680, 140075, 193, 7.2194226999999955
194, 6.774643127780176, 38.43405122272039, 46.33618594024141, 0.7472286999999999, 120.0, 708, 140783, 194, 7.514083800000094
195, 5.092478216035862, 38.44850538912459, 46.362196290161336, 0.7460416, 105.0, 611, 141394, 195, 6.768242299999997
196, 6.715485113482868, 38.39904247142013, 46.34442610455742, 0.7446934000000002, 125.0, 887, 142281, 196, 9.505815899999902
197, 5.237346510463333, 38.38769346088558, 46.24934297413021, 0.7433407000000004, 120.0, 616, 142897, 197, 6.480973099999915
198, 6.34046527221439, 38.380865138509996, 46.321491250669325, 0.7420411000000001, 155.0, 828, 143725, 198, 9.175701600000025
199, 5.598811709179598, 38.37109978619744, 46.2611241015266, 0.7405308999999997, 185.0, 850, 144575, 199, 9.131613499999958
200, 6.700311150428576, 38.33769750741812, 46.252692229442104, 0.7388884, 210.0, 975, 145550, 200, 10.519615499999986
201, 6.1637408223297125, 38.40925077509911, 46.341167681892664, 0.7373152000000002, 135.0, 773, 146323, 201, 8.560211299999992
202, 5.65674089962709, 38.39557856025425, 46.33340463300123, 0.735985, 105.0, 705, 147028, 202, 7.8661081000000195
203, 6.102529285680767, 38.345357119062086, 46.2163011099546, 0.7345252000000005, 210.0, 917, 147945, 203, 10.15403989999993
204, 4.651426109586443, 38.37451324462891, 46.23814246768043, 0.7332274, 120.0, 525, 148470, 204, 5.809150399999908
205, 5.869905639955631, 38.37866168388953, 46.27606329306578, 0.7320529000000005, 170.0, 780, 149250, 205, 8.664913700000056
206, 6.37199279851756, 38.347416581617885, 46.20783970466744, 0.7306147000000002, 335.0, 818, 150068, 206, 8.976938300000029
207, 5.676438203464874, 37.776171137074954, 45.534365989254255, 0.7293844000000004, 30.0, 549, 150617, 207, 6.1376498999999285
208, 5.038946199027879, 37.75453450452803, 45.528167322430434, 0.7277463999999999, 315.0, 1271, 151888, 208, 14.252241299999923
209, 5.617641919738974, 37.73364137844989, 45.4821307583327, 0.7258384000000002, 215.0, 849, 152737, 209, 10.265693599999963
210, 4.722587896082527, 37.7668000393688, 45.52517163416263, 0.7243425999999998, 180.0, 813, 153550, 210, 9.143029099999922
211, 5.096250716461102, 37.805713819588725, 45.54102116171648, 0.7227217000000001, 260.0, 988, 154538, 211, 11.148521999999957
212, 3.770761114566448, 37.755595563155914, 45.47306686334952, 0.7210053999999995, 125.0, 919, 155457, 212, 9.884956699999975
213, 5.368055189987522, 37.76073686880023, 45.482181275617265, 0.7194250000000003, 165.0, 837, 156294, 213, 8.98981880000008
214, 5.534712203760665, 37.75874105325692, 45.51449771596569, 0.7179598000000003, 180.0, 791, 157085, 214, 8.563085300000012
215, 5.3022444134974105, 37.78287789202112, 45.53183226698027, 0.7167907000000004, 125.0, 508, 157593, 215, 5.390197400000034
216, 4.493481878670611, 37.700852469510814, 45.426566030812815, 0.7157529999999995, 105.0, 645, 158238, 216, 6.8258359000000155
217, 4.017753255367279, 37.803627943792264, 45.53016029806698, 0.714637, 20.0, 595, 158833, 217, 6.362552200000096
218, 6.942071974920134, 37.73574789000971, 45.52385013508347, 0.7137675999999998, 15.0, 371, 159204, 218, 3.9647655999999643
219, 5.883074865999653, 37.80880562627585, 45.5349834919955, 0.7129953999999998, 80.0, 487, 159691, 219, 5.21573520000004
220, 4.049676957157848, 37.91052897256724, 45.69095861119753, 0.7120287999999999, 75.0, 587, 160278, 220, 6.28506660000005
221, 4.422451487425806, 37.96276417624187, 45.71469912505502, 0.7107697000000001, 210.0, 812, 161090, 221, 8.716043200000058
222, 5.692876181525682, 37.94660924573594, 45.75445467835813, 0.7094242000000002, 145.0, 683, 161773, 222, 7.354940400000032
223, 3.2121487418020784, 37.979137154636355, 45.74072258708534, 0.7081642000000004, 135.0, 717, 162490, 223, 7.725112400000057
224, 5.444101271117299, 37.94261710509348, 45.756912655929426, 0.7069123000000002, 105.0, 674, 163164, 224, 7.291831699999989
225, 8.027569797765873, 37.90890901738947, 45.767686485123114, 0.7057315000000001, 105.0, 638, 163802, 225, 6.868052599999942
226, 9.725836086332798, 38.22109181213379, 46.22223903656006, 0.7047072999999999, 60.0, 500, 164302, 226, 5.4178858999999875
227, 4.813666327033901, 37.9501159509921, 45.7159747825953, 0.7037793999999999, 60.0, 531, 164833, 227, 5.77237660000003
228, 3.879153985482629, 37.932919452893316, 45.691593593703296, 0.7021018, 410.0, 1333, 166166, 228, 14.3264997
229, 4.767297601114375, 37.929755772454136, 45.68943212401054, 0.6999652000000002, 315.0, 1041, 167207, 229, 11.263343400000053
230, 4.641366311879249, 37.90277359398168, 45.672000355697705, 0.6984640000000002, 155.0, 627, 167834, 230, 6.8581036000000495
231, 4.555565576783115, 37.96672428451256, 45.737351530137474, 0.6966342999999998, 395.0, 1406, 169240, 231, 15.281942299999969
232, 5.982734223117415, 37.940246001398116, 45.73386772642744, 0.6948189999999997, 35.0, 611, 169851, 232, 6.679682800000023
233, 3.73605948090177, 37.589977842388734, 45.248595565256444, 0.6939126999999999, 35.0, 396, 170247, 233, 4.494238900000028
234, 4.387077465874177, 37.44024551768362, 45.08359435752586, 0.6928273, 165.0, 810, 171057, 234, 9.484831899999904
235, 7.147006613453134, 37.46213488395397, 45.22734847435584, 0.6913495000000002, 255.0, 832, 171889, 235, 9.583474000000024
236, 4.513316264735308, 37.368799475604774, 44.984687963649854, 0.6899941000000002, 135.0, 674, 172563, 236, 8.216277900000023
237, 3.7488433515925417, 37.38719162168239, 44.98612192402715, 0.6884766999999999, 300.0, 1012, 173575, 237, 13.108691699999895
238, 5.119631504181956, 37.380469968009265, 45.014125395843394, 0.6868522000000002, 410.0, 793, 174368, 238, 10.202838100000008
239, 4.739557125011398, 37.33761743078366, 45.0559021507894, 0.6855616000000001, 110.0, 641, 175009, 239, 7.879585299999917
240, 5.546859743224047, 37.44493443587364, 45.15494522477259, 0.6843385000000002, 135.0, 718, 175727, 240, 8.673284199999898
241, 5.5696157297728375, 37.299985940959054, 44.93705961275377, 0.683227, 70.0, 517, 176244, 241, 6.31780260000005
242, 5.214099960202661, 37.39469425763157, 45.05046732134264, 0.6818265999999994, 340.0, 1039, 177283, 242, 12.614682200000061
243, 4.670359755667408, 37.388714389110476, 45.0242769810442, 0.6801706000000002, 110.0, 801, 178084, 243, 9.318063400000028
244, 7.246177566017997, 37.42127234212468, 45.14324974745847, 0.6789690999999999, 110.0, 534, 178618, 244, 6.270900300000221
245, 4.043195480738545, 37.425140151778336, 45.08196239122834, 0.6777990999999999, 180.0, 766, 179384, 245, 9.128668300000072
246, 3.35772533785531, 37.634245792580714, 45.32340250778908, 0.6761430999999994, 345.0, 1074, 180458, 246, 12.382051199999978
247, 5.027346176454927, 37.82225005933554, 45.651567482712245, 0.6744493000000003, 180.0, 808, 181266, 247, 9.119005399999878
248, 9.523444680758745, 37.87156612932189, 45.736985047395564, 0.6731776000000002, 60.0, 605, 181871, 248, 7.542367899999817
249, 5.593400577753048, 37.84101982304615, 45.60276612781343, 0.6720849999999998, 5.0, 609, 182480, 249, 7.596474499999886
250, 5.922788118574825, 37.81085768568939, 45.5580428893191, 0.6708276999999997, 145.0, 788, 183268, 250, 8.961544900000035
251, 4.556631057194926, 37.86168778950328, 45.59709884181167, 0.6695541999999999, 120.0, 627, 183895, 251, 7.246268799999825
252, 4.657057692228879, 37.75461701403947, 45.48606152279451, 0.6684346, 135.0, 617, 184512, 252, 7.20359859999985
253, 4.469682955311132, 37.80392863523526, 45.52048763181012, 0.6671134000000002, 210.0, 851, 185363, 253, 9.804693900000075
254, 4.111672240264556, 37.83606438094711, 45.566414750380325, 0.6654132999999997, 260.0, 1038, 186401, 254, 12.11196229999996
255, 3.743927044648191, 37.87264289619019, 45.58889551577361, 0.6637546, 210.0, 805, 187206, 255, 9.465618699999823
256, 4.900168592471008, 37.81470718569645, 45.573260136556684, 0.6622911999999999, 165.0, 821, 188027, 256, 9.533566000000064
257, 3.908127633980505, 37.81992395486042, 45.59949459877743, 0.6608458, 155.0, 785, 188812, 257, 9.028504200000043
258, 3.749306009753662, 37.87563920956032, 45.62202339546353, 0.6594048999999996, 170.0, 816, 189628, 258, 9.575615299999981
259, 4.380094427649897, 37.815684654094554, 45.568290486747834, 0.6580872999999998, 105.0, 648, 190276, 259, 7.533153600000105
260, 5.023970577799822, 37.73050134876107, 45.428847740269916, 0.6567930999999997, 175.0, 790, 191066, 260, 9.133986399999912
261, 7.0316115303436915, 37.65988214111328, 45.45494641113281, 0.6557446000000001, 50.0, 375, 191441, 261, 4.4154490999999325
262, 4.960716560365647, 37.713071958286555, 45.41852767824188, 0.6548356000000004, 105.0, 635, 192076, 262, 7.408469299999979
263, 4.367358843597605, 37.75891623342323, 45.47754869340001, 0.6536259999999999, 105.0, 709, 192785, 263, 8.32288480000011
264, 5.721784980428789, 37.800669285593926, 45.56743467152798, 0.6521977000000001, 410.0, 878, 193663, 264, 10.24488550000001
265, 5.168662393985908, 37.70559788360271, 45.45029654025015, 0.6505632999999998, 400.0, 938, 194601, 265, 11.094682700000021
266, 5.27911442075856, 37.78327999512354, 45.5477537214756, 0.6493734999999999, 55.0, 384, 194985, 266, 4.563668199999938
267, 3.3015901427382945, 37.69027164254589, 45.34941817838519, 0.6483735999999997, 185.0, 727, 195712, 267, 8.549203300000045
268, 7.268975678646203, 37.791953915682704, 45.57661415793679, 0.6469767999999998, 210.0, 825, 196537, 268, 9.803075300000046
269, 3.855184882687944, 37.74581715451838, 45.482337668686895, 0.6456033999999997, 180.0, 701, 197238, 269, 8.212085800000068
270, 3.9329181666657025, 37.70052690895236, 45.417962122936636, 0.6446197, 55.0, 392, 197630, 270, 4.682269500000075
271, 4.965990399354196, 37.73897169161946, 45.48478898525819, 0.6435280000000003, 150.0, 821, 198451, 271, 9.759260799999993
272, 5.969275483590573, 37.7723136606796, 45.52484435051625, 0.6423004000000002, 55.0, 543, 198994, 272, 6.477580400000079
273, 5.7062035453312125, 37.80744135513401, 45.58561893714914, 0.6410889999999999, 140.0, 803, 199797, 273, 9.424246899999844
274, 4.313976834674181, 38.18822946281077, 45.96631967736677, 0.6394995999999995, 215.0, 963, 200760, 274, 11.608794799999941
275, 5.961601540538264, 38.341166937138645, 46.21937828430259, 0.6379768000000002, 155.0, 729, 201489, 275, 8.782106399999975
276, 5.3471705124515, 38.34260885974867, 46.185580604655556, 0.6367167999999999, 105.0, 671, 202160, 276, 7.949267899999995
277, 4.4407839882446245, 38.35574168629117, 46.197610603438484, 0.6355944999999996, 110.0, 576, 202736, 277, 6.872101100000009
278, 4.552456971626532, 38.43993290951377, 46.260557058233964, 0.6346486, 80.0, 475, 203211, 278, 5.684396500000048
279, 4.4146294296021376, 38.343973470705805, 46.201670978510265, 0.6336469000000002, 310.0, 638, 203849, 279, 7.645234299999856
280, 4.157406297922134, 38.29803354436701, 46.146114155162465, 0.6325777000000001, 80.0, 550, 204399, 280, 6.594322900000179
281, 4.045636670891288, 38.30585431377388, 46.132844283141885, 0.630748, 490.0, 1483, 205882, 281, 18.061127599999963
282, 6.9335663807861385, 38.35849132853977, 46.251853616198126, 0.6290875000000001, 50.0, 362, 206244, 282, 4.472057200000108
283, 7.0272069424099755, 38.45827020704746, 46.40136057883501, 0.6283009000000002, 50.0, 512, 206756, 283, 6.27603309999995
284, 6.668030601535806, 38.318100101691634, 46.248604045989524, 0.6270777999999998, 210.0, 847, 207603, 284, 10.233996200000092
285, 2.8563114598356374, 38.37189669632793, 46.16349537218388, 0.6259536999999998, 45.0, 402, 208005, 285, 4.956010699999979
286, 3.330001364381093, 38.33691497989323, 46.148522646530814, 0.6249294999999999, 145.0, 736, 208741, 286, 8.987236799999891
287, 3.5812079796521488, 38.381256391976834, 46.22823715479551, 0.6229935999999994, 365.0, 1415, 210156, 287, 17.18166569999994
288, 3.9632101607912267, 38.76403459334978, 46.64605254114609, 0.620974, 210.0, 829, 210985, 288, 10.16375569999991
289, 7.203005845216233, 38.80052029487141, 46.754743805144756, 0.6195835000000002, 140.0, 716, 211701, 289, 9.072280799999817
290, 5.49097313050654, 38.67709030762562, 46.62784326669261, 0.6182875000000003, 105.0, 724, 212425, 290, 9.089238000000023
291, 2.8591769934526874, 38.70199853611521, 46.574810408840776, 0.617149, 105.0, 541, 212966, 291, 6.802431699999943
292, 6.937814183970801, 38.745307772992604, 46.67240192803992, 0.6160644999999997, 145.0, 664, 213630, 292, 8.176504499999965
293, 4.036104657351504, 38.752755867650144, 46.67071520945869, 0.6143184999999994, 220.0, 1276, 214906, 293, 16.047565300000088
294, 3.639762044545132, 38.710941328799656, 46.60241348069168, 0.6126832000000001, 50.0, 541, 215447, 294, 6.845800800000006
295, 3.009042908633013, 38.60862460548495, 46.42961542694657, 0.6116130999999997, 140.0, 648, 216095, 295, 8.027490600000192
296, 5.077292406596895, 38.73451932776713, 46.67347344306012, 0.6104637999999998, 25.0, 629, 216724, 296, 7.955374599999914
297, 3.290765366883892, 38.64523097722217, 46.55498071150346, 0.6095413000000001, 40.0, 396, 217120, 297, 5.011481600000025
298, 4.494711353662884, 38.671551030650484, 46.55414052709378, 0.6086575, 120.0, 586, 217706, 298, 7.266466399999899
299, 7.351522059621899, 38.77994946950042, 46.76381140736757, 0.6075441999999998, 70.0, 651, 218357, 299, 8.172627599999942
300, 5.536631127790009, 38.76109555395026, 46.69989260121396, 0.6062742999999998, 135.0, 760, 219117, 300, 9.558582599999909
301, 4.45891412034213, 38.75503715622091, 46.65108854525557, 0.6052051, 45.0, 428, 219545, 301, 5.4368135000001985
302, 4.584414733540313, 39.10212805683926, 47.08495074572604, 0.6038686000000001, 260.0, 1057, 220602, 302, 14.094765400000142
303, 2.9707615996294154, 39.29650847049035, 47.2631104528521, 0.6024970000000001, 115.0, 467, 221069, 303, 5.811156499999925
304, 4.242297963415159, 39.16780029618729, 47.1923638085048, 0.6011380000000001, 205.0, 1043, 222112, 304, 13.017794200000026
305, 3.9028973218313485, 39.29482103687848, 47.33763465585635, 0.5996188, 110.0, 645, 222757, 305, 8.183648700000049
306, 4.594563882454295, 39.267460896960046, 47.25383721242532, 0.5985505000000001, 45.0, 542, 223299, 306, 6.994684799999959
307, 4.884877662135542, 39.28038238415615, 47.28121842857745, 0.5974372, 180.0, 695, 223994, 307, 9.019981099999995
308, 5.067094822391748, 39.271879896721316, 47.331387036607346, 0.596476, 45.0, 373, 224367, 308, 4.7204825000001165
309, 5.221244499786098, 39.278761824577664, 47.304723249929594, 0.5953725999999999, 360.0, 853, 225220, 309, 10.827400399999988
310, 2.8747390835265803, 39.23657413885845, 47.21118036905924, 0.5940514000000001, 70.0, 615, 225835, 310, 7.759705100000019
311, 4.266464112576709, 39.194259672022575, 47.19666772102242, 0.5930155000000003, 80.0, 536, 226371, 311, 6.7323129999999765
312, 4.719390777764079, 39.27709822915743, 47.30294751929982, 0.5918589999999998, 135.0, 749, 227120, 312, 9.620071300000063
313, 4.151298533756655, 39.2637706193004, 47.24695252265977, 0.5904478, 195.0, 819, 227939, 313, 10.50303340000005
314, 4.722609804363853, 39.195681026548044, 47.20137217212282, 0.5891724999999998, 105.0, 598, 228537, 314, 7.635088500000165
315, 5.431422164756201, 39.323800138469394, 47.385316688092686, 0.5878008999999998, 265.0, 926, 229463, 315, 11.888151599999901
316, 4.088450998381565, 39.240654241550736, 47.23403186463473, 0.5861979999999999, 315.0, 855, 230318, 316, 10.859926700000187
317, 6.765435078722167, 39.023945911821116, 47.06275512511472, 0.5846815000000001, 205.0, 830, 231148, 317, 11.348323000000164
318, 5.900686757481075, 39.02939443193244, 47.04034274851782, 0.5834781999999998, 75.0, 507, 231655, 318, 6.75118220000013
319, 7.02506978037371, 39.083088043914444, 47.13550828517168, 0.5822388999999999, 160.0, 870, 232525, 319, 11.166223200000104
320, 4.064512469183217, 39.10682512575442, 47.071899537782414, 0.5809563999999997, 115.0, 555, 233080, 320, 7.220689600000014
321, 3.6523431570971527, 38.99642653481113, 46.9697437349744, 0.5799151, 60.0, 602, 233682, 321, 7.858131599999979
322, 5.171773069445405, 39.09130224743605, 47.11656663211166, 0.5786776, 210.0, 773, 234455, 322, 10.037414399999989
323, 4.037270122704035, 39.04412464895648, 47.01683254584581, 0.5773807000000001, 45.0, 668, 235123, 323, 8.719863999999916
324, 5.537015051262229, 39.10289713829174, 47.125362560903426, 0.5759038000000002, 535.0, 973, 236096, 324, 12.855881000000181
325, 3.894646063330972, 39.068595669823836, 47.03994378842024, 0.5742189999999998, 210.0, 899, 236995, 325, 11.907514900000024
326, 4.753748545890123, 39.114089401674946, 47.10765090190189, 0.5727708999999999, 135.0, 710, 237705, 326, 9.305221200000005
327, 5.506765085446127, 39.08281329064912, 47.11033173161615, 0.5713885, 210.0, 826, 238531, 327, 10.94034019999981
328, 4.722265255070135, 39.07091264069008, 47.05707357243261, 0.5698989999999997, 180.0, 829, 239360, 328, 10.952908900000011
329, 4.575505255391262, 39.01289798291914, 46.99161537966114, 0.5684193999999998, 150.0, 815, 240175, 329, 10.840892799999892
330, 4.696768587139038, 38.67319529859578, 46.58466260426972, 0.5669964999999999, 240.0, 766, 240941, 330, 10.266828899999837
331, 2.878383832247928, 38.620927276611326, 46.465104098320005, 0.5655870999999999, 140.0, 800, 241741, 331, 10.585174399999914
332, 5.832964968623467, 38.67271824385686, 46.638830272235424, 0.5642181999999999, 320.0, 721, 242462, 332, 9.444798499999933
333, 4.8309209967387545, 38.70103768501573, 46.58000441689528, 0.5629797999999999, 155.0, 655, 243117, 333, 8.814893600000005
334, 6.63135248679118, 38.6736136212375, 46.62596061060337, 0.5617314999999999, 80.0, 732, 243849, 334, 9.9402556
335, 4.292162898788423, 38.604526498612024, 46.48558007926782, 0.5604238, 240.0, 721, 244570, 335, 9.721028299999944
336, 6.48146156348564, 38.61059803432889, 46.58631475943106, 0.5592889000000001, 80.0, 540, 245110, 336, 7.299605200000087
337, 3.7562316803769633, 38.64988959919322, 46.482359649195814, 0.5582088999999998, 150.0, 660, 245770, 337, 8.784564299999829
338, 6.820048790478091, 38.71459345630904, 46.66320464110459, 0.5566033, 345.0, 1124, 246894, 338, 15.102374399999917
339, 8.061916290542761, 38.73565587878061, 46.752589399526116, 0.5549446000000002, 210.0, 719, 247613, 339, 11.952431599999954
340, 4.885727509964833, 38.72415567069985, 46.61308647244734, 0.5536801000000002, 110.0, 686, 248299, 340, 11.039830500000107
341, 3.785444183754629, 38.65020098911693, 46.52198280428003, 0.5520349000000004, 240.0, 1142, 249441, 341, 16.088925000000017
342, 3.965790237618398, 38.75795169851017, 46.609969354667456, 0.5505094, 85.0, 553, 249994, 342, 7.670778400000017
343, 3.218067324244669, 38.599798385336335, 46.44895793167136, 0.5493826000000002, 105.0, 699, 250693, 343, 9.5050126000001
344, 5.3241986158147325, 38.68331039563744, 46.59297658869651, 0.5482450000000001, 140.0, 565, 251258, 344, 7.78354679999984
345, 6.200061597892602, 38.65288685152195, 46.56949053514724, 0.5472000999999997, 35.0, 596, 251854, 345, 8.505961999999954
346, 3.919067688356926, 38.65886810567895, 46.56512114297345, 0.5455243000000001, 395.0, 1266, 253120, 346, 17.483673100000033
347, 6.131007000335358, 38.62345500442217, 46.58300215523198, 0.5436694000000002, 195.0, 795, 253915, 347, 11.247928799999954
348, 5.201329173039875, 38.64500484666858, 46.55333084765226, 0.5421826000000001, 220.0, 857, 254772, 348, 12.158987399999887
349, 4.9944393586749305, 38.52805060263374, 46.41346885261706, 0.5408056, 100.0, 673, 255445, 349, 9.391624800000045
350, 2.9792392576275164, 38.61154884155048, 46.413610892022604, 0.5397130000000001, 90.0, 541, 255986, 350, 7.795410100000026
351, 4.059769153477175, 38.561357927887805, 46.398561960152485, 0.5387706999999999, 105.0, 506, 256492, 351, 7.3371391999999105
352, 4.791968122329398, 38.5653348291938, 46.462967360686505, 0.5373981999999999, 465.0, 1019, 257511, 352, 14.311805999999706
353, 3.157078972096271, 38.5882145019776, 46.416501126824855, 0.5358078999999998, 155.0, 748, 258259, 353, 10.529315499999939
354, 3.644710068806851, 38.60503020941042, 46.47126123676938, 0.5343543999999999, 85.0, 867, 259126, 354, 12.138630899999953
355, 2.7511080416811615, 38.63720959575237, 46.50744049969841, 0.5330385999999997, 105.0, 595, 259721, 355, 8.579343000000335
356, 4.782177428026756, 38.6429556612483, 46.55405136839359, 0.5317515999999999, 95.0, 835, 260556, 356, 12.01335599999993
357, 2.76486245120007, 38.62217857060808, 46.452908408775755, 0.5306797, 45.0, 356, 260912, 357, 5.197110300000077
358, 3.8499982294665847, 38.68179244661956, 46.59552343443492, 0.5297410000000002, 105.0, 687, 261599, 358, 9.78994909999983
359, 3.96369904066193, 38.55760401154715, 46.4227536174147, 0.5285260000000003, 105.0, 663, 262262, 359, 10.131616099999974
360, 3.4727967159935784, 38.5908186433065, 46.43930146022396, 0.5271148, 85.0, 905, 263167, 360, 14.306133900000077
361, 5.35028797981059, 38.582959055265036, 46.47480106862192, 0.5251185999999999, 325.0, 1313, 264480, 361, 20.10129010000037
362, 8.23445836079674, 38.694396046939815, 46.65874547057509, 0.5233842999999999, 75.0, 614, 265094, 362, 8.702230399999735
363, 3.0299541590016656, 38.47657337338906, 46.251730137922635, 0.5223745, 30.0, 508, 265602, 363, 7.767450400000143
364, 5.244294090146788, 38.58994702796015, 46.51811957934912, 0.5212090000000003, 215.0, 787, 266389, 364, 11.601028699999915
365, 4.275088653057422, 38.60895451735995, 46.51015183461325, 0.5197474000000002, 170.0, 837, 267226, 365, 11.832462999999734
366, 2.97947772021755, 38.56275463421083, 46.370604271112484, 0.5184523000000001, 60.0, 602, 267828, 366, 8.593976000000112
367, 3.3013288564081167, 38.71200701634302, 46.57810316520466, 0.5175747999999999, 110.0, 373, 268201, 367, 5.314517099999648
368, 3.8652433228073466, 38.67326078427004, 46.53432846552821, 0.5165289999999998, 210.0, 789, 268990, 368, 11.058792699999685
369, 4.0122948918602255, 38.6867447428184, 46.57850603160291, 0.5153644000000001, 90.0, 505, 269495, 369, 7.422284700000091
370, 4.310322678759694, 38.461728625297546, 46.31663298130035, 0.5141899000000002, 120.0, 800, 270295, 370, 11.785310400000071
371, 3.6785434526800085, 38.1536580084113, 45.8946742256414, 0.5129470000000002, 60.0, 581, 270876, 371, 8.524806100000205
372, 4.445456220372384, 38.1998406033556, 46.038309132551944, 0.5118885999999997, 135.0, 595, 271471, 372, 8.69335880000017
373, 2.801360890257546, 38.19633100614773, 45.95203960749108, 0.5107816000000001, 180.0, 635, 272106, 373, 9.202250899999854
374, 5.51675755551333, 38.244967223635726, 46.11502062302697, 0.5097574, 40.0, 503, 272609, 374, 7.350122400000146
375, 4.345384825070782, 38.19218015272749, 46.004522123002445, 0.5082265, 435.0, 1198, 273807, 375, 17.21449870000015
376, 2.9018255180652655, 38.188441407339916, 45.966709431239536, 0.5065183, 210.0, 700, 274507, 376, 10.109081200000219
377, 3.774976778499358, 38.2444764085026, 46.033424524948494, 0.5050503999999997, 165.0, 931, 275438, 377, 13.599682200000188
378, 3.660085210805667, 38.16389301565827, 45.93909929228611, 0.5033341, 275.0, 976, 276414, 378, 14.391397999999754
379, 5.354289867962249, 38.17524968734895, 46.04301665527652, 0.5020992999999999, 80.0, 396, 276810, 379, 5.899198499999784
380, 4.252626813961676, 38.20358974920643, 45.981860114095866, 0.5007511, 265.0, 1102, 277912, 380, 16.000103699999727
381, 4.3619734362781335, 38.214938307149886, 45.977619690087074, 0.4990051000000001, 230.0, 838, 278750, 381, 12.28306160000011
382, 2.920047688277046, 38.15887232211673, 45.874529449394466, 0.4978494999999998, 85.0, 446, 279196, 382, 6.495982600000389
383, 2.838000606553895, 38.15348469325475, 45.877436378115696, 0.49697560000000013, 90.0, 525, 279721, 383, 7.618212900000344
384, 3.7995729650993373, 38.09616426077996, 45.84584179240696, 0.4961773, 50.0, 362, 280083, 384, 5.414620600000035
385, 3.8298314815248125, 37.469369973709334, 45.1076086186651, 0.49524849999999987, 120.0, 670, 280753, 385, 10.035092899999654
386, 6.388131055113387, 37.522621811719326, 45.24046735520932, 0.49418560000000006, 80.0, 511, 281264, 386, 7.791329200000291
387, 5.7878398363375005, 37.458919546339246, 45.159436554378935, 0.4930777000000001, 375.0, 720, 281984, 387, 10.704776700000366
388, 4.4443355535360265, 37.40704780230991, 45.03250337047257, 0.4920544, 5.0, 417, 282401, 388, 6.372058999999808
389, 7.705541692851087, 37.4531032693103, 45.12774757848251, 0.49133800000000016, 40.0, 379, 282780, 389, 5.6189839999997275
390, 4.809546006355855, 37.50706029016635, 45.17664141200589, 0.4901752000000002, 215.0, 913, 283693, 390, 13.662510399999974
391, 4.059689533979373, 37.45161236067464, 45.08932435458764, 0.48875500000000005, 180.0, 665, 284358, 391, 10.014472900000328
392, 3.552404469055789, 37.40208547973633, 45.026159955705914, 0.48736900000000005, 395.0, 875, 285233, 392, 13.051078699999834
393, 2.8534119567844307, 37.43790792615226, 45.064957404404545, 0.48626109999999995, 45.0, 356, 285589, 393, 5.411474399999861
394, 7.50035263006058, 37.5144579216286, 45.19958444524694, 0.48545469999999996, 40.0, 540, 286129, 394, 8.382170400000177
395, 4.654746968359906, 37.501701960747845, 45.17319440718884, 0.48392019999999997, 225.0, 1165, 287294, 395, 17.91431360000024
396, 6.225985474107578, 37.53299082281755, 45.27035127221582, 0.4821985000000002, 250.0, 748, 288042, 396, 11.585937899999863
397, 5.297120952657146, 37.54704655704335, 45.190026340321594, 0.4809987999999998, 135.0, 585, 288627, 397, 8.994090499999857
398, 3.0693616940866133, 37.51691786949567, 45.13851263846509, 0.47990170000000004, 105.0, 634, 289261, 398, 10.364938000000166
399, 5.1097681208619345, 37.578023633730446, 45.240948971469045, 0.47864889999999993, 140.0, 758, 290019, 399, 13.801544400000239
400, 5.414370775486105, 37.656240149991675, 45.37047082024652, 0.4775337999999999, 30.0, 481, 290500, 400, 8.118385600000238
401, 5.93978962679359, 37.58458536493571, 45.29110977134989, 0.47673819999999995, 35.0, 403, 290903, 401, 8.44264579999981
402, 6.315028264737546, 37.59649733675601, 45.27325990864278, 0.4757067999999998, 130.0, 743, 291646, 402, 13.431198400000085
403, 4.026929850730745, 37.58651096738618, 45.26682907192186, 0.4742550999999998, 285.0, 870, 292516, 403, 14.361511099999916
404, 4.19481389070237, 37.57680001580966, 45.235229749880226, 0.4726593999999998, 365.0, 903, 293419, 404, 13.687478199999987
405, 7.611496192827728, 37.6407569458766, 45.403760054689016, 0.4711221999999999, 195.0, 805, 294224, 405, 12.670039499999803
406, 8.054814282175018, 37.673561289035504, 45.41922977562011, 0.4698279999999998, 105.0, 633, 294857, 406, 10.130289700000048
407, 2.622855637260802, 37.586528229386836, 45.18858823384324, 0.4687327000000001, 70.0, 584, 295441, 407, 9.155728900000213
408, 6.253156494145116, 37.639952915288696, 45.35342378485693, 0.4672872999999998, 265.0, 1022, 296463, 408, 16.92537420000008
409, 3.683414792644701, 37.60660708002497, 45.249075387143606, 0.4657473999999999, 150.0, 689, 297152, 409, 11.820630600000186
410, 6.072995111603796, 37.56134355804067, 45.21793821829337, 0.4643982999999999, 180.0, 810, 297962, 410, 12.881347399999868
411, 4.974205234344076, 37.63686512481102, 45.32811688291212, 0.46315540000000005, 35.0, 571, 298533, 411, 8.86442070000021
412, 4.275904095883649, 37.59111347757124, 45.23771259674966, 0.4622113, 50.0, 478, 299011, 412, 7.896713399999953
413, 5.152968141286733, 37.55059188615454, 45.26578842106256, 0.4612978, 90.0, 537, 299548, 413, 8.683705500000087
414, 4.266764914318466, 37.63235222930599, 45.28564409019981, 0.4603708000000001, 70.0, 493, 300041, 414, 8.08853790000012
415, 5.779386966930101, 37.50208075891094, 45.17571098602678, 0.45877870000000004, 445.0, 1276, 301317, 415, 19.931754100000035
416, 4.037517533957417, 37.55538741326729, 45.23811390540603, 0.45703539999999976, 135.0, 661, 301978, 416, 10.475686100000075
417, 2.5904392695981966, 37.452945794171164, 45.0490033385242, 0.45599589999999995, 105.0, 494, 302472, 417, 8.44182180000007
418, 3.8614243820465943, 37.4620590743485, 45.10784483622838, 0.4545216999999998, 325.0, 1144, 303616, 418, 18.72529050000003
419, 5.029178858872486, 37.45385516384792, 45.13578651411117, 0.4526892999999999, 305.0, 892, 304508, 419, 14.34080589999985
420, 3.1636147916663524, 37.437055356126734, 45.05697482008035, 0.4515381999999999, 80.0, 387, 304895, 420, 6.1769656999999825
421, 3.0347822072408186, 37.54877190362839, 45.18654479173125, 0.4508496999999999, 45.0, 378, 305273, 421, 6.0378208000001905
422, 2.7900320624482475, 37.49261126972883, 45.1045959794072, 0.4496977000000002, 185.0, 902, 306175, 422, 14.52687799999967
423, 5.0231370315235, 37.60997495472497, 45.31357382255983, 0.44806960000000007, 270.0, 907, 307082, 423, 14.269033200000194
424, 4.004679217494489, 37.51585882860229, 45.13456352652377, 0.44661339999999994, 190.0, 711, 307793, 424, 11.33076519999986
425, 5.71537550786443, 37.53321687798751, 45.22437500359279, 0.44532369999999993, 165.0, 722, 308515, 425, 11.586223800000425
426, 4.098972462969167, 37.46956398892565, 45.137168910227665, 0.44401240000000014, 100.0, 735, 309250, 426, 11.73693800000001
427, 2.9072624924875465, 37.448256527364016, 45.02674667265734, 0.44290629999999986, 90.0, 494, 309744, 427, 7.960905800000091
428, 5.223470667063185, 37.5632624465428, 45.16577732429076, 0.44214130000000007, 70.0, 356, 310100, 428, 5.7291934999998375
429, 3.0634141092275757, 37.88778016207029, 45.538002014160156, 0.44132050000000006, 60.0, 556, 310656, 429, 8.815414099999998
430, 6.080200052114085, 37.91109900604764, 45.647950161262976, 0.44012799999999996, 400.0, 769, 311425, 430, 12.242996799999673
431, 6.030259710597865, 37.93268963067526, 45.77855429412625, 0.4386744999999999, 180.0, 846, 312271, 431, 13.757321600000068
432, 4.437487030559677, 37.933638343164475, 45.66397249900689, 0.43738209999999994, 175.0, 590, 312861, 432, 9.431283699999767
433, 2.553157057758867, 37.84712056950427, 45.5381806660398, 0.4361148999999997, 260.0, 818, 313679, 433, 13.676184099999773
434, 4.083358942502726, 37.873423752076725, 45.567892105293616, 0.4348756, 135.0, 559, 314238, 434, 10.371473100000003
435, 3.258013328708795, 37.87375892114171, 45.5760142792539, 0.4333653999999999, 475.0, 1119, 315357, 435, 18.28496939999968
436, 4.922765362334002, 37.94470006147308, 45.65313303310241, 0.43175619999999976, 85.0, 669, 316026, 436, 10.829825700000129
437, 4.263914308957966, 37.91605528420199, 45.627745892368466, 0.43019830000000003, 200.0, 1062, 317088, 437, 17.339613899999677
438, 4.514054896330262, 37.89070146847394, 45.6258099042772, 0.42800320000000014, 420.0, 1377, 318465, 438, 22.663050799999837
439, 5.862497911395664, 37.98906646998583, 45.7518476188007, 0.4261536999999998, 120.0, 678, 319143, 439, 11.130378600000313
440, 3.884177865917686, 37.95236079254792, 45.69745917942213, 0.42490179999999983, 110.0, 713, 319856, 440, 11.553576300000259
441, 4.765083073264757, 37.4383226308804, 45.0470635886295, 0.4233402999999999, 155.0, 1022, 320878, 441, 17.07022589999997
442, 4.321827359038506, 37.46081956076961, 45.107719999919006, 0.4216609000000003, 200.0, 844, 321722, 442, 13.902118099999825
443, 4.740115683540212, 37.39841935251852, 45.042409361907545, 0.41997070000000014, 200.0, 1034, 322756, 443, 16.983767900000203
444, 2.6976643584449995, 37.38353656054081, 44.94422932403082, 0.4186413999999999, 75.0, 443, 323199, 444, 7.159748800000216
445, 2.8120026133581106, 37.44899266318092, 45.05509446173693, 0.4178655999999999, 60.0, 419, 323618, 445, 6.883845500000007
446, 4.706264171960932, 37.41152505313649, 45.065090488952265, 0.4166010999999998, 290.0, 986, 324604, 446, 16.10814130000017
447, 5.8263086815472365, 37.48064894038263, 45.181857033381384, 0.41531679999999993, 60.0, 441, 325045, 447, 7.21458819999998
448, 4.138039952098797, 37.4327062139448, 45.07435446227623, 0.41410449999999993, 410.0, 906, 325951, 448, 14.973069099999975
449, 2.7704236116033445, 37.417752003960096, 45.02336015301241, 0.4126239999999999, 140.0, 739, 326690, 449, 12.054156199999852
450, 2.861930790727728, 37.379206728131585, 44.965623812729056, 0.41115789999999985, 235.0, 890, 327580, 450, 14.982348300000012
451, 3.337412381502003, 37.483959329191336, 45.10857382947596, 0.4093362999999998, 410.0, 1134, 328714, 451, 20.47321200000033
452, 2.728730381081356, 37.384892164437304, 44.97950891735267, 0.40770189999999995, 120.0, 682, 329396, 452, 12.870528899999954
453, 4.884023772953432, 38.01504270336296, 45.79266349520316, 0.40630599999999994, 285.0, 869, 330265, 453, 15.595847699999922
454, 3.7002313161297566, 39.30097910063798, 47.3373415119016, 0.40488220000000014, 70.0, 713, 330978, 454, 11.763527800000247
455, 4.696630117530473, 39.43776944671014, 47.47876866176875, 0.40352769999999993, 185.0, 792, 331770, 455, 13.071367799999734
456, 4.910116958510348, 39.382438593755275, 47.42193670664184, 0.4019815000000001, 205.0, 926, 332696, 456, 15.822537000000011
457, 4.590786700522913, 39.36629937575744, 47.398847872072515, 0.4003489000000002, 195.0, 888, 333584, 457, 15.105239399999846
458, 4.797630681270275, 39.36047904341693, 47.3897027278292, 0.39861819999999987, 215.0, 1035, 334619, 458, 17.837628400000085
459, 5.081050130170606, 39.30830632777736, 47.324673169619075, 0.39671649999999986, 265.0, 1078, 335697, 459, 18.737193699999807
460, 5.2945038857328335, 39.338727445380634, 47.40396348524463, 0.3945853, 570.0, 1290, 336987, 460, 21.737416399999802
461, 2.748122414124423, 39.34657957518629, 47.290920407901254, 0.3930589, 50.0, 406, 337393, 461, 6.829402300000311
462, 3.23938337002321, 39.28489691705695, 47.278971820694665, 0.39176380000000005, 405.0, 1033, 338426, 462, 17.28707099999974
463, 8.383986996248538, 39.32426277981248, 47.43704286286997, 0.3902149, 75.0, 688, 339114, 463, 11.552601700000196
464, 3.7713298096541212, 39.343946360299626, 47.32277840643302, 0.3889738, 340.0, 691, 339805, 464, 11.629947999999786
465, 6.093437504078585, 39.277599274345725, 47.282494719493044, 0.38744199999999995, 275.0, 1011, 340816, 465, 16.909956100000272
466, 4.732266006495455, 39.12286028416037, 47.10866991221476, 0.3861567999999999, 60.0, 417, 341233, 466, 7.025312700000086
467, 3.763889172036712, 39.24515509167014, 47.23000770579639, 0.38514519999999997, 110.0, 707, 341940, 467, 11.969759600000089
468, 3.5579111809738575, 39.24280534793609, 47.17439803390589, 0.3837088000000002, 200.0, 889, 342829, 468, 15.054409299999861
469, 6.442866128720137, 39.25634015857844, 47.33075743617274, 0.38225710000000007, 155.0, 724, 343553, 469, 12.531658899999911
470, 3.9281951977177876, 39.22902357082285, 47.138239369330826, 0.3809782, 160.0, 697, 344250, 470, 11.765322899999774
471, 2.6225920054094343, 39.23365612079061, 47.18023207009911, 0.3800007999999999, 60.0, 389, 344639, 471, 6.738162000000102
472, 4.266019188401055, 39.21451008585988, 47.235860494212794, 0.3784816, 550.0, 1299, 345938, 472, 22.87665879999986
473, 4.861825816797198, 39.24066991266215, 47.29112132090442, 0.3768355, 115.0, 530, 346468, 473, 9.058928899999955
474, 4.2666717428360545, 39.16462252957977, 47.116004331268535, 0.37586529999999996, 110.0, 548, 347016, 474, 9.492441399999734
475, 4.336106899111086, 39.25045237733434, 47.270709522588646, 0.3744567999999998, 225.0, 1017, 348033, 475, 18.127318800000012
476, 3.8954815175276862, 39.20743384355767, 47.17475554522346, 0.37276119999999985, 185.0, 867, 348900, 476, 14.783898700000009
477, 3.987092552139389, 39.036813622295426, 46.97131799324401, 0.3706065999999999, 650.0, 1527, 350427, 477, 26.76584580000008
478, 7.561889959448992, 38.65547212467637, 46.58628238411837, 0.3682648000000002, 295.0, 1075, 351502, 478, 19.148812299999918
479, 2.627823999697211, 38.64839923743045, 46.48892964257134, 0.3669408999999999, 125.0, 396, 351898, 479, 6.911664100000053
480, 2.702880506757377, 38.650726218845534, 46.50627064359361, 0.36627399999999993, 55.0, 345, 352243, 480, 5.948953399999937
481, 2.560618746157955, 38.66746038100299, 46.51752357931698, 0.3655810000000001, 110.0, 425, 352668, 481, 7.423316299999897
482, 4.382842939750574, 38.66771219538703, 46.55249555855856, 0.3641932, 265.0, 1117, 353785, 482, 19.264189299999998
483, 6.00255248441959, 38.68885850906372, 46.57519485892319, 0.3623023, 155.0, 984, 354769, 483, 16.94315060000008
484, 7.8843556216245965, 38.799902218203, 46.77170011303093, 0.3610612, 60.0, 395, 355164, 484, 6.856331200000113
485, 3.802165018251309, 38.682935090446186, 46.51587956055976, 0.36010899999999985, 120.0, 663, 355827, 485, 11.471371600000111
486, 3.800568866048338, 38.72645015957989, 46.57714267923862, 0.35894349999999986, 105.0, 632, 356459, 486, 11.000591600000007
487, 2.5936271455164612, 38.641144319731616, 46.45269704358331, 0.3577222, 150.0, 725, 357184, 487, 12.510641100000157
488, 6.790601180907876, 38.64719544477307, 46.59862054085129, 0.35646399999999995, 145.0, 673, 357857, 488, 11.971182799999951
489, 5.156573910356549, 38.68160285156356, 46.509142401313454, 0.3548196999999998, 295.0, 1154, 359011, 489, 20.706092100000205
490, 5.211068215528597, 38.637396010584716, 46.53216770866652, 0.35279740000000026, 535.0, 1093, 360104, 490, 19.718941200000245
491, 4.5838207995663405, 37.95607078278223, 45.687687298751285, 0.3508615, 215.0, 1058, 361162, 491, 18.102206399999886
492, 5.182407499775969, 37.983633267023684, 45.70636397883432, 0.34901919999999986, 170.0, 989, 362151, 492, 17.94536479999988
493, 6.105789478887853, 37.94587947443912, 45.715015672382556, 0.34778709999999985, 50.0, 380, 362531, 493, 7.053152699999828
494, 7.485211799685821, 38.020861220402914, 45.824837544943065, 0.3469473999999998, 60.0, 553, 363084, 494, 10.350492699999904
495, 4.454938647407107, 37.991726857423785, 45.72873275876045, 0.3458737, 80.0, 640, 363724, 495, 11.280258300000241
496, 2.5682882494027752, 37.983699264921675, 45.65708267132853, 0.34495029999999993, 45.0, 386, 364110, 496, 6.85722880000003
497, 3.8402764393204816, 37.94912429961507, 45.686151311882526, 0.3439702, 170.0, 703, 364813, 497, 12.768790099999933
498, 4.141901053473843, 38.02610552287886, 45.75603956226223, 0.34240689999999996, 250.0, 1034, 365847, 498, 18.039934399999765
499, 5.344715267745838, 37.993798534535685, 45.71433449527932, 0.340777, 145.0, 777, 366624, 499, 13.401987199999894
500, 4.108895648240722, 38.00541820680356, 45.73747433356519, 0.3397437999999998, 65.0, 371, 366995, 500, 6.6080244999998285
501, 3.232732709888266, 37.962286516052586, 45.68371390664117, 0.3385954, 320.0, 905, 367900, 501, 16.1744034999997
502, 2.4210857053040242, 37.94918108570332, 45.67818363734654, 0.33733989999999997, 35.0, 490, 368390, 502, 8.73347399999966
503, 4.413442687705699, 38.09301663927464, 45.880231422463844, 0.33655149999999995, 140.0, 386, 368776, 503, 7.112173399999847
504, 3.4476627236418667, 37.96629216426061, 45.68657745837545, 0.33551200000000003, 145.0, 769, 369545, 504, 14.307697399999597
505, 5.431247945053413, 37.81778163160299, 45.59183346860794, 0.3339954999999999, 185.0, 916, 370461, 505, 17.012453800000003
506, 4.77167098679638, 37.586090944707394, 45.274225652217865, 0.3327102999999999, 45.0, 512, 370973, 506, 9.615408399999978
507, 2.6315923426775023, 37.54730206307979, 45.13571180146316, 0.3316491999999999, 155.0, 667, 371640, 507, 12.651845800000046
508, 2.539848006405574, 37.565703674167175, 45.17918307390656, 0.3306807999999999, 75.0, 409, 372049, 508, 7.561591899999712
509, 4.473146777662996, 37.60917013141966, 45.28270983952348, 0.32972679999999993, 35.0, 651, 372700, 509, 11.92734449999989
510, 3.6868175867127886, 37.584333618334234, 45.221786959906936, 0.32865669999999986, 110.0, 538, 373238, 510, 9.841073099999903
511, 4.531616904363245, 37.60694840018934, 45.257380142710566, 0.32720860000000007, 300.0, 1071, 374309, 511, 19.80254670000022
512, 2.6960800567987686, 37.54551080461434, 45.143270598172364, 0.32569209999999993, 95.0, 614, 374923, 512, 13.78961419999996
513, 4.391368826671883, 37.575732373067424, 45.224015235258676, 0.32380299999999995, 575.0, 1485, 376408, 513, 31.386320400000386
514, 2.5146421019727714, 37.588207848252225, 45.22523101310529, 0.3214422999999999, 185.0, 1138, 377546, 514, 25.15630800000008
515, 4.964204280274589, 37.561718211454505, 45.24928299719546, 0.3197755, 235.0, 714, 378260, 515, 13.633104099999855
516, 4.041789565662869, 37.60752299574555, 45.26541815429437, 0.31869369999999997, 80.0, 488, 378748, 516, 9.423621599999478
517, 3.275446127762141, 37.57801516805246, 45.18659930516109, 0.31731219999999993, 205.0, 1047, 379795, 517, 19.285535600000003
518, 2.771082135451119, 37.344622656615854, 44.87818106154949, 0.31575429999999993, 335.0, 684, 380479, 518, 13.006654499999968
519, 4.094466340228699, 37.308370977208234, 44.932340214217916, 0.31464189999999986, 35.0, 552, 381031, 519, 9.799943700000767
520, 3.8092793781636107, 37.250079325396754, 44.864300513902094, 0.3136717, 70.0, 526, 381557, 520, 9.053543900000477
521, 4.912154145293483, 37.335083984747165, 44.944501113891604, 0.31246029999999997, 150.0, 820, 382377, 521, 14.15503500000068
522, 5.336848405871293, 37.30607070007657, 44.943339910476006, 0.31089700000000003, 440.0, 917, 383294, 522, 15.979857499999525
523, 3.4618722894935416, 37.3257089207416, 44.91077851806263, 0.3094903, 135.0, 646, 383940, 523, 11.14939879999929
524, 4.195810356538862, 37.33313002216217, 44.95343654231938, 0.30851470000000003, 90.0, 438, 384378, 524, 7.593303599999672
525, 5.4344159798568175, 37.3131566310751, 44.9329052530486, 0.3070764999999998, 320.0, 1160, 385538, 525, 19.973463999999694
526, 5.328827524882985, 37.31304513714191, 44.930922596895826, 0.30499660000000006, 190.0, 1151, 386689, 526, 19.864143899999362
527, 3.6035387448028, 37.29912613882606, 44.90035834226633, 0.3029103999999998, 310.0, 1167, 387856, 527, 20.014778699999624
528, 2.7852030919223534, 37.195708353011334, 44.72418635008765, 0.30153069999999993, 75.0, 366, 388222, 528, 6.427281799999946
529, 4.048698267204711, 37.27146939258883, 44.87591737668715, 0.3001950999999998, 330.0, 1118, 389340, 529, 19.423422999999275
530, 2.496290852216041, 37.3094960075635, 44.87083978098831, 0.29860029999999993, 125.0, 654, 389994, 530, 11.4165181999997
531, 3.4816998663096648, 37.20284026069059, 44.80937995578209, 0.2971855, 210.0, 918, 390912, 531, 16.005884100000003
532, 3.6510060268278997, 37.324998716173425, 44.892591870962, 0.2957805999999999, 160.0, 643, 391555, 532, 11.231597099999817
533, 2.7612904981704234, 37.33416860592291, 44.89422748399817, 0.29462230000000006, 165.0, 644, 392199, 533, 11.221576799999639
534, 2.6918545418485675, 37.24065030178177, 44.782888566964886, 0.2934649, 190.0, 642, 392841, 534, 11.366570500000307
535, 3.7318750376011742, 37.285069970197455, 44.856185153473255, 0.29226789999999997, 165.0, 688, 393529, 535, 12.098082099999374
536, 2.6915737472384187, 37.26240636075183, 44.86630442072242, 0.29112940000000004, 125.0, 577, 394106, 536, 10.549756299999899
537, 5.266541591354276, 37.35535774165637, 44.96131216010002, 0.2895589000000001, 330.0, 1168, 395274, 537, 20.43690460000016
538, 4.879180027911924, 37.260775544327686, 44.8482516563102, 0.2879163999999999, 75.0, 657, 395931, 538, 11.6205944000003
539, 4.839404225997303, 37.313024632308796, 44.93223943917648, 0.2860002999999998, 245.0, 1472, 397403, 539, 26.082053799999812
540, 6.542454188801058, 37.31437142497027, 44.96646524116668, 0.2836378, 420.0, 1153, 398556, 540, 20.396935800000392
541, 6.654312456100942, 37.35507718684, 44.9843255853729, 0.28203579999999995, 125.0, 627, 399183, 541, 11.262957900000401
542, 7.1796317587505625, 37.36497290163155, 44.9943168249475, 0.28087389999999995, 90.0, 664, 399847, 542, 11.849646300000131
543, 3.2947713707265747, 37.43363976953514, 45.03259112445482, 0.2793726999999999, 260.0, 1004, 400851, 543, 17.95972889999939
544, 3.736085398964686, 37.464878283834736, 45.0765621013604, 0.27800919999999996, 65.0, 511, 401362, 544, 9.248428099999728
545, 3.8546300392251376, 37.47993573477102, 45.111205655475, 0.2766205, 395.0, 1032, 402394, 545, 18.379007300000012
546, 3.412769113066174, 37.41153636689728, 45.02069905254217, 0.27482859999999987, 445.0, 959, 403353, 546, 17.108090399999128
547, 4.750932749607162, 37.48159231977138, 45.173899228204945, 0.2735163999999999, 60.0, 499, 403852, 547, 8.982745299999806
548, 2.9456765990365636, 37.413141912528175, 45.003402043519756, 0.27192879999999975, 470.0, 1265, 405117, 548, 22.762578199999552
549, 3.807283628131358, 37.40407846022625, 45.02951941587487, 0.26990829999999993, 260.0, 980, 406097, 549, 17.616156299999602
550, 3.750892089501468, 37.44456526248758, 44.99840589969461, 0.2684529999999999, 110.0, 637, 406734, 550, 11.615500500000053
551, 3.6015960861230925, 37.477100911153826, 45.096917329936296, 0.2669176, 625.0, 1069, 407803, 551, 19.373167300000205
552, 6.740519911123132, 37.44437337461799, 45.1547715579036, 0.26539929999999995, 120.0, 618, 408421, 552, 11.214614900000015
553, 3.4129343587680037, 37.4148120336413, 44.99107346050823, 0.26405379999999995, 175.0, 877, 409298, 553, 15.969604799999615
554, 4.459187892861733, 37.27465298711037, 44.8692167950915, 0.26229429999999987, 430.0, 1078, 410376, 554, 19.673827999999958
555, 3.5815928420920455, 36.8855338130825, 44.379533682868335, 0.2606967999999999, 285.0, 697, 411073, 555, 12.711649100000614
556, 3.80741457734893, 36.911126314488854, 44.420001979920926, 0.2591469999999999, 415.0, 1025, 412098, 556, 18.709307600000102
557, 4.525729600775551, 36.911202432494434, 44.43442665623822, 0.2577393999999999, 100.0, 539, 412637, 557, 9.882303999999749
558, 2.8028268620800287, 36.85228034558769, 44.304029294096246, 0.2566909, 75.0, 626, 413263, 558, 11.614349499999662
559, 5.117983697961302, 36.9557569529119, 44.51835522298795, 0.2551788999999999, 370.0, 1054, 414317, 559, 19.31097890000001
560, 4.175058499033804, 36.93658577247902, 44.44346434981735, 0.25350129999999993, 210.0, 810, 415127, 560, 14.98700749999989
561, 5.9347175420968945, 36.93695041396855, 44.511168355092956, 0.2517409, 485.0, 1146, 416273, 561, 21.18967789999988
562, 2.5196288348989615, 36.856243638007406, 44.31318900447048, 0.2499949, 260.0, 794, 417067, 562, 15.222691700000723
563, 2.14256043713091, 36.90599817827523, 44.35345827815044, 0.2486826999999999, 105.0, 664, 417731, 563, 12.62792459999946
564, 2.430897265885916, 36.888369492810185, 44.37568683174724, 0.24755049999999998, 200.0, 594, 418325, 564, 11.498112700000092
565, 4.613432488685399, 36.97370740214775, 44.525729860102736, 0.24650019999999992, 150.0, 573, 418898, 565, 11.163922499999899
566, 4.320008000937673, 36.95501628806012, 44.508241055839676, 0.24529509999999993, 180.0, 766, 419664, 566, 14.787753100000373
567, 3.058115343869447, 36.93176171224411, 44.43958651202999, 0.24355450000000003, 600.0, 1168, 420832, 567, 22.71142569999938
568, 2.0217327582929525, 36.94699825754987, 44.46439666349645, 0.2421586, 40.0, 383, 421215, 568, 8.088126499999817
569, 4.557018438673983, 36.98308439929076, 44.49874698754513, 0.24145749999999996, 105.0, 396, 421611, 569, 8.267831200000728
570, 5.921787589135036, 37.017517219943045, 44.548134649279056, 0.24036219999999994, 265.0, 821, 422432, 570, 16.98907329999929
571, 5.055534925107463, 36.92752960865005, 44.49822755000762, 0.2387700999999999, 290.0, 948, 423380, 571, 19.155638299999737
572, 4.462103517075791, 37.00175560155564, 44.547307178113584, 0.23730849999999987, 195.0, 676, 424056, 572, 13.92006720000063
573, 5.771328420482168, 36.996980628425646, 44.581371330586215, 0.23581269999999993, 330.0, 986, 425042, 573, 20.898316499999964
574, 3.494518722890176, 37.02633808999166, 44.55713635465524, 0.23443209999999998, 45.0, 548, 425590, 574, 12.441740399999617
575, 4.903384609238259, 36.95777671372713, 44.52310315174843, 0.2329740999999999, 365.0, 1072, 426662, 575, 23.00720519999959
576, 2.4962859077231188, 36.92744124919153, 44.39625700492535, 0.2308420000000001, 475.0, 1297, 427959, 576, 29.23370679999971
577, 3.890763144162797, 36.9610123541907, 44.5034669900022, 0.2288853999999999, 145.0, 877, 428836, 577, 20.096389299999828
578, 2.6938497140725084, 36.93273535042166, 44.40249620241539, 0.22761459999999994, 120.0, 535, 429371, 578, 11.488897500000348
579, 3.8209280465252515, 36.97504325804672, 44.509393870345946, 0.2266902999999999, 80.0, 492, 429863, 579, 10.19184469999982
580, 5.992426998286412, 36.58804065046639, 44.11171284116548, 0.22559499999999996, 155.0, 725, 430588, 580, 15.244938199999524
581, 2.2334529876544784, 36.47297754629256, 43.8466755522841, 0.22428909999999996, 195.0, 726, 431314, 581, 15.653690600000118
582, 5.749110741311351, 36.54749563356109, 44.04208443243772, 0.22295619999999997, 95.0, 755, 432069, 582, 15.611708700000236
583, 5.013390954126053, 36.5401353774373, 43.92816965515215, 0.22158099999999997, 125.0, 773, 432842, 583, 15.970081200000095
584, 5.021370384453807, 36.60684257124382, 44.11413942432772, 0.22041909999999987, 115.0, 518, 433360, 584, 10.776189500000328
585, 5.17605157846677, 36.533591643939, 43.97544305315489, 0.21947949999999994, 130.0, 526, 433886, 585, 10.982799100000193
586, 2.392787402750511, 36.459732351332086, 43.83068286466744, 0.21841389999999988, 155.0, 658, 434544, 586, 13.720713600000636
587, 3.436712835489302, 36.4244581363947, 43.83438607710826, 0.21732399999999993, 175.0, 553, 435097, 587, 11.14991419999933
588, 4.57253614798568, 36.61256381239312, 44.09283207631719, 0.2162259999999999, 205.0, 667, 435764, 588, 13.569350899999336
589, 4.7459797754774, 36.590620543197154, 44.0597858674838, 0.21513699999999994, 85.0, 543, 436307, 589, 11.28090389999943
590, 5.514030727675592, 36.553012440748795, 44.015179751541815, 0.21355209999999994, 460.0, 1218, 437525, 590, 25.27287129999968
591, 3.3177977850646316, 36.5451881094886, 43.97298816298458, 0.2117557, 385.0, 778, 438303, 591, 16.12053360000027
592, 9.562494467630392, 36.63742572246212, 44.254648255829764, 0.21032829999999997, 215.0, 808, 439111, 592, 17.205913299999338
593, 4.107819769856821, 36.595435054539756, 44.03374771643682, 0.20886939999999998, 310.0, 813, 439924, 593, 17.914077200000065
594, 4.077072287313451, 36.34251219325055, 43.733685301067354, 0.20690199999999997, 670.0, 1373, 441297, 594, 29.697294099999453
595, 4.8437013117737715, 36.35795037812418, 43.813392166339675, 0.20491839999999997, 170.0, 831, 442128, 595, 17.34969530000035
596, 2.5093401838959597, 36.33290470405618, 43.67671620538025, 0.20364759999999998, 80.0, 581, 442709, 596, 12.816300100000262
597, 7.6773418456546425, 36.39322730192204, 43.83762225908102, 0.20277549999999997, 40.0, 388, 443097, 597, 8.155868799999553
598, 7.0431806372492405, 36.338776883725764, 43.82082509923864, 0.2018187999999999, 115.0, 675, 443772, 598, 13.786790400000427
599, 6.967872636898397, 36.38468848797016, 43.847695521085356, 0.20055159999999997, 140.0, 733, 444505, 599, 15.331485900000189
600, 6.949757372083909, 36.449922683192234, 43.8847970682032, 0.19952469999999992, 75.0, 408, 444913, 600, 9.164020200000778
601, 5.075718431167191, 36.30862644021281, 43.72225829768302, 0.1982709999999999, 190.0, 985, 445898, 601, 21.122927399999753
602, 4.397902459156805, 36.362157226702486, 43.75931770138055, 0.1967958999999999, 170.0, 654, 446552, 602, 13.76636150000013
603, 3.6532314827506855, 36.2676949020504, 43.5988460688628, 0.1956267999999999, 210.0, 645, 447197, 603, 13.491694900000766
604, 4.741662468309457, 36.388887861282, 43.790618688653765, 0.19402209999999995, 445.0, 1138, 448335, 604, 23.5076111999997
605, 3.3381207062262446, 36.3133735040561, 43.677026443369414, 0.19238499999999992, 135.0, 681, 449016, 605, 13.723260200000368
606, 5.3050157252851635, 36.375334209866, 43.83631087743748, 0.19115649999999992, 140.0, 684, 449700, 606, 14.028193000000101
607, 2.5780482403251157, 36.12885795639877, 43.43903020637341, 0.19009899999999988, 55.0, 491, 450191, 607, 9.918163800000002
608, 3.637287591854216, 36.104874399145, 43.423813700869175, 0.18910179999999996, 130.0, 617, 450808, 608, 12.581542299999455
609, 3.8640719459837545, 36.10991022690483, 43.46523155129474, 0.1877184999999999, 175.0, 920, 451728, 609, 18.534951300000102
610, 7.0733219064938515, 36.12503265683763, 43.55306040382859, 0.1865278, 105.0, 403, 452131, 610, 8.20983359999991
611, 7.177430163135834, 36.263204118717695, 43.757168611194615, 0.18569439999999995, 60.0, 523, 452654, 611, 10.892625999999836
612, 5.04014712144832, 36.12356452560969, 43.44214141453894, 0.18459279999999995, 120.0, 701, 453355, 612, 14.304452600000332
613, 5.508620692669336, 36.13294932756766, 43.50949978543468, 0.18305829999999995, 325.0, 1004, 454359, 613, 20.59757880000052
614, 5.662391890792185, 36.16117121682783, 43.5810755825499, 0.18121419999999994, 520.0, 1045, 455404, 614, 21.3383601000005
615, 3.366706327566012, 36.15766558159055, 43.48483834754764, 0.17913069999999995, 580.0, 1270, 456674, 615, 26.09696559999975
616, 6.129581357110723, 36.162915925259185, 43.53546296079032, 0.1767843999999999, 345.0, 1337, 458011, 616, 27.90109510000002
617, 2.3439596225727275, 36.042320141146355, 43.3373729816129, 0.17498979999999995, 90.0, 657, 458668, 617, 15.162586200000078
618, 3.211632647301519, 36.17887920361978, 43.54554251829783, 0.1736208999999999, 270.0, 864, 459532, 618, 19.68440499999997
619, 3.847452617649521, 36.13746151632192, 43.50001557019292, 0.17249049999999994, 120.0, 392, 459924, 619, 8.65373129999989
620, 4.950959114745575, 35.656844559375074, 42.90234380693578, 0.17099199999999987, 330.0, 1273, 461197, 620, 28.300816699999814
621, 2.312765911221504, 35.53196842225481, 42.68442482270902, 0.16952319999999987, 45.0, 359, 461556, 621, 8.070967600000586
622, 5.569420455182575, 35.6822099848412, 42.99201981606337, 0.1686726999999999, 85.0, 586, 462142, 622, 13.16015359999983
623, 5.713699725399516, 35.6356186282878, 42.91293626902055, 0.16779250000000004, 55.0, 392, 462534, 623, 8.555515500000183
624, 5.402126248925924, 35.642404073190484, 42.923706362861736, 0.16702749999999986, 85.0, 458, 462992, 624, 10.097511599999962
625, 4.348550971319172, 35.60081819354034, 42.844187099759175, 0.16543449999999987, 415.0, 1312, 464304, 625, 28.63247009999941
626, 4.165931035793511, 35.66602206675528, 42.90607070447796, 0.163531, 145.0, 803, 465107, 626, 17.872485200000483
627, 5.980866955972656, 35.59009186426798, 42.80838478936089, 0.16203069999999997, 195.0, 864, 465971, 627, 18.581396399999903
628, 4.351613389328122, 35.55701075168635, 42.79383752835508, 0.16070949999999995, 160.0, 604, 466575, 628, 13.240008900000248
629, 4.218202393980812, 35.58435309135308, 42.83202681298983, 0.1588915, 450.0, 1416, 467991, 629, 33.31661470000017
630, 8.006377946720066, 35.62627658786544, 42.9629818962281, 0.1570194999999999, 185.0, 664, 468655, 630, 14.80014360000041
631, 3.7004421974760993, 35.597030805268744, 42.814050453158885, 0.15515739999999992, 405.0, 1405, 470060, 631, 31.255309600000146
632, 3.0614225209004933, 35.779695381611695, 43.03018031626831, 0.15291009999999997, 465.0, 1092, 471152, 632, 26.4812107000007
633, 5.648975108555713, 35.78267993507804, 43.04468018668039, 0.15159969999999998, 50.0, 364, 471516, 633, 7.891444199999569
634, 3.824111207789583, 35.7719699045415, 43.04440903192452, 0.15081669999999991, 80.0, 506, 472022, 634, 10.92008320000059
635, 5.371192171147056, 35.79123506359026, 43.12085808024687, 0.14981049999999996, 90.0, 612, 472634, 635, 13.79645679999976
636, 3.5734413361728743, 35.799033906724716, 43.057942365717004, 0.14828769999999994, 180.0, 1080, 473714, 636, 25.737871999999697
637, 3.4726885404048353, 35.850365204218576, 43.14576099704238, 0.14685939999999995, 60.0, 507, 474221, 637, 11.574285099999543
638, 5.899660604040195, 35.81033271178931, 43.16216676656678, 0.1453797999999999, 245.0, 1137, 475358, 638, 26.230994599999576
639, 3.5629239990437322, 35.817655135907245, 43.08370019082969, 0.1438785999999999, 85.0, 531, 475889, 639, 11.84343440000066
640, 5.7530009465397525, 35.79167229601695, 43.09665328560726, 0.14287599999999992, 75.0, 583, 476472, 640, 14.073598599999968
641, 4.294274515834639, 35.77434038678886, 43.053880357450964, 0.1414674999999999, 395.0, 982, 477454, 641, 23.725004699999772
642, 5.0069773266046775, 35.799311835143435, 43.05656164825048, 0.13995279999999993, 95.0, 701, 478155, 642, 16.213979899999686
643, 3.1455527010966433, 35.68229869929227, 42.91277434609153, 0.13852989999999993, 215.0, 880, 479035, 643, 20.677835700000287
644, 3.3134224177168234, 35.78265302894759, 43.056642039500886, 0.13712139999999992, 225.0, 685, 479720, 644, 16.15927719999945
645, 4.964126499541833, 35.556736018346704, 42.78501193938048, 0.1358424999999999, 230.0, 736, 480456, 645, 17.098288799999864
646, 7.288854584595321, 35.44169290800196, 42.70582064221951, 0.1345869999999999, 185.0, 659, 481115, 646, 15.057371500000045
647, 5.194647364696147, 35.49910871210233, 42.69341643964741, 0.13335489999999994, 310.0, 710, 481825, 647, 16.516989799999465
648, 4.686703392654612, 35.49574476035944, 42.69114127659906, 0.13212459999999993, 170.0, 657, 482482, 648, 15.31902700000046
649, 4.76431352510438, 35.42232593265804, 42.60273507544092, 0.13063239999999993, 215.0, 1001, 483483, 649, 23.648630100000446
650, 2.3108877031161836, 35.382860957640005, 42.52969107702764, 0.12938769999999997, 10.0, 382, 483865, 650, 8.990307200000643
651, 3.4753997536865247, 35.50694817763109, 42.72247761693494, 0.12836529999999988, 130.0, 754, 484619, 651, 17.36444819999997
652, 4.625448762046567, 35.42817964320386, 42.63510518493376, 0.12669399999999992, 310.0, 1103, 485722, 652, 25.75061209999967
653, 3.854665574812744, 35.40744692736333, 42.589820120957455, 0.1245195999999999, 425.0, 1313, 487035, 653, 30.57159849999971
654, 6.477955128684222, 35.53725869484779, 42.78597319336571, 0.12247119999999996, 380.0, 963, 487998, 654, 22.24825989999954
655, 2.8641614619540587, 35.41058253662202, 42.559851478298384, 0.12042009999999988, 370.0, 1316, 489314, 655, 30.489375999999538
656, 5.3509186070185715, 35.452460850694834, 42.65674129884634, 0.11845179999999995, 280.0, 871, 490185, 656, 20.507099699999344
657, 5.488735091566741, 35.37391893009195, 42.586401831834834, 0.11730879999999991, 45.0, 399, 490584, 657, 9.66215319999992
658, 4.2221220741878165, 35.42715053730183, 42.59676056366425, 0.11605059999999993, 410.0, 999, 491583, 658, 23.998174699999254
659, 4.315981379424716, 35.40413493442637, 42.61866928132948, 0.11430279999999994, 150.0, 943, 492526, 659, 22.554247099999884
660, 2.4591906909272074, 35.51610493183136, 42.70987458229065, 0.11273409999999995, 190.0, 800, 493326, 660, 18.696111700000074
661, 3.2765651172556884, 35.44562304430995, 42.659558764819444, 0.11117889999999993, 385.0, 928, 494254, 661, 21.564363000000412
662, 3.038694307470508, 35.389152489529664, 42.54898566975752, 0.10942389999999998, 500.0, 1022, 495276, 662, 24.443934699999772
663, 4.609446043899139, 35.46533752898002, 42.68105205464214, 0.10721079999999993, 480.0, 1437, 496713, 663, 34.12374439999985
664, 8.220426309573572, 35.55829217792612, 42.884425711842766, 0.10551069999999993, 85.0, 452, 497165, 664, 10.65839589999996
665, 3.740369140546249, 35.39982232263394, 42.532073792262466, 0.10416249999999994, 335.0, 1046, 498211, 665, 25.092648499999996
666, 5.094335263719515, 35.52083183386248, 42.790612032199824, 0.10258839999999987, 145.0, 703, 498914, 666, 16.936405899999954
667, 4.97851564601476, 35.37936031055074, 42.5972403695932, 0.10083986861659992, 400.0, 1265, 500179, 667, 32.803638899999896
668, 4.284447892463287, 34.979385339891586, 42.084460578093655, 0.1000000000000001, 65.0, 740, 500919, 668, 20.794976099999985
669, 3.8920078007778263, 35.02384673380384, 42.11688632123611, 0.09999999999999956, 205.0, 816, 501735, 669, 20.378330300000016
670, 4.808977719901477, 35.01528023403436, 42.15213281940894, 0.09999999999999949, 185.0, 826, 502561, 670, 19.946445100000346
671, 3.767614227382303, 35.04039640627037, 42.15513566044264, 0.0999999999999996, 335.0, 809, 503370, 671, 21.072172399999545
672, 2.619066005559919, 34.96333255179941, 41.97772981695933, 0.10000000000000096, 130.0, 584, 503954, 672, 14.450926000000436
673, 4.082935994766928, 35.08133688149629, 42.197006384531655, 0.09999999999999827, 545.0, 1080, 505034, 673, 26.461570800000118
674, 2.272006093530909, 35.08232082687058, 42.18347003243186, 0.10000000000000095, 140.0, 572, 505606, 674, 14.14600800000062
675, 5.888430019964115, 34.9792302053234, 42.204612949482645, 0.09999999999999999, 230.0, 754, 506360, 675, 20.41852689999996
676, 6.48350814198446, 35.090437966084366, 42.3150269572778, 0.10000000000000098, 25.0, 607, 506967, 676, 17.091633099999854
677, 3.250770372195958, 34.99044241346755, 42.06420006623139, 0.09999999999999913, 235.0, 888, 507855, 677, 21.771754799999144
678, 3.063588823319155, 34.978152866686806, 42.06816854530808, 0.09999999999999915, 230.0, 885, 508740, 678, 22.00652010000067
679, 2.5761459122073718, 35.00532583737507, 42.080446177221546, 0.09999999999999909, 280.0, 895, 509635, 679, 22.65586600000006
680, 4.4732820333882435, 35.1835250291668, 42.33287811904657, 0.10000000000000098, 180.0, 610, 510245, 680, 15.275280500000008
681, 3.839743798634854, 35.424428120030186, 42.59157322498429, 0.09999999999999894, 165.0, 926, 511171, 681, 24.68140080000012
682, 5.196674371050602, 35.43556146965423, 42.64246254922707, 0.09999999999999694, 445.0, 1637, 512808, 682, 43.97301930000049
683, 2.526419651773444, 35.36549059627978, 42.5375975626378, 0.09999999999999956, 210.0, 815, 513623, 683, 22.683272899999793
684, 2.488805124538276, 35.28273602855626, 42.41231771649218, 0.09999999999999919, 260.0, 879, 514502, 684, 27.420373900000413
685, 4.39383482336998, 35.37203690378289, 42.591712660538526, 0.10000000000000071, 80.0, 380, 514882, 685, 9.919477699999334
686, 5.2116145795098126, 35.37117365754831, 42.56666669144798, 0.10000000000000099, 75.0, 626, 515508, 686, 16.069716699999844
687, 2.3191787860721247, 35.43273720386866, 42.60577290766948, 0.09999999999999792, 300.0, 1184, 516692, 687, 29.994470999999976
688, 2.994668685395045, 35.387303567883535, 42.541855602179886, 0.10000000000000063, 120.0, 677, 517369, 688, 20.417969600000106
689, 3.337328729128937, 35.3237693595355, 42.49925067763475, 0.10000000000000027, 100.0, 718, 518087, 689, 20.04547580000053
690, 4.523929525785055, 35.40347181019447, 42.62139733500501, 0.09999999999999876, 270.0, 964, 519051, 690, 24.937255300000288
691, 4.5375115210456505, 35.44146037049346, 42.644991457593314, 0.09999999999999902, 185.0, 910, 519961, 691, 24.182004499999493
692, 4.6163948886982045, 35.08271774437084, 42.19833502187593, 0.10000000000000099, 40.0, 631, 520592, 692, 17.453220800000054
693, 5.246987921228513, 35.08799688969184, 42.25083351135254, 0.09999999999999921, 260.0, 872, 521464, 693, 23.86836949999997
694, 2.9500325413189343, 35.0164178250104, 42.09319094934407, 0.10000000000000064, 205.0, 676, 522140, 694, 18.097014999999374
695, 3.015481198522842, 34.9657687915946, 42.03384210478585, 0.09999999999999935, 225.0, 848, 522988, 695, 22.793606100000034
696, 5.441241823802249, 34.89721321337151, 42.005986501155284, 0.10000000000000099, 140.0, 627, 523615, 696, 16.61053830000037
697, 5.045670860905512, 35.01814484474403, 42.12380860570748, 0.09999999999999797, 425.0, 1174, 524789, 697, 32.535249500000646
698, 4.84370248945787, 35.000956257038794, 42.11323362450605, 0.09999999999999953, 160.0, 819, 525608, 698, 22.550300899999456
699, 5.546537437400836, 35.054645573190236, 42.230197567852606, 0.10000000000000071, 25.0, 383, 525991, 699, 10.689978899999915
700, 4.713973483833691, 35.08490878875523, 42.221173157681044, 0.09999999999999921, 190.0, 874, 526865, 700, 24.661090499999773
701, 4.852909890581473, 34.97846127920087, 42.08448944237257, 0.0999999999999984, 430.0, 1049, 527914, 701, 28.996374300000753
702, 5.5671472066225345, 35.0257029013756, 42.155830737872, 0.10000000000000099, 110.0, 624, 528538, 702, 16.24230609999995
703, 4.8447507156648015, 34.99247964266359, 42.089169495788326, 0.10000000000000012, 165.0, 737, 529275, 703, 18.25724639999953
704, 3.866458583225924, 35.17272532946691, 42.303342633902744, 0.09999999999999686, 480.0, 1688, 530963, 704, 44.304042099999606
705, 7.087023977036636, 35.2684141532662, 42.44504429138813, 0.10000000000000073, 35.0, 388, 531351, 705, 10.087999800000034
706, 8.269253445425454, 35.282945897719436, 42.533751759248624, 0.10000000000000078, 80.0, 425, 531776, 706, 10.91393270000026
707, 5.490188782035358, 35.240980923365036, 42.44165689377558, 0.10000000000000099, 125.0, 630, 532406, 707, 15.723289200000181
708, 3.9508569326370817, 35.162480989221024, 42.33790184613232, 0.09999999999999822, 375.0, 1095, 533501, 708, 31.788589599999796
709, 2.8214670180389803, 35.19155031631767, 42.29861773097527, 0.09999999999999869, 190.0, 977, 534478, 709, 26.984999499999503
710, 4.498460302171859, 35.16490336738114, 42.31604287834043, 0.10000000000000098, 125.0, 614, 535092, 710, 18.721334699999716
711, 3.4337588991267776, 35.160798479219444, 42.30023163567172, 0.10000000000000096, 75.0, 589, 535681, 711, 17.90583030000016
712, 3.6099211249504304, 35.16093831920915, 42.28271350491932, 0.09999999999999867, 410.0, 983, 536664, 712, 26.155283600000075
713, 5.563315444251951, 35.156411604257045, 42.32422067203669, 0.09999999999999902, 235.0, 909, 537573, 713, 25.6034424999998
714, 4.106453693022369, 35.23465245417493, 42.388893839321845, 0.09999999999999983, 175.0, 777, 538350, 714, 21.168740199999775
715, 3.7890982740734303, 35.13412934003558, 42.25326902553013, 0.0999999999999992, 225.0, 875, 539225, 715, 23.581073800000013
716, 4.073396365024878, 34.97492779391797, 42.06547850840475, 0.09999999999999702, 540.0, 1585, 540810, 716, 39.79466409999986
717, 4.156781001359616, 34.88400988829763, 41.92809011225115, 0.10000000000000082, 45.0, 456, 541266, 717, 11.693019499999536
718, 4.373352971401657, 34.8287112806431, 41.87355828397502, 0.10000000000000099, 130.0, 637, 541903, 718, 16.53991269999915
719, 4.7159067853500085, 34.95367796004086, 42.070622598109225, 0.09999999999999912, 210.0, 892, 542795, 719, 22.994694200000595
720, 2.1421175225303983, 34.882815415004515, 41.89354347372955, 0.10000000000000091, 35.0, 530, 543325, 720, 14.31949540000005
721, 4.237014457605213, 34.87875045252125, 41.966826868336106, 0.10000000000000057, 225.0, 684, 544009, 721, 18.608818699999574
722, 5.000820837989343, 34.821276121914984, 41.91790695843445, 0.10000000000000042, 65.0, 701, 544710, 722, 19.548355599999923
723, 4.286953200877766, 34.88021309207184, 41.98997186089204, 0.09999999999999791, 580.0, 1188, 545898, 723, 33.428129900000386
724, 4.506251960955746, 34.900680292107374, 41.94657345039532, 0.10000000000000098, 40.0, 603, 546501, 724, 15.795554899999843
725, 6.675566001791796, 34.92641145452802, 42.08602985156858, 0.09999999999999826, 435.0, 1084, 547585, 725, 28.93498659999932
726, 5.223184564208102, 34.94106690976873, 42.04362685986737, 0.10000000000000028, 190.0, 716, 548301, 726, 18.358015499999965
727, 5.435962014779526, 34.89759824675918, 41.9901996855618, 0.0999999999999971, 280.0, 1538, 549839, 727, 38.60300670000015
728, 5.176339318441948, 34.54835337855638, 41.565719707314216, 0.09999999999999816, 715.0, 1113, 550952, 728, 29.008651899999677
729, 3.5848885384598055, 34.453150178440104, 41.44865562733786, 0.09999999999999835, 585.0, 1061, 552013, 729, 31.161314800000582
730, 4.089148447628079, 34.44727419507601, 41.38000406166513, 0.10000000000000069, 80.0, 367, 552380, 730, 10.717617700000119
731, 4.9576135743409395, 34.519563472747805, 41.567216117858884, 0.10000000000000088, 120.0, 500, 552880, 731, 14.946402800000214
732, 5.231022967319356, 34.46475017222555, 41.47735538165086, 0.0999999999999985, 315.0, 1021, 553901, 732, 27.990343000000394
733, 6.885947295823282, 34.51638305987571, 41.604344339898674, 0.09999999999999935, 275.0, 849, 554750, 733, 24.844259299999976
734, 3.626679622602041, 34.52423868952571, 41.477091665703455, 0.0999999999999983, 335.0, 1073, 555823, 734, 32.35553880000043
735, 5.629256837744722, 34.52194537921827, 41.570344798418944, 0.09999999999999977, 370.0, 784, 556607, 735, 21.696659199999885
736, 5.796940647783534, 34.49908000230789, 41.55197376012802, 0.10000000000000071, 55.0, 384, 556991, 736, 10.998366400000123
737, 3.7528469130760604, 34.46039273661952, 41.41036784098059, 0.09999999999999805, 370.0, 1147, 558138, 737, 31.231254700000136
738, 2.880670631833544, 34.4638908812494, 41.434627243966766, 0.09999999999999837, 235.0, 1056, 559194, 738, 29.635327799998777
739, 4.533078045293918, 34.56651255138079, 41.58023758844379, 0.09999999999999797, 455.0, 1174, 560368, 739, 34.44131560000096
740, 5.11928904655873, 34.88403938215545, 41.99557860704828, 0.09999999999999767, 295.0, 1273, 561641, 740, 36.11221699999987
741, 4.419105846022133, 34.87521446261836, 41.93938238124199, 0.10000000000000063, 120.0, 677, 562318, 741, 19.088721900001474
742, 3.8204453233404143, 34.91372215747833, 41.981440436455514, 0.09999999999999863, 240.0, 992, 563310, 742, 30.186641100000998
743, 3.2218182273862657, 34.83388255492986, 41.90233862469768, 0.10000000000000057, 165.0, 684, 563994, 743, 24.26984210000046
744, 6.062959333188342, 34.82132448906446, 41.88816631344983, 0.10000000000000056, 170.0, 685, 564679, 744, 20.211437100000694
745, 4.009709468423294, 34.86092036729314, 41.94291908491012, 0.100000000000001, 155.0, 639, 565318, 745, 19.414053200000126
746, 3.312242864818784, 34.82612194269615, 41.90135312125283, 0.10000000000000091, 125.0, 531, 565849, 746, 16.832839700000477
747, 4.345814670173976, 34.90774674329929, 41.9945976063163, 0.10000000000000071, 155.0, 668, 566517, 747, 19.332723699999406
748, 6.221538895247632, 34.91850514725923, 41.986618544387234, 0.10000000000000087, 55.0, 653, 567170, 748, 20.519087700000455
749, 4.072422867336238, 34.838702127697005, 41.89803809199193, 0.10000000000000005, 240.0, 746, 567916, 749, 20.873778699999093
750, 3.683287546009861, 34.78000749124063, 41.845526698933604, 0.1000000000000009, 120.0, 518, 568434, 750, 14.669833799998742
751, 2.451445977602686, 34.79788974091247, 41.81275124602266, 0.10000000000000069, 70.0, 364, 568798, 751, 11.407530100001168
752, 6.731588017206293, 34.892891188000526, 42.05711338686388, 0.10000000000000053, 145.0, 688, 569486, 752, 19.778431000000637
753, 3.457178003409267, 34.92180843871397, 41.98765089880226, 0.09999999999999795, 545.0, 1178, 570664, 753, 32.5901513000008
754, 5.169288569879263, 35.08806795392718, 42.21720075679005, 0.10000000000000074, 125.0, 665, 571329, 754, 18.655906299998605
755, 3.2922700417246085, 35.058902103748125, 42.17537721045504, 0.10000000000000069, 35.0, 671, 572000, 755, 18.0963359999987
756, 3.4762739161871803, 35.11188971464801, 42.18606976794589, 0.10000000000000099, 70.0, 628, 572628, 756, 17.299811999999292
757, 2.1692353561634325, 34.99043964356866, 42.02498103134505, 0.10000000000000085, 90.0, 655, 573283, 757, 18.488828399998965
758, 6.482403245104962, 35.02268911810482, 42.19516149088114, 0.10000000000000085, 75.0, 476, 573759, 758, 15.578792399999656
759, 5.293357952307812, 35.06338308066843, 42.193016791697104, 0.09999999999999919, 260.0, 877, 574636, 759, 24.339234500001112
760, 5.757297125007236, 35.14897797868374, 42.31113488708823, 0.0999999999999976, 400.0, 1307, 575943, 760, 34.728434199998446
761, 5.203508437803608, 35.086755654750725, 42.288946649427686, 0.10000000000000077, 210.0, 663, 576606, 761, 17.225482899999406
762, 6.268424799697595, 35.14097491710259, 42.322123804190056, 0.10000000000000096, 105.0, 586, 577192, 762, 15.98860390000118
763, 2.6107727383640973, 34.985420515730574, 41.98675901052114, 0.10000000000000069, 60.0, 370, 577562, 763, 9.649851799998942
764, 6.881660887435507, 35.173768880555954, 42.32123954690618, 0.10000000000000094, 35.0, 556, 578118, 764, 14.354851999998573
765, 4.593000622084536, 35.03819617991067, 42.15773502186032, 0.09999999999999956, 130.0, 815, 578933, 765, 20.966924899999867
766, 3.9901350461099785, 35.02497706866816, 42.103703594452924, 0.09999999999999981, 110.0, 778, 579711, 766, 20.196108500000264
767, 5.590909322041391, 35.16082804273851, 42.30343628873919, 0.10000000000000075, 60.0, 404, 580115, 767, 10.60548370000106
768, 5.094651095998975, 35.23379627863566, 42.41686296463013, 0.10000000000000099, 115.0, 624, 580739, 768, 16.21583289999944
769, 3.7483327441382217, 35.19058227347176, 42.305367797912965, 0.09999999999999862, 230.0, 994, 581733, 769, 25.80915610000011
770, 3.6667278760996833, 35.18861109607083, 42.301010666539504, 0.09999999999999834, 295.0, 1063, 582796, 770, 27.557618700000603
771, 4.153853792798761, 35.27586164952583, 42.41131528721846, 0.09999999999999808, 355.0, 1137, 583933, 771, 29.509208900000885
772, 6.9165988619734975, 35.25940543789159, 42.46177789713752, 0.09999999999999874, 135.0, 967, 584900, 772, 25.520971500000087
773, 5.84600006000189, 35.24943811032111, 42.38930636346935, 0.09999999999999602, 820.0, 2505, 587405, 773, 65.53198660000089
774, 3.5994264746997873, 35.262169708925136, 42.37331275565951, 0.0999999999999985, 370.0, 1020, 588425, 774, 26.626241500000106
775, 3.5737386982952337, 35.26107923540639, 42.39220083606449, 0.10000000000000091, 115.0, 521, 588946, 775, 13.636188500000571
776, 2.2606342385382683, 35.16299579194847, 42.25539032027213, 0.0999999999999985, 280.0, 1022, 589968, 776, 27.012752000000546
777, 5.066382772203721, 34.96937136375773, 42.08392327914477, 0.09999999999999694, 530.0, 1634, 591602, 777, 42.805167399999846
778, 5.8025448562004245, 35.041805146290706, 42.18606471281785, 0.10000000000000091, 70.0, 520, 592122, 778, 13.721742899999299
779, 4.616094975842266, 34.920156809288684, 42.01313262849342, 0.1000000000000009, 80.0, 508, 592630, 779, 13.437378399999943
780, 3.3390712266597675, 34.96521545880562, 42.028394710121816, 0.10000000000000091, 50.0, 519, 593149, 780, 13.726345999999467
781, 4.02136308629408, 34.83469541730005, 41.861269268945115, 0.1, 135.0, 751, 593900, 781, 20.0941815999995
782, 3.6172300894233516, 35.02236295284185, 42.10615669336534, 0.10000000000000091, 85.0, 532, 594432, 782, 14.019371999998839
783, 4.119136038301539, 34.9454582465463, 42.03500452762892, 0.10000000000000031, 170.0, 714, 595146, 783, 19.006094000000303
784, 2.9432063187898883, 34.93592038849736, 42.00313583969155, 0.09999999999999706, 610.0, 1564, 596710, 784, 49.9306832000002
785, 4.403277247510224, 35.017310793660265, 42.12428000794739, 0.09999999999999881, 210.0, 952, 597662, 785, 34.40648890000011
786, 6.207686337026497, 35.008884253040435, 42.17100967130354, 0.10000000000000088, 35.0, 496, 598158, 786, 16.97679170000083
787, 3.686088025742661, 34.93231568605669, 42.01147763959823, 0.09999999999999863, 180.0, 992, 599150, 787, 35.64486410000063
788, 3.661093305139895, 34.82282926342659, 41.8755668783337, 0.09999999999999877, 340.0, 959, 600109, 788, 31.795330699998885
789, 3.1091865689304634, 34.286278494970794, 41.215367566141175, 0.09999999999999971, 185.0, 793, 600902, 789, 29.330285599999115
790, 4.003280257259366, 34.34453132679167, 41.30971635887807, 0.0999999999999983, 280.0, 1073, 601975, 790, 35.64263790000041
791, 5.422288489849939, 34.44793953424619, 41.462454036430074, 0.10000000000000092, 125.0, 648, 602623, 791, 18.59258629999931
792, 4.84214022469062, 34.38259112822704, 41.35573382255359, 0.0999999999999987, 175.0, 975, 603598, 792, 35.092199299999265
793, 3.0116873354729368, 34.35409500264676, 41.30791039867936, 0.09999999999999831, 200.0, 1070, 604668, 793, 35.69841289999931
794, 5.1750390449228885, 34.33517525076674, 41.31246256173524, 0.10000000000000099, 280.0, 619, 605287, 794, 21.193853000000672
795, 3.9990852168275652, 34.268377841984005, 41.168287442541676, 0.09999999999999985, 255.0, 773, 606060, 795, 25.047271499999624
796, 3.8612277588426527, 34.32408956049797, 41.273973043024135, 0.09999999999999915, 135.0, 886, 606946, 796, 27.18470630000047
797, 8.946043568333605, 34.43660405871172, 41.49167644885159, 0.10000000000000073, 85.0, 387, 607333, 797, 11.41997149999952
798, 2.9988918541003042, 34.3588363313579, 41.307861876919475, 0.09999999999999862, 340.0, 994, 608327, 798, 30.72267009999996
799, 5.097905245432321, 34.39916808943734, 41.365335084160286, 0.10000000000000078, 85.0, 662, 608989, 799, 19.999343999999837
800, 2.329390348423095, 34.37042854172843, 41.30787933894566, 0.09999999999999941, 125.0, 840, 609829, 800, 24.584752599999774
801, 5.010022096201643, 34.298901818536066, 41.235969089053654, 0.0999999999999986, 305.0, 999, 610828, 801, 30.728973100000076
802, 4.145301924662762, 34.209048658314316, 41.12515723351205, 0.10000000000000037, 105.0, 707, 611535, 802, 23.47474289999991
803, 6.02939201977515, 34.2923882597949, 41.267528103083556, 0.09999999999999803, 300.0, 1151, 612686, 803, 34.389422500000364
804, 4.25649951170992, 34.24310150994195, 41.10975244027597, 0.10000000000000066, 60.0, 675, 613361, 804, 19.537749099999928
805, 3.242934434513898, 34.20020379150341, 41.10743347441335, 0.0999999999999978, 790.0, 1228, 614589, 805, 38.60541709999961
806, 3.139910305536447, 34.272685050964355, 41.194485587869735, 0.10000000000000003, 225.0, 748, 615337, 806, 24.3146940000006
807, 3.503456647164888, 34.30146669053797, 41.21410794422006, 0.10000000000000098, 160.0, 611, 615948, 807, 19.71415789999992
808, 5.87845648987547, 34.22749717191888, 41.200857491411895, 0.09999999999999702, 525.0, 1583, 617531, 808, 51.30162240000027
809, 3.0277808712901138, 34.269777050438236, 41.17469114831812, 0.09999999999999927, 225.0, 863, 618394, 809, 26.904364300000452
810, 3.06338329919397, 34.1427748004348, 41.020453561139135, 0.09999999999999964, 325.0, 803, 619197, 810, 26.769993600000817
811, 2.296161860227585, 34.2166730748417, 41.12719961511706, 0.10000000000000096, 155.0, 591, 619788, 811, 18.46706129999984
812, 4.478034120989721, 34.19467444699065, 41.13543923659385, 0.09999999999999923, 370.0, 871, 620659, 812, 26.35461900000155
813, 4.033873693358279, 34.21589155143566, 41.162169092156915, 0.10000000000000032, 105.0, 712, 621371, 813, 22.453744200000074
814, 3.478228891073955, 34.209003963855785, 41.135228083189894, 0.09999999999999791, 370.0, 1188, 622559, 814, 36.911797799999476
815, 4.638061654617839, 34.18262239878113, 41.13159606558539, 0.09999999999999985, 205.0, 773, 623332, 815, 23.65533510000023
816, 3.7943362533926965, 34.19109569091797, 41.10703006591797, 0.10000000000000099, 100.0, 625, 623957, 816, 19.32376739999927
817, 4.372022202533144, 34.18195582388367, 41.125433082404776, 0.10000000000000088, 110.0, 651, 624608, 817, 20.94926530000157
818, 4.194513525736112, 34.16285668121525, 41.079613462108775, 0.09999999999999956, 100.0, 815, 625423, 818, 24.664360099999612
819, 3.552284939057916, 34.110469832375784, 41.02315634611611, 0.10000000000000092, 200.0, 535, 625958, 819, 16.329965599999923
820, 5.1981605507477635, 34.27598894102283, 41.232725601875465, 0.10000000000000066, 135.0, 674, 626632, 820, 20.376532499998575
821, 4.469978588638732, 34.26422800772714, 41.219415013892565, 0.09999999999999792, 570.0, 1187, 627819, 821, 35.43143549999877
822, 4.360200162032819, 34.228282972964855, 41.15844470091867, 0.09999999999999885, 325.0, 943, 628762, 822, 27.849871399999756
823, 3.445211208565941, 34.227256355782906, 41.145751491383244, 0.10000000000000092, 85.0, 537, 629299, 823, 16.12346129999969
824, 5.381225198391473, 34.119397134923226, 41.08548420104221, 0.09999999999999963, 200.0, 804, 630103, 824, 23.62031509999906
825, 4.4969996299208095, 33.998932187070594, 40.85973344235219, 0.09999999999999919, 180.0, 877, 630980, 825, 26.33949399999983
826, 2.638963202596459, 33.94380525142844, 40.769980186570194, 0.10000000000000099, 65.0, 637, 631617, 826, 19.50107249999928
827, 2.3734204935893977, 33.97868188822044, 40.835819304364286, 0.10000000000000099, 110.0, 636, 632253, 827, 19.63862960000006
828, 4.511905010264059, 34.00574628801185, 40.902763549479744, 0.0999999999999981, 270.0, 1127, 633380, 828, 34.3624022999993
829, 4.773410228285601, 33.96150993869594, 40.84426937546841, 0.09999999999999984, 95.0, 774, 634154, 829, 24.047328099999504
830, 3.8131459015713403, 33.96718512179091, 40.79633941442505, 0.10000000000000069, 105.0, 367, 634521, 830, 11.367799300000115
831, 4.283120085379495, 34.01097778541208, 40.894020205882185, 0.0999999999999967, 475.0, 1796, 636317, 831, 55.47017919999962
832, 4.917194784871688, 33.93098568399624, 40.845937022237706, 0.09999999999999873, 150.0, 969, 637286, 832, 29.566364300000714
833, 3.720566276872679, 34.0871313825671, 40.96379641456898, 0.10000000000000073, 50.0, 389, 637675, 833, 11.729592699999557
834, 4.196271229503681, 33.96185540477548, 40.85234785215037, 0.10000000000000066, 40.0, 353, 638028, 834, 11.012006400000246
835, 8.021131670696938, 34.06241389876562, 41.031220844169596, 0.10000000000000078, 105.0, 423, 638451, 835, 12.932401599999139
836, 3.737457254986194, 33.98274436141505, 40.82049627496739, 0.09999999999999971, 145.0, 792, 639243, 836, 27.33064949999971
837, 4.2195534567847055, 33.968972776678406, 40.8025863187727, 0.10000000000000045, 95.0, 697, 639940, 837, 26.159074500001225
838, 4.224678629815798, 33.73807675340618, 40.55563128732559, 0.0999999999999988, 200.0, 953, 640893, 838, 33.360926200000904
839, 6.284099304486117, 33.76557998483568, 40.62719344513912, 0.10000000000000081, 140.0, 659, 641552, 839, 20.758220899999287
840, 4.585777953049668, 33.64260559601543, 40.46098752893826, 0.1000000000000009, 30.0, 514, 642066, 840, 16.481482299999698
841, 2.9087933363511382, 33.731799203949855, 40.547996962001555, 0.09999999999999926, 150.0, 865, 642931, 841, 30.310775800000556
842, 3.1505990106666433, 33.69754900172137, 40.48532989612524, 0.10000000000000052, 180.0, 690, 643621, 842, 23.306126099998437
843, 5.853095538605372, 33.721642746208865, 40.638567010355736, 0.10000000000000073, 130.0, 386, 644007, 843, 13.613557599999695
844, 5.439456957672696, 33.724296769818054, 40.57795017575755, 0.09999999999999847, 315.0, 1030, 645037, 844, 35.31031470000016
845, 5.256456970829856, 33.77949936895659, 40.62766244483716, 0.1000000000000008, 100.0, 660, 645697, 845, 22.639623199998823
846, 2.4070500365509346, 33.75849428799207, 40.5075643428419, 0.10000000000000095, 180.0, 567, 646264, 846, 21.057375399999728
847, 4.0516480386607325, 33.695516282522334, 40.551027502154554, 0.10000000000000071, 55.0, 383, 646647, 847, 15.120766500000173
848, 4.948525639168589, 33.69124658423734, 40.503251975798705, 0.10000000000000088, 5.0, 498, 647145, 848, 18.30271609999909
849, 4.257475933258118, 33.67595245041729, 40.502353283055484, 0.09999999999999891, 400.0, 931, 648076, 849, 33.101822399999946
850, 6.272737110614988, 33.67501376562684, 40.51454621305727, 0.0999999999999981, 225.0, 1131, 649207, 850, 42.87530669999978
851, 5.638287850845082, 33.658408766148085, 40.54191055407155, 0.10000000000000045, 365.0, 698, 649905, 851, 25.32523200000105
852, 3.8987562791287718, 34.02708523572402, 40.869238704716395, 0.09999999999999759, 675.0, 1308, 651213, 852, 44.944917500000884
853, 3.229946556342702, 34.06793531214569, 40.94640545834219, 0.09999999999999916, 435.0, 882, 652095, 853, 31.173382000000856
854, 3.5460980204212067, 34.0282842194944, 40.91469387036116, 0.09999999999999726, 405.0, 1457, 653552, 854, 46.90028809999967
855, 2.284998562417904, 33.97463464094301, 40.836685067559834, 0.10000000000000007, 110.0, 742, 654294, 855, 23.872606400000222
856, 6.728679317558549, 34.05559296755447, 41.042253293696135, 0.09999999999999873, 140.0, 970, 655264, 856, 34.053905400000076
857, 2.3888565959515926, 33.9490944654092, 40.75082097546807, 0.1000000000000008, 75.0, 435, 655699, 857, 20.081825499999468
858, 4.164498322039304, 34.11252003553918, 40.96358121334736, 0.10000000000000073, 40.0, 387, 656086, 858, 14.97134240000014
859, 3.3077912921068435, 34.065720925884186, 40.91457949910418, 0.100000000000001, 40.0, 638, 656724, 859, 22.41711679999935
860, 3.6315123293500537, 33.99077888214933, 40.88481761593881, 0.09999999999999858, 300.0, 1003, 657727, 860, 36.886397999998735
861, 4.157629704765566, 34.04733208507533, 40.93859605328938, 0.09999999999999673, 455.0, 1782, 659509, 861, 72.41917160000048
862, 4.908468652287162, 34.18534422401351, 41.115251872200446, 0.0999999999999991, 255.0, 893, 660402, 862, 33.754759999999806
863, 3.686991973620329, 34.41578872433267, 41.351126750642784, 0.09999999999999878, 160.0, 956, 661358, 863, 34.678239299999404
864, 2.665578736640303, 34.37307170679871, 41.29855690808363, 0.09999999999999734, 540.0, 1420, 662778, 864, 51.04841940000006
865, 4.110718000263786, 34.40325006329401, 41.36597008719545, 0.10000000000000078, 190.0, 662, 663440, 865, 24.26475240000036
866, 4.433483770998513, 34.45557466522465, 41.47836451956896, 0.0999999999999978, 645.0, 1230, 664670, 866, 44.261759700000766
867, 6.201409874625504, 34.453778270721436, 41.48636247253418, 0.09999999999999859, 175.0, 1000, 665670, 867, 36.25614549999955
868, 3.438267881027247, 34.34856717952853, 41.32248734827306, 0.10000000000000074, 50.0, 397, 666067, 868, 14.618568199999572
869, 4.881950493122943, 34.40784125238273, 41.351257808144666, 0.09999999999999855, 450.0, 1009, 667076, 869, 36.286815299999944
870, 3.501908622697714, 34.43908149191419, 41.385100246725344, 0.0999999999999988, 435.0, 954, 668030, 870, 37.60263920000034
871, 3.329358383451517, 34.358258423438436, 41.31309294480544, 0.1000000000000009, 125.0, 650, 668680, 871, 28.329705500000273
872, 5.194892222454458, 34.39729396702012, 41.363994399168504, 0.09999999999999845, 465.0, 1034, 669714, 872, 34.18093239999871
873, 4.363652062132245, 34.65345199827164, 41.66172060285296, 0.09999999999999884, 590.0, 945, 670659, 873, 30.744225399999777
874, 5.16100291407039, 34.766568183898926, 41.84758633458337, 0.09999999999999928, 330.0, 860, 671519, 874, 28.21334510000088
875, 5.3100312842898365, 34.83400133537307, 41.91934403067011, 0.09999999999999833, 180.0, 1066, 672585, 875, 34.872124699999404
876, 3.900419952663212, 34.8333215883979, 41.822825511045885, 0.09999999999999881, 275.0, 951, 673536, 876, 31.638824800000293
877, 3.8821654480854324, 34.803200339326764, 41.85492975877063, 0.0999999999999996, 190.0, 808, 674344, 877, 26.767876400001114
878, 4.866510456226565, 34.8583713737694, 41.93481049482427, 0.09999999999999845, 285.0, 1036, 675380, 878, 34.49430129999928
879, 5.1980105312460845, 34.77161891707058, 41.81576323920283, 0.09999999999999892, 220.0, 928, 676308, 879, 31.035162500000297
880, 6.451960479697096, 34.821366696604144, 41.8792409265679, 0.09999999999999819, 315.0, 1103, 677411, 880, 36.47130520000064
881, 5.53970863187898, 34.81783849680772, 41.910372058655916, 0.1000000000000007, 75.0, 377, 677788, 881, 12.681616999998369
882, 4.939105824289615, 34.80420170611108, 41.82261243526466, 0.1000000000000009, 150.0, 513, 678301, 882, 17.174946799999816
883, 5.70952313768062, 34.84493224011992, 41.91074589586165, 0.09999999999999848, 210.0, 1026, 679327, 883, 34.00492029999987
884, 6.070922901519124, 34.97968891715814, 42.09163267254948, 0.09999999999999856, 450.0, 1007, 680334, 884, 33.411318599999504
885, 2.5629741090579308, 35.32822198176729, 42.43357655621957, 0.10000000000000064, 40.0, 345, 680679, 885, 11.370384099998773
886, 7.611809314889719, 35.32150027487013, 42.525532713642825, 0.09999999999999763, 525.0, 1296, 681975, 886, 43.185226100000364
887, 3.614165872436459, 35.26611984166722, 42.388205956065725, 0.09999999999999915, 190.0, 885, 682860, 887, 29.402844500000356
888, 5.060248600079996, 35.34950929230697, 42.50840010500608, 0.09999999999999777, 430.0, 1239, 684099, 888, 41.12687189999997
889, 5.541099647503524, 35.28366818251433, 42.457350862089285, 0.09999999999999998, 235.0, 756, 684855, 889, 25.42865950000123
890, 3.5387760976135065, 35.32431014427177, 42.456571151903454, 0.09999999999999865, 225.0, 987, 685842, 890, 33.262183700000605
891, 8.996572205998811, 35.353952005685095, 42.58457835898342, 0.10000000000000075, 210.0, 664, 686506, 891, 22.34070950000023
892, 5.166498772192584, 35.25723127696825, 42.46737364064092, 0.10000000000000069, 50.0, 368, 686874, 892, 12.536958700000469
893, 3.965260539379953, 35.3260901152198, 42.438007724818895, 0.09999999999999963, 140.0, 804, 687678, 893, 27.135939800000415
894, 5.5698815848754375, 35.23194753741384, 42.46110839954966, 0.10000000000000055, 195.0, 686, 688364, 894, 23.099752599999192
895, 4.120236815134517, 35.19817405747418, 42.29524391022429, 0.10000000000000087, 190.0, 653, 689017, 895, 115.81294920000073
896, 5.07182871774755, 35.34706950969383, 42.4579176902771, 0.10000000000000087, 135.0, 488, 689505, 896, 19.697669499999392
897, 4.35357969340986, 35.38393833050442, 42.55613075814596, 0.09999999999999906, 180.0, 902, 690407, 897, 40.03850379999858
898, 3.726221421645145, 35.294923584782026, 42.428795300287064, 0.09999999999999845, 235.0, 1033, 691440, 898, 56.58959959999993
899, 2.912327806739591, 35.26405118356539, 42.406619241669425, 0.09999999999999769, 520.0, 1270, 692710, 899, 77.77581180000016
900, 6.26066216754734, 35.20415335633701, 42.390816847722334, 0.10000000000000074, 165.0, 665, 693375, 900, 67.55529550000028
901, 7.332456641077996, 35.34257269795736, 42.48932282511393, 0.1000000000000007, 75.0, 375, 693750, 901, 15.556278699999893
902, 3.686186702293757, 35.273744872806105, 42.430744705350676, 0.1000000000000009, 70.0, 507, 694257, 902, 20.623825399999987
903, 3.341972476267439, 35.266736571244365, 42.388643388673074, 0.09999999999999852, 275.0, 1016, 695273, 903, 45.94397559999925
904, 2.3691379123687555, 35.26394189807646, 42.360379187615365, 0.10000000000000099, 155.0, 637, 695910, 904, 64.74614389999988
905, 6.53456314064302, 35.19796926209613, 42.40104161800441, 0.10000000000000098, 70.0, 601, 696511, 905, 48.632629499999894
906, 3.1782142754736658, 35.34247260814865, 42.47671516108459, 0.09999999999999915, 225.0, 886, 697397, 906, 42.698212900000726
907, 4.939784314558473, 35.37833259207776, 42.50071435731364, 0.0999999999999997, 135.0, 794, 698191, 907, 88.19950140000037
908, 5.356244988054716, 35.304447872284726, 42.446101866644945, 0.09999999999999767, 200.0, 1273, 699464, 908, 155.4206361000015
909, 4.324581068845259, 35.42844196531507, 42.60228751712375, 0.09999999999999906, 265.0, 900, 700364, 909, 116.17492019999918
910, 3.4928616362677256, 35.63583015636274, 42.815381189820116, 0.09999999999999705, 325.0, 1570, 701934, 910, 207.1720549999991
911, 6.274361322755898, 35.634558740859774, 42.91296581861969, 0.10000000000000091, 135.0, 649, 702583, 911, 37.00375359999998
912, 4.969868962032702, 35.48411194514302, 42.67910551793367, 0.1000000000000009, 20.0, 515, 703098, 912, 23.880148399999598
913, 2.3926046365445637, 35.53372345487755, 42.69438205856875, 0.10000000000000075, 165.0, 664, 703762, 913, 31.687676999999894
914, 4.011735413240594, 35.596791018914736, 42.81536665050262, 0.09999999999999824, 350.0, 1090, 704852, 914, 55.9759866000004
915, 5.143863195759147, 35.77016587897913, 43.05182756452418, 0.1000000000000007, 175.0, 670, 705522, 915, 34.25195839999833
916, 3.728705372180525, 35.62066214852511, 42.82091651980926, 0.09999999999999948, 285.0, 829, 706351, 916, 42.17484749999858
917, 3.999208688560063, 35.662901222203274, 42.880441906882375, 0.09999999999999792, 385.0, 1186, 707537, 917, 85.6359696999989
918, 3.3445674184979737, 35.654801454405856, 42.86584274181421, 0.10000000000000052, 105.0, 690, 708227, 918, 60.43013339999925
919, 4.4968696074197325, 35.59316279188724, 42.795519377485846, 0.0999999999999989, 440.0, 934, 709161, 919, 110.97984229999929
920, 5.528366101327136, 35.61249585232916, 42.849726985666415, 0.09999999999999992, 210.0, 763, 709924, 920, 106.54853259999982
921, 4.526168922196506, 36.052232784742245, 43.33978219292188, 0.09999999999999908, 355.0, 899, 710823, 921, 123.07053019999876
922, 3.741699883392992, 36.0995106463011, 43.40411394608807, 0.09999999999999733, 270.0, 1426, 712249, 922, 183.28641059999973
923, 8.04981234243938, 36.17996327130628, 43.529767277030594, 0.10000000000000081, 155.0, 658, 712907, 923, 87.39032109999971
924, 3.6224721991128273, 36.08137119351976, 43.39975574478717, 0.09999999999999706, 625.0, 1558, 714465, 924, 194.7685543000007
925, 4.384680700333661, 36.14434570433602, 43.5336871717342, 0.09999999999999884, 280.0, 945, 715410, 925, 146.01478759999918
926, 4.418889061957852, 36.115833990403004, 43.440934793127276, 0.09999999999999797, 575.0, 1172, 716582, 926, 151.3473200999997
927, 5.50788425376859, 36.09851169281493, 43.44096336120995, 0.10000000000000099, 180.0, 626, 717208, 927, 80.17426960000012
928, 3.0564971822831364, 36.01809525868249, 43.28965655130053, 0.10000000000000099, 65.0, 630, 717838, 928, 75.22983229999954
929, 4.322461442908419, 36.09509091993675, 43.420975292596914, 0.10000000000000067, 125.0, 673, 718511, 929, 83.11607750000076
930, 3.7964975676402006, 36.12941283254481, 43.457397468054474, 0.09999999999999831, 475.0, 1072, 719583, 930, 128.6496288999988
931, 5.422604110271025, 36.2287818138416, 43.59323868384728, 0.09999999999999842, 565.0, 1040, 720623, 931, 120.73644430000058
932, 4.991833357846356, 36.32993262652393, 43.68919515101695, 0.09999999999999758, 205.0, 1314, 721937, 932, 134.39651719999893
933, 4.306671645676968, 36.31431684036315, 43.63905265441942, 0.09999999999999769, 425.0, 1271, 723208, 933, 45.14655160000075
934, 5.995397400787917, 36.36116517225728, 43.72140595910339, 0.09999999999999896, 445.0, 919, 724127, 934, 32.234914200000276
935, 2.3729573101106136, 36.17961058537354, 43.43628944976879, 0.0999999999999994, 220.0, 842, 724969, 935, 29.777311499999996
936, 3.1603386361547106, 36.27928257556865, 43.57726397872398, 0.09999999999999941, 205.0, 839, 725808, 936, 29.38739700000042
937, 4.377480248555642, 36.335299314679325, 43.71827282776704, 0.10000000000000096, 80.0, 592, 726400, 937, 21.241482699999324
938, 3.517000687691964, 36.29291273977601, 43.63739907577268, 0.09999999999999688, 425.0, 1669, 728069, 938, 64.20418570000038
939, 5.997555641492583, 36.31349447718206, 43.7106973684059, 0.10000000000000091, 55.0, 530, 728599, 939, 20.911850500000583
940, 5.980830045505432, 36.27417612482366, 43.6313073254677, 0.09999999999999952, 130.0, 821, 729420, 940, 31.819762200000696
941, 3.375737516029048, 36.36739454539451, 43.73649966130491, 0.10000000000000069, 95.0, 671, 730091, 941, 26.995097300001362
942, 3.697392727877866, 36.11884068860595, 43.41509303136353, 0.09999999999999906, 240.0, 901, 730992, 942, 35.212274499999694
943, 10.807631557801896, 36.21638760135751, 43.62266437096776, 0.10000000000000055, 135.0, 686, 731678, 943, 27.029405499999484
944, 5.155210949230838, 36.17388946945603, 43.43225088583456, 0.09999999999999894, 305.0, 925, 732603, 944, 36.23264500000005
945, 4.324380752005618, 36.03176801166837, 43.26110385713123, 0.10000000000000049, 145.0, 693, 733296, 945, 27.159592599999087
946, 4.394216040943327, 36.18476451945369, 43.486775344562275, 0.1000000000000007, 60.0, 373, 733669, 946, 14.669039200000043
947, 3.6244780439465836, 35.861009572118924, 43.07272341433127, 0.10000000000000081, 100.0, 446, 734115, 947, 17.63033220000034
948, 3.130490010499216, 35.99746143440761, 43.25134437382631, 0.1000000000000002, 135.0, 727, 734842, 948, 28.91063650000069
949, 5.677454801323463, 36.06181370015047, 43.40614620597995, 0.09999999999999781, 340.0, 1225, 736067, 949, 48.46234749999894
950, 4.8606131913302875, 36.094855952698126, 43.39822535485815, 0.10000000000000088, 85.0, 493, 736560, 950, 19.413555000000997
951, 6.06138516277949, 36.06947711252418, 43.3928538214461, 0.09999999999999724, 565.0, 1466, 738026, 951, 58.84731910000119
952, 5.2145264563712095, 36.123141600446004, 43.427531720204634, 0.09999999999999731, 355.0, 1435, 739461, 952, 56.79236470000069
953, 4.324223391852904, 36.276275258022565, 43.5833623485732, 0.09999999999999744, 495.0, 1372, 740833, 953, 54.13789209999959
954, 9.017375686011722, 36.533230826553506, 43.97024904828819, 0.10000000000000082, 175.0, 657, 741490, 954, 26.16148179999982
955, 5.244373246696805, 36.41034430955998, 43.79640573268066, 0.09999999999999783, 340.0, 1217, 742707, 955, 47.86547520000022
956, 3.1921525583104224, 36.346304151467, 43.677743873948934, 0.09999999999999996, 120.0, 757, 743464, 956, 30.145937199999025
957, 6.1310107044065285, 36.34134058073568, 43.74966481373029, 0.10000000000000078, 170.0, 662, 744126, 957, 26.548252200002025
958, 5.700407369622797, 36.40165552179864, 43.757982914933315, 0.10000000000000081, 135.0, 658, 744784, 958, 26.688765499999135
959, 4.860778739984104, 36.39418447396726, 43.77232799492897, 0.0999999999999971, 365.0, 1541, 746325, 959, 66.74734909999825
960, 5.208104942973053, 36.47321411861429, 43.85267880928262, 0.09999999999999769, 335.0, 1267, 747592, 960, 49.044044700000086
961, 5.250350733396192, 36.32075739491937, 43.67037213799412, 0.10000000000000088, 130.0, 652, 748244, 961, 33.72273859999768
962, 5.271395642389223, 36.36653066438342, 43.71687843686058, 0.09999999999999716, 340.0, 1512, 749756, 962, 79.48148260000016
963, 5.532991749017464, 36.205600212457256, 43.5168606862206, 0.10000000000000063, 95.0, 678, 750434, 963, 35.70441600000049
964, 4.505468267538633, 35.91723284065447, 43.14715393396581, 0.10000000000000092, 200.0, 647, 751081, 964, 36.484224100000574
965, 5.3508539794986305, 35.94817035216504, 43.23157372112876, 0.09999999999999797, 640.0, 1173, 752254, 965, 65.68850309999834
966, 5.238610239399977, 35.90640349337007, 43.151740151561604, 0.10000000000000087, 190.0, 653, 752907, 966, 50.95318909999696
967, 5.57778498914934, 36.00329872869676, 43.3057116184282, 0.10000000000000075, 30.0, 403, 753310, 967, 32.58618340000248
968, 6.3598620798970975, 35.93276932731507, 43.279657394166975, 0.10000000000000099, 120.0, 630, 753940, 968, 56.092749399998866
969, 5.092504746928487, 35.95768550167913, 43.25253016534059, 0.10000000000000013, 155.0, 736, 754676, 969, 87.77566899999874
970, 6.227132618305499, 36.01073981252503, 43.32919983204903, 0.10000000000000067, 60.0, 673, 755349, 970, 40.764714700002514
971, 5.64811251194999, 36.02862724346664, 43.336675428061405, 0.10000000000000092, 55.0, 539, 755888, 971, 30.247013600001083
972, 3.87161439665129, 35.99079003774904, 43.2274311321068, 0.09999999999999887, 185.0, 941, 756829, 972, 54.12100530000316
973, 5.753799148000015, 35.94553598451491, 43.2549356573733, 0.099999999999998, 275.0, 1163, 757992, 973, 136.5696809000001
974, 4.873706716390958, 35.96458656546303, 43.221267491815375, 0.09999999999999809, 345.0, 1135, 759127, 974, 149.7316193000006
975, 4.843370417327237, 35.953576531439474, 43.214202600022766, 0.09999999999999956, 205.0, 815, 759942, 975, 106.90788210000028
976, 4.373468058124969, 35.758695439972946, 43.01473896081368, 0.09999999999999841, 195.0, 1045, 760987, 976, 133.0038437000003
977, 5.621069074586567, 35.792929180159376, 43.10491110805224, 0.09999999999999959, 180.0, 811, 761798, 977, 108.3882534000004
978, 3.3927433915675325, 35.69774383147133, 42.896246415408534, 0.10000000000000003, 160.0, 748, 762546, 978, 97.57178040000144
979, 4.532848523092817, 35.67476357874265, 42.8763382992088, 0.09999999999999888, 210.0, 937, 763483, 979, 129.3380423999988
980, 3.2698899232170255, 35.61563311792371, 42.8451835598516, 0.10000000000000063, 200.0, 677, 764160, 980, 90.06924710000021
981, 4.434418738824415, 35.70199871745124, 42.94109496057216, 0.09999999999999869, 180.0, 979, 765139, 981, 131.34893270000248
982, 4.509471286627524, 35.75232208651264, 42.92976418476062, 0.09999999999999908, 375.0, 898, 766037, 982, 118.86818680000215
983, 4.540343593574644, 35.665267538580096, 42.89625692071382, 0.10000000000000096, 110.0, 644, 766681, 983, 88.5110726999992
984, 4.158115332916785, 35.62131570298839, 42.82630654968524, 0.10000000000000045, 85.0, 697, 767378, 984, 91.20549140000003
985, 4.577147314717798, 35.71613879073919, 42.95424035810775, 0.09999999999999766, 390.0, 1285, 768663, 985, 178.9101589999991
986, 2.480334980898207, 35.68172255880743, 42.85010015600674, 0.10000000000000094, 35.0, 557, 769220, 986, 76.2207414000004
987, 7.864568373134125, 35.80594291501832, 43.22592040867482, 0.10000000000000099, 110.0, 618, 769838, 987, 86.21148769999854
988, 5.715403714587589, 35.630796163924515, 42.873762754915276, 0.0999999999999999, 185.0, 767, 770605, 988, 99.44901120000213
989, 4.830185475161654, 35.58754975350146, 42.77462967007146, 0.10000000000000091, 100.0, 519, 771124, 989, 66.48950540000078
990, 3.656678007587223, 35.61269833170645, 42.78453073918567, 0.09999999999999734, 665.0, 1418, 772542, 990, 187.74579399999857
991, 2.632752747812555, 35.661573674284966, 42.804576602752846, 0.10000000000000094, 80.0, 563, 773105, 991, 66.82103620000271
992, 5.922770346961677, 35.63734772362943, 42.867120803800475, 0.09999999999999888, 60.0, 938, 774043, 992, 63.68000879999818
993, 2.579306742668329, 35.54757403761414, 42.6747918511003, 0.10000000000000066, 110.0, 674, 774717, 993, 35.519729600000574
994, 2.445359530584059, 35.56042766696035, 42.7190165688451, 0.09999999999999992, 140.0, 763, 775480, 994, 39.60515160000068
995, 4.31887104575163, 35.616930453696945, 42.83583483463816, 0.09999999999999754, 470.0, 1335, 776815, 995, 68.66892310000185
996, 6.332542859669503, 35.596509319005136, 42.795806428781404, 0.10000000000000055, 135.0, 686, 777501, 996, 34.03634120000061
997, 6.171087008483708, 35.61544137954712, 42.84327843093872, 0.09999999999999859, 310.0, 1000, 778501, 997, 50.76017299999876
998, 5.540903606970114, 35.59994600363483, 42.82742751142986, 0.10000000000000099, 190.0, 622, 779123, 998, 46.13461299999835
999, 5.423115250226859, 35.58270157733875, 42.742571204646644, 0.09999999999999952, 110.0, 821, 779944, 999, 45.66254140000092
1000, 4.8915288711602285, 35.346938266791774, 42.47778008440307, 0.09999999999999853, 355.0, 1014, 780958, 1000, 54.62012940000204
1001, 4.703820039004756, 35.316531847684814, 42.42792715781774, 0.10000000000000099, 80.0, 624, 781582, 1001, 34.745544400000654
1002, 6.338336610792593, 35.414876945412594, 42.62236677220738, 0.09999999999999855, 210.0, 1011, 782593, 1002, 54.99231039999722
1003, 4.420146048617634, 35.3089701981978, 42.42754140333696, 0.0999999999999982, 440.0, 1100, 783693, 1003, 53.04447230000005
1004, 4.769440446877748, 35.40366075172853, 42.56176671231731, 0.09999999999999673, 450.0, 1780, 785473, 1004, 80.02814619999845
1005, 4.724635249995683, 35.3518604186644, 42.53217471019331, 0.09999999999999946, 155.0, 830, 786303, 1005, 37.56968190000043
1006, 4.600961935122958, 35.31018854623817, 42.39747675930161, 0.10000000000000075, 180.0, 664, 786967, 1006, 29.85888519999935
1007, 4.425149580921511, 35.3962286605717, 42.53196406769789, 0.10000000000000092, 90.0, 647, 787614, 1007, 29.881089800001064
1008, 4.734552304553134, 35.32984942481632, 42.44643327622187, 0.10000000000000099, 185.0, 630, 788244, 1008, 28.39736300000004
1009, 5.52237756502029, 35.359009038403045, 42.52885615599222, 0.09999999999999909, 130.0, 895, 789139, 1009, 40.163541999998415
1010, 4.86547838030451, 35.42520369578452, 42.624714997563046, 0.10000000000000092, 60.0, 548, 789687, 1010, 24.762711300001683
1011, 5.581809115812999, 35.40089317434999, 42.52619749879184, 0.0999999999999992, 180.0, 876, 790563, 1011, 39.488843900002394
1012, 6.111837921076912, 35.46138824635306, 42.64311990252996, 0.09999999999999915, 120.0, 885, 791448, 1012, 40.360441900000296
1013, 6.159592749118203, 35.40062149981189, 42.56078911041705, 0.09999999999999912, 245.0, 891, 792339, 1013, 40.393882600001234
1014, 5.902683578042621, 35.50232778112572, 42.6787963315665, 0.10000000000000088, 55.0, 498, 792837, 1014, 22.668220499999734
1015, 5.517148112540213, 35.499113413829676, 42.681231553033484, 0.09999999999999998, 110.0, 755, 793592, 1015, 33.918542100000195
1016, 4.753441064066503, 35.51886420932166, 42.673999760387346, 0.09999999999999756, 515.0, 1321, 794913, 1016, 59.718898599996464
1017, 4.683630967093103, 35.4926003482392, 42.66471024734275, 0.09999999999999779, 195.0, 1234, 796147, 1017, 55.38899470000251
1018, 4.012686591652577, 35.47589503773643, 42.64606625588654, 0.09999999999999978, 175.0, 782, 796929, 1018, 35.382405799999106
1019, 4.3277450425774635, 35.49997499276206, 42.667600577788825, 0.0999999999999988, 170.0, 955, 797884, 1019, 43.84734969999772
1020, 7.359299417970993, 35.48108168420594, 42.71910793498411, 0.10000000000000091, 85.0, 531, 798415, 1020, 24.21892459999799
1021, 3.064406554328051, 35.49185543669436, 42.66985663682401, 0.09999999999999859, 295.0, 1002, 799417, 1021, 45.42004349999843
1022, 3.3608515656223337, 35.588307791719394, 42.799128769810814, 0.1000000000000004, 160.0, 703, 800120, 1022, 32.38399489999938
1023, 3.4404670046736494, 35.55385349598454, 42.738442937017005, 0.10000000000000049, 200.0, 693, 800813, 1023, 31.373712700002216
1024, 3.7241563332890744, 35.666260846342965, 42.87264253741683, 0.10000000000000094, 120.0, 563, 801376, 1024, 27.64679410000099
1025, 6.362411484494062, 35.643764971734996, 42.92736937471493, 0.10000000000000088, 60.0, 501, 801877, 1025, 22.756628200000705
1026, 5.3952906817127175, 35.625895522782024, 42.77727247602755, 0.10000000000000099, 335.0, 633, 802510, 1026, 29.204041199998755
1027, 5.019112117314724, 35.569941561046846, 42.81865710829839, 0.09999999999999908, 135.0, 898, 803408, 1027, 41.28484120000212
1028, 4.673333268954243, 35.65046922941916, 42.84916855924515, 0.09999999999999805, 405.0, 1145, 804553, 1028, 52.195106700000906
1029, 5.059781144600858, 35.62043906490561, 42.82629156776262, 0.09999999999999856, 235.0, 1006, 805559, 1029, 46.31942759999947
1030, 4.960470618222389, 35.66059558292955, 42.83310283187532, 0.09999999999999952, 210.0, 822, 806381, 1030, 37.96475450000071
1031, 3.335224832933915, 35.64803613107416, 42.83491493418247, 0.09999999999999973, 125.0, 790, 807171, 1031, 36.720808099998976
1032, 4.536099082446894, 35.57353460560469, 42.75011486032261, 0.09999999999999697, 415.0, 1619, 808790, 1032, 74.45070519999717
1033, 3.243909510076681, 35.57290514944968, 42.70857389082416, 0.09999999999999887, 260.0, 939, 809729, 1033, 43.886045999999624
1034, 5.884431830009087, 35.80964391436798, 43.09983681053515, 0.09999999999999785, 350.0, 1208, 810937, 1034, 55.780697500002134
1035, 5.274429951980175, 35.80240758351308, 43.08015001863455, 0.10000000000000045, 125.0, 697, 811634, 1035, 32.55840299999909
1036, 5.260308892173002, 35.807924194639895, 43.04229632221845, 0.09999999999999858, 245.0, 1004, 812638, 1036, 46.153643400000874
1037, 4.5151323543167585, 35.816275737584085, 43.04657370796031, 0.09999999999999755, 490.0, 1326, 813964, 1037, 62.600210500000685
1038, 4.03895950497009, 35.86604044372431, 43.1066229918218, 0.0999999999999988, 235.0, 954, 814918, 1038, 44.38786330000221
1039, 7.470559118837501, 35.91421922619974, 43.330516246413204, 0.10000000000000073, 80.0, 389, 815307, 1039, 18.24252669999987
1040, 3.5962475776295397, 35.729751036280675, 42.943176933697295, 0.10000000000000069, 135.0, 672, 815979, 1040, 31.701633000000584
1041, 4.897697348378061, 35.77742020780688, 43.033381799652, 0.10000000000000096, 150.0, 582, 816561, 1041, 27.192513099998905
1042, 5.9157379635017024, 35.87379624502999, 43.15929528025838, 0.0999999999999971, 525.0, 1540, 818101, 1042, 72.03520100000242
1043, 4.425439836698933, 35.85598955750466, 43.10238536894322, 0.09999999999999766, 305.0, 1280, 819381, 1043, 60.22104209999816
1044, 4.272746241916056, 35.74247162992304, 42.96027657118711, 0.1000000000000004, 105.0, 704, 820085, 1044, 34.10867750000034
1045, 4.0096300407966, 35.566026120164274, 42.71953326868256, 0.09999999999999916, 340.0, 884, 820969, 1045, 42.44347629999902
1046, 4.134685814545847, 35.48344990842358, 42.65823950841527, 0.09999999999999906, 285.0, 902, 821871, 1046, 42.75445149999723
1047, 5.205665821652848, 35.52813378520302, 42.7035901935785, 0.09999999999999888, 285.0, 937, 822808, 1047, 44.81482500000129
1048, 5.608876050892964, 35.51746078833793, 42.71543521788514, 0.0999999999999995, 225.0, 824, 823632, 1048, 39.39820139999938
1049, 4.87533174494988, 35.56483947819677, 42.74407478858684, 0.10000000000000095, 115.0, 580, 824212, 1049, 27.728100699998322
1050, 2.9510907584274153, 35.48276802998669, 42.61386500664477, 0.10000000000000091, 75.0, 530, 824742, 1050, 25.415984499999468
1051, 3.437488050373527, 35.52409184914009, 42.665425665238324, 0.09999999999999956, 225.0, 816, 825558, 1051, 39.72302480000144
1052, 5.198314039518759, 35.59588566392955, 42.827519547652656, 0.10000000000000037, 180.0, 707, 826265, 1052, 34.13055059999897
1053, 4.296411858865952, 35.53014445232841, 42.66844045863771, 0.10000000000000078, 175.0, 662, 826927, 1053, 31.257262200000696
1054, 3.335627279100074, 35.55824061066892, 42.74218520312242, 0.09999999999999934, 180.0, 852, 827779, 1054, 41.075500300001295
1055, 5.28084127308201, 35.50466214398206, 42.72287235825749, 0.09999999999999885, 225.0, 944, 828723, 1055, 45.20094560000143
1056, 4.810193015584178, 35.54028475259159, 42.752809919019754, 0.10000000000000085, 15.0, 469, 829192, 1056, 22.332024200000888
1057, 3.2679016067678752, 35.4641368284844, 42.61145624244195, 0.10000000000000077, 140.0, 663, 829855, 1057, 31.957399599999917
1058, 6.813339065430758, 35.315499683055336, 42.46921834165544, 0.10000000000000098, 155.0, 599, 830454, 1058, 29.144406399998843
1059, 3.359094819190565, 35.0880832979756, 42.15973425051334, 0.10000000000000059, 125.0, 682, 831136, 1059, 32.720751000000746
1060, 2.8873390148328557, 35.220648149016554, 42.28717050734599, 0.10000000000000099, 140.0, 628, 831764, 1060, 30.131021500001225
1061, 2.758347235212652, 35.22488581156559, 42.30535435299222, 0.10000000000000046, 160.0, 695, 832459, 1061, 33.717487699999765
1062, 2.45348310179518, 35.182324322419056, 42.2279435175999, 0.10000000000000085, 65.0, 471, 832930, 1062, 22.742679300001328
1063, 5.556858314986688, 35.19774262531694, 42.33876855689359, 0.09999999999999946, 260.0, 830, 833760, 1063, 39.63870250000036
1064, 4.894176548176049, 35.18484539643177, 42.25062311920672, 0.09999999999999905, 295.0, 905, 834665, 1064, 44.104638500000874
1065, 4.828347998627714, 35.10334873021206, 42.216124789514275, 0.09999999999999831, 175.0, 1070, 835735, 1065, 51.98860429999695
1066, 5.825896250587267, 35.30512698878094, 42.434302614531966, 0.0999999999999998, 185.0, 781, 836516, 1066, 37.80579209999996
1067, 5.906113936983628, 35.2285233978042, 42.3043345687981, 0.09999999999999967, 210.0, 798, 837314, 1067, 38.94528900000296
1068, 4.127675046037981, 35.22884339071613, 42.33108307404296, 0.09999999999999971, 135.0, 793, 838107, 1068, 38.45279750000191
1069, 4.691436418932593, 35.25239877262991, 42.41610768407643, 0.09999999999999859, 325.0, 1002, 839109, 1069, 48.86673400000291
1070, 2.4293903096488094, 35.355899413217024, 42.442959133742036, 0.10000000000000071, 85.0, 379, 839488, 1070, 18.426675899998372
1071, 6.896941401732182, 35.35587824871537, 42.50436898596613, 0.0999999999999998, 205.0, 781, 840269, 1071, 38.1063574999971
1072, 3.5715629170017857, 35.487968355329855, 42.624084836227105, 0.10000000000000059, 185.0, 682, 840951, 1072, 33.384210399999574
1073, 5.169894842316057, 35.4666725408251, 42.65594530907747, 0.10000000000000092, 85.0, 535, 841486, 1073, 26.0410066000004
1074, 6.139880700881843, 35.52146883895224, 42.66466646505179, 0.10000000000000074, 40.0, 399, 841885, 1074, 19.48628589999862
1075, 6.145710533502434, 35.58245727919548, 42.844150684255006, 0.099999999999998, 365.0, 1163, 843048, 1075, 56.174819999996544
1076, 6.741487222565328, 35.5560162513032, 42.78806277539939, 0.09999999999999883, 165.0, 947, 843995, 1076, 46.122568599999795
1077, 7.869419894747801, 35.542201798445696, 42.749462741238254, 0.1000000000000003, 165.0, 715, 844710, 1077, 35.27125679999881
1078, 5.807176743104646, 35.580934417036616, 42.731634585369804, 0.10000000000000099, 40.0, 621, 845331, 1078, 30.631319899999653
1079, 2.3902525559389045, 35.46259019959648, 42.61020700500982, 0.1000000000000007, 80.0, 371, 845702, 1079, 18.053911699997116
1080, 2.541789423309554, 35.49269789404261, 42.61160291903804, 0.10000000000000062, 55.0, 337, 846039, 1080, 17.06091390000074
1081, 8.3389988177719, 35.58853385575855, 42.78925350276568, 0.10000000000000085, 160.0, 655, 846694, 1081, 31.792866799998592
1082, 7.243293899950844, 35.543253357345996, 42.6502299639369, 0.09999999999999934, 190.0, 851, 847545, 1082, 41.42368980000174
1083, 5.00228352282705, 35.5341145382197, 42.74326252001608, 0.09999999999999767, 530.0, 1274, 848819, 1083, 62.469940200000565
1084, 3.838990267821227, 35.469695282772214, 42.57149984229425, 0.10000000000000087, 90.0, 483, 849302, 1084, 23.533383199999662
1085, 4.458974834156129, 35.592547882434936, 42.770554363635156, 0.10000000000000095, 90.0, 645, 849947, 1085, 31.92128700000103
1086, 4.835963450659905, 34.87383409819678, 41.89853091514547, 0.09999999999999712, 345.0, 1528, 851475, 1086, 75.38572130000102
1087, 5.237162568860254, 34.846276575535505, 41.905480074351566, 0.09999999999999885, 160.0, 943, 852418, 1087, 46.531674800000474
1088, 6.421092331506058, 34.82213207659111, 41.86048345704906, 0.10000000000000098, 145.0, 617, 853035, 1088, 30.56865850000031
1089, 5.017949813813494, 34.941449287610176, 42.03096621432285, 0.10000000000000009, 160.0, 741, 853776, 1089, 36.55946589999803
1090, 3.7533147372956415, 34.80375021406748, 41.77650332404572, 0.1000000000000009, 115.0, 515, 854291, 1090, 25.320408499999758
1091, 4.304606195203268, 34.83366754263719, 41.85588151643384, 0.09999999999999999, 250.0, 754, 855045, 1091, 38.035475299999234
1092, 3.090685507994004, 34.82699104879989, 41.82590410846084, 0.09999999999999848, 270.0, 1029, 856074, 1092, 51.13746199999878
1093, 4.902003649530446, 34.77824207127388, 41.807063257752965, 0.09999999999999959, 185.0, 812, 856886, 1093, 40.65159560000029
1094, 4.633688096467223, 34.88069971464093, 41.88378281309931, 0.10000000000000073, 40.0, 387, 857273, 1094, 20.374552299999777
1095, 3.5351416073344253, 34.93960283754824, 41.94056283532678, 0.0999999999999986, 245.0, 999, 858272, 1095, 49.696738300001016
1096, 4.616380248382687, 34.84219260025024, 41.8733362083435, 0.09999999999999859, 505.0, 1000, 859272, 1096, 50.12980599999719
1097, 2.720499299363922, 34.75835868227902, 41.72912192235132, 0.10000000000000087, 175.0, 653, 859925, 1097, 32.88665970000147
1098, 3.9181844574170857, 34.446482413669806, 41.41561967381891, 0.09999999999999835, 200.0, 1060, 860985, 1098, 53.149412499999016
1099, 4.548353030497805, 34.40839586242578, 41.34978529950079, 0.09999999999999776, 325.0, 1242, 862227, 1099, 57.27796599999783
1100, 3.2821661450021193, 34.36075433821586, 41.26910110098197, 0.09999999999999808, 340.0, 1138, 863365, 1100, 46.68606050000017
1101, 3.9396253774609806, 34.38213437528753, 41.3254383393188, 0.09999999999999831, 540.0, 1072, 864437, 1101, 44.30474400000094
1102, 4.129148578081491, 34.423265337674124, 41.367431318175115, 0.09999999999999755, 390.0, 1325, 865762, 1102, 54.694668100000854
1103, 7.1712710957223615, 34.482394436528566, 41.45737832615196, 0.0999999999999996, 210.0, 809, 866571, 1103, 33.986018200001126
1104, 4.22661601535643, 34.35459533861863, 41.262068858683016, 0.09999999999999762, 400.0, 1298, 867869, 1104, 71.58647469999778
1105, 4.921922942399144, 34.42137995086798, 41.36220890867944, 0.09999999999999733, 550.0, 1428, 869297, 1105, 73.16547759999958
1106, 6.528945273364451, 34.33759821078841, 41.3139428598353, 0.10000000000000099, 140.0, 637, 869934, 1106, 31.070570799998677
1107, 5.540841882261173, 34.392553819233534, 41.34308460606722, 0.10000000000000099, 155.0, 627, 870561, 1107, 29.30987969999842
1108, 2.80033719336376, 34.36249068300816, 41.25862643491424, 0.09999999999999866, 255.0, 986, 871547, 1108, 45.81258429999798
1109, 6.795128999859284, 34.415299364390215, 41.406934319896195, 0.0999999999999982, 305.0, 1099, 872646, 1109, 52.89250869999887
1110, 4.577276232644019, 34.260192663507794, 41.189027534709545, 0.0999999999999998, 255.0, 781, 873427, 1110, 39.05548540000018
1111, 6.1185416205100145, 34.4143168177515, 41.406884570197676, 0.1000000000000005, 115.0, 691, 874118, 1111, 36.60718469999847
1112, 2.9327844260851457, 34.34601427046249, 41.22061277705331, 0.09999999999999745, 450.0, 1371, 875489, 1112, 68.91673550000269
1113, 4.9588020813966684, 34.2730462397148, 41.25009075396215, 0.1000000000000009, 45.0, 511, 876000, 1113, 26.617880999998306
1114, 4.849134149642398, 34.349571228027344, 41.304196453734534, 0.0999999999999991, 290.0, 894, 876894, 1114, 42.90494039999976
1115, 3.8907569576389958, 34.36364387228414, 41.30069872912239, 0.09999999999999802, 370.0, 1156, 878050, 1115, 56.116830499999196
1116, 5.964115100998616, 34.407841325313484, 41.32845948401918, 0.09999999999999735, 335.0, 1410, 879460, 1116, 74.2107279999982
1117, 4.641956621677355, 34.30276279592873, 41.162156579727515, 0.10000000000000074, 145.0, 665, 880125, 1117, 36.91357359999893
1118, 5.087351271915331, 34.314593125505056, 41.25935981148168, 0.10000000000000057, 75.0, 684, 880809, 1118, 34.550297099998716
1119, 5.014289661215226, 34.32328839364221, 41.29178245018758, 0.10000000000000092, 110.0, 537, 881346, 1119, 27.367569100002584
1120, 2.9072160959536397, 34.17355702794931, 41.01267788705509, 0.1000000000000006, 20.0, 331, 881677, 1120, 16.5523600000015
1121, 4.302643858507183, 34.26089422569512, 41.185262668206825, 0.09999999999999963, 125.0, 805, 882482, 1121, 37.54393590000109
1122, 4.520924645527632, 34.42876129039175, 41.39903002369161, 0.10000000000000063, 70.0, 343, 882825, 1122, 16.52128449999873
1123, 5.513738501905335, 34.32844260747254, 41.22316039315326, 0.1000000000000009, 100.0, 506, 883331, 1123, 24.082672399999865
1124, 5.539671765956265, 34.29818825972708, 41.19762613619977, 0.10000000000000057, 165.0, 684, 884015, 1124, 33.170685799999774
1125, 6.38713241985651, 34.34445651165851, 41.36919630967177, 0.10000000000000049, 70.0, 693, 884708, 1125, 35.30819699999847
1126, 6.216299064188118, 34.356603125230635, 41.343714978321486, 0.099999999999999, 185.0, 913, 885621, 1126, 45.9245336999993
1127, 3.4720473040936453, 34.30582029561426, 41.24347850694795, 0.10000000000000099, 95.0, 619, 886240, 1127, 30.994198599997617
1128, 7.791830335297413, 34.44266656098934, 41.47776119728828, 0.10000000000000024, 110.0, 722, 886962, 1128, 35.04895790000228
1129, 2.435615691555783, 34.36116810139705, 41.219098518489474, 0.10000000000000082, 45.0, 453, 887415, 1129, 22.173123900000064
1130, 3.9079996041382814, 34.30094655354818, 41.20048314444026, 0.10000000000000087, 70.0, 483, 887898, 1130, 23.161505000000034
1131, 8.524111142922571, 34.30949776626559, 41.350837566495606, 0.10000000000000092, 30.0, 541, 888439, 1131, 26.170491000000766
1132, 5.5329120703578445, 34.27988227188361, 41.22187323395431, 0.09999999999999973, 140.0, 791, 889230, 1132, 40.635758300002635
1133, 3.591382735108734, 34.256363226678474, 41.155642522445426, 0.10000000000000078, 140.0, 661, 889891, 1133, 33.574637199999415
1134, 8.657834970309395, 33.98013182085846, 40.87942305659748, 0.09999999999999991, 95.0, 764, 890655, 1134, 37.16443829999844
1135, 4.305487757282598, 33.79279235213723, 40.60074194586386, 0.10000000000000081, 125.0, 658, 891313, 1135, 32.665660300001036
1136, 6.217029550384462, 34.013409430808736, 40.90232765764415, 0.09999999999999892, 170.0, 929, 892242, 1136, 45.914045699999406
1137, 3.858226804668975, 33.921709140727025, 40.72743700389834, 0.09999999999999748, 695.0, 1358, 893600, 1137, 65.64941679999902
1138, 4.901018826969693, 33.873859359117276, 40.72696896863033, 0.09999999999999654, 745.0, 1932, 895532, 1138, 89.02989819999857
1139, 4.916263106068066, 33.855775328090346, 40.697943169382945, 0.0999999999999982, 510.0, 1099, 896631, 1139, 54.053822999998374
1140, 4.20930966343815, 33.938900606664596, 40.76845213946174, 0.10000000000000081, 105.0, 442, 897073, 1140, 21.531245400001353
1141, 3.775846614368413, 33.95443047725991, 40.80041811890798, 0.09999999999999798, 280.0, 1168, 898241, 1141, 55.56990470000164
1142, 4.69001848196111, 33.863029410199424, 40.70309212847454, 0.09999999999999953, 215.0, 820, 899061, 1142, 36.377833599999576
1143, 4.2311297309876394, 33.81427361166984, 40.62981497994426, 0.09999999999999898, 195.0, 917, 899978, 1143, 41.22869210000135
1144, 4.296827604143141, 33.96938426741238, 40.78745118502913, 0.10000000000000084, 70.0, 464, 900442, 1144, 22.889984600002208
1145, 4.308949769954769, 33.923883007931096, 40.77178625229909, 0.0999999999999973, 460.0, 1441, 901883, 1145, 69.85282929999812
1146, 5.419325150258878, 33.99086739326887, 40.89484967805277, 0.09999999999999802, 535.0, 1154, 903037, 1146, 69.31652540000141
1147, 4.008360026948789, 33.90209229684313, 40.75503071329226, 0.09999999999999892, 260.0, 927, 903964, 1147, 40.93826120000085
1148, 6.29893319647289, 34.04613310619465, 40.97976840491434, 0.09999999999999847, 220.0, 1030, 904994, 1148, 47.75028590000147
1149, 3.2940995782993885, 33.95955135968266, 40.80718055257992, 0.09999999999999869, 515.0, 980, 905974, 1149, 46.38000380000085
1150, 4.069778372701403, 33.95483751023096, 40.751824481057746, 0.10000000000000071, 40.0, 383, 906357, 1150, 15.968100999998569
1151, 5.447665136759316, 34.02565570439799, 40.89610217080671, 0.09999999999999794, 355.0, 1179, 907536, 1151, 48.36203260000184
1152, 5.370581127635251, 33.9607899384658, 40.862162210296354, 0.10000000000000081, 110.0, 658, 908194, 1152, 27.1683309
1153, 2.760135591430196, 33.989482849416596, 40.81896496490693, 0.10000000000000095, 95.0, 568, 908762, 1153, 23.087286199999653
1154, 6.831775840297975, 34.064678411871, 41.02525203153702, 0.09999999999999835, 385.0, 1059, 909821, 1154, 44.8290061000007
1155, 5.774594432580529, 34.0150366040354, 40.8795179465479, 0.09999999999999958, 100.0, 814, 910635, 1155, 35.352851499999815
1156, 4.937363587980717, 33.944361687865324, 40.82346469142168, 0.09999999999999952, 160.0, 823, 911458, 1156, 36.23320690000037
1157, 5.857699093338868, 33.99346700357207, 40.88641796247334, 0.10000000000000038, 115.0, 705, 912163, 1157, 29.953656499998033
1158, 4.043673959959831, 33.91238568510328, 40.73253175474348, 0.09999999999999751, 445.0, 1344, 913507, 1158, 59.869827700000315
1159, 3.583738774796668, 33.85996255342541, 40.68721698875591, 0.099999999999998, 345.0, 1165, 914672, 1159, 50.730087100000674
1160, 5.400457844160188, 33.952723026275635, 40.84671978132259, 0.10000000000000064, 115.0, 676, 915348, 1160, 29.66196029999992
1161, 5.51312698220618, 33.968679300329306, 40.88483769590683, 0.09999999999999729, 605.0, 1448, 916796, 1161, 62.52275390000068
1162, 4.541640907816009, 34.01402243882596, 40.84090562923226, 0.10000000000000062, 50.0, 334, 917130, 1162, 16.734754700002668
1163, 4.316271712575282, 33.94088533704526, 40.76784340689115, 0.09999999999999831, 325.0, 1070, 918200, 1163, 50.42952250000235
1164, 5.276061230484362, 33.70358635088719, 40.52769964550613, 0.1000000000000008, 110.0, 436, 918636, 1164, 19.63800479999918
1165, 5.369086890091556, 33.99081443631372, 40.92448433887127, 0.09999999999999744, 540.0, 1376, 920012, 1165, 59.29655569999886
1166, 3.913000129857811, 33.74347266181041, 40.637866456629865, 0.10000000000000096, 15.0, 590, 920602, 1166, 29.18992750000325
1167, 2.6819605397764574, 33.78540948019074, 40.58562799237752, 0.10000000000000099, 140.0, 627, 921229, 1167, 30.42629339999985
1168, 4.612128947501239, 33.87782743667122, 40.734220597668845, 0.10000000000000045, 145.0, 698, 921927, 1168, 32.96058249999987
1169, 3.604458254239613, 33.69025067494328, 40.4496542737, 0.10000000000000074, 160.0, 665, 922592, 1169, 29.065467699998408
1170, 4.673084330508932, 33.85163515722248, 40.69066424436972, 0.10000000000000095, 85.0, 568, 923160, 1170, 26.400502899999992
1171, 4.789937254995617, 33.82397776250524, 40.692814032067105, 0.09999999999999888, 120.0, 937, 924097, 1171, 42.6426363999999
1172, 5.858426882306848, 33.70795401659879, 40.46919251210762, 0.10000000000000091, 95.0, 528, 924625, 1172, 25.03449250000267
1173, 7.3543735766545275, 33.85933135183234, 40.71942495475138, 0.10000000000000074, 145.0, 665, 925290, 1173, 33.593381800001225
1174, 6.759937316916769, 33.932679590234905, 40.7730975514136, 0.09999999999999974, 135.0, 788, 926078, 1174, 37.89829689999897
1175, 4.925962394165267, 33.82854341844791, 40.700335608197314, 0.09999999999999826, 245.0, 1084, 927162, 1175, 51.911095200001
1176, 4.5693476216866165, 33.7407466409079, 40.579297650569, 0.09999999999999755, 725.0, 1329, 928491, 1176, 62.78183809999973
1177, 6.397178620463742, 33.81746225917185, 40.64585611094599, 0.09999999999999759, 570.0, 1311, 929802, 1177, 64.60592779999934
1178, 5.1407670728709345, 34.05890187629856, 40.94908307095077, 0.10000000000000059, 185.0, 682, 930484, 1178, 31.67272089999824
1179, 7.276436907722863, 34.21341049240999, 41.14671812378303, 0.09999999999999694, 425.0, 1635, 932119, 1179, 84.46848490000048
1180, 3.4744803733559815, 34.149915845689755, 41.02688793974798, 0.09999999999999776, 490.0, 1242, 933361, 1180, 62.430087299999286
1181, 5.475763211964305, 34.134706448557104, 41.03492731741421, 0.09999999999999906, 60.0, 902, 934263, 1181, 43.70014479999736
1182, 6.5545160739520885, 34.274210150370344, 41.28336255992958, 0.10000000000000071, 150.0, 668, 934931, 1182, 30.941111600001022
1183, 4.2949483828826684, 34.26185522617721, 41.181194139803544, 0.1000000000000005, 155.0, 691, 935622, 1183, 34.93207980000079
1184, 5.954968980079391, 34.16027057946599, 41.07602294982667, 0.09999999999999999, 250.0, 753, 936375, 1184, 36.430578100000275
1185, 5.074669069119793, 34.24341017300965, 41.12228596796755, 0.09999999999999933, 105.0, 854, 937229, 1185, 39.17892309999661
1186, 5.402818737639955, 34.19465397196201, 41.11663758021457, 0.09999999999999808, 115.0, 1138, 938367, 1186, 53.28599060000124
1187, 5.007523600909594, 34.239386723245694, 41.16283678351016, 0.09999999999999742, 420.0, 1378, 939745, 1187, 64.10197749999861
1188, 5.174871117385686, 34.20729597281797, 41.114594100755895, 0.09999999999999776, 670.0, 1244, 940989, 1188, 63.623376599996845
1189, 7.7911255301404285, 34.161935713589955, 41.12591307852274, 0.09999999999999797, 245.0, 1173, 942162, 1189, 59.89113370000268
1190, 2.4382513395500442, 34.09296132473045, 40.93672698522321, 0.10000000000000099, 160.0, 641, 942803, 1190, 33.065602200000285
1191, 5.052876550529227, 34.24887440188619, 41.13044552728367, 0.0999999999999991, 175.0, 894, 943697, 1191, 45.77367949999825
1192, 3.6826607312744772, 34.16460327721538, 41.08028650059946, 0.09999999999999833, 170.0, 1065, 944762, 1192, 54.55633659999876
1193, 5.209387483619387, 34.1573964231202, 41.071552793420445, 0.09999999999999794, 205.0, 1181, 945943, 1193, 60.423006400000304
1194, 7.434707327190897, 34.16921278562018, 41.088631849644884, 0.09999999999999983, 210.0, 777, 946720, 1194, 40.03614560000278
1195, 4.52838696837626, 34.27733553709046, 41.22344073580924, 0.10000000000000007, 190.0, 742, 947462, 1195, 38.09475119999843
1196, 7.7165810806748265, 34.2425895015863, 41.20968444518533, 0.10000000000000098, 135.0, 599, 948061, 1196, 32.92352570000003
1197, 5.522712114000959, 34.19385805758801, 41.10992325269259, 0.10000000000000019, 145.0, 728, 948789, 1197, 38.82964770000035
1198, 5.15664000022991, 34.21371794949059, 41.12775394123714, 0.09999999999999945, 185.0, 833, 949622, 1198, 39.641895299999305
1199, 3.5695817666963983, 34.05462083222891, 40.92274892339807, 0.09999999999999777, 385.0, 1237, 950859, 1199, 60.04382670000268
1200, 3.1737738618630864, 34.07968138519829, 40.944192498863565, 0.09999999999999853, 275.0, 1014, 951873, 1200, 50.757114800002455
1201, 5.443607743530779, 34.104859706333706, 41.085078605968285, 0.09999999999999826, 270.0, 1085, 952958, 1201, 52.199184299999615
1202, 6.72711768443119, 34.13741628158191, 41.11622781989988, 0.09999999999999785, 255.0, 1210, 954168, 1202, 57.39554800000042
1203, 4.956008623540401, 34.07323565573063, 40.938988933923106, 0.09999999999999835, 305.0, 1060, 955228, 1203, 48.97086829999898
1204, 5.106592210221203, 33.98877194163563, 40.844131190261564, 0.10000000000000092, 160.0, 546, 955774, 1204, 25.311843699997553
1205, 4.758324448853108, 34.04436203592641, 40.90968134169033, 0.10000000000000099, 65.0, 621, 956395, 1205, 29.08718349999981
1206, 2.668005594875563, 34.10774623499673, 40.974952597941716, 0.09999999999999781, 330.0, 1223, 957618, 1206, 57.326813600000605
1207, 4.586453190519668, 34.07509678944503, 40.97876666607243, 0.09999999999999855, 505.0, 1010, 958628, 1207, 51.97087760000068
1208, 4.938851741871481, 34.122292014414285, 41.01593969622229, 0.09999999999999953, 170.0, 819, 959447, 1208, 42.14577180000197
1209, 3.8496991494088895, 34.05631979086654, 40.92236977980542, 0.1000000000000009, 80.0, 506, 959953, 1209, 26.067472299997462
1210, 3.892583497115628, 33.98679060235246, 40.85746789747669, 0.09999999999999815, 215.0, 1116, 961069, 1210, 58.46361930000057
1211, 4.414593405699524, 34.32028784188482, 41.26203554576687, 0.10000000000000064, 75.0, 347, 961416, 1211, 17.795883099999628
1212, 7.551242743045479, 34.04993034461876, 41.01144688593877, 0.10000000000000071, 70.0, 385, 961801, 1212, 19.94149599999946
1213, 4.60157383303049, 34.00096989124316, 40.946004346826705, 0.10000000000000099, 100.0, 641, 962442, 1213, 32.93692329999976
1214, 5.7838057908616465, 34.158694860245234, 41.03493900353724, 0.10000000000000045, 130.0, 698, 963140, 1214, 35.73061619999862
1215, 5.184752356342808, 34.087599188981656, 41.00626769227658, 0.10000000000000088, 80.0, 501, 963641, 1215, 26.106397400002606
1216, 4.494514948215582, 34.07735345467569, 40.951520654219614, 0.10000000000000034, 415.0, 711, 964352, 1216, 37.02228010000181
1217, 5.187455588495706, 34.1629845908074, 41.04946579675951, 0.10000000000000087, 105.0, 482, 964834, 1217, 25.243258499998774
1218, 6.648862158003195, 34.07356472401212, 40.99377851393942, 0.09999999999999808, 460.0, 1137, 965971, 1218, 58.70890220000001
1219, 2.691589831582964, 34.097746317789436, 40.95046343868726, 0.0999999999999992, 145.0, 876, 966847, 1219, 45.42657640000107
1220, 4.401453547221972, 34.02884587768122, 40.89838156192861, 0.10000000000000038, 90.0, 705, 967552, 1220, 36.611171900000045
1221, 4.540753890662064, 34.07222102310857, 40.972633350541436, 0.09999999999999853, 245.0, 1015, 968567, 1221, 53.86304569999993
1222, 5.468860235698935, 33.96536314316887, 40.862143202692224, 0.10000000000000099, 45.0, 629, 969196, 1222, 33.24509190000026
1223, 5.394842270450392, 34.10900831085117, 40.98300348441264, 0.10000000000000048, 175.0, 694, 969890, 1223, 36.19170369999847
1224, 4.563253150059013, 33.858864620539144, 40.680138979934334, 0.10000000000000099, 190.0, 635, 970525, 1224, 33.389720999999554
1225, 3.4396149411044714, 33.85525853354013, 40.72998442515222, 0.10000000000000067, 155.0, 673, 971198, 1225, 35.33118860000104
1226, 4.385120203640701, 33.799015808105466, 40.63930189787452, 0.1000000000000007, 165.0, 670, 971868, 1226, 35.21488039999895
1227, 6.132897008058279, 33.959360632345586, 40.866316044205405, 0.09999999999999931, 160.0, 857, 972725, 1227, 44.664420200002496
1228, 5.028809474396741, 33.76358317092789, 40.588666320679074, 0.09999999999999858, 545.0, 1003, 973728, 1228, 52.54104979999829
1229, 5.050643252066957, 33.732860676096074, 40.5350602171052, 0.09999999999999781, 585.0, 1221, 974949, 1229, 64.41631390000111
1230, 4.843591045280828, 33.79062109317594, 40.63848232991487, 0.0999999999999995, 260.0, 824, 975773, 1230, 43.41215419999935
1231, 4.32382791115757, 33.844955568368725, 40.67189208620545, 0.09999999999999741, 575.0, 1384, 977157, 1231, 72.66532989999905
1232, 9.717207715341281, 33.95514149909472, 40.80652861583552, 0.09999999999999952, 80.0, 822, 977979, 1232, 43.51301189999867
1233, 5.292036591851302, 33.866481006903804, 40.724183065594, 0.09999999999999976, 180.0, 786, 978765, 1233, 41.53898710000067
1234, 3.079891272757345, 33.870801534624576, 40.69259510209075, 0.10000000000000063, 170.0, 678, 979443, 1234, 35.931691599998885
1235, 5.1295358726432125, 34.04696114795414, 40.89338601480319, 0.09999999999999852, 340.0, 1016, 980459, 1235, 54.03814020000209
1236, 5.638804535459106, 34.21889035900434, 41.18614035844803, 0.10000000000000071, 45.0, 384, 980843, 1236, 20.158396199996787
1237, 3.552115578661942, 34.242220064488855, 41.150387102718554, 0.09999999999999803, 360.0, 1148, 981991, 1237, 60.546233199998824
1238, 2.6954392542441687, 34.20378264897986, 41.10020829051859, 0.10000000000000085, 150.0, 474, 982465, 1238, 25.09700420000081
1239, 4.530863135202589, 34.225769478422855, 41.15644672384851, 0.09999999999999766, 145.0, 1279, 983744, 1239, 67.4941820999993
1240, 5.721621256601291, 34.37310890308593, 41.36539176128101, 0.09999999999999949, 260.0, 826, 984570, 1240, 43.69423040000038
1241, 3.783336376074267, 34.29043818397756, 41.203031346841826, 0.10000000000000088, 140.0, 652, 985222, 1241, 34.76326799999879
1242, 3.734758227486426, 34.306579652526565, 41.245426822716084, 0.100000000000001, 75.0, 639, 985861, 1242, 34.14681399999972
1243, 6.612280001433152, 34.34794933279765, 41.34884796367302, 0.10000000000000062, 125.0, 679, 986540, 1243, 36.289473000000726
1244, 4.76760283495403, 34.21030064423879, 41.11942070060306, 0.10000000000000095, 110.0, 576, 987116, 1244, 30.839760900002148
1245, 5.287964962796095, 34.262370934605826, 41.22664013901198, 0.10000000000000091, 110.0, 519, 987635, 1245, 27.93925920000038
1246, 3.6707469869055784, 34.35713621377945, 41.301795810461044, 0.100000000000001, 180.0, 640, 988275, 1246, 33.712680000000546
1247, 4.735165236107975, 34.28757413329351, 41.24414425184085, 0.09999999999999772, 310.0, 1259, 989534, 1247, 67.16345229999934
1248, 2.890047305585412, 34.27975397955752, 41.19505920760128, 0.10000000000000085, 165.0, 654, 990188, 1248, 34.926208299999416
1249, 7.424101771427951, 34.171306554111865, 41.11444720346993, 0.10000000000000092, 70.0, 545, 990733, 1249, 29.445446500001708
1250, 5.53864529519068, 34.247444035025204, 41.24803745606366, 0.1000000000000006, 210.0, 680, 991413, 1250, 36.95341429999826
1251, 3.918652826011181, 34.19580473158095, 41.04716962687174, 0.09999999999999812, 275.0, 1125, 992538, 1251, 59.88339179999821
1252, 3.4074398114218876, 34.10789997945696, 40.947211732800376, 0.0999999999999991, 260.0, 894, 993432, 1252, 47.882042100001854
1253, 4.560686816395729, 34.19134319544461, 41.09199965653781, 0.0999999999999999, 175.0, 766, 994198, 1253, 41.700439899999765
1254, 6.453843139035969, 34.17244961240896, 41.145316705064246, 0.10000000000000055, 95.0, 686, 994884, 1254, 36.71255889999884
1255, 3.197135731151158, 34.18496199694547, 41.05003631245006, 0.0999999999999982, 370.0, 1100, 995984, 1255, 59.24436050000077
1256, 3.8991754757969277, 34.16361104247701, 41.06500351947287, 0.09999999999999835, 315.0, 1058, 997042, 1256, 56.846137000000454
1257, 5.185674698284793, 34.18916066795069, 41.080461443047, 0.09999999999999845, 475.0, 1034, 998076, 1257, 55.53087989999767
1258, 4.346106755491346, 34.345861620903015, 41.286841764450074, 0.10000000000000074, 45.0, 400, 998476, 1258, 21.810490500000014
1259, 5.223813969012566, 34.23685933135882, 41.175894691675595, 0.09999999999999797, 290.0, 1172, 999648, 1259, 63.03832749999856
