,loss,mae,mean_q,mean_eps,episode_reward,nb_episode_steps,nb_steps,episode,duration
0,0,0,0,0,260.0,795,795,0,1.8188750999999996
1, 0, 0, 0, 0, 150.0, 759, 1554, 1, 1.5355471000000005
2, 0, 0, 0, 0, 75.0, 485, 2039, 2, 0.9914085999999998
3, 0, 0, 0, 0, 60.0, 540, 2579, 3, 1.1535263999999987
4, 0, 0, 0, 0, 230.0, 993, 3572, 4, 2.1031891000000016
5, 0, 0, 0, 0, 35.0, 443, 4015, 5, 0.9413624999999968
6, 0, 0, 0, 0, 290.0, 1370, 5385, 6, 2.8191802999999993
7, 0, 0, 0, 0, 120.0, 693, 6078, 7, 1.4395877000000006
8, 0, 0, 0, 0, 35.0, 499, 6577, 8, 1.0464944000000003
9, 0, 0, 0, 0, 105.0, 585, 7162, 9, 1.2175797000000017
10, 0, 0, 0, 0, 180.0, 631, 7793, 10, 1.3067571999999998
11, 0, 0, 0, 0, 180.0, 675, 8468, 11, 1.3848648999999966
12, 0, 0, 0, 0, 75.0, 639, 9107, 12, 1.2998562999999983
13, 0, 0, 0, 0, 155.0, 646, 9753, 13, 1.3512387000000032
14, 0, 0, 0, 0, 105.0, 525, 10278, 14, 1.0797032999999985
15, 0, 0, 0, 0, 185.0, 860, 11138, 15, 1.7824151000000015
16, 0, 0, 0, 0, 40.0, 394, 11532, 16, 0.8326051999999962
17, 0, 0, 0, 0, 225.0, 1078, 12610, 17, 2.1931030000000007
18, 0, 0, 0, 0, 150.0, 555, 13165, 18, 1.134872999999999
19, 0, 0, 0, 0, 205.0, 883, 14048, 19, 1.858325899999997
20, 0, 0, 0, 0, 135.0, 592, 14640, 20, 1.2573572000000013
21, 0, 0, 0, 0, 80.0, 556, 15196, 21, 1.1466339999999988
22, 0, 0, 0, 0, 90.0, 521, 15717, 22, 1.3328168999999974
23, 0, 0, 0, 0, 210.0, 798, 16515, 23, 1.7444017000000045
24, 0, 0, 0, 0, 215.0, 703, 17218, 24, 1.4917552999999941
25, 0, 0, 0, 0, 230.0, 963, 18181, 25, 2.065818
26, 0, 0, 0, 0, 65.0, 402, 18583, 26, 0.8370961999999977
27, 0, 0, 0, 0, 110.0, 684, 19267, 27, 1.3940776999999969
28, 0, 0, 0, 0, 120.0, 674, 19941, 28, 1.3065882000000002
29, 0, 0, 0, 0, 415.0, 861, 20802, 29, 1.7298197999999942
30, 0, 0, 0, 0, 165.0, 615, 21417, 30, 1.2513396000000014
31, 0, 0, 0, 0, 170.0, 761, 22178, 31, 1.5370396
32, 0, 0, 0, 0, 155.0, 567, 22745, 32, 1.1856108999999933
33, 0, 0, 0, 0, 165.0, 958, 23703, 33, 1.9551980000000029
34, 0, 0, 0, 0, 65.0, 559, 24262, 34, 1.1439497999999944
35, 0, 0, 0, 0, 315.0, 934, 25196, 35, 1.8805630000000022
36, 0, 0, 0, 0, 210.0, 784, 25980, 36, 1.5995617999999965
37, 0, 0, 0, 0, 75.0, 383, 26363, 37, 0.7999454999999998
38, 0, 0, 0, 0, 215.0, 883, 27246, 38, 1.7771052999999952
39, 0, 0, 0, 0, 45.0, 410, 27656, 39, 0.8489227000000028
40, 0, 0, 0, 0, 55.0, 611, 28267, 40, 1.250811799999994
41, 0, 0, 0, 0, 45.0, 492, 28759, 41, 1.0082945000000052
42, 0, 0, 0, 0, 55.0, 384, 29143, 42, 0.7763556000000023
43, 0, 0, 0, 0, 135.0, 622, 29765, 43, 1.240134800000007
44, 0, 0, 0, 0, 270.0, 993, 30758, 44, 1.9707204999999988
45, 0, 0, 0, 0, 360.0, 1114, 31872, 45, 2.2011022000000082
46, 0, 0, 0, 0, 225.0, 797, 32669, 46, 1.6494104000000078
47, 0, 0, 0, 0, 45.0, 586, 33255, 47, 1.210047099999997
48, 0, 0, 0, 0, 110.0, 588, 33843, 48, 1.2714025000000078
49, 0, 0, 0, 0, 230.0, 931, 34774, 49, 1.9055034000000006
50, 0, 0, 0, 0, 35.0, 382, 35156, 50, 0.7740299000000022
51, 0, 0, 0, 0, 210.0, 668, 35824, 51, 1.3278854999999936
52, 0, 0, 0, 0, 80.0, 512, 36336, 52, 1.0715763000000038
53, 0, 0, 0, 0, 125.0, 495, 36831, 53, 1.0246057000000093
54, 0, 0, 0, 0, 180.0, 810, 37641, 54, 1.6627810000000096
55, 0, 0, 0, 0, 125.0, 608, 38249, 55, 1.2523570999999976
56, 0, 0, 0, 0, 225.0, 773, 39022, 56, 1.5718784000000028
57, 0, 0, 0, 0, 80.0, 606, 39628, 57, 1.2262965999999977
58, 0, 0, 0, 0, 255.0, 902, 40530, 58, 1.7815848999999986
59, 0, 0, 0, 0, 135.0, 700, 41230, 59, 1.4745073999999931
60, 0, 0, 0, 0, 155.0, 688, 41918, 60, 1.4127849000000055
61, 0, 0, 0, 0, 155.0, 517, 42435, 61, 1.0842892000000006
62, 0, 0, 0, 0, 200.0, 849, 43284, 62, 1.7621929999999963
63, 0, 0, 0, 0, 105.0, 645, 43929, 63, 1.411963
64, 0, 0, 0, 0, 120.0, 643, 44572, 64, 1.4251057000000031
65, 0, 0, 0, 0, 135.0, 502, 45074, 65, 1.084002599999991
66, 0, 0, 0, 0, 165.0, 722, 45796, 66, 1.5333255000000037
67, 0, 0, 0, 0, 135.0, 691, 46487, 67, 1.3738677000000052
68, 0, 0, 0, 0, 235.0, 1590, 48077, 68, 3.0447969000000086
69, 0, 0, 0, 0, 160.0, 804, 48881, 69, 1.5905995999999902
70, 0, 0, 0, 0, 180.0, 1197, 50078, 70, 2.3058909000000085
71, 0, 0, 0, 0, 105.0, 541, 50619, 71, 1.1038831000000044
72, 0, 0, 0, 0, 110.0, 689, 51308, 72, 1.3840510999999935
73, 0, 0, 0, 0, 165.0, 727, 52035, 73, 1.4192864000000043
74, 0, 0, 0, 0, 120.0, 681, 52716, 74, 1.3599124000000131
75, 0, 0, 0, 0, 445.0, 960, 53676, 75, 1.864976200000001
76, 0, 0, 0, 0, 110.0, 707, 54383, 76, 1.3965876999999978
77, 0, 0, 0, 0, 105.0, 793, 55176, 77, 1.5619419000000079
78, 0, 0, 0, 0, 210.0, 790, 55966, 78, 1.5618221000000005
79, 0, 0, 0, 0, 65.0, 526, 56492, 79, 1.0564459
80, 0, 0, 0, 0, 185.0, 958, 57450, 80, 1.8978182999999973
81, 0, 0, 0, 0, 180.0, 765, 58215, 81, 1.5199579999999884
82, 0, 0, 0, 0, 40.0, 373, 58588, 82, 0.7614686000000006
83, 0, 0, 0, 0, 180.0, 778, 59366, 83, 1.5265410000000088
84, 0, 0, 0, 0, 20.0, 489, 59855, 84, 0.980202399999996
85, 0, 0, 0, 0, 155.0, 975, 60830, 85, 1.9268146999999942
86, 0, 0, 0, 0, 210.0, 804, 61634, 86, 1.5973491999999965
87, 0, 0, 0, 0, 110.0, 697, 62331, 87, 1.3820472999999822
88, 0, 0, 0, 0, 465.0, 1088, 63419, 88, 2.1074004000000173
89, 0, 0, 0, 0, 150.0, 794, 64213, 89, 1.550095099999993
90, 0, 0, 0, 0, 135.0, 650, 64863, 90, 1.288964199999981
91, 0, 0, 0, 0, 150.0, 569, 65432, 91, 1.1496348000000012
92, 0, 0, 0, 0, 105.0, 500, 65932, 92, 1.0233226000000002
93, 0, 0, 0, 0, 75.0, 510, 66442, 93, 1.0490096999999992
94, 0, 0, 0, 0, 65.0, 389, 66831, 94, 0.7891399000000092
95, 0, 0, 0, 0, 105.0, 683, 67514, 95, 1.3843824999999867
96, 0, 0, 0, 0, 165.0, 834, 68348, 96, 1.6842589000000032
97, 0, 0, 0, 0, 65.0, 428, 68776, 97, 0.8813097999999968
98, 0, 0, 0, 0, 55.0, 404, 69180, 98, 0.8066954999999894
99, 0, 0, 0, 0, 75.0, 404, 69584, 99, 0.8006008999999779
100, 0, 0, 0, 0, 80.0, 691, 70275, 100, 1.3478814000000057
101, 0, 0, 0, 0, 80.0, 532, 70807, 101, 1.0590271000000087
102, 0, 0, 0, 0, 55.0, 484, 71291, 102, 1.0065383999999824
103, 0, 0, 0, 0, 210.0, 982, 72273, 103, 1.9265833000000043
104, 0, 0, 0, 0, 120.0, 697, 72970, 104, 1.3691599999999937
105, 0, 0, 0, 0, 35.0, 387, 73357, 105, 0.8077197000000069
106, 0, 0, 0, 0, 185.0, 741, 74098, 106, 1.4395722000000148
107, 0, 0, 0, 0, 135.0, 755, 74853, 107, 1.4999535999999978
108, 0, 0, 0, 0, 125.0, 691, 75544, 108, 1.3665741000000082
109, 0, 0, 0, 0, 345.0, 1190, 76734, 109, 2.286120899999986
110, 0, 0, 0, 0, 135.0, 662, 77396, 110, 1.307614000000001
111, 0, 0, 0, 0, 105.0, 670, 78066, 111, 1.3536075000000096
112, 0, 0, 0, 0, 285.0, 878, 78944, 112, 1.7301143999999908
113, 0, 0, 0, 0, 210.0, 775, 79719, 113, 1.512493500000005
114, 0, 0, 0, 0, 105.0, 726, 80445, 114, 1.4287298000000135
115, 0, 0, 0, 0, 75.0, 528, 80973, 115, 1.073145199999999
116, 0, 0, 0, 0, 75.0, 613, 81586, 116, 1.2293439000000035
117, 0, 0, 0, 0, 75.0, 604, 82190, 117, 1.1992604000000142
118, 0, 0, 0, 0, 120.0, 669, 82859, 118, 1.3316664000000173
119, 0, 0, 0, 0, 90.0, 707, 83566, 119, 1.4157243999999878
120, 0, 0, 0, 0, 180.0, 764, 84330, 120, 1.532127900000006
121, 0, 0, 0, 0, 105.0, 645, 84975, 121, 1.3437556000000086
122, 0, 0, 0, 0, 100.0, 700, 85675, 122, 1.3899666000000082
123, 0, 0, 0, 0, 190.0, 770, 86445, 123, 1.5182663999999875
124, 0, 0, 0, 0, 50.0, 429, 86874, 124, 0.8727261999999882
125, 0, 0, 0, 0, 105.0, 655, 87529, 125, 1.2955910999999958
126, 0, 0, 0, 0, 255.0, 759, 88288, 126, 1.5082491000000005
127, 0, 0, 0, 0, 105.0, 603, 88891, 127, 1.2161735999999905
128, 0, 0, 0, 0, 50.0, 586, 89477, 128, 1.162909500000012
129, 0, 0, 0, 0, 320.0, 1165, 90642, 129, 2.2606468999999834
130, 0, 0, 0, 0, 80.0, 391, 91033, 130, 0.7997524000000169
131, 0, 0, 0, 0, 395.0, 819, 91852, 131, 1.6027503999999908
132, 0, 0, 0, 0, 105.0, 637, 92489, 132, 1.256399999999985
133, 0, 0, 0, 0, 80.0, 689, 93178, 133, 1.382769599999989
134, 0, 0, 0, 0, 210.0, 695, 93873, 134, 1.388959099999994
135, 0, 0, 0, 0, 260.0, 993, 94866, 135, 1.9501749000000075
136, 0, 0, 0, 0, 110.0, 536, 95402, 136, 1.0889947000000006
137, 0, 0, 0, 0, 60.0, 623, 96025, 137, 1.2361125000000186
138, 0, 0, 0, 0, 80.0, 554, 96579, 138, 1.1341572000000042
139, 0, 0, 0, 0, 110.0, 632, 97211, 139, 1.2880467000000237
140, 0, 0, 0, 0, 105.0, 606, 97817, 140, 1.236202800000001
141, 0, 0, 0, 0, 50.0, 441, 98258, 141, 0.8528108999999802
142, 0, 0, 0, 0, 120.0, 629, 98887, 142, 1.2946093999999846
143, 0, 0, 0, 0, 155.0, 794, 99681, 143, 1.5705681999999968
144, 6.247116928129369, 6.818278855481138, 8.26181376004363, 0.8191045000000001, 435.0, 1314, 100995, 144, 51.704008699999974
145, 6.399988259360904, 6.8172160866147, 8.149841439383371, 0.8177374000000002, 80.0, 525, 101520, 145, 27.6390126
146, 5.387170650258827, 6.805272878767389, 8.088151614462133, 0.8167806999999999, 150.0, 538, 102058, 146, 28.188528899999994
147, 5.705218559703778, 6.813319049140279, 8.076351673412077, 0.8155998999999998, 210.0, 774, 102832, 147, 40.59433039999999
148, 5.418072677471421, 6.814840287647464, 8.070949160239913, 0.8142696999999995, 110.0, 704, 103536, 148, 37.136116800000025
149, 5.423189823747809, 6.819460938029485, 8.0514697494567, 0.8124949000000004, 135.0, 1268, 104804, 149, 67.73221869999998
150, 6.0990959634172155, 6.838268124676765, 8.056391520703093, 0.8106769000000006, 120.0, 752, 105556, 150, 41.840548100000035
151, 5.518307907374825, 6.83157694621349, 8.027538905932209, 0.8095429000000003, 95.0, 508, 106064, 151, 28.280985200000032
152, 5.2012407835667505, 6.831997548868208, 8.035391046311045, 0.8083764999999995, 180.0, 788, 106852, 152, 43.71084819999999
153, 5.365846185755909, 6.846631759987738, 8.036878060218983, 0.8070687999999998, 110.0, 665, 107517, 153, 36.2043592
154, 5.651999240558154, 6.842244119427967, 7.998888287195931, 0.8061130000000001, 100.0, 397, 107914, 154, 21.5518548
155, 5.4766089624764, 6.826160054335093, 7.987599216638393, 0.8053876000000003, 75.0, 409, 108323, 155, 22.22360679999997
156, 5.7186214193046006, 6.862059681477062, 8.057077155308585, 0.8044263999999998, 85.0, 659, 108982, 156, 36.06155100000001
157, 5.307506485479553, 6.877536394349, 8.072476960920374, 0.8028693999999995, 225.0, 1071, 110053, 157, 59.39607920000003
158, 4.132153879398272, 6.930470918720314, 8.312126211447692, 0.8013501999999998, 105.0, 617, 110670, 158, 35.294757499999946
159, 3.238797895438836, 6.900881597757949, 8.319775991122741, 0.8004430000000001, 40.0, 391, 111061, 159, 22.12336449999998
160, 3.1876171622085705, 6.899225796088263, 8.307431729277923, 0.7994494000000004, 130.0, 713, 111774, 160, 39.5674702
161, 3.2278791415882875, 6.8970201743175705, 8.310218203977408, 0.7983595000000004, 110.0, 498, 112272, 161, 27.777193299999908
162, 3.2816391686412776, 6.910807852878749, 8.305530069475976, 0.7974297999999995, 85.0, 535, 112807, 162, 31.381815300000085
163, 3.2786735464823304, 6.9078664516900306, 8.319853941857138, 0.7963929999999999, 190.0, 617, 113424, 163, 35.296384099999955
164, 3.690558924131665, 6.917189618815547, 8.320516172377602, 0.7952374000000003, 155.0, 667, 114091, 164, 38.84326729999998
165, 3.561452788886165, 6.925045600304236, 8.326794821146953, 0.7941574000000002, 85.0, 533, 114624, 165, 30.357465599999955
166, 3.1359385854851753, 6.92180139516734, 8.322615961849593, 0.7931259999999998, 70.0, 613, 115237, 166, 34.94984169999998
167, 3.2878390655403567, 6.936639187540519, 8.337981488969591, 0.7919343999999999, 145.0, 711, 115948, 167, 41.10841069999992
168, 2.8695455698423014, 6.9307135169945875, 8.324245264807951, 0.7905529000000003, 175.0, 824, 116772, 168, 47.472987900000135
169, 3.2289751236651503, 6.943506371198227, 8.35275479754375, 0.7891758999999998, 105.0, 706, 117478, 169, 40.631309699999974
170, 3.5647751517778588, 6.948933872309598, 8.355475529166293, 0.7881048999999999, 90.0, 484, 117962, 170, 28.290253099999973
171, 3.1885131004118628, 6.967020383024057, 8.36288608112822, 0.7868584000000002, 425.0, 901, 118863, 171, 53.09383509999998
172, 3.301456174076, 6.96999930331025, 8.381707700023101, 0.7852357000000006, 90.0, 902, 119765, 172, 52.66629110000008
173, 3.3952565223567817, 7.164481199742852, 8.570694008925456, 0.7835589999999998, 290.0, 961, 120726, 173, 56.43178940000007
174, 3.514885409602097, 7.223879486930613, 8.654515637426961, 0.7819885000000001, 155.0, 784, 121510, 174, 48.013304099999914
175, 3.83440365863157, 7.212269132222725, 8.669541911892471, 0.7807302999999999, 50.0, 614, 122124, 175, 36.09756149999998
176, 3.308741867806589, 7.209764404994686, 8.648590505519621, 0.7793659000000005, 240.0, 902, 123026, 176, 53.53463160000001
177, 3.2716024949714186, 7.207622144970856, 8.65003489756018, 0.7778718999999998, 210.0, 758, 123784, 177, 45.08599170000002
178, 3.0278543476114934, 7.183548566491846, 8.62324049766051, 0.7768531, 80.0, 374, 124158, 178, 22.340235899999925
179, 3.717104866642554, 7.20217860809706, 8.630745172849686, 0.7759018, 120.0, 683, 124841, 179, 40.63696579999987
180, 3.2764240624765826, 7.201647880959184, 8.626802888635087, 0.7747614999999995, 135.0, 584, 125425, 180, 35.03311070000018
181, 3.5825331358673473, 7.209851439387654, 8.646467545542855, 0.7736724999999998, 105.0, 626, 126051, 181, 38.72614909999993
182, 3.2192053684364943, 7.216403430296203, 8.654911846427595, 0.7722594999999998, 210.0, 944, 126995, 182, 57.52592159999995
183, 3.510931934107025, 7.213313346388955, 8.647667911067698, 0.7708374999999998, 60.0, 636, 127631, 183, 38.859135400000014
184, 3.8622675076374033, 7.222653659799481, 8.656582315455484, 0.7694505999999998, 155.0, 905, 128536, 184, 54.03521590000014
185, 3.182126689568544, 7.210897283065013, 8.649146608205942, 0.7682851, 45.0, 390, 128926, 185, 23.487689099999898
186, 3.503493434557366, 7.214450916127553, 8.651219429950865, 0.7670269000000002, 455.0, 1008, 129934, 186, 60.66376140000011
187, 3.3949184828400614, 7.357958685874939, 8.823648935317992, 0.7656697, 60.0, 500, 130434, 187, 30.12741720000008
188, 3.2329155121451225, 7.373746663387691, 8.86712325800245, 0.7647381999999998, 105.0, 535, 130969, 188, 33.59431840000002
189, 3.2039468894961853, 7.377758040394582, 8.857536413300206, 0.7637454999999999, 45.0, 568, 131537, 189, 36.003804700000046
190, 4.0384597957134245, 7.401975832412492, 8.899183782890661, 0.7629328, 25.0, 335, 131872, 190, 21.37189340000009
191, 2.8247479490594927, 7.376008053231083, 8.87804039007698, 0.7620804999999998, 75.0, 612, 132484, 191, 39.03937329999985
192, 3.4358674304733254, 7.388875523097858, 8.87185170313179, 0.7607853999999995, 295.0, 827, 133311, 192, 52.92297749999989
193, 3.090242356617949, 7.383392949602497, 8.874099288413774, 0.7595586999999998, 55.0, 536, 133847, 193, 34.51412190000019
194, 3.4222304812658613, 7.400301967825845, 8.886008436434738, 0.7586911000000002, 35.0, 428, 134275, 194, 27.528420500000266
195, 3.0512812099733404, 7.396347917904511, 8.882997871103866, 0.7579800999999998, 40.0, 362, 134637, 195, 23.3878337000001
196, 3.404007063043761, 7.400193321061318, 8.894590571484406, 0.7569541000000001, 220.0, 778, 135415, 196, 50.40346079999972
197, 3.106781847223671, 7.397416853753508, 8.879718069798347, 0.7554024999999999, 335.0, 946, 136361, 197, 61.785328500000105
198, 2.907285178162023, 7.3943528248050105, 8.883943367990105, 0.7538545, 180.0, 774, 137135, 198, 50.47189530000014
199, 3.0170770829219764, 7.398152910406433, 8.898250460285068, 0.7525260999999999, 160.0, 702, 137837, 199, 45.97868219999964
200, 3.5942021948362584, 7.411017125482717, 8.904921918942783, 0.7512426999999999, 155.0, 724, 138561, 200, 47.5616243999998
201, 3.2221659221586876, 7.410229078664349, 8.90198690477856, 0.7498332999999998, 215.0, 842, 139403, 201, 55.548700499999995
202, 3.9006729932427406, 7.420036336898804, 8.903260208129883, 0.7486255, 135.0, 500, 139903, 202, 33.06253629999992
203, 2.6395855860504427, 7.368196497976252, 8.821807519524498, 0.7475653000000003, 155.0, 678, 140581, 203, 45.02132799999981
204, 2.63953045091913, 7.366065343615435, 8.828166147615418, 0.7465923999999997, 155.0, 403, 140984, 204, 26.990949399999863
205, 2.444809201468121, 7.366426401138305, 8.828633717623624, 0.7457347, 180.0, 550, 141534, 205, 36.7356906
206, 2.851855955829235, 7.359199635513729, 8.819553089947119, 0.7444936000000001, 215.0, 829, 142363, 206, 55.43032549999998
207, 2.8246524264063457, 7.369569438748655, 8.82935646888429, 0.7429339000000006, 160.0, 904, 143267, 207, 60.62723159999996
208, 2.7654967502734373, 7.35446276887555, 8.814243307737547, 0.7416387999999999, 35.0, 535, 143802, 208, 36.04736180000009
209, 3.000395377178987, 7.3813973267873125, 8.841207982699077, 0.7406173000000003, 145.0, 600, 144402, 209, 40.55352210000001
210, 2.2981538081389306, 7.38408043894101, 8.843330889075286, 0.7397362, 45.0, 379, 144781, 210, 25.81301530000019
211, 3.0546894248586978, 7.382740023825018, 8.845851965800776, 0.7385571999999998, 235.0, 931, 145712, 211, 63.16891069999974
212, 2.9288756642043214, 7.378199497758212, 8.84021924569845, 0.7370074000000001, 205.0, 791, 146503, 212, 54.085669900000084
213, 3.1360991358570365, 7.370888998712528, 8.839644302654863, 0.7354332999999995, 305.0, 958, 147461, 213, 65.5808121
214, 3.1970394293467206, 7.387998809569921, 8.855916331364558, 0.7342200999999999, 70.0, 390, 147851, 214, 26.939722699999948
215, 3.410460054058934, 7.399450678137405, 8.864937241397687, 0.7335073000000001, 20.0, 402, 148253, 215, 27.745890500000314
216, 2.8749868000245447, 7.398688641958713, 8.856636711460377, 0.7324785999999996, 210.0, 741, 148994, 216, 51.31764220000014
217, 2.5526453972018825, 7.3920063533083935, 8.855212179653307, 0.7309521999999999, 270.0, 955, 149949, 217, 66.39248850000013
218, 2.638505671582921, 7.529302238377809, 9.019436651499484, 0.729577, 105.0, 573, 150522, 218, 39.97654550000016
219, 2.6532640426662497, 7.551673393438358, 9.057292149798705, 0.7285158999999998, 110.0, 606, 151128, 219, 42.55943840000009
220, 2.834505100742447, 7.549526908242331, 9.046905351428068, 0.7273350999999998, 105.0, 706, 151834, 220, 49.59949460000007
221, 2.949638758449007, 7.547669883831929, 9.04102893933248, 0.7262371, 85.0, 514, 152348, 221, 36.22946899999988
222, 2.8969249833276893, 7.55183906079737, 9.042528734179186, 0.7254676000000001, 55.0, 341, 152689, 222, 24.153726600000027
223, 2.7315902558752594, 7.563176078936977, 9.072606883412204, 0.7247944000000001, 55.0, 407, 153096, 223, 28.957591700000194
224, 3.25950474650916, 7.580503930596157, 9.094410878825562, 0.7240843, 90.0, 382, 153478, 224, 27.195322999999917
225, 3.1749658630839708, 7.55803939039484, 9.066227703846147, 0.7233751000000002, 50.0, 406, 153884, 225, 28.781551000000036
226, 2.2882820031006044, 7.54688909282423, 9.045829505136568, 0.7226155, 50.0, 438, 154322, 226, 31.3195111
227, 3.065384709557212, 7.568732960767251, 9.071206432533767, 0.7211979999999992, 285.0, 1137, 155459, 227, 81.04730410000002
228, 2.999362697242578, 7.587554554175441, 9.092910557475468, 0.7195960000000003, 180.0, 643, 156102, 228, 46.08249419999993
229, 2.524835822694614, 7.586706918184874, 9.097554669614698, 0.7184682999999997, 180.0, 610, 156712, 229, 43.80860960000018
230, 2.382394205639779, 7.575324949440647, 9.07840265974783, 0.7174611999999999, 90.0, 509, 157221, 230, 36.703745000000254
231, 3.02794026275194, 7.585734637916511, 9.093968134399846, 0.7166224000000001, 95.0, 423, 157644, 231, 30.538568899999973
232, 2.764328961942426, 7.583212462541099, 9.090250206884937, 0.7156638999999998, 125.0, 642, 158286, 232, 46.459635400000025
233, 3.078897654098913, 7.591085329134602, 9.10163289377512, 0.7145415999999999, 165.0, 605, 158891, 233, 43.99404380000033
234, 2.4164883296574113, 7.587025378356239, 9.098229520390218, 0.7132851999999998, 65.0, 791, 159682, 234, 57.62982039999997
235, 2.9250533372413687, 7.889395469389622, 9.465825098865437, 0.7117147000000001, 395.0, 954, 160636, 235, 69.66635639999959
236, 2.4932752578085617, 8.0210937555813, 9.622865975358105, 0.7105024, 5.0, 393, 161029, 236, 28.886351999999988
237, 2.662892893942322, 8.026286777736633, 9.6348871471375, 0.7095772000000002, 180.0, 635, 161664, 237, 46.85329249999995
238, 2.9332456695053097, 8.02885449762662, 9.624974180542978, 0.7081137999999999, 315.0, 991, 162655, 238, 73.15493659999947
239, 2.8364261971084797, 8.02618029841558, 9.62783957513224, 0.7066558000000002, 85.0, 629, 163284, 239, 46.81460920000063
240, 2.940630106307283, 8.030459703373003, 9.633514488799662, 0.7057342000000001, 30.0, 395, 163679, 240, 29.42633190000015
241, 2.6151560438973696, 8.02362398797421, 9.624039680967096, 0.7046865999999999, 215.0, 769, 164448, 241, 57.43226340000001
242, 2.803111589638426, 8.027218975572504, 9.624197972126495, 0.7033626999999998, 170.0, 702, 165150, 242, 52.5280115000005
243, 3.0358382686116228, 8.028292731581063, 9.63402818263262, 0.7023394, 5.0, 435, 165585, 243, 32.88293580000027
244, 2.5999365576253033, 8.026212905416426, 9.629380701393481, 0.7014043000000001, 120.0, 604, 166189, 244, 45.60420369999974
245, 2.5382022754180418, 8.030131675465576, 9.628228388334575, 0.7001596, 290.0, 779, 166968, 245, 58.91403730000002
246, 2.3924669869568036, 8.037386110395094, 9.64051360031434, 0.6989202999999996, 30.0, 598, 167566, 246, 45.448263999999654
247, 2.744691054087138, 8.03896096873612, 9.636046837518993, 0.6977944, 75.0, 653, 168219, 247, 49.858882800000174
248, 2.719424888468456, 8.037579617270415, 9.645821922859916, 0.696628, 115.0, 643, 168862, 248, 49.1869329000001
249, 2.7765887532875224, 8.041505128332654, 9.645445562758535, 0.6954769000000002, 210.0, 636, 169498, 249, 48.791871999999785
250, 2.6352641682921267, 8.142650076291263, 9.764330221186205, 0.6938803, 325.0, 1138, 170636, 250, 87.39974579999944
251, 2.659060184531156, 8.219527776060552, 9.871870933456972, 0.6918589000000002, 330.0, 1108, 171744, 251, 85.61306400000012
252, 2.665024151630828, 8.21186081992588, 9.858861703139086, 0.6902883999999998, 125.0, 637, 172381, 252, 49.28450519999933
253, 2.3880289132361647, 8.218044017578338, 9.863057023161774, 0.6890715999999997, 100.0, 715, 173096, 253, 55.64235010000084
254, 2.4610512585384896, 8.214441425961219, 9.863241703232374, 0.6872544999999997, 230.0, 1304, 174400, 254, 102.00803209999958
255, 2.6105995684520704, 8.220137183287726, 9.866082625381296, 0.6855310000000001, 55.0, 611, 175011, 255, 48.146696599999814
256, 2.5926773215296195, 8.235279813649452, 9.87397350253792, 0.6841450000000004, 210.0, 929, 175940, 256, 73.44570490000024
257, 2.4807065147767537, 8.220648506239279, 9.857584998678805, 0.6823440999999998, 300.0, 1072, 177012, 257, 85.91934539999966
258, 2.6525207899161933, 8.237245869702216, 9.876800689487089, 0.6810526, 40.0, 363, 177375, 258, 29.058735600000546
259, 2.7624996323835225, 8.234113173591822, 9.898102096785928, 0.6803650000000002, 75.0, 401, 177776, 259, 32.12583859999995
260, 2.3752683626315565, 8.230233543622347, 9.881300157277371, 0.6794884, 90.0, 573, 178349, 260, 46.122723999999835
261, 2.8222602158023307, 8.246522997672553, 9.896555151606337, 0.6784444, 65.0, 587, 178936, 261, 49.71393840000019
262, 3.0001721905547143, 8.261467409765949, 9.906781942398453, 0.6773050000000004, 155.0, 679, 179615, 262, 55.08083210000041
263, 2.518155817695962, 8.266972645018637, 9.918122880174893, 0.6757417000000002, 230.0, 1058, 180673, 263, 85.76788119999947
264, 2.7170952890943916, 8.282694077790199, 9.935442009290501, 0.6741424, 190.0, 719, 181392, 264, 58.585346500000014
265, 2.3005849112780825, 8.28619190694864, 9.952421716865361, 0.6728392, 165.0, 729, 182121, 265, 59.52865099999963
266, 2.0375614690768464, 8.285223885868373, 9.945208051718536, 0.6713020000000001, 310.0, 979, 183100, 266, 80.06562020000001
267, 2.4185513199481647, 8.285703557543457, 9.948135508224368, 0.6699601, 180.0, 512, 183612, 267, 42.14977220000037
268, 2.7517296085013196, 8.307213182573195, 9.980163679494487, 0.6686677000000001, 215.0, 924, 184536, 268, 76.31173069999932
269, 2.258479413037555, 8.300322074364612, 9.95781212842252, 0.6672808000000001, 135.0, 617, 185153, 269, 51.129689000000326
270, 1.9877813670051823, 8.293526230640762, 9.949133283515293, 0.6660892000000003, 120.0, 707, 185860, 270, 52.90462360000038
271, 2.4588152765432993, 8.310627911885579, 9.98455324045817, 0.6651153999999998, 30.0, 375, 186235, 271, 28.27504769999996
272, 2.381274293641734, 8.306085864896696, 9.960108012687868, 0.6642243999999998, 65.0, 615, 186850, 272, 46.16152449999936
273, 2.223116493815608, 8.304157563407355, 9.96473336441229, 0.6630895000000001, 140.0, 646, 187496, 273, 48.682269500000075
274, 2.488190851699222, 8.31103327243359, 9.973900346632128, 0.6621615999999999, 20.0, 385, 187881, 274, 29.164191599999867
275, 2.626957631141478, 8.301414680238292, 9.971391406071398, 0.6614614000000001, 30.0, 393, 188274, 275, 29.847678299999643
276, 2.0674708466024074, 8.303295672597473, 9.970720606797197, 0.6602104, 215.0, 997, 189271, 276, 75.76344249999966
277, 2.0332469127108994, 8.318109185211263, 9.97814233070313, 0.6589719999999999, 100.0, 379, 189650, 277, 29.063135299999885
278, 2.3927129150385795, 8.464618220515604, 10.160061514670874, 0.6580089999999998, 310.0, 691, 190341, 278, 53.0076310000004
279, 3.003544817547413, 8.615612544554615, 10.350167807025189, 0.6568632999999997, 160.0, 582, 190923, 279, 44.81405189999987
280, 2.4671422216534054, 8.61351531660053, 10.356674666695751, 0.6559560999999999, 80.0, 426, 191349, 280, 32.83470440000019
281, 2.6723088171266154, 8.621933675811675, 10.363284707783224, 0.6549715000000004, 110.0, 668, 192017, 281, 51.50176099999953
282, 2.842798701118833, 8.62856854746739, 10.367492090910673, 0.6536791, 175.0, 768, 192785, 282, 59.35731920000035
283, 2.1514593917891323, 8.624935108351993, 10.354614858133385, 0.6525360999999996, 135.0, 502, 193287, 283, 39.00977640000019
284, 2.361700015374262, 8.623503147303962, 10.359330713460057, 0.6515272, 110.0, 619, 193906, 284, 48.3915648000002
285, 1.9287006231084947, 8.616965715346797, 10.35274781104057, 0.6504121, 85.0, 620, 194526, 285, 48.35127680000005
286, 3.2072121978254247, 8.635809385686889, 10.373126119599306, 0.6493753000000004, 65.0, 532, 195058, 286, 41.53937190000033
287, 1.98400444068426, 8.61437642618191, 10.35018963140944, 0.6481629999999997, 230.0, 815, 195873, 287, 63.865941300000486
288, 2.4093153545935255, 8.631806828190216, 10.359022423176075, 0.6465034, 155.0, 1029, 196902, 288, 81.16288840000016
289, 2.4692987668163635, 8.632082705778235, 10.36832572039436, 0.6451948000000001, 60.0, 425, 197327, 289, 33.639863700000205
290, 2.241368128277827, 8.630024017766118, 10.359100373461843, 0.6443515, 105.0, 512, 197839, 290, 40.7329878999999
291, 2.8137978520661653, 8.654245019201834, 10.393114963034263, 0.6430068999999998, 360.0, 982, 198821, 291, 77.98619099999996
292, 2.8877605337345362, 8.650044570534916, 10.390624878035489, 0.641539, 100.0, 649, 199470, 292, 51.82230530000015
293, 2.469174912171156, 8.650006335793119, 10.380279111139702, 0.6404797000000001, 80.0, 528, 199998, 293, 42.28909420000036
294, 2.4802435887742926, 8.730503492002134, 10.482841118706597, 0.6393970000000001, 115.0, 675, 200673, 294, 54.039662600000156
295, 2.4958380840682284, 8.735851295620543, 10.502301021656827, 0.6382378, 145.0, 613, 201286, 295, 49.220986500000436
296, 2.3024300863492537, 8.738604632874356, 10.491016775570198, 0.6370173999999997, 135.0, 743, 202029, 296, 59.70279399999981
297, 2.551049022687186, 8.746809600056082, 10.50880844537231, 0.6355414, 285.0, 897, 202926, 297, 72.00988589999997
298, 2.902531681735726, 8.753674052743351, 10.515914392471313, 0.6344280999999998, 30.0, 340, 203266, 298, 27.483619499999804
299, 2.616913509167982, 8.75870734922002, 10.524073989203806, 0.6338017, 35.0, 356, 203622, 299, 28.686037399999805
300, 2.4604718317575704, 8.753721939575119, 10.50970340522948, 0.6327639999999999, 265.0, 797, 204419, 300, 64.04597600000034
301, 2.387647762588119, 8.749919963788383, 10.505772558948662, 0.6314778999999996, 105.0, 632, 205051, 301, 50.8098274999993
302, 2.2341440448845464, 8.759445460762565, 10.51362692014439, 0.6303375999999998, 145.0, 635, 205686, 302, 51.016460599999846
303, 2.22178869963323, 8.751884391825035, 10.51243451133607, 0.6289155999999998, 365.0, 945, 206631, 303, 76.1336025999999
304, 2.7878673435810724, 8.771524319042989, 10.532955438384016, 0.6275124999999999, 125.0, 614, 207245, 304, 49.35087070000009
305, 2.8682867233029765, 8.77083771686286, 10.546323596222352, 0.626383, 135.0, 641, 207886, 305, 51.596198999999615
306, 2.813001233187343, 8.76631732432768, 10.529803995595325, 0.6248530000000004, 325.0, 1059, 208945, 306, 84.96395839999968
307, 2.832928774944906, 8.774620991945266, 10.53906307390758, 0.6228918999999995, 175.0, 1120, 210065, 307, 89.7795274
308, 2.5370786337325204, 8.870876293915968, 10.669354110497695, 0.6214158999999999, 95.0, 520, 210585, 308, 41.79476279999926
309, 3.3334193081358916, 8.88235542748245, 10.67284753867664, 0.6203691999999998, 230.0, 643, 211228, 309, 51.63489539999955
310, 2.575012386774633, 8.888892883745957, 10.665804335289078, 0.6193432, 65.0, 497, 211725, 310, 39.85616720000053
311, 2.969367129872348, 8.879956092024067, 10.674060840346202, 0.6183028000000004, 70.0, 659, 212384, 311, 52.90606879999996
312, 2.5593721344616838, 8.880331019260371, 10.667015893941919, 0.6171138999999999, 185.0, 662, 213046, 312, 53.1035054999993
313, 2.7412314939295777, 8.875427825001482, 10.658071009114908, 0.6156730000000001, 280.0, 939, 213985, 313, 75.08930770000006
314, 2.46601287286262, 8.881027636831545, 10.667317229864288, 0.6143895999999998, 45.0, 487, 214472, 314, 38.96564229999967
315, 2.5375878857950953, 8.88440693618704, 10.683087345999084, 0.6133671999999998, 135.0, 649, 215121, 315, 51.93803839999964
316, 2.5492508132373337, 8.881054354979929, 10.672996683036331, 0.6117660999999995, 290.0, 1130, 216251, 316, 90.42852630000016
317, 2.7534230254803385, 8.908248999459403, 10.704134108679636, 0.6101191000000001, 175.0, 700, 216951, 317, 56.15718900000138
318, 2.8169738412950855, 8.908699263791108, 10.702001741413627, 0.6086952999999997, 265.0, 882, 217833, 318, 70.55350499999986
319, 2.674645173287741, 8.898407297350278, 10.693168675693151, 0.6072255999999999, 260.0, 751, 218584, 319, 60.08879270000034
320, 2.246327336954027, 8.893228999240943, 10.681095579906625, 0.6058917999999998, 180.0, 731, 219315, 320, 58.454223799999454
321, 2.1794653630845593, 8.898659902699356, 10.69051830772647, 0.6047055999999996, 110.0, 587, 219902, 321, 46.9793738999997
322, 2.182706818838166, 9.165761626098433, 11.013296277160146, 0.6036273999999999, 65.0, 611, 220513, 322, 48.97552209999958
323, 2.633962570851345, 9.21295458042693, 11.085021813472588, 0.6018751000000003, 390.0, 1336, 221849, 323, 106.70633129999987
324, 2.3598004364657346, 9.205170049734996, 11.064039548238119, 0.600292, 110.0, 423, 222272, 324, 33.92971839999882
325, 2.6083735240491355, 9.210865829873272, 11.061986423852876, 0.5994541000000001, 65.0, 508, 222780, 325, 40.73565559999952
326, 2.758223532479702, 9.218943883093168, 11.070558884889463, 0.5985307000000001, 190.0, 518, 223298, 326, 41.60474819999945
327, 2.561431319432488, 9.199278554541575, 11.056546536074976, 0.5976523, 50.0, 458, 223756, 327, 36.69886940000106
328, 2.4326667314687134, 9.205373337928284, 11.068729618301244, 0.5967748000000002, 110.0, 517, 224273, 328, 41.52087390000088
329, 2.799838669469474, 9.207139713039119, 11.062395969710026, 0.5956318000000002, 155.0, 753, 225026, 329, 60.38165209999897
330, 3.0652377176885457, 9.223485146998128, 11.087146972192967, 0.5942575000000001, 205.0, 774, 225800, 330, 61.96792579999965
331, 2.684144588784921, 9.222060259913862, 11.085076893024551, 0.5926015, 170.0, 1066, 226866, 331, 85.4601118999999
332, 2.764900638662242, 9.227975390423303, 11.093546362346029, 0.5905459000000001, 530.0, 1218, 228084, 332, 97.3416232999989
333, 2.5732208967695653, 9.224120558930828, 11.083131402460504, 0.5889538000000002, 65.0, 551, 228635, 333, 44.16608150000138
334, 2.602287096419514, 9.226814681304797, 11.08756915428686, 0.5876460999999998, 115.0, 902, 229537, 334, 72.18787079999856
335, 3.3866206123218494, 9.245538868058954, 11.099173698174875, 0.586423, 105.0, 457, 229994, 335, 36.85973430000013
336, 2.9346347798217094, 9.357034267185288, 11.24581726208993, 0.5854258, 315.0, 651, 230645, 336, 52.4469468999996
337, 2.581797134308588, 9.362229794373006, 11.252428416949634, 0.5841027999999999, 245.0, 819, 231464, 337, 65.5421237999999
338, 3.0681177396266186, 9.369387046626358, 11.266401142370505, 0.5828167, 90.0, 610, 232074, 338, 48.77163110000038
339, 2.8861224416365543, 9.378951100272493, 11.2763727498744, 0.5816764000000002, 210.0, 657, 232731, 339, 52.61099060000015
340, 2.804990584675395, 9.387180834866026, 11.269395411489873, 0.5805208000000001, 100.0, 627, 233358, 340, 50.0646085999997
341, 2.6974663722413865, 9.3921967048807, 11.29229176778449, 0.5791087000000001, 315.0, 942, 234300, 341, 75.29803410000022
342, 2.622036866867278, 9.395447153079358, 11.280178095720991, 0.5776921, 130.0, 632, 234932, 342, 50.73210179999842
343, 2.2923546945602875, 9.384107090356782, 11.27924621574522, 0.5766660999999998, 70.0, 508, 235440, 343, 40.654394299999694
344, 2.644859855460995, 9.401583729393662, 11.295035939644007, 0.5751846999999994, 330.0, 1138, 236578, 344, 90.86632920000011
345, 2.4203999248196775, 9.383315247374696, 11.268686686464497, 0.5731903, 290.0, 1078, 237656, 345, 86.16966090000096
346, 2.6888718107494256, 9.3919719907646, 11.28597346659985, 0.571636, 65.0, 649, 238305, 346, 51.85448109999925
347, 2.5535162507541598, 9.384764901143305, 11.281965191058093, 0.5704282000000003, 195.0, 693, 238998, 347, 55.5188466999989
348, 2.503691636761987, 9.407964303120073, 11.295025739325098, 0.5690575000000001, 150.0, 830, 239828, 348, 66.45067709999967
349, 3.0915229695026207, 9.607955445688237, 11.537019222501725, 0.5679703000000002, 35.0, 378, 240206, 349, 30.316915100000188
350, 2.4418718998870217, 9.785387702735074, 11.759594912988593, 0.5670324999999998, 160.0, 664, 240870, 350, 53.18606030000046
351, 2.821671850409494, 9.802128709752974, 11.77708410532935, 0.5654934999999999, 355.0, 1046, 241916, 351, 83.46647770000163
352, 2.926680241665129, 9.811635465253124, 11.795016099076244, 0.5635746999999997, 455.0, 1086, 243002, 352, 87.09686489999876
353, 2.9694024302560362, 9.824944771806981, 11.813553609346089, 0.5615541999999999, 320.0, 1159, 244161, 353, 92.68346759999986
354, 3.083866853059445, 9.835497079540627, 11.838044745852523, 0.5601718, 20.0, 377, 244538, 354, 30.299141999999847
355, 2.548389775673939, 9.822970355172123, 11.827024944877156, 0.5594662, 45.0, 407, 244945, 355, 32.64164230000097
356, 2.7804701445419666, 9.829834047769536, 11.818879002091512, 0.5584770999999997, 85.0, 692, 245637, 356, 55.494882699998925
357, 2.9840448392289027, 9.82798207461179, 11.812064351616325, 0.5575267000000002, 30.0, 364, 246001, 357, 29.216434099998878
358, 2.7392458192703435, 9.84213494185375, 11.828085783885733, 0.5567976999999998, 45.0, 446, 246447, 358, 35.800262900000234
359, 2.4520380430976334, 9.827657090580981, 11.810358565786611, 0.5560651000000001, 105.0, 368, 246815, 359, 29.609751300000426
360, 2.626867532923853, 9.828120794138446, 11.809740975111653, 0.5549725000000002, 200.0, 846, 247661, 360, 67.8522185999991
361, 2.8529316102195463, 9.85006881684296, 11.838189440488199, 0.5535145000000002, 190.0, 774, 248435, 361, 62.17866150000009
362, 2.392841048097268, 9.847538059446928, 11.821810244657835, 0.5523166000000003, 90.0, 557, 248992, 362, 44.82804260000012
363, 2.47332282918348, 9.855805201748494, 11.847438692809574, 0.5513625999999999, 70.0, 503, 249495, 363, 40.432658300000185
364, 2.855700344245576, 9.883260666949194, 11.888351347461436, 0.5503374999999998, 135.0, 636, 250131, 364, 51.23242390000087
365, 2.7937007071168134, 10.055388988870563, 12.088702256029302, 0.5492899, 35.0, 528, 250659, 365, 42.549718700000085
366, 2.629586956451046, 10.052276335264507, 12.090606727562918, 0.5478913000000001, 495.0, 1026, 251685, 366, 82.60986380000031
367, 3.2576845742355696, 10.068123424414432, 12.111524981874409, 0.5462254, 440.0, 825, 252510, 367, 66.36636010000075
368, 2.5334917820162244, 10.077375391971918, 12.127388752831353, 0.5447539, 195.0, 810, 253320, 368, 65.08106909999879
369, 2.410687452122601, 10.084388767478309, 12.11197731693162, 0.5436027999999999, 120.0, 469, 253789, 369, 37.70773030000055
370, 2.531707402313356, 10.091069977575069, 12.13434943741174, 0.5425552000000002, 110.0, 695, 254484, 370, 55.82094450000113
371, 2.5433491667265495, 10.079841032116775, 12.11667185006865, 0.5413482999999996, 120.0, 646, 255130, 371, 51.8700618999992
372, 3.132052978344885, 10.088801698380733, 12.137492730798, 0.5398632999999999, 505.0, 1004, 256134, 372, 80.71096039999975
373, 2.9358288566864545, 10.097249583343961, 12.146218869223523, 0.5380552000000003, 320.0, 1005, 257139, 373, 80.93216100000063
374, 2.305502692530603, 10.092754047735895, 12.12481133869255, 0.5366188, 35.0, 591, 257730, 374, 47.76165420000143
375, 2.497157669138341, 10.101960749853225, 12.151304160656572, 0.5355577, 90.0, 588, 258318, 375, 47.32665880000059
376, 2.7623647497791164, 10.101014915502295, 12.14998739845348, 0.5346468999999999, 35.0, 424, 258742, 376, 34.17009580000013
377, 2.66101622345244, 10.10343748714337, 12.152089091468016, 0.5334534999999998, 220.0, 902, 259644, 377, 72.68865960000039
378, 2.844474441710664, 10.061447366240062, 12.098162205691265, 0.5321097999999999, 125.0, 591, 260235, 378, 47.69706059999953
379, 2.813127316047798, 9.967523778503265, 11.989946831410853, 0.5308615000000001, 230.0, 796, 261031, 379, 64.26285970000026
380, 3.0065765484961204, 9.997060995132397, 12.022073129241585, 0.5292999999999999, 240.0, 939, 261970, 380, 75.76001630000064
381, 2.3897426843719085, 9.990634748203037, 12.002638767449682, 0.5273946999999995, 415.0, 1178, 263148, 381, 95.0349540999996
382, 2.854712729270642, 10.00196075186489, 12.036754109815197, 0.5259951999999999, 85.0, 377, 263525, 382, 30.591784300000654
383, 3.096383577182745, 10.001224852068248, 12.026249100540996, 0.5253759999999997, 35.0, 311, 263836, 383, 25.307510399999956
384, 2.873135478501339, 10.00319645331407, 12.027947404138853, 0.5244237999999999, 150.0, 747, 264583, 384, 60.3680289999993
385, 2.6838803295242157, 10.001375590948234, 12.016262920279251, 0.5232726999999998, 125.0, 532, 265115, 385, 43.09801989999869
386, 2.8139796902949206, 10.00841345261777, 12.048187882091867, 0.5221647999999999, 175.0, 699, 265814, 386, 56.46985440000026
387, 2.912272845170688, 10.016039544280279, 12.045598121774717, 0.5204404000000001, 365.0, 1217, 267031, 387, 97.99309820000053
388, 2.717479453423624, 10.012966958133214, 12.035777131780193, 0.5187843999999998, 150.0, 623, 267654, 388, 50.29250450000109
389, 2.7203023656073846, 10.010938344579754, 12.02673740459211, 0.5177484999999998, 55.0, 528, 268182, 389, 42.612712199999805
390, 3.4265114377389647, 10.038451194763184, 12.079008099175958, 0.5162139999999995, 235.0, 1177, 269359, 390, 94.63026509999872
391, 3.591362738532239, 10.053351420780707, 12.076955930940036, 0.5147370999999998, 45.0, 464, 269823, 391, 37.42157319999933
392, 2.4509358268910186, 10.237098909937004, 12.300744363068334, 0.5134257999999998, 365.0, 993, 270816, 392, 79.53413209999962
393, 2.9883251484669304, 10.288533845027098, 12.36169473688846, 0.5121532, 115.0, 421, 271237, 393, 33.745064799999454
394, 2.373521762151344, 10.275201244514529, 12.330949305152359, 0.5114529999999999, 70.0, 357, 271594, 394, 28.66028650000044
395, 2.870040053929541, 10.291238744351553, 12.386902905184472, 0.5106222999999999, 110.0, 566, 272160, 395, 45.22634939999989
396, 2.388329162041127, 10.285668657629529, 12.35510076080238, 0.5097870999999998, 75.0, 362, 272522, 396, 28.962341399999787
397, 3.19365448498768, 10.299968801129738, 12.377340303304862, 0.5084416, 290.0, 1133, 273655, 397, 91.07559080000101
398, 3.10482544899901, 10.300371882374302, 12.393633026286869, 0.5068351, 130.0, 652, 274307, 398, 52.289283400001295
399, 2.8758672156877685, 10.30806955292252, 12.384877684192638, 0.5053761999999999, 295.0, 969, 275276, 399, 77.6526716999997
400, 2.66936986782028, 10.30832274332395, 12.403563558065217, 0.5039623, 80.0, 602, 275878, 400, 47.945737399999416
401, 2.2078746683942057, 10.305129055173877, 12.377102403779535, 0.5029875999999999, 70.0, 481, 276359, 401, 38.40697900000123
402, 2.804491433708822, 10.32013002082483, 12.403707249247613, 0.5018311, 175.0, 804, 277163, 402, 64.26943900000151
403, 3.0211955936259876, 10.333975566939495, 12.417691474635852, 0.5005162, 155.0, 657, 277820, 403, 52.47284679999939
404, 3.173630579886958, 10.339356484264135, 12.419064300507307, 0.4987729000000001, 395.0, 1280, 279100, 404, 102.1460418000006
405, 2.504889366159938, 10.327599016987548, 12.40739327060933, 0.4972680999999999, 45.0, 392, 279492, 405, 31.308701999998448
406, 2.792379625351075, 10.315177141901959, 12.401768222870118, 0.49646709999999994, 55.0, 498, 279990, 406, 39.90985089999958
407, 2.2936890134735712, 10.479813096384524, 12.61310731040107, 0.49567869999999997, 55.0, 378, 280368, 407, 30.187873099999706
408, 2.777276315305876, 10.512925985341399, 12.622503898022755, 0.4943278000000001, 405.0, 1123, 281491, 408, 89.59585619999962
409, 3.433230910240934, 10.531621686528238, 12.66410756379031, 0.49203550000000007, 555.0, 1424, 282915, 409, 113.57395700000052
410, 3.5022221901505617, 10.530426610272457, 12.653605942279551, 0.4898601999999998, 230.0, 993, 283908, 410, 79.3003891999997
411, 3.4318345372107273, 10.541543112049425, 12.673339294620531, 0.48837880000000006, 110.0, 653, 284561, 411, 52.21202110000013
412, 2.8585103143949877, 10.54278863653093, 12.665666667518016, 0.4871619999999999, 175.0, 699, 285260, 412, 61.003045100000236
413, 3.291481090613774, 10.547917905535018, 12.658268690563384, 0.4860603999999999, 180.0, 525, 285785, 413, 42.74230390000048
414, 3.094267692491412, 10.542105913162231, 12.659599585533142, 0.4850479, 65.0, 600, 286385, 414, 50.360265499999514
415, 3.4136831009392465, 10.557244144773412, 12.687513257223737, 0.4833144999999999, 575.0, 1326, 287711, 415, 109.21782119999989
416, 3.239377964787023, 10.553545760217114, 12.690478256558333, 0.48154329999999995, 130.0, 642, 288353, 416, 53.90581569999995
417, 3.5018163294391296, 10.572170637350167, 12.707587552984908, 0.48035529999999993, 150.0, 678, 289031, 417, 57.0462682999987
418, 3.3582442258813567, 10.550989668608597, 12.669977473503595, 0.47926090000000005, 80.0, 538, 289569, 418, 47.51352109999971
419, 3.2317736900236858, 10.61760067363603, 12.759734301901796, 0.4779946, 240.0, 869, 290438, 419, 74.43439849999959
420, 3.618525570996726, 10.681341269456786, 12.847595068228093, 0.4765743999999999, 165.0, 709, 291147, 420, 64.45854350000081
421, 2.9237978297360936, 10.67907689880669, 12.827107859377112, 0.47492199999999996, 300.0, 1127, 292274, 421, 101.74920380000003
422, 3.3497864854444526, 10.687561893136907, 12.85228405412002, 0.4731184, 400.0, 877, 293151, 422, 77.99655019999955
423, 3.234990127767321, 10.689121334214224, 12.848543678525711, 0.47113749999999943, 280.0, 1324, 294475, 423, 119.4342357000005
424, 3.0748887989319673, 10.701942839228947, 12.862557044184825, 0.46900810000000015, 230.0, 1042, 295517, 424, 90.16646620000029
425, 3.125591727926557, 10.70761712732162, 12.866329774499578, 0.46756539999999985, 45.0, 561, 296078, 425, 47.929653499999404
426, 3.057263045725308, 10.707848456123687, 12.871123735873583, 0.46630180000000004, 445.0, 843, 296921, 426, 74.76862380000057
427, 2.967303178005102, 10.718389212445516, 12.870825724718047, 0.4646205999999999, 270.0, 1025, 297946, 427, 86.73415999999997
428, 3.438946431177728, 10.743497662645705, 12.91757889199764, 0.46264059999999974, 515.0, 1175, 299121, 428, 95.47602459999871
429, 3.352132581764302, 10.760795326176977, 12.933442561857161, 0.4609693000000001, 160.0, 682, 299803, 429, 55.2968192999997
430, 2.9031633146766094, 10.852052448558158, 13.026688042681775, 0.4595617000000001, 135.0, 882, 300685, 430, 71.54960779999965
431, 2.804807491074177, 10.893577705934247, 13.081540609266918, 0.4581946000000002, 110.0, 637, 301322, 431, 55.467323199998646
432, 3.1205183354572013, 10.8946363152398, 13.085277752346462, 0.45701379999999997, 90.0, 675, 301997, 432, 58.86283579999872
433, 3.681819116183036, 10.908575819550657, 13.117012338386736, 0.4556557, 200.0, 834, 302831, 433, 72.70539129999997
434, 3.2887879703005756, 10.91782678738989, 13.127805900092076, 0.4541922999999998, 180.0, 792, 303623, 434, 68.77945349999936
435, 3.515996357509095, 10.906124148399208, 13.101882974053645, 0.45291429999999977, 160.0, 628, 304251, 435, 54.56994699999996
436, 3.923799008937778, 10.92707793272225, 13.14507733484742, 0.45178389999999996, 130.0, 628, 304879, 436, 54.85549009999886
437, 2.8980085470400523, 10.91092982354643, 13.111124977794796, 0.4508064999999999, 80.0, 458, 305337, 437, 40.02794259999973
438, 3.4428915526931134, 10.921413937535483, 13.116064783432401, 0.4495924000000003, 610.0, 891, 306228, 438, 77.60416149999946
439, 3.7393440593372693, 10.928027071046435, 13.13210148299036, 0.448246, 90.0, 605, 306833, 439, 52.79274749999968
440, 3.3971889753167224, 10.917083808226165, 13.117251575104962, 0.4472217999999999, 95.0, 533, 307366, 440, 46.603623699998934
441, 2.7895632932496195, 10.912813788348636, 13.110731800327402, 0.44622999999999996, 170.0, 569, 307935, 441, 48.76520890000029
442, 3.2667900219512664, 10.925264409663926, 13.12422309087278, 0.44514729999999997, 145.0, 634, 308569, 442, 54.61141420000058
443, 3.5515776043312464, 10.908294416019178, 13.118679728676524, 0.4441438, 135.0, 481, 309050, 443, 40.768343699999605
444, 3.322581341197149, 10.91191419992554, 13.112024912673435, 0.44307009999999974, 140.0, 712, 309762, 444, 64.37333059999946
445, 3.184835659124927, 10.932700843717308, 13.126543661300321, 0.4420629999999999, 50.0, 407, 310169, 445, 33.94445040000028
446, 3.3353961089864455, 10.99236626411552, 13.213371094061648, 0.44055099999999964, 445.0, 1273, 311442, 446, 106.64354540000022
447, 3.19235533173975, 11.00362253632244, 13.21848736287936, 0.4384369, 175.0, 1076, 312518, 447, 91.38861890000044
448, 3.332009579826352, 11.012637402382365, 13.223808872919141, 0.4362949, 340.0, 1304, 313822, 448, 116.41767149999941
449, 3.5839575460119844, 11.012976182320704, 13.240172584262021, 0.4348179999999999, 60.0, 337, 314159, 449, 27.362671800001408
450, 3.1842432555259603, 10.999704651457062, 13.217060706944912, 0.433909, 165.0, 673, 314832, 450, 54.569890299997496
451, 3.454474002291635, 11.015816167958866, 13.235005938183276, 0.43250859999999997, 250.0, 883, 315715, 451, 71.2577229999988
452, 3.5576988502625753, 11.00296019237658, 13.227411101846133, 0.4309029999999999, 280.0, 901, 316616, 452, 73.92422760000045
453, 3.47582572580008, 11.012384645352189, 13.228804201855086, 0.4292325999999998, 460.0, 955, 317571, 453, 77.4012255000016
454, 3.5717592087007106, 11.008918952224846, 13.21698482413041, 0.4278943, 10.0, 532, 318103, 454, 42.74463130000004
455, 2.754172576178204, 10.991763061176647, 13.197063752954657, 0.4269205, 80.0, 550, 318653, 455, 44.3544146000022
456, 2.821899346027966, 10.986771460211239, 13.181031907018427, 0.4255696000000001, 180.0, 951, 319604, 456, 76.71003180000116
457, 3.5676482996255836, 11.028001990710791, 13.25661142987253, 0.4241997999999999, 160.0, 571, 320175, 457, 46.38045630000124
458, 3.03987086738298, 11.106851163738503, 13.355424221404299, 0.4233853, 60.0, 334, 320509, 458, 27.082498200001282
459, 3.810780987360148, 11.128170963140787, 13.363752696868168, 0.42221799999999976, 325.0, 963, 321472, 459, 81.83368989999872
460, 3.6668644310557283, 11.120004320517182, 13.354659952223301, 0.4208904999999999, 175.0, 512, 321984, 460, 44.60521289999815
461, 3.4290765653447783, 11.132853458981508, 13.383163051633232, 0.41981679999999993, 140.0, 681, 322665, 461, 59.83314009999958
462, 4.08306967538816, 11.156031693352594, 13.391377957661946, 0.41847489999999987, 155.0, 810, 323475, 462, 65.4850907
463, 3.512773491550183, 11.141423989724421, 13.38360576906066, 0.41712489999999985, 315.0, 690, 324165, 463, 56.54380610000226
464, 3.5730818383091565, 11.133491764263232, 13.368692354280121, 0.4161511, 50.0, 392, 324557, 464, 31.237912500000675
465, 3.6160118534701513, 11.150025866000137, 13.39096835972454, 0.4147768, 345.0, 1135, 325692, 465, 90.03932989999885
466, 4.451626518948211, 11.148632423082988, 13.40111694600847, 0.41343130000000006, 55.0, 360, 326052, 466, 28.683397100001457
467, 3.1198243060169615, 11.13987001588073, 13.371396507026137, 0.41232519999999984, 230.0, 869, 326921, 467, 68.69936660000167
468, 3.073035738249794, 11.143131504992171, 13.377169345822209, 0.41082579999999974, 370.0, 797, 327718, 468, 63.12187780000022
469, 3.4900840257266688, 11.15443888637248, 13.405696625187822, 0.40893220000000013, 705.0, 1307, 329025, 469, 110.54270410000026
470, 3.6197164805326185, 11.15394482735618, 13.42008962182608, 0.4071628, 135.0, 659, 329684, 470, 56.45841269999801
471, 3.5721532921420365, 11.198875372002764, 13.45899040088421, 0.4059793, 125.0, 656, 330340, 471, 56.06882029999906
472, 3.6666856893773616, 11.272169103001701, 13.522847142868493, 0.40462840000000017, 245.0, 845, 331185, 472, 72.48063720000209
473, 3.7464650303474967, 11.271887889705445, 13.538127795692063, 0.4032541, 170.0, 682, 331867, 473, 58.34486549999929
474, 3.182902720457391, 11.270914314366594, 13.548857461953466, 0.4022847999999999, 105.0, 395, 332262, 474, 33.865794299999834
475, 4.367672371930547, 11.292684220208063, 13.575464038848876, 0.4015243, 80.0, 450, 332712, 475, 38.47741039999892
476, 4.325803129593531, 11.279546254475912, 13.5542314453125, 0.40078180000000013, 55.0, 375, 333087, 476, 32.13687549999668
477, 3.1544419540651316, 11.278730038977521, 13.552121711472576, 0.39948759999999994, 295.0, 1063, 334150, 477, 90.7438590999991
478, 3.0263257277863365, 11.274207285472325, 13.55180524871463, 0.3981529, 90.0, 420, 334570, 478, 35.900579500001186
479, 3.687777406984578, 11.27942095621246, 13.557695502366368, 0.397261, 110.0, 571, 335141, 479, 48.7423060000001
480, 3.1735027425900735, 11.282319789724259, 13.543283544940714, 0.39609099999999986, 330.0, 729, 335870, 480, 62.01895599999989
481, 3.8554070148506576, 11.281250881698897, 13.550185424619608, 0.3951010000000001, 55.0, 371, 336241, 481, 31.49898640000174
482, 3.440697246566301, 11.274047350627905, 13.5383453639324, 0.39359170000000004, 475.0, 1306, 337547, 482, 111.24223820000043
483, 3.9175467453457253, 11.270716001372314, 13.540418007321543, 0.39188259999999986, 45.0, 593, 338140, 483, 50.61123940000107
484, 3.616592938754395, 11.286544051425148, 13.54825727739407, 0.3901698999999999, 505.0, 1310, 339450, 484, 111.86186780000207
485, 3.677743401142615, 11.290516984110644, 13.54875878643889, 0.3885643, 35.0, 474, 339924, 485, 40.39716810000027
486, 3.7797569222629765, 11.326216839277604, 13.611745272056927, 0.38728899999999994, 465.0, 943, 340867, 486, 80.53504279999834
487, 3.4049621746377197, 11.359059666478357, 13.640928723091303, 0.3858211, 140.0, 688, 341555, 487, 58.703478299998096
488, 3.1944151938952925, 11.345409345725965, 13.616643971068447, 0.3847689999999999, 75.0, 481, 342036, 488, 41.10595699999976
489, 3.845753175236177, 11.353058338625996, 13.636617872450087, 0.38340460000000004, 295.0, 1035, 343071, 489, 88.34009119999973
490, 4.331476348819154, 11.372360399997596, 13.660032792524857, 0.3821760999999999, 20.0, 330, 343401, 490, 28.24856379999983
491, 3.1759497386101687, 11.353196419460673, 13.639663573721764, 0.38136789999999987, 35.0, 568, 343969, 491, 48.527143300001626
492, 3.210358881751924, 11.35216767259635, 13.628912511840891, 0.3800727999999998, 250.0, 871, 344840, 492, 74.42749050000202
493, 4.038731973517585, 11.379498876966872, 13.667659241873938, 0.3784896999999999, 190.0, 888, 345728, 493, 75.99772599999778
494, 3.082667004575103, 11.357854292617175, 13.646034061167635, 0.3771837999999999, 110.0, 563, 346291, 494, 48.12242770000012
495, 3.7953607738474426, 11.36756037497411, 13.659746846232625, 0.3760894, 255.0, 653, 346944, 495, 55.78302859999894
496, 3.738687298334006, 11.363877150025031, 13.658275486724545, 0.3750561999999999, 75.0, 495, 347439, 496, 42.53543730000092
497, 4.177114245713484, 11.368947976972999, 13.645270594154915, 0.3738727000000001, 235.0, 820, 348259, 497, 70.04765070000212
498, 3.999155498665708, 11.362099551426546, 13.643332201833944, 0.3725452, 70.0, 655, 348914, 498, 56.10700419999921
499, 4.031068601929549, 11.357983988227573, 13.640668564654412, 0.37144809999999995, 65.0, 564, 349478, 499, 48.38904300000286
500, 4.486121093031899, 11.358490179148381, 13.642863715178642, 0.3705634, 90.0, 419, 349897, 500, 36.1568769000005
501, 4.969688179936309, 11.408918695612696, 13.720397272417623, 0.36971200000000004, 80.0, 527, 350424, 501, 45.246933099999296
502, 3.805335254759335, 11.41426450612492, 13.712942242777798, 0.36854739999999986, 190.0, 767, 351191, 502, 65.76508860000104
503, 3.308505976343298, 11.416585486930412, 13.703487466405463, 0.36725769999999996, 190.0, 666, 351857, 503, 57.04109729999982
504, 3.5442775187511293, 11.399676095871698, 13.700382712026121, 0.3663181, 120.0, 378, 352235, 504, 32.460270800002036
505, 3.477401339463083, 11.41033657438125, 13.695160841358971, 0.36520480000000005, 165.0, 859, 353094, 505, 74.2797599000005
506, 4.334874617750545, 11.43524133574941, 13.732400859548912, 0.3639357999999999, 150.0, 551, 353645, 506, 47.37876519999918
507, 3.843570927502599, 11.436510914037997, 13.740437414222358, 0.3626956, 175.0, 827, 354472, 507, 72.32115700000213
508, 3.8732069207706985, 11.417842970623427, 13.716624881845554, 0.3613744, 150.0, 641, 355113, 508, 55.0741726999986
509, 3.8412712179043895, 11.419859375346041, 13.718693001996364, 0.35996409999999995, 340.0, 926, 356039, 509, 79.2102752000028
510, 3.8105941398021503, 11.425146370260125, 13.726699548705012, 0.35755119999999996, 485.0, 1755, 357794, 510, 150.01747539999997
511, 3.7689561927862933, 11.422653120822133, 13.710585536991978, 0.35499609999999987, 280.0, 1084, 358878, 511, 92.78806439999971
512, 3.4615898276683907, 11.409109482472276, 13.703259229900134, 0.3531267999999999, 360.0, 993, 359871, 512, 84.87376600000061
513, 3.604651189609218, 11.601665577457528, 13.935311398075203, 0.35130700000000015, 255.0, 1029, 360900, 513, 88.14284140000018
514, 4.423976256639934, 11.65520280716466, 13.994344827006845, 0.34964649999999997, 265.0, 816, 361716, 514, 69.98679389999961
515, 4.243692077810948, 11.632732132153633, 13.980942831283961, 0.3485610999999999, 30.0, 390, 362106, 515, 33.57082540000192
516, 4.850434579355142, 11.655206863650966, 14.011200223820337, 0.3474891999999999, 255.0, 801, 362907, 516, 68.80106720000185
517, 3.6195348391606323, 11.643329044183096, 13.9804635350255, 0.3457747000000001, 285.0, 1104, 364011, 517, 94.64242300000114
518, 3.71716135045691, 11.642207522343002, 13.999688233902205, 0.3439971999999999, 335.0, 871, 364882, 518, 74.95081980000032
519, 3.582808390673117, 11.63535401811688, 13.97935918457757, 0.3425319999999999, 245.0, 757, 365639, 519, 64.94534750000093
520, 4.208536376061373, 11.644390408766585, 14.002420968252986, 0.34127199999999985, 120.0, 643, 366282, 520, 55.310579599998164
521, 3.5361235117968257, 11.65103893399425, 13.99480858281931, 0.3395430999999999, 285.0, 1278, 367560, 521, 109.4952075000001
522, 3.470288030674003, 11.638358562667936, 13.98043240563718, 0.33808149999999987, 20.0, 346, 367906, 522, 29.68601359999957
523, 4.052884792906217, 11.662745623926591, 14.007862688729126, 0.33657669999999984, 530.0, 1326, 369232, 523, 113.47610290000011
524, 3.704122119957895, 11.673746050100693, 14.031252982023362, 0.3348441999999999, 50.0, 599, 369831, 524, 51.428168400001596
525, 3.8594662834325604, 11.839345215515769, 14.214489387107019, 0.3336102999999999, 90.0, 772, 370603, 525, 66.41798950000157
526, 3.6615514792724997, 11.891886242849385, 14.274692344094465, 0.3323142999999999, 185.0, 668, 371271, 526, 57.38209310000093
527, 3.6277530172041486, 11.902275883962238, 14.299852496101742, 0.33103269999999996, 200.0, 756, 372027, 527, 64.81343360000028
528, 3.9939492741256086, 11.896183262056518, 14.278718039133016, 0.32988880000000004, 75.0, 515, 372542, 528, 41.174124299999676
529, 3.8709472327403005, 11.889710690706007, 14.277910227737118, 0.3285325, 365.0, 992, 373534, 529, 78.03483829999823
530, 3.9451388069337474, 11.895705934395467, 14.286696132860685, 0.3270412, 115.0, 665, 374199, 530, 52.223104599997896
531, 3.5298151537705373, 11.896905201871249, 14.283936027101996, 0.32568309999999995, 265.0, 844, 375043, 531, 66.62672979999843
532, 4.619457930868323, 11.904268564496721, 14.288156682794744, 0.324577, 105.0, 385, 375428, 532, 30.36048529999971
533, 3.656184683630879, 11.887783776579335, 14.282372028332977, 0.32365359999999993, 190.0, 641, 376069, 533, 50.65293269999893
534, 3.4727177691494564, 11.881566441425642, 14.272325937430297, 0.3224619999999999, 95.0, 683, 376752, 534, 53.94957319999958
535, 3.7523292555643692, 11.882063970078518, 14.280885005867395, 0.3212308, 125.0, 685, 377437, 535, 54.06464159999814
536, 3.5788190260833086, 11.899301854142898, 14.288087884549867, 0.3195981999999997, 325.0, 1129, 378566, 536, 88.90793730000223
537, 3.965773063933045, 11.896792456551381, 14.301650771647255, 0.3179682999999999, 130.0, 682, 379248, 537, 53.72762390000207
538, 4.411587357148916, 11.977105207175295, 14.383530191030513, 0.3164895999999999, 300.0, 961, 380209, 538, 75.93102549999821
539, 3.9035537997804264, 12.19706688780729, 14.660437040291871, 0.31516209999999995, 105.0, 514, 380723, 539, 40.45024059999923
540, 3.95933618317463, 12.218831071516325, 14.668028802350403, 0.3141396999999999, 110.0, 622, 381345, 540, 49.17335610000009
541, 3.995396327202519, 12.20643864472707, 14.661994438171387, 0.3124998999999999, 555.0, 1200, 382545, 541, 94.38578899999993
542, 3.5424711408688125, 12.19486424723559, 14.650742895892428, 0.3106557999999999, 390.0, 849, 383394, 542, 66.8329988000005
543, 3.1523371279437677, 12.177665992432654, 14.622437152355612, 0.3093499, 85.0, 602, 383996, 543, 47.649569500001235
544, 4.11032313116185, 12.180239853301606, 14.644497536993645, 0.30846159999999995, 45.0, 385, 384381, 544, 30.397498800000903
545, 4.223432729298302, 12.187706073983442, 14.643302359282327, 0.3076983999999999, 105.0, 463, 384844, 545, 36.676218900000094
546, 3.7259062926691793, 12.184478418921735, 14.634087483375081, 0.30653379999999997, 130.0, 831, 385675, 546, 65.51190560000032
547, 4.1193128619478605, 12.204572004348778, 14.654599048164734, 0.3051676, 135.0, 687, 386362, 547, 54.25488860000041
548, 3.6345662791181255, 12.193255456718239, 14.640981535009436, 0.30388329999999997, 185.0, 740, 387102, 548, 58.43354739999995
549, 4.918624035332554, 12.231026971802232, 14.686709721883139, 0.30263679999999993, 135.0, 645, 387747, 549, 50.88433090000035
550, 3.830937588616356, 12.214505007847603, 14.656818948261478, 0.3015352, 80.0, 579, 388326, 550, 45.81287979999979
551, 3.9886193175797207, 12.197245128523289, 14.66095075296428, 0.30015819999999993, 185.0, 951, 389277, 551, 75.00205360000109
552, 3.803763997318135, 12.232348407764293, 14.69778092150061, 0.2985768999999999, 365.0, 806, 390083, 552, 63.87577930000043
553, 3.9309106245526233, 12.476082114549838, 14.979591521253203, 0.29724579999999995, 180.0, 673, 390756, 553, 53.03835529999924
554, 3.853870411797801, 12.454162575798817, 14.97400447169029, 0.29589399999999993, 150.0, 829, 391585, 554, 65.5162264999999
555, 3.423835902719058, 12.45402719926422, 14.953730754962228, 0.29452330000000004, 160.0, 694, 392279, 555, 54.80789879999793
556, 4.121173916175078, 12.464882302625535, 14.989290315436927, 0.29345859999999985, 100.0, 489, 392768, 556, 41.09691490000114
557, 3.655429205057204, 12.461029777327655, 14.959101823851583, 0.29232909999999995, 245.0, 766, 393534, 557, 66.64145270000154
558, 3.6174241219017955, 12.47200086567853, 14.979477293426926, 0.29097369999999995, 145.0, 740, 394274, 558, 64.23126030000276
559, 3.59075162369992, 12.468900815128885, 14.988845062886735, 0.2894914, 135.0, 907, 395181, 559, 81.30926669999826
560, 3.9228797145438996, 12.493824231222774, 15.00928171886487, 0.28787409999999997, 190.0, 890, 396071, 560, 79.72927789999812
561, 3.5765564206554936, 12.485794477129568, 14.999769535010664, 0.2861199999999999, 295.0, 1059, 397130, 561, 87.05784660000063
562, 3.787844676282105, 12.49655544757843, 15.00873829484955, 0.28428130000000007, 195.0, 984, 398114, 562, 80.02492680000069
563, 3.5052458168938756, 12.49148613395113, 14.996345144329648, 0.28292049999999996, 85.0, 528, 398642, 563, 43.0267763999982
564, 4.26893460103006, 12.500504772239756, 15.017910912772205, 0.28167489999999995, 215.0, 856, 399498, 564, 73.32636690000072
565, 3.1955580829890233, 12.487021619457588, 14.99028371807266, 0.2804338, 110.0, 523, 400021, 565, 45.78935350000029
566, 3.9761284860872452, 12.465239159778882, 14.95403801702684, 0.2795445999999998, 70.0, 465, 400486, 566, 40.6030310999995
567, 3.552602285524157, 12.441565012868917, 14.937334339977255, 0.27844389999999997, 270.0, 758, 401244, 567, 65.66552310000043
568, 3.548790696013508, 12.440373552705344, 14.941289011265567, 0.27729999999999994, 80.0, 513, 401757, 568, 44.5351894000014
569, 4.486908425484549, 12.467828591834264, 14.984957400864445, 0.275995, 150.0, 937, 402694, 569, 81.41131460000179
570, 4.053638924151806, 12.459842883894597, 14.955097025838391, 0.2744208999999999, 125.0, 812, 403506, 570, 70.64559159999772
571, 3.9512237394584044, 12.452296436591306, 14.972872537510996, 0.2733363999999999, 70.0, 393, 403899, 571, 34.205370600000606
572, 3.933236897983009, 12.458936319842358, 14.968473860122614, 0.27214389999999994, 395.0, 932, 404831, 572, 80.76179730000149
573, 3.7768722155297447, 12.473640610450921, 14.985012480270031, 0.27072460000000004, 105.0, 645, 405476, 573, 56.063832400002866
574, 4.230113312454507, 12.499616711446555, 15.005905331951556, 0.26941689999999996, 230.0, 808, 406284, 574, 70.01960300000064
575, 4.180072802048858, 12.477289820962604, 14.991304941074823, 0.26810379999999995, 120.0, 651, 406935, 575, 56.51049480000074
576, 4.103336510866249, 12.493970237315166, 15.00235135685507, 0.2667105999999999, 175.0, 897, 407832, 576, 77.89849070000128
577, 4.217773073559044, 12.495072130028529, 15.014659093536494, 0.26543169999999994, 80.0, 524, 408356, 577, 45.58522330000051
578, 3.654535484179041, 12.495870530525949, 15.008038141121084, 0.2642842, 220.0, 751, 409107, 578, 65.25076529999933
579, 3.8601714596152306, 12.514417164436372, 15.038075212687882, 0.2627551, 305.0, 948, 410055, 579, 82.27506569999969
580, 3.770695834703238, 12.62911229615938, 15.165303403680975, 0.2611989999999999, 140.0, 781, 410836, 580, 67.77399829999922
581, 3.6526009182048123, 12.598796030234174, 15.141520784612288, 0.2598804999999999, 60.0, 684, 411520, 581, 59.08543019999706
582, 3.535505855819488, 12.622370793511875, 15.157361993716071, 0.2584485999999999, 245.0, 907, 412427, 582, 78.59479300000021
583, 3.7970216773182632, 12.640949521070667, 15.18317757101898, 0.25690599999999997, 175.0, 807, 413234, 583, 69.85965950000173
584, 4.671241407696881, 12.64480107862558, 15.203616476770657, 0.2555766999999998, 125.0, 670, 413904, 584, 58.04905680000229
585, 4.38545573368755, 12.652212814390083, 15.196208970459102, 0.2545084, 75.0, 517, 414421, 585, 44.781842100001086
586, 4.194348428258322, 12.664759119650475, 15.204784436333448, 0.25344459999999985, 195.0, 665, 415086, 586, 57.6442332000006
587, 3.93745488354138, 12.633562708861076, 15.16460815074917, 0.2519074, 340.0, 1043, 416129, 587, 90.0850668000021
588, 3.6798072857465844, 12.64234909525298, 15.177440513007927, 0.24975009999999992, 395.0, 1354, 417483, 588, 116.76342300000033
589, 3.8197520763028, 12.630070522319423, 15.154919269988083, 0.24729130000000002, 450.0, 1378, 418861, 589, 119.03989410000213
590, 3.245946487052399, 12.627890280115674, 15.155302181578518, 0.2457432999999999, 40.0, 342, 419203, 590, 29.53472959999999
591, 4.373916444347201, 12.913324038920132, 15.505301331228559, 0.2442637, 700.0, 1302, 420505, 591, 112.2392949999994
592, 4.168317304828526, 13.3848503070595, 16.072556883043948, 0.2420749, 170.0, 1130, 421635, 592, 97.58610209999824
593, 4.08021230821585, 13.402468429144294, 16.087806690642097, 0.2403567999999999, 215.0, 779, 422414, 593, 67.38128470000083
594, 4.029286947374963, 13.39121134537088, 16.08473702339129, 0.2393370999999999, 25.0, 354, 422768, 594, 30.630387900000642
595, 3.62000776671256, 13.404183086199252, 16.090103865612164, 0.23810769999999998, 265.0, 1012, 423780, 595, 87.62911209999947
596, 3.846884142446697, 13.432717221315539, 16.135363005339318, 0.2362374999999999, 285.0, 1066, 424846, 596, 92.15554329999941
597, 4.083968116560742, 13.447666546425285, 16.128712836886265, 0.23480379999999998, 70.0, 527, 425373, 597, 45.6747034
598, 3.773331658539795, 13.420110929220112, 16.12167957505409, 0.2337615999999999, 175.0, 631, 426004, 598, 60.21029029999772
599, 4.017798970282225, 13.441036086778256, 16.143936820788905, 0.23210200000000003, 280.0, 1213, 427217, 599, 104.96557380000013
600, 4.049050891252212, 13.44265997969074, 16.135722242755655, 0.2302812999999999, 125.0, 810, 428027, 600, 70.17047620000085
601, 3.7258634805124, 13.437940260885172, 16.133947399092015, 0.22868289999999994, 280.0, 966, 428993, 601, 83.559844899999
602, 3.650690764114539, 13.568111024193865, 16.28839690005349, 0.22636810000000007, 855.0, 1606, 430599, 602, 138.4628316999988
603, 3.9281153779343834, 13.733439567898001, 16.48197632389409, 0.22411629999999994, 175.0, 896, 431495, 603, 77.39131189999898
604, 4.9329407162075745, 13.753350313869092, 16.528452600251644, 0.22281939999999997, 110.0, 545, 432040, 604, 47.209168299999874
605, 4.2211284057115215, 13.752294477944176, 16.495962980837106, 0.2217654999999999, 140.0, 626, 432666, 605, 54.06118760000027
606, 3.5916036760553403, 13.737058057176306, 16.513996353555232, 0.2207791, 165.0, 470, 433136, 606, 40.51559579999957
607, 3.551945709305214, 13.712639061887366, 16.473504206783456, 0.21999520000000003, 65.0, 401, 433537, 607, 34.52625679999983
608, 4.278337808001426, 13.740798902511596, 16.501385325770226, 0.21907629999999995, 90.0, 620, 434157, 608, 53.43594669999948
609, 3.3380836527815743, 13.71432305464815, 16.462851214760683, 0.21772539999999993, 250.0, 881, 435038, 609, 75.79292279999936
610, 4.162408635804527, 13.732338935257452, 16.49713123954742, 0.2160432999999999, 265.0, 988, 436026, 610, 84.86829390000275
611, 3.8880290003147207, 13.731325382260394, 16.489271044112193, 0.2142873999999999, 220.0, 963, 436989, 611, 82.85970960000122
612, 4.334779143685085, 13.731851885804033, 16.49538690150663, 0.2128104999999999, 105.0, 678, 437667, 612, 58.26075950000086
613, 3.567033027470445, 13.734259175632697, 16.485032999759724, 0.21171699999999993, 25.0, 537, 438204, 613, 46.28661160000047
614, 4.277465065163033, 13.757955148071957, 16.528785463953426, 0.21049479999999993, 190.0, 821, 439025, 614, 70.64602820000073
615, 3.582285648540938, 13.748302671644423, 16.510107446889407, 0.20926179999999997, 125.0, 549, 439574, 615, 48.98342849999972
616, 3.7294170606720853, 13.84989473901213, 16.6258231824787, 0.20816199999999987, 155.0, 673, 440247, 616, 56.619710700000724
617, 3.814220334456462, 14.04641174767895, 16.872679738127957, 0.20665899999999993, 340.0, 997, 441244, 617, 85.81055749999723
618, 3.654663757627527, 14.042134705435465, 16.860850855634716, 0.20503089999999988, 230.0, 812, 442056, 618, 69.4297321999984
619, 4.186241423203495, 14.051896134396522, 16.88169564913921, 0.2033127999999999, 370.0, 1097, 443153, 619, 98.60688010000013
620, 3.9865943179244088, 14.047233794514574, 16.866248112006726, 0.2017773999999999, 95.0, 609, 443762, 620, 52.196372899998096
621, 4.4423250290977805, 14.074637373791465, 16.900401173764642, 0.20037609999999995, 280.0, 948, 444710, 621, 79.58056950000173
622, 3.537531642194844, 14.067052690780349, 16.894751385138395, 0.19900359999999992, 115.0, 577, 445287, 622, 49.550283199998375
623, 4.087718714993129, 14.07576416222624, 16.897530456661254, 0.1979037999999999, 140.0, 645, 445932, 623, 55.54127819999849
624, 3.4960634950591496, 14.085953788933795, 16.90951677423858, 0.19615599999999994, 525.0, 1297, 447229, 624, 108.859332
625, 3.682793016969805, 14.082862107711431, 16.909324344093278, 0.19438029999999984, 95.0, 676, 447905, 625, 57.49971119999827
626, 4.267643263267691, 14.088919126597387, 16.9303516728918, 0.1926441999999999, 300.0, 1253, 449158, 626, 105.73090379999849
627, 3.652698837409475, 14.097770664891769, 16.93884081031844, 0.1910548, 85.0, 513, 449671, 627, 43.87959989999945
628, 3.9901889630726406, 14.125379017421178, 16.951065490837383, 0.1899945999999999, 150.0, 665, 450336, 628, 56.007417500000884
629, 3.665531729304984, 14.163530000884286, 16.996197225449237, 0.1886752, 150.0, 801, 451137, 629, 68.19394230000034
630, 3.8928419700776686, 14.173537535619253, 17.014465540105647, 0.18706329999999996, 280.0, 990, 452127, 630, 83.93837200000053
631, 3.729836462128082, 14.158161937790428, 16.993035678095467, 0.1856359, 160.0, 596, 452723, 631, 54.87486810000337
632, 3.8283408594184687, 14.148648815495628, 16.975078856661206, 0.18449469999999996, 95.0, 672, 453395, 632, 61.615438700002414
633, 3.5626625115146284, 14.148308349644534, 16.982665406210998, 0.18330399999999994, 90.0, 651, 454046, 633, 59.7208169000005
634, 3.3969285642945923, 14.149026204394056, 16.967449165938735, 0.1823715999999999, 75.0, 385, 454431, 634, 34.80753940000068
635, 4.207185085492524, 14.166791084914179, 17.016724686873587, 0.18171729999999994, 85.0, 342, 454773, 635, 32.095153300000675
636, 3.9964922689078435, 14.13392058819468, 16.96925818482434, 0.18057609999999988, 280.0, 926, 455699, 636, 85.36726710000221
637, 4.075190562098774, 14.149390202137962, 16.98489349991528, 0.17913969999999993, 80.0, 670, 456369, 637, 59.10747160000028
638, 3.4160020037642065, 14.13210612674929, 16.96862265101019, 0.1773441999999999, 840.0, 1325, 457694, 638, 115.603154299999
639, 3.615609069235791, 14.13359262530965, 16.966415416029164, 0.17567289999999994, 170.0, 532, 458226, 639, 46.063815599998634
640, 3.914990844776725, 14.144537932801954, 16.97159490490904, 0.17483049999999986, 80.0, 404, 458630, 640, 34.62065580000126
641, 4.000221059131349, 14.153563942861489, 16.97616617260061, 0.17383779999999993, 315.0, 699, 459329, 641, 60.5157958000018
642, 4.325214447726644, 14.312100517633295, 17.173844328144085, 0.17210349999999994, 440.0, 1228, 460557, 642, 108.6572038000013
643, 4.8487358182076585, 14.475926790805842, 17.373026532053157, 0.1704547, 105.0, 604, 461161, 643, 53.069551099997625
644, 3.7063951512796667, 14.468618851855286, 17.368066148522335, 0.16907319999999995, 295.0, 931, 462092, 644, 81.18813199999931
645, 4.757857672766286, 14.498230681522113, 17.381700989562447, 0.16752519999999996, 255.0, 789, 462881, 645, 68.97843410000132
646, 3.626161362842167, 14.482824063710229, 17.377500941712473, 0.16623819999999997, 150.0, 641, 463522, 646, 56.71147660000133
647, 4.109639334490658, 14.464948349848306, 17.36326992268465, 0.16517619999999994, 135.0, 539, 464061, 647, 53.014474899999186
648, 4.358292082770262, 14.491603801899734, 17.39798227875866, 0.16387479999999993, 240.0, 907, 464968, 648, 85.70587979999982
649, 3.9922495127318594, 14.48710987167141, 17.38503894099483, 0.16242669999999998, 130.0, 702, 465670, 649, 62.38718090000111
650, 3.9748271952782357, 14.487176290239606, 17.389452002389092, 0.16116489999999992, 200.0, 700, 466370, 650, 59.47196709999844
651, 4.149917813447805, 14.482419766966586, 17.37489187812299, 0.1595169999999999, 575.0, 1131, 467501, 651, 103.52960019999955
652, 4.23983670954718, 14.476110470670683, 17.373213918297886, 0.15787089999999998, 235.0, 698, 468199, 652, 61.123993600001995
653, 4.195810316968709, 14.443048994243146, 17.33813873231411, 0.15666669999999994, 125.0, 640, 468839, 653, 53.252403099999356
654, 4.076889938730443, 14.454601413733705, 17.3414697250449, 0.15559299999999995, 120.0, 553, 469392, 654, 46.11128070000268
655, 3.9030257336466416, 14.505432419950811, 17.41000758297384, 0.15415749999999992, 230.0, 1042, 470434, 655, 87.67367779999768
656, 4.4081575771552, 14.597256967129598, 17.527282121527286, 0.1522764999999999, 300.0, 1048, 471482, 656, 93.90455949999887
657, 4.399578509954461, 14.626532583800046, 17.54120379661206, 0.15048009999999987, 175.0, 948, 472430, 657, 85.40075250000154
658, 4.023933194006231, 14.627673844697679, 17.55852735439361, 0.14900499999999997, 215.0, 691, 473121, 658, 61.84214450000218
659, 4.37542494327523, 14.61707860370015, 17.550340448423874, 0.1478025999999999, 180.0, 645, 473766, 659, 57.25274899999931
660, 4.952972602873564, 14.613966064406204, 17.535029952083274, 0.14649039999999994, 205.0, 813, 474579, 660, 70.97805119999975
661, 3.709358406595037, 14.574603719215018, 17.49983949567363, 0.1451187999999999, 170.0, 711, 475290, 661, 62.772006399998645
662, 3.348046129045923, 14.603103307337543, 17.52973093082702, 0.14392809999999995, 115.0, 612, 475902, 662, 58.306667100001505
663, 3.9420435475465845, 14.596618505624624, 17.523483557047253, 0.14283909999999994, 105.0, 598, 476500, 663, 56.13103349999801
664, 3.719184745281515, 14.583051942099988, 17.504766340658698, 0.1419813999999999, 50.0, 355, 476855, 664, 30.937150000001566
665, 4.469208519963118, 14.576327068989093, 17.501899150701668, 0.1411938999999999, 145.0, 520, 477375, 665, 46.51884220000284
666, 4.701970094007484, 14.599794380995679, 17.52061650135657, 0.14009679999999997, 150.0, 699, 478074, 666, 60.19164439999804
667, 4.180928505202222, 14.593526184821444, 17.515394261229932, 0.13905909999999994, 135.0, 454, 478528, 667, 47.33086149999872
668, 3.8259691909246487, 14.599448300235442, 17.518799293584266, 0.13782069999999993, 180.0, 922, 479450, 668, 78.5808700000016
669, 3.9056900709426428, 14.635153502288883, 17.560983024742335, 0.1365651999999999, 30.0, 473, 479923, 669, 40.09007299999939
670, 3.382306477912961, 14.483992477738104, 17.38159073244661, 0.13498479999999993, 340.0, 1283, 481206, 670, 117.80282819999775
671, 3.996601407930906, 14.489232157680247, 17.392818978022795, 0.13312989999999988, 145.0, 778, 481984, 671, 65.65337549999822
672, 4.397168724677142, 14.496867643083846, 17.42133318796879, 0.13189419999999988, 90.0, 595, 482579, 672, 48.808574200000294
673, 3.8537101935109366, 14.491117873399155, 17.398901501945826, 0.13053069999999992, 405.0, 920, 483499, 673, 75.18029589999787
674, 4.392681325417111, 14.519327647525195, 17.441778359175427, 0.12908889999999995, 80.0, 682, 484181, 674, 61.27362880000146
675, 3.9455815772125624, 14.502514765812801, 17.39913093558264, 0.12767949999999992, 155.0, 884, 485065, 675, 73.97919449999972
676, 3.3236446095140355, 14.49984022274352, 17.39739603076065, 0.12637089999999984, 140.0, 570, 485635, 676, 51.69821159999992
677, 4.29075630868573, 14.522270520134727, 17.444416308166957, 0.12513069999999993, 270.0, 808, 486443, 677, 73.99604410000029
678, 3.466326314581316, 14.495645496131337, 17.39250035690049, 0.12360699999999988, 190.0, 885, 487328, 678, 77.8936176999996
679, 3.503598890186328, 14.510896567417229, 17.407117216483407, 0.1221480999999999, 195.0, 736, 488064, 679, 64.86946999999782
680, 4.095077391734349, 14.518465546753802, 17.42311418279432, 0.12066759999999993, 220.0, 909, 488973, 680, 80.30780400000003
681, 4.541528735150437, 14.530196141516539, 17.445705861183807, 0.11928159999999992, 145.0, 631, 489604, 681, 55.60546020000038
682, 3.973660757154894, 14.562244676856627, 17.485199884518487, 0.11787039999999988, 370.0, 937, 490541, 682, 84.36923939999906
683, 4.068245508426049, 14.631399319478293, 17.56911800953627, 0.11641779999999993, 110.0, 677, 491218, 683, 59.1443025999979
684, 4.379649601126394, 14.616961508947062, 17.552048974003352, 0.11517399999999994, 105.0, 705, 491923, 684, 65.22618059999877
685, 3.644486244144607, 14.62280344684764, 17.552446239189415, 0.11407689999999991, 40.0, 514, 492437, 685, 47.73093090000111
686, 3.7565978485975204, 14.606669659940353, 17.527668609382204, 0.1130346999999999, 185.0, 644, 493081, 686, 58.15754150000066
687, 4.458192829107098, 14.629500601565729, 17.561662268420324, 0.11157039999999989, 150.0, 983, 494064, 687, 84.82965160000094
688, 4.0873814244663365, 14.609755392949651, 17.536772750213764, 0.11010699999999989, 115.0, 643, 494707, 688, 53.976971900003264
689, 3.8064384139933676, 14.612858957357483, 17.521110483256955, 0.10886049999999994, 170.0, 742, 495449, 689, 63.0320501999995
690, 3.305359774211835, 14.627885352166826, 17.5432737286221, 0.10741779999999997, 215.0, 861, 496310, 690, 74.36419820000083
691, 3.9955779555670174, 14.61100583985543, 17.544818741644974, 0.10537299999999995, 385.0, 1411, 497721, 691, 130.0255657000016
692, 3.7035298985125262, 14.6051595337655, 17.52379958076072, 0.10350999999999999, 210.0, 659, 498380, 692, 65.0275490999993
693, 3.702766725915996, 14.598454739071986, 17.51349553987467, 0.1021095999999999, 395.0, 897, 499277, 693, 97.61369189999823
694, 3.6231900874240184, 14.588373441468816, 17.505087157265006, 0.10059110012546997, 210.0, 797, 500074, 694, 73.55672060000143
695, 4.042591822086548, 14.621539312250475, 17.552321163832353, 0.0999999999999969, 775.0, 1666, 501740, 695, 149.41554130000077
696, 3.8879007092678104, 14.616320618628382, 17.544754637642036, 0.09999999999999913, 235.0, 889, 502629, 696, 80.17944640000132
697, 4.206184016328293, 14.622295527194144, 17.55376012938807, 0.0999999999999978, 550.0, 1228, 503857, 697, 108.9429995999999
698, 4.507022742194877, 14.636839646052985, 17.579650955726965, 0.09999999999999924, 220.0, 869, 504726, 698, 77.37091109999528
699, 3.571477905520654, 14.65086659223831, 17.578663944934128, 0.09999999999999748, 505.0, 1355, 506081, 699, 120.5479875999954
700, 4.6050898876455095, 14.639241655667623, 17.586023653878105, 0.10000000000000067, 60.0, 360, 506441, 700, 32.95773389999522
701, 3.877871796287395, 14.653833465318423, 17.58337480184194, 0.1000000000000001, 195.0, 740, 507181, 701, 65.16237639999599
702, 3.7140676516186466, 14.657930891046414, 17.606022019362726, 0.10000000000000098, 90.0, 607, 507788, 702, 53.31321659999958
703, 4.449830680764441, 14.673247680581849, 17.63012462648852, 0.10000000000000084, 120.0, 464, 508252, 703, 40.843140799996036
704, 4.683555223392057, 14.684523229870942, 17.642056586116464, 0.09999999999999852, 255.0, 1017, 509269, 704, 88.99940399999468
705, 4.287269506135755, 14.679565452226331, 17.614207925613382, 0.10000000000000063, 160.0, 677, 509946, 705, 65.77392490000057
706, 4.373380082240593, 14.791443611231882, 17.75517983228477, 0.09999999999999837, 270.0, 1054, 511000, 706, 95.27540360000421
707, 3.8179070942195845, 14.79992374520243, 17.769549511097097, 0.10000000000000092, 115.0, 648, 511648, 707, 56.64112140000361
708, 3.5408534338131195, 14.784125171723913, 17.742691123420425, 0.10000000000000094, 40.0, 549, 512197, 708, 45.87130780000007
709, 3.939092208415766, 14.78441357720818, 17.74489700271214, 0.10000000000000078, 150.0, 661, 512858, 709, 55.11255340000207
710, 4.491542403787244, 14.784272642037593, 17.757366608943183, 0.1000000000000006, 155.0, 681, 513539, 710, 60.82563780000055
711, 3.1907434778913886, 14.776809619466064, 17.745712744637995, 0.10000000000000088, 125.0, 497, 514036, 711, 41.32546369999909
712, 4.146990737609582, 14.798435024123073, 17.757777092948793, 0.09999999999999916, 455.0, 882, 514918, 712, 73.18765230000281
713, 3.8118048846006394, 14.79886431274414, 17.768559790039063, 0.09999999999999774, 400.0, 1250, 516168, 713, 106.51767090000067
714, 3.8837249570201484, 14.824137203877555, 17.797537757857608, 0.10000000000000085, 125.0, 479, 516647, 714, 42.46790820000024
715, 4.487212543015498, 14.827438808705685, 17.796143594449454, 0.10000000000000092, 80.0, 548, 517195, 715, 48.69346460000088
716, 4.556577044862805, 14.827573696772257, 17.79903991171654, 0.10000000000000095, 85.0, 564, 517759, 716, 50.171572500003094
717, 3.8447339395385476, 14.819364045745697, 17.795801568861624, 0.09999999999999858, 410.0, 1005, 518764, 717, 88.6852543999994
718, 4.282668697478988, 14.832659566962478, 17.79706758620755, 0.09999999999999791, 360.0, 1192, 519956, 718, 106.13944310000079
719, 4.254887628884529, 14.615455875462574, 17.548735527503887, 0.09999999999999924, 170.0, 869, 520825, 719, 77.96463290000247
720, 4.955571500397233, 14.616422024984209, 17.534765182979523, 0.10000000000000071, 15.0, 378, 521203, 720, 34.06254980000085
721, 3.9532072861617973, 14.579263453171633, 17.51939923740993, 0.09999999999999931, 190.0, 856, 522059, 721, 75.5485719999997
722, 4.190541593883282, 14.574293893772166, 17.507444388700492, 0.09999999999999823, 235.0, 1092, 523151, 722, 96.55575089999911
723, 4.390027390000932, 14.617576720777494, 17.549655413697543, 0.09999999999999747, 570.0, 1364, 524515, 723, 120.26932659999875
724, 3.978305364892619, 14.599801959819278, 17.53138599376621, 0.0999999999999986, 305.0, 997, 525512, 724, 88.35771419999946
725, 3.9988283447499544, 14.630101887684948, 17.5577545462385, 0.09999999999999906, 440.0, 901, 526413, 725, 79.60896259999572
726, 4.268985576851687, 14.628816567660188, 17.565658950546336, 0.09999999999999723, 420.0, 1471, 527884, 726, 130.10988740000175
727, 3.926665349601799, 14.627232199349072, 17.561420246193418, 0.09999999999999756, 435.0, 1324, 529208, 727, 140.98238920000585
728, 4.177790052116677, 14.680807580061948, 17.630491029152235, 0.09999999999999822, 220.0, 1098, 530306, 728, 121.07775440000114
729, 3.741816158816408, 14.796324611013475, 17.774084729396055, 0.09999999999999976, 160.0, 786, 531092, 729, 80.46818329999951
730, 3.799581496508082, 14.788894495252746, 17.760483602133903, 0.10000000000000023, 235.0, 724, 531816, 730, 68.60822840000037
731, 4.317961094407696, 14.80788101414918, 17.750047129604656, 0.1000000000000009, 80.0, 506, 532322, 731, 48.96198480000021
732, 4.48617919067809, 14.790141253906159, 17.74045365166771, 0.10000000000000071, 55.0, 669, 532991, 732, 63.36206239999592
733, 4.356013539302977, 14.798310511659787, 17.770969043148746, 0.09999999999999813, 430.0, 1119, 534110, 733, 107.43548659999942
734, 3.4652504714274364, 14.816103529387306, 17.78263737232589, 0.09999999999999806, 695.0, 1142, 535252, 734, 108.48926950000168
735, 3.3526870287639996, 14.823499640612535, 17.790727870565064, 0.10000000000000034, 110.0, 710, 535962, 735, 63.873067299995455
736, 4.047312724634838, 14.849996212855965, 17.82384585502881, 0.09999999999999964, 140.0, 803, 536765, 736, 71.8580304000061
737, 3.723331562273622, 14.850646666955338, 17.820722444922524, 0.09999999999999852, 260.0, 1017, 537782, 737, 91.3481721000062
738, 3.6267043646291004, 14.858706750115045, 17.839336839854287, 0.10000000000000046, 255.0, 695, 538477, 738, 62.64258549999795
739, 3.946291731288828, 14.858574445993622, 17.81957762782559, 0.09999999999999956, 180.0, 815, 539292, 739, 73.62107209999522
740, 4.377704718860529, 14.87211407597733, 17.857380523757705, 0.09999999999999858, 220.0, 1003, 540295, 740, 91.16091880000022
741, 3.527129203231042, 14.862569166141256, 17.828534579133123, 0.09999999999999862, 290.0, 994, 541289, 741, 92.3111124000061
742, 3.8037401945648077, 14.866572903159136, 17.842361913898035, 0.09999999999999944, 185.0, 835, 542124, 742, 74.67635809999774
743, 3.939605687688661, 14.87280560088409, 17.83538166605729, 0.09999999999999842, 555.0, 1043, 543167, 743, 95.95748119999917
744, 4.178437618584557, 14.901797080422467, 17.875005385454962, 0.0999999999999989, 240.0, 935, 544102, 744, 87.62960860000021
745, 3.882859196339478, 14.888328353039213, 17.860858569196722, 0.09999999999999945, 215.0, 833, 544935, 745, 75.27621709999949
746, 3.598690665624978, 14.877761606455218, 17.859291686893798, 0.10000000000000092, 125.0, 647, 545582, 746, 61.80498310000257
747, 4.159300224977313, 14.896831029841167, 17.884239349180504, 0.10000000000000077, 110.0, 413, 545995, 747, 41.35415700000158
748, 3.6892780066839332, 14.919252271600108, 17.90160483897058, 0.09999999999999899, 245.0, 915, 546910, 748, 81.3442412000004
749, 3.908916503947694, 14.912528028711677, 17.886008638888597, 0.1000000000000009, 115.0, 512, 547422, 749, 45.86495130000549
750, 3.9757300978818817, 14.91937937116409, 17.905309343551842, 0.10000000000000071, 70.0, 669, 548091, 750, 60.29481020000094
751, 4.602303862038102, 14.923999864071101, 17.90576919787893, 0.09999999999999815, 380.0, 1117, 549208, 751, 98.5865546999994
752, 4.024205070038944, 14.928595295877525, 17.921410469078797, 0.09999999999999873, 315.0, 969, 550177, 752, 92.16049980000389
753, 3.4124294195678972, 14.94731207404818, 17.92846674862362, 0.10000000000000069, 185.0, 672, 550849, 753, 61.163220800001
754, 4.199811441864593, 14.980646032777686, 17.97301179500467, 0.09999999999999983, 310.0, 777, 551626, 754, 68.81986029999825
755, 4.0548600109496915, 14.944985593663583, 17.93353614807129, 0.10000000000000088, 75.0, 505, 552131, 755, 46.49520350000239
756, 3.7996944102436996, 14.961253659243233, 17.955090128671717, 0.09999999999999815, 230.0, 1118, 553249, 756, 105.17710320000333
757, 4.59561931028605, 14.968280173075225, 17.954956894087115, 0.10000000000000084, 65.0, 459, 553708, 757, 40.643358699999226
758, 4.221366323616672, 14.965368282882514, 17.969714339857713, 0.0999999999999988, 390.0, 953, 554661, 758, 84.45532370000001
759, 4.377849091493755, 14.965317580678047, 17.96260079550087, 0.09999999999999921, 255.0, 872, 555533, 759, 79.4444896999994
760, 4.412538586267784, 14.961098353364575, 17.963744211552747, 0.09999999999999831, 195.0, 1072, 556605, 760, 100.17155510000157
761, 4.76745415490005, 14.964708176379904, 17.96725691667935, 0.10000000000000009, 255.0, 741, 557346, 761, 67.46746249999705
762, 4.086023483306739, 14.966893525639916, 17.96356336933792, 0.10000000000000099, 85.0, 628, 557974, 762, 59.234293100002105
763, 4.586816144063149, 14.955994622501326, 17.96678005265601, 0.0999999999999996, 180.0, 810, 558784, 763, 76.32327850000001
764, 4.310605593517147, 14.96668177481377, 17.972005678041, 0.10000000000000071, 50.0, 379, 559163, 764, 35.36409709999862
765, 4.412093149500817, 14.997735464937302, 18.01435448092665, 0.09999999999999744, 555.0, 1374, 560537, 765, 121.21203160000005
766, 3.947181061894264, 15.067785224824581, 18.106233126712294, 0.09999999999999935, 295.0, 848, 561385, 766, 71.12180339999759
767, 4.2540960048065815, 15.054979912179416, 18.075614226711252, 0.09999999999999899, 140.0, 915, 562300, 767, 78.57867580000311
768, 4.348803417107023, 15.097868035130633, 18.136972917479163, 0.0999999999999989, 315.0, 934, 563234, 768, 85.24364950000017
769, 4.048720781853858, 15.070063879134807, 18.099284936350287, 0.10000000000000038, 360.0, 705, 563939, 769, 63.937297199998284
770, 4.269569900167157, 15.085776738798085, 18.1120775611736, 0.09999999999999898, 240.0, 917, 564856, 770, 82.81539869999688
771, 4.663394264416189, 15.095948939041424, 18.133061388487455, 0.0999999999999972, 375.0, 1488, 566344, 771, 134.5024837999954
772, 4.682536603482264, 15.10337939532298, 18.125857711288162, 0.09999999999999835, 315.0, 1060, 567404, 772, 95.5395028999992
773, 4.200819471601084, 15.096657317098437, 18.1199576440992, 0.09999999999999815, 240.0, 1118, 568522, 773, 100.60912529999769
774, 4.605807626923538, 15.113362242996955, 18.14234743664443, 0.09999999999999902, 375.0, 908, 569430, 774, 81.50162390000332
775, 4.8651621972228964, 15.15335698969224, 18.17413499869552, 0.1000000000000009, 80.0, 510, 569940, 775, 46.08649819999846
776, 4.322282008072756, 15.268822235173836, 18.32568634581125, 0.09999999999999896, 295.0, 919, 570859, 776, 82.80129979999765
777, 4.736776266837012, 15.302171192197958, 18.362451285798087, 0.10000000000000077, 130.0, 663, 571522, 777, 59.68734940000286
778, 4.718452495003243, 15.289830293394964, 18.360695450761693, 0.09999999999999988, 185.0, 769, 572291, 778, 69.27353529999527
779, 4.6805559098102245, 15.310053426365306, 18.368362610105986, 0.09999999999999729, 390.0, 1446, 573737, 779, 130.3260616999978
780, 4.134631398577686, 15.32112078915507, 18.376485287786245, 0.09999999999999798, 380.0, 1169, 574906, 780, 105.07789950000006
781, 4.764823064574829, 15.319438740656926, 18.38629437960111, 0.1000000000000009, 115.0, 650, 575556, 781, 58.613119699999515
782, 5.298803315028476, 15.36363367077577, 18.45496975461577, 0.10000000000000098, 115.0, 613, 576169, 782, 55.306827699998394
783, 5.692277533139369, 15.361992218697718, 18.428126379500988, 0.1000000000000009, 120.0, 516, 576685, 783, 46.52225940000062
784, 4.655756034688625, 15.340394484495114, 18.40763707055835, 0.10000000000000088, 45.0, 499, 577184, 784, 44.92447989999346
785, 3.8764832277159296, 15.34425968238438, 18.41856761480071, 0.10000000000000081, 110.0, 447, 577631, 785, 40.284470300000976
786, 4.026546391784496, 15.330282146044505, 18.390501271510384, 0.10000000000000096, 120.0, 643, 578274, 786, 57.88806990000012
787, 4.351610515875277, 15.326904998861481, 18.407804085065475, 0.10000000000000094, 140.0, 557, 578831, 787, 50.17511060000106
788, 4.808542240411043, 15.324972501340902, 18.389217102302695, 0.10000000000000078, 105.0, 424, 579255, 788, 38.23538549999648
789, 4.616127900441842, 15.379087564231913, 18.459639409779616, 0.09999999999999751, 555.0, 1347, 580602, 789, 121.36459309999918
790, 4.158031454188584, 15.443359582381841, 18.539729303156836, 0.0999999999999975, 540.0, 1352, 581954, 790, 121.29937389999395
791, 4.666486396311057, 15.458482179716293, 18.56340768583747, 0.09999999999999803, 265.0, 1151, 583105, 791, 103.32373490000464
792, 4.736407345865827, 15.452256601645177, 18.528689103297502, 0.10000000000000088, 65.0, 502, 583607, 792, 45.14391060000344
793, 4.517702945510911, 15.442258740540796, 18.534534730434903, 0.09999999999999867, 315.0, 981, 584588, 793, 88.27239839999675
794, 4.565094579615683, 15.470186994660576, 18.57444900656646, 0.10000000000000091, 35.0, 530, 585118, 794, 47.71401160000096
795, 4.4835554295446665, 15.465837908539385, 18.564481637277208, 0.10000000000000042, 260.0, 701, 585819, 795, 63.23092960000213
796, 4.127900540915592, 15.455023491695393, 18.55945216532004, 0.10000000000000055, 185.0, 686, 586505, 796, 61.67958859999635
797, 4.643926293001395, 15.468561073545077, 18.568313999890595, 0.10000000000000048, 215.0, 694, 587199, 797, 62.53020259999903
798, 4.599005757457149, 15.460851881625878, 18.564139058468115, 0.09999999999999745, 540.0, 1370, 588569, 798, 123.42367400000512
799, 4.680839501833086, 15.460823988935758, 18.568443766244283, 0.09999999999999813, 345.0, 1121, 589690, 799, 101.05612069999916
800, 4.0666340790232836, 15.50672202937457, 18.621035906733297, 0.10000000000000073, 90.0, 392, 590082, 800, 35.43596360000083
801, 4.720029978767822, 15.754294120428854, 18.921222197382075, 0.099999999999999, 395.0, 912, 590994, 801, 82.168365000005
802, 5.060911236147001, 15.764738756187995, 18.929072463972886, 0.09999999999999891, 160.0, 932, 591926, 802, 83.99987469999905
803, 5.098593429055185, 15.783848943453027, 18.959328077895627, 0.09999999999999803, 280.0, 1149, 593075, 803, 103.49408229999972
804, 4.774774389221983, 15.82464886935252, 19.00511279124134, 0.09999999999999755, 355.0, 1325, 594400, 804, 119.33276950000436
805, 4.081956430148053, 15.806670600551248, 18.981251038347704, 0.10000000000000088, 160.0, 651, 595051, 805, 58.46643310000218
806, 4.578615669565028, 15.802430863840033, 18.98573674638587, 0.10000000000000075, 155.0, 664, 595715, 806, 59.85256179999851
807, 4.802863262967792, 15.810477950356223, 18.969097228030822, 0.10000000000000012, 395.0, 737, 596452, 807, 66.4533650999947
808, 4.570690763326326, 15.806704559668297, 18.979778027498845, 0.10000000000000071, 115.0, 669, 597121, 808, 60.39649869999994
809, 5.0317331385102015, 15.799259098110632, 18.960694601313595, 0.0999999999999997, 270.0, 794, 597915, 809, 71.68483179999748
810, 5.292685223619143, 15.791916919477059, 18.955064238923967, 0.1000000000000008, 150.0, 660, 598575, 810, 59.62767609999719
811, 4.520170897842859, 15.801471123155558, 18.971678131031542, 0.09999999999999935, 265.0, 848, 599423, 811, 76.49736940000003
812, 4.282763710549508, 15.805573849294378, 18.969032997920596, 0.09999999999999923, 185.0, 870, 600293, 812, 78.5982950999969
813, 4.201005239224295, 15.7912139600637, 18.953506250075627, 0.10000000000000055, 120.0, 686, 600979, 813, 62.12093370000366
814, 5.268987378284528, 15.806257758202491, 18.9716072032978, 0.10000000000000071, 20.0, 385, 601364, 814, 34.9375629999995
815, 4.923063747591259, 15.791305072161279, 18.949043399214023, 0.09999999999999801, 645.0, 1157, 602521, 815, 104.40917679999984
816, 4.9310903915219795, 15.788381395442197, 18.95421549518112, 0.10000000000000087, 185.0, 653, 603174, 816, 59.31500130000495
817, 5.199682423373318, 15.793379150693069, 18.956616750458622, 0.09999999999999978, 200.0, 782, 603956, 817, 70.89624710000498
818, 5.89332777026796, 15.787032020179025, 18.961762925308115, 0.10000000000000056, 145.0, 685, 604641, 818, 62.29163439999684
819, 4.768833526778104, 15.762983138925335, 18.928081070848286, 0.09999999999999853, 430.0, 1015, 605656, 819, 92.56571239999903
820, 4.8717850088781, 15.771028892666687, 18.946554871166455, 0.09999999999999956, 290.0, 816, 606472, 820, 70.73194119999971
821, 5.163389806745245, 15.799677381620688, 18.968802115496466, 0.09999999999999824, 360.0, 1088, 607560, 821, 89.62538979999954
822, 5.196289132449253, 15.79047695521033, 18.96315561175615, 0.09999999999999754, 665.0, 1331, 608891, 822, 109.29705639999884
823, 5.006862268519669, 15.79920405833995, 18.966760595305626, 0.10000000000000031, 170.0, 714, 609605, 823, 58.628274700000475
824, 4.9804851144921685, 15.672776366068312, 18.821336716659797, 0.09999999999999873, 215.0, 968, 610573, 824, 79.46090130000084
825, 5.112261945311644, 15.635874589024121, 18.793945743292326, 0.10000000000000098, 60.0, 611, 611184, 825, 50.20682800000213
826, 5.3245354897373325, 15.631904352029414, 18.782226110365553, 0.10000000000000099, 125.0, 637, 611821, 826, 52.047363799996674
827, 5.422122097219846, 15.6070501601126, 18.73521296645896, 0.09999999999999876, 305.0, 962, 612783, 827, 78.78948579999997
828, 5.706418671573165, 15.63361742339865, 18.78300891514242, 0.10000000000000056, 155.0, 685, 613468, 828, 55.912412600002426
829, 5.17130300294922, 15.599902271198529, 18.73449075406677, 0.10000000000000096, 100.0, 581, 614049, 829, 47.614285999996355
830, 5.10209940933848, 15.605665260220166, 18.75418467847457, 0.10000000000000096, 90.0, 644, 614693, 830, 52.67533480000566
831, 5.928864128381834, 15.629117314749902, 18.76913664931551, 0.10000000000000092, 110.0, 545, 615238, 831, 44.612334700002975
832, 4.988805378648056, 15.594508885589887, 18.724201856112902, 0.09999999999999878, 275.0, 957, 616195, 832, 78.1330184000035
833, 4.5100777795431, 15.605438918447565, 18.73902427076061, 0.10000000000000063, 80.0, 677, 616872, 833, 55.310769199997594
834, 4.852375345329182, 15.61292574965545, 18.766283556150572, 0.09999999999999996, 210.0, 758, 617630, 834, 62.28174830000353
835, 5.23530858071124, 15.616480492317146, 18.767303736297347, 0.09999999999999766, 705.0, 1281, 618911, 835, 105.00344049999694
836, 4.914400593089005, 15.634431087145714, 18.800436373818723, 0.0999999999999986, 155.0, 997, 619908, 836, 88.0781582999989
837, 5.397958910223191, 15.944606291098038, 19.141694319671785, 0.09999999999999866, 170.0, 985, 620893, 837, 89.61494400000083
838, 4.905412502894326, 15.975861393963848, 19.18841624587932, 0.09999999999999884, 225.0, 945, 621838, 838, 83.89679939999769
839, 4.648535942698174, 15.992553844912894, 19.21446343274995, 0.10000000000000078, 180.0, 662, 622500, 839, 58.68065249999927
840, 5.052058219201961, 15.99662288323556, 19.213410646745587, 0.09999999999999996, 215.0, 758, 623258, 840, 67.68083009999827
841, 5.136578337072598, 15.999815481895972, 19.23134947945579, 0.09999999999999805, 440.0, 1147, 624405, 841, 101.63992039999721
842, 4.969326625380369, 15.998955961564372, 19.20142069589377, 0.10000000000000098, 75.0, 617, 625022, 842, 54.37232429999858
843, 4.943190624762555, 16.006017343365418, 19.22122007681399, 0.09999999999999869, 190.0, 980, 626002, 843, 86.08637050000107
844, 5.4308553572335, 16.016702567451492, 19.230750949396562, 0.09999999999999844, 360.0, 1038, 627040, 844, 95.51895599999989
845, 4.818579542746937, 16.006681650877, 19.218699157238007, 0.1000000000000004, 240.0, 704, 627744, 845, 62.21517820000008
846, 5.002636198845431, 16.02290051401612, 19.25692329102605, 0.09999999999999919, 210.0, 878, 628622, 846, 78.09554090000165
847, 4.6970981423876115, 16.020426860877446, 19.24499046121325, 0.10000000000000094, 170.0, 560, 629182, 847, 50.19068449999759
848, 5.078740650329812, 16.026345684455585, 19.248521536000112, 0.09999999999999816, 240.0, 1114, 630296, 848, 99.81783529999666
849, 4.732821356231412, 16.083386245500037, 19.323516398826982, 0.0999999999999966, 475.0, 1878, 632174, 849, 165.95151999999507
850, 4.41361192173494, 16.058821100249254, 19.26873115292214, 0.10000000000000074, 60.0, 401, 632575, 850, 35.34610849999444
851, 5.050361241751046, 16.07499297700227, 19.3018133336473, 0.09999999999999894, 325.0, 926, 633501, 851, 80.95064130000537
852, 4.586525699625844, 16.050330648560454, 19.28064085089642, 0.10000000000000052, 80.0, 690, 634191, 852, 59.638620300000184
853, 4.7807813364092775, 16.1072982833974, 19.33927735723711, 0.09999999999999878, 200.0, 956, 635147, 853, 86.37537730000622
854, 4.334764607013136, 16.11757550170456, 19.34744756118111, 0.10000000000000052, 170.0, 690, 635837, 854, 60.4481167000049
855, 4.610985123899561, 16.113300229435605, 19.3621709248018, 0.09999999999999853, 225.0, 1014, 636851, 855, 89.10361349999584
856, 4.970648568041786, 16.138796920547943, 19.38381747476117, 0.09999999999999859, 165.0, 1002, 637853, 856, 93.68597279999813
857, 4.391128070084951, 16.172721927882257, 19.435315446545626, 0.09999999999999692, 510.0, 1641, 639494, 857, 146.60014460000093
858, 4.388987301615998, 16.210862910375, 19.465105075389147, 0.1000000000000009, 45.0, 512, 640006, 858, 48.72408330000326
859, 4.568409076237932, 16.35036843888303, 19.64014786659403, 0.09999999999999887, 195.0, 940, 640946, 859, 90.26377550000325
860, 5.242999831322304, 16.356249680203838, 19.65182677970445, 0.09999999999999873, 345.0, 968, 641914, 860, 89.09153589999914
861, 4.2902064120184775, 16.36200498780118, 19.654509876347795, 0.10000000000000099, 115.0, 632, 642546, 861, 55.79791240000486
862, 4.997833610889879, 16.329197258562655, 19.588069545256126, 0.10000000000000096, 160.0, 592, 643138, 862, 54.5554159999956
863, 5.467774095776419, 16.3314750011749, 19.610827858257448, 0.10000000000000098, 300.0, 613, 643751, 863, 55.23785459999635
864, 4.904773973201106, 16.344820605060917, 19.632685649685744, 0.09999999999999866, 460.0, 984, 644735, 864, 88.3950887999963
865, 4.850445365108502, 16.33701507058113, 19.622871423223216, 0.09999999999999977, 230.0, 785, 645520, 865, 69.74689950000175
866, 5.210557350986882, 16.326392424734014, 19.629092493876197, 0.10000000000000067, 70.0, 361, 645881, 866, 32.12081600000238
867, 4.203453031437236, 16.305100542254152, 19.5936878845755, 0.10000000000000063, 40.0, 339, 646220, 867, 30.165790999999444
868, 5.192386184819043, 16.32504098303616, 19.599614191800356, 0.1000000000000009, 135.0, 512, 646732, 868, 46.01139949999924
869, 5.568551149324377, 16.349175667688016, 19.644560737669654, 0.09999999999999767, 565.0, 1276, 648008, 869, 113.01157060000696
870, 5.421774667727612, 16.35741220401871, 19.63007829822554, 0.09999999999999955, 250.0, 817, 648825, 870, 72.69090690000303
871, 4.77526985055422, 16.338285711182067, 19.62009068029335, 0.09999999999999858, 305.0, 1004, 649829, 871, 94.97689669999818
872, 5.165803346910961, 16.41436837347752, 19.71488157231757, 0.09999999999999781, 415.0, 1222, 651051, 872, 114.44802359999449
873, 5.370317746853006, 16.434397604273652, 19.734614017822732, 0.10000000000000091, 105.0, 522, 651573, 873, 50.29482129999815
874, 6.025092253065485, 16.457324276654635, 19.76329344067778, 0.09999999999999806, 480.0, 1143, 652716, 874, 105.20563650000258
875, 4.992507444259578, 16.43918294143979, 19.748669865201222, 0.0999999999999977, 395.0, 1263, 653979, 875, 120.88917850000144
876, 4.9788528986535, 16.463719266069752, 19.784644445498696, 0.09999999999999913, 165.0, 889, 654868, 876, 97.80944150000141
877, 4.659403969455698, 16.481698774092692, 19.76955375991054, 0.10000000000000067, 90.0, 358, 655226, 877, 33.623478999994404
878, 5.2726079985910195, 16.462064684483042, 19.789036110230256, 0.09999999999999967, 450.0, 798, 656024, 878, 74.96474809999927
879, 5.810999822334425, 16.50462627693041, 19.834389686584473, 0.10000000000000064, 205.0, 676, 656700, 879, 65.49620489999506
880, 5.003032282754746, 16.473054481980014, 19.783128328175344, 0.10000000000000082, 40.0, 451, 657151, 880, 43.28382749999582
881, 5.174877951961833, 16.462251177081814, 19.789956900980567, 0.10000000000000098, 120.0, 616, 657767, 881, 57.66893919999711
882, 4.979651353975336, 16.47416455838982, 19.795928731194618, 0.0999999999999982, 290.0, 1099, 658866, 882, 102.13121580000006
883, 5.179664627106294, 16.48507119330807, 19.808882680146592, 0.10000000000000052, 80.0, 690, 659556, 883, 65.2040160999968
884, 4.900083329603828, 16.439677172236973, 19.749016135629983, 0.09999999999999971, 295.0, 792, 660348, 884, 74.13385070000368
885, 4.883563977491245, 16.435361109377084, 19.745126869013458, 0.10000000000000091, 125.0, 527, 660875, 885, 48.996746099997836
886, 4.672676529203143, 16.417349084329107, 19.728253534031246, 0.10000000000000095, 80.0, 574, 661449, 886, 52.74448470000061
887, 5.215182560718864, 16.434516164422767, 19.7546169757843, 0.0999999999999976, 565.0, 1304, 662753, 887, 120.1636387000035
888, 5.0385527187593, 16.455257484628834, 19.78099145671234, 0.09999999999999946, 245.0, 831, 663584, 888, 77.80368710000039
889, 5.449966441238031, 16.430559147913904, 19.74470199143522, 0.09999999999999898, 190.0, 916, 664500, 889, 85.0667162000027
890, 4.9323175147286635, 16.42930981862051, 19.742336147523204, 0.09999999999999887, 210.0, 941, 665441, 890, 87.18198950000078
891, 5.186520036605856, 16.45119206628586, 19.763558067275163, 0.09999999999999867, 455.0, 982, 666423, 891, 91.14377450000029
892, 5.258930658277177, 16.47684950625162, 19.787299947151077, 0.10000000000000099, 70.0, 633, 667056, 892, 58.93206510000164
893, 4.6143239604645085, 16.450387318407902, 19.78353895593862, 0.10000000000000098, 85.0, 610, 667666, 893, 56.402668400005496
894, 5.2563734503510675, 16.466878035129646, 19.79583769883865, 0.10000000000000099, 230.0, 624, 668290, 894, 58.5783717000013
895, 5.222606385336783, 16.459361200045823, 19.776332407069386, 0.10000000000000091, 65.0, 532, 668822, 895, 49.22051280000596
896, 5.461674889190631, 16.480827876004305, 19.81667540290139, 0.0999999999999982, 315.0, 1100, 669922, 896, 103.46291520000523
897, 4.433822454188815, 16.523416039994256, 19.860083018391595, 0.10000000000000098, 95.0, 613, 670535, 897, 59.144801099995675
898, 4.909042034175859, 16.54437705367359, 19.880819302174583, 0.09999999999999752, 465.0, 1340, 671875, 898, 124.70793740000227
899, 4.951554925782465, 16.54937545487672, 19.89881958775797, 0.09999999999999747, 745.0, 1361, 673236, 899, 122.24229469999409
900, 5.757907727595126, 16.54710380039858, 19.884633173567526, 0.10000000000000081, 50.0, 445, 673681, 900, 38.28031660000124
901, 5.669918549474347, 16.5663209509051, 19.912670185691432, 0.09999999999999944, 210.0, 836, 674517, 901, 71.48098629999731
902, 5.091738425403002, 16.571089336121698, 19.923595854010713, 0.09999999999999858, 340.0, 1004, 675521, 902, 91.40646750000451
903, 4.469807823341858, 16.595581520961808, 19.928562288042865, 0.10000000000000099, 110.0, 632, 676153, 903, 58.101011700004165
904, 4.833219665787818, 16.587603052282123, 19.939653029000706, 0.09999999999999902, 255.0, 908, 677061, 904, 77.27629460000026
905, 4.2349320682521645, 16.591102187104802, 19.930687433506154, 0.10000000000000085, 20.0, 478, 677539, 905, 39.77757759999804
906, 5.1947219255792945, 16.601846132097364, 19.965710501127607, 0.10000000000000099, 155.0, 632, 678171, 906, 52.144853999998304
907, 4.777741523990669, 16.57645413291502, 19.91637611772162, 0.0999999999999986, 410.0, 996, 679167, 907, 85.35100200000306
908, 4.985986842931348, 16.576211315972827, 19.92692314229221, 0.1, 175.0, 751, 679918, 908, 67.11325159999978
909, 5.459370217971431, 16.766540199576074, 20.145686599583303, 0.1000000000000009, 160.0, 515, 680433, 909, 46.021458000002895
910, 5.097976669753657, 16.803750896273577, 20.186875705682937, 0.09999999999999835, 295.0, 1058, 681491, 910, 93.70242989999679
911, 4.849240985457242, 16.81387961263333, 20.200808296328958, 0.099999999999999, 225.0, 913, 682404, 911, 80.82238620000135
912, 5.698725944345302, 16.81059128578673, 20.190847910211442, 0.09999999999999887, 460.0, 940, 683344, 912, 83.68396770000254
913, 5.544184695361024, 16.793397812336362, 20.182185004047692, 0.10000000000000091, 175.0, 649, 683993, 913, 57.584091500000795
914, 4.938694919940745, 16.818775526355655, 20.191880728714263, 0.09999999999999981, 200.0, 778, 684771, 914, 68.89382580000529
915, 5.472586674611164, 16.81670482972916, 20.197928998042677, 0.09999999999999958, 190.0, 814, 685585, 915, 71.84411950000504
916, 5.032929419788389, 16.818529758813245, 20.199866701007853, 0.10000000000000007, 390.0, 742, 686327, 916, 65.8777614999999
917, 4.754523568114742, 16.81791188422085, 20.201832490808822, 0.09999999999999945, 180.0, 833, 687160, 917, 73.8073654999971
918, 5.571342155001419, 16.84094534702834, 20.23282112658185, 0.09999999999999817, 340.0, 1109, 688269, 918, 97.93970239999908
919, 4.930917944194477, 16.839744233312324, 20.221253426900013, 0.0999999999999984, 220.0, 1049, 689318, 919, 92.78019260000292
920, 5.5561611692894965, 17.069963805856762, 20.516595790260716, 0.09999999999999745, 295.0, 1368, 690686, 920, 120.85819839999749
921, 4.926408198798696, 17.323716133435568, 20.815195202827454, 0.09999999999999788, 655.0, 1200, 691886, 921, 105.88490060000186
922, 4.834044031504184, 17.330753696391362, 20.841010627100022, 0.10000000000000091, 50.0, 531, 692417, 922, 46.992254500000854
923, 5.309781776366907, 17.32685130280277, 20.831456573083397, 0.09999999999999923, 340.0, 871, 693288, 923, 77.09297309999965
924, 5.090609246030801, 17.351012121814936, 20.83959922191136, 0.09999999999999912, 335.0, 891, 694179, 924, 78.8787153000012
925, 5.297189093030905, 17.33222325745615, 20.814316473792942, 0.10000000000000099, 50.0, 619, 694798, 925, 54.70196709999436
926, 5.324640936306227, 17.305022283084472, 20.789888600067886, 0.09999999999999931, 280.0, 857, 695655, 926, 75.82922649999819
927, 5.116352547934594, 17.31659632769757, 20.79376626406728, 0.09999999999999752, 500.0, 1338, 696993, 927, 118.23239570000442
928, 4.969457967692826, 17.310395154614135, 20.78777694508509, 0.09999999999999866, 350.0, 985, 697978, 928, 87.09881769999629
929, 5.294327621303854, 17.3233433053607, 20.82275695744015, 0.10000000000000069, 130.0, 672, 698650, 929, 59.532582300002105
930, 6.092867375068042, 17.336728657501332, 20.820995189141534, 0.10000000000000094, 150.0, 552, 699202, 930, 48.81823009999789
931, 4.935779766301567, 17.323175476710738, 20.815607879833163, 0.09999999999999927, 335.0, 863, 700065, 931, 76.33547879999969
932, 5.431271048260242, 17.50629286240455, 21.02504431583967, 0.09999999999999999, 225.0, 753, 700818, 932, 66.59823529999994
933, 5.032869693313737, 17.487376707145966, 21.026703515110245, 0.10000000000000077, 65.0, 415, 701233, 933, 36.74308110000129
934, 5.193527927901596, 17.49643770158291, 21.030844083428384, 0.100000000000001, 175.0, 640, 701873, 934, 56.615724399998726
935, 5.581398369313718, 17.53089774764694, 21.06188409249704, 0.0999999999999986, 265.0, 999, 702872, 935, 88.38416660000075
936, 5.205643029289593, 17.545451317529487, 21.080885556549948, 0.09999999999999803, 350.0, 1151, 704023, 936, 101.48091489999933
937, 5.68596827602215, 17.53000467698351, 21.05437294939439, 0.0999999999999974, 695.0, 1390, 705413, 937, 123.01654699999926
938, 5.371831381556153, 17.52893371819707, 21.0422854458184, 0.09999999999999876, 400.0, 963, 706376, 938, 85.23129490000429
939, 5.441178097197388, 17.54744653501381, 21.077001373611658, 0.0999999999999996, 360.0, 809, 707185, 939, 71.67181849999906
940, 5.859026983517529, 17.557277050685705, 21.091654399921, 0.10000000000000092, 85.0, 543, 707728, 940, 48.11202640000556
941, 5.125711509580702, 17.54298981766873, 21.08412795014434, 0.10000000000000099, 150.0, 637, 708365, 941, 56.56227260000014
942, 5.3042461285508296, 17.532153777845675, 21.076254994487474, 0.09999999999999756, 590.0, 1324, 709689, 942, 117.09904429999733
943, 6.20416406773578, 17.558404903627384, 21.111847144735734, 0.10000000000000035, 130.0, 708, 710397, 943, 62.79469059999974
944, 5.161805814170456, 17.581555311958088, 21.111477827862142, 0.09999999999999921, 225.0, 874, 711271, 944, 77.74666459999571
945, 5.123298203270968, 17.564309215790814, 21.127290485450725, 0.10000000000000073, 10.0, 389, 711660, 945, 34.46959639999841
946, 5.735695438655236, 17.578841082179984, 21.11399574459936, 0.09999999999999937, 200.0, 847, 712507, 946, 75.16829790000338
947, 5.529483803479666, 17.58571850511387, 21.124596734794697, 0.09999999999999769, 800.0, 1269, 713776, 947, 112.2521928999995
948, 5.4617157665944305, 17.577536693873768, 21.104929157944976, 0.09999999999999766, 445.0, 1281, 715057, 948, 113.36647780000203
949, 5.702618336413708, 17.594685042168294, 21.132625622048945, 0.10000000000000088, 120.0, 497, 715554, 949, 44.03728969999793
950, 5.3776280112922885, 17.554719036095968, 21.102569070819204, 0.10000000000000098, 80.0, 603, 716157, 950, 53.4165051999953
951, 5.929368561876871, 17.538830277833295, 21.072562983616645, 0.10000000000000073, 25.0, 386, 716543, 951, 34.261638699994364
952, 5.77375542938048, 17.572206723897846, 21.109198707786113, 0.10000000000000099, 200.0, 631, 717174, 952, 55.914109900004405
953, 5.401794626270216, 17.55389768131088, 21.0803245690944, 0.1000000000000004, 115.0, 703, 717877, 953, 62.07966139999917
954, 5.48460993374978, 17.5373151152284, 21.06425971451339, 0.1000000000000003, 170.0, 715, 718592, 954, 63.14070029999857
955, 5.355559804551699, 17.544892347275034, 21.065421131927074, 0.10000000000000081, 210.0, 659, 719251, 955, 58.347413000003144
956, 6.432742393767561, 17.515710612289777, 21.028287134097734, 0.10000000000000091, 100.0, 524, 719775, 956, 46.49275839999609
957, 4.680703476677096, 17.680290433061803, 21.23353046634333, 0.10000000000000098, 100.0, 615, 720390, 957, 54.658237999996345
958, 6.02515982597092, 17.763873234676804, 21.3451534774419, 0.09999999999999913, 320.0, 887, 721277, 958, 78.64662969999335
959, 5.323481796527191, 17.780308727209263, 21.358233801482072, 0.09999999999999994, 230.0, 761, 722038, 959, 67.46745129999908
960, 5.443728082528398, 17.760002621051203, 21.334195237181504, 0.10000000000000082, 140.0, 657, 722695, 960, 58.20394059999671
961, 6.398700332893999, 17.78858794606858, 21.350313767548105, 0.10000000000000098, 90.0, 614, 723309, 961, 54.592854100003024
962, 5.654381572017985, 17.760064697265626, 21.341737403554365, 0.10000000000000098, 65.0, 605, 723914, 962, 54.54750480000075
963, 5.397007881047947, 17.73977767617759, 21.303334651314714, 0.09999999999999822, 260.0, 1098, 725012, 963, 96.15692539999873
964, 5.435978932905009, 17.724710287662184, 21.279603284726715, 0.1000000000000009, 65.0, 507, 725519, 964, 44.41433210000105
965, 5.1100611352701515, 17.71810515846793, 21.28993941730089, 0.09999999999999992, 240.0, 762, 726281, 965, 84.56019099999685
966, 5.555761043519435, 17.718539684564046, 21.287180621181253, 0.09999999999999679, 580.0, 1734, 728015, 966, 185.02041360000294
967, 5.213210030888928, 17.703413132133832, 21.25312969954371, 0.10000000000000085, 210.0, 654, 728669, 967, 65.02035800000158
968, 5.071561016911602, 17.661054795470562, 21.203202056322127, 0.09999999999999748, 530.0, 1356, 730025, 968, 126.44094969999423
969, 5.686837974016404, 17.537277746812762, 21.06284671843307, 0.10000000000000042, 185.0, 701, 730726, 969, 69.46319360000052
970, 5.173096449685698, 17.549414214767328, 21.091348707375406, 0.09999999999999791, 315.0, 1190, 731916, 970, 111.37818690000131
971, 6.2904245087345565, 17.58015997955418, 21.11862773955055, 0.10000000000000057, 35.0, 319, 732235, 971, 31.25670330000139
972, 5.337275680907876, 17.56707442962562, 21.083267700639126, 0.10000000000000024, 185.0, 722, 732957, 972, 68.59760549999919
973, 5.637572598031589, 17.557191795962197, 21.08367085456848, 0.09999999999999813, 520.0, 1120, 734077, 973, 105.43336850000196
974, 5.1025978361201965, 17.521273379919233, 21.04152887621741, 0.10000000000000073, 170.0, 667, 734744, 974, 63.251706700000796
975, 5.285950342536639, 17.497327735304168, 21.021204889819607, 0.10000000000000067, 65.0, 358, 735102, 975, 34.61233070000162
976, 5.516382766606139, 17.515776013298858, 21.04044569825097, 0.10000000000000094, 125.0, 556, 735658, 976, 53.89040109999769
977, 5.6645967496765985, 17.51068241442021, 21.028726821317402, 0.10000000000000098, 110.0, 603, 736261, 977, 55.4300796000025
978, 5.691536734807186, 17.508750773698857, 21.023349693493966, 0.0999999999999998, 180.0, 780, 737041, 978, 69.33605759999773
979, 5.624280098093793, 17.500272083492995, 21.01008872691106, 0.09999999999999903, 435.0, 906, 737947, 979, 76.10870860000432
980, 5.881058364425033, 17.477697507259503, 20.98342223375602, 0.10000000000000087, 110.0, 481, 738428, 980, 40.454351000000315
981, 5.456446090956482, 17.470647231983175, 20.993976135435126, 0.0999999999999994, 230.0, 842, 739270, 981, 71.0129342999935
982, 5.0892132740953695, 17.45794347798602, 20.959853533632266, 0.10000000000000059, 15.0, 322, 739592, 982, 27.256403899998986
983, 5.480881703465353, 17.556228738214344, 21.084072876981754, 0.09999999999999995, 260.0, 759, 740351, 983, 63.99244329999783
984, 5.064393307341904, 17.73766793366161, 21.299871311102468, 0.10000000000000069, 150.0, 671, 741022, 984, 56.622946099996625
985, 5.573017251818148, 17.681129920065313, 21.233602187042003, 0.10000000000000082, 105.0, 657, 741679, 985, 55.3421057999949
986, 5.5424198827362465, 17.653535802428422, 21.223046484897296, 0.10000000000000037, 140.0, 707, 742386, 986, 59.50334909999947
987, 5.1358915386275, 17.666097694101403, 21.215788132341952, 0.09999999999999949, 235.0, 826, 743212, 987, 69.5693853000048
988, 5.679617621814995, 17.67558200010779, 21.26852236519083, 0.09999999999999931, 325.0, 855, 744067, 988, 72.30968869999924
989, 5.167415952682495, 17.67909502168981, 21.22788487566196, 0.10000000000000098, 140.0, 615, 744682, 989, 51.834530000000086
990, 5.479588273563996, 17.702478650755484, 21.261229439909236, 0.09999999999999959, 220.0, 812, 745494, 990, 68.48057039999549
991, 5.529014076067119, 17.684611342534296, 21.23691228257508, 0.09999999999999881, 175.0, 952, 746446, 991, 80.20175890000246
992, 5.541059112195344, 17.70245664592657, 21.256263662701006, 0.09999999999999869, 135.0, 978, 747424, 992, 82.24875199999951
993, 4.950730109607085, 17.73409997936014, 21.31073480350956, 0.09999999999999885, 255.0, 942, 748366, 993, 80.109157400002
994, 5.955562555098879, 17.776179482280345, 21.351387908493262, 0.10000000000000064, 65.0, 345, 748711, 994, 29.3837954000046
995, 5.086564042631597, 17.72626604674662, 21.278956654152807, 0.10000000000000063, 150.0, 677, 749388, 995, 57.01249380000081
996, 5.07280376779581, 17.651991446337064, 21.192442473299252, 0.09999999999999859, 365.0, 1002, 750390, 996, 84.38254700000107
997, 5.04756098769099, 17.49740562921075, 21.013496022277156, 0.10000000000000099, 65.0, 633, 751023, 997, 56.48940230000153
998, 5.075949765822072, 17.51312738464406, 21.04140522189642, 0.09999999999999785, 510.0, 1207, 752230, 998, 114.6686139999947
999, 5.828806675305856, 17.51765437830939, 21.05602928801637, 0.1, 225.0, 751, 752981, 999, 71.66296100000181
1000, 5.352510547799537, 17.5330975704571, 21.065852645539888, 0.09999999999999877, 260.0, 959, 753940, 1000, 90.1747927999968
1001, 5.0263258241975795, 17.54883178223702, 21.084641596238562, 0.10000000000000098, 205.0, 642, 754582, 1001, 60.020903600001475
1002, 5.415030562279949, 17.55368654309541, 21.0784234309927, 0.10000000000000027, 45.0, 718, 755300, 1002, 66.27525620000233
1003, 5.250091347641076, 17.558712799836016, 21.086855273912, 0.09999999999999887, 350.0, 939, 756239, 1003, 87.2095713000017
1004, 4.692204082012177, 17.592044546944756, 21.14092927660261, 0.10000000000000064, 40.0, 350, 756589, 1004, 31.987488300001132
1005, 5.080471896813945, 17.529103722989834, 21.06256664293702, 0.10000000000000088, 145.0, 651, 757240, 1005, 59.801298999998835
1006, 4.8171539808231625, 17.555927860280857, 21.066314223034134, 0.10000000000000069, 55.0, 366, 757606, 1006, 33.76973210000142
1007, 5.567316729562564, 17.547559322090017, 21.073700167965807, 0.09999999999999923, 160.0, 871, 758477, 1007, 80.72544729999936
1008, 5.520514701964402, 17.56404411454915, 21.099721522466375, 0.09999999999999865, 530.0, 988, 759465, 1008, 91.05182590000186
1009, 5.13832644208796, 17.729158046252408, 21.292368424314482, 0.10000000000000045, 225.0, 698, 760163, 1009, 64.39751870000327
1010, 4.987182998736965, 18.272534099310935, 21.952237683129283, 0.09999999999999909, 280.0, 897, 761060, 1010, 81.89578539999638
1011, 4.728208594451858, 18.255886308376162, 21.90807135083524, 0.10000000000000078, 160.0, 662, 761722, 1011, 61.06689449999976
1012, 5.48415507509054, 18.254246029820475, 21.928719005384647, 0.09999999999999805, 510.0, 1144, 762866, 1012, 105.64529030000267
1013, 4.884053301943307, 18.22915999182704, 21.89768011528149, 0.09999999999999827, 335.0, 1083, 763949, 1013, 100.38003949999984
1014, 5.831117419631329, 18.255056381225586, 21.938029563527387, 0.09999999999999946, 350.0, 831, 764780, 1014, 76.09931920000236
1015, 5.221546324873061, 18.262786162622046, 21.940499795205664, 0.09999999999999837, 310.0, 1056, 765836, 1015, 96.9891306999998
1016, 4.922040284944009, 18.281266315142833, 21.952647571657067, 0.0999999999999978, 430.0, 1226, 767062, 1016, 111.49380519999977
1017, 5.028817272329905, 18.282461258302252, 21.959677803468512, 0.10000000000000088, 135.0, 498, 767560, 1017, 45.32079710000107
1018, 5.400256878942068, 18.265276870844556, 21.93648812522186, 0.10000000000000088, 165.0, 652, 768212, 1018, 59.91339579999476
1019, 5.343141984661049, 18.26655601608419, 21.933110943018832, 0.09999999999999831, 285.0, 1070, 769282, 1019, 97.31183139999484
1020, 5.0747576119853, 18.2724945392484, 21.951624342974494, 0.09999999999999991, 400.0, 765, 770047, 1020, 65.03587449999759
1021, 4.950869247222918, 18.62062075515678, 22.37525075679451, 0.09999999999999819, 265.0, 1105, 771152, 1021, 96.39318440000352
1022, 5.507776430534654, 18.65715987797746, 22.399146591720818, 0.09999999999999871, 235.0, 971, 772123, 1022, 81.96123009999428
1023, 5.342131294270672, 18.632364424448166, 22.370473165360707, 0.10000000000000095, 80.0, 567, 772690, 1023, 48.54715160000342
1024, 5.167246110445664, 18.61821196172585, 22.359234979568427, 0.09999999999999812, 630.0, 1124, 773814, 1024, 117.4871701000011
1025, 6.234442139973416, 18.649398077214624, 22.400487293972272, 0.09999999999999962, 155.0, 806, 774620, 1025, 83.12434029999713
1026, 5.463381610139385, 18.63438801608243, 22.37941992204268, 0.09999999999999902, 150.0, 910, 775530, 1026, 87.12612929999887
1027, 6.020398127698453, 18.648883359083133, 22.390096055384365, 0.10000000000000098, 120.0, 642, 776172, 1027, 75.07243400000152
1028, 4.988121009437662, 18.637733907197653, 22.36851079037315, 0.09999999999999881, 165.0, 950, 777122, 1028, 115.52433680000104
1029, 5.663372311052064, 18.664606971627528, 22.42292236267754, 0.09999999999999855, 500.0, 1011, 778133, 1029, 101.15798709999945
1030, 5.490077289610352, 18.677990867275334, 22.415960027816446, 0.09999999999999845, 410.0, 1034, 779167, 1030, 100.2966424000042
1031, 5.3614697139838645, 18.631490760013975, 22.375716525110704, 0.10000000000000095, 95.0, 580, 779747, 1031, 58.58452150000085
1032, 5.56754478329589, 18.849340377066298, 22.621158402941006, 0.10000000000000088, 75.0, 494, 780241, 1032, 49.185827499997686
1033, 4.769306516188841, 19.04290663401286, 22.850805468437, 0.10000000000000073, 70.0, 390, 780631, 1033, 41.880308399995556
1034, 5.153528944106612, 19.01914242024486, 22.828984105079467, 0.09999999999999876, 220.0, 963, 781594, 1034, 97.0851629999961
1035, 5.490101229791288, 19.002104466756183, 22.821304844043873, 0.10000000000000066, 120.0, 675, 782269, 1035, 65.65517109999928
1036, 6.190439559452569, 19.000750829212702, 22.802405257723226, 0.1000000000000007, 170.0, 670, 782939, 1036, 64.78059999999823
1037, 5.085277593581476, 19.020719194857875, 22.836119632186175, 0.09999999999999831, 300.0, 1070, 784009, 1037, 105.82305030000134
1038, 5.480709103220749, 19.032688059471333, 22.840202267744687, 0.09999999999999926, 115.0, 867, 784876, 1038, 82.81932049999887
1039, 5.035746204125987, 19.022879691408733, 22.835729516597684, 0.09999999999999976, 200.0, 787, 785663, 1039, 72.87235369999689
1040, 5.472784720683304, 19.06260893873935, 22.89360462119096, 0.09999999999999842, 365.0, 1041, 786704, 1040, 94.32795230000193
1041, 4.868979937476771, 19.06027207715171, 22.86653628349304, 0.10000000000000094, 160.0, 560, 787264, 1041, 52.35753069999919
1042, 4.680475254825184, 19.066665216173444, 22.881100670950755, 0.10000000000000042, 145.0, 700, 787964, 1042, 65.54872920000344
1043, 5.380752502216233, 19.066572421442263, 22.90923802057902, 0.09999999999999998, 270.0, 756, 788720, 1043, 71.85009880000143
1044, 5.362825975946437, 19.060062569034205, 22.872628674798772, 0.09999999999999772, 295.0, 1259, 789979, 1044, 112.85568030000286
1045, 5.680762353445121, 19.100177093591103, 22.950668906810343, 0.10000000000000092, 125.0, 537, 790516, 1045, 49.40516899999784
1046, 5.103733058304316, 19.079209602966877, 22.900404107859238, 0.10000000000000092, 80.0, 537, 791053, 1046, 47.223564500003704
1047, 5.382499269570745, 19.04843417765421, 22.87605316216866, 0.09999999999999944, 235.0, 836, 791889, 1047, 74.9629969000016
1048, 5.020432097608583, 19.01972404000355, 22.834463367685238, 0.10000000000000057, 170.0, 684, 792573, 1048, 59.75579629999993
1049, 4.655909829779176, 19.007498412732257, 22.81959306325344, 0.09999999999999903, 185.0, 906, 793479, 1049, 78.00146900000254
1050, 5.456595193278727, 18.998864218826693, 22.81382807187385, 0.0999999999999988, 430.0, 955, 794434, 1050, 82.35694149999472
1051, 4.710769376426171, 19.03893129886725, 22.85824349721273, 0.0999999999999998, 245.0, 780, 795214, 1051, 67.30681929999992
1052, 5.442714609333936, 19.030766882814365, 22.84653325199397, 0.10000000000000091, 50.0, 523, 795737, 1052, 45.15601179999794
1053, 5.659912760130705, 19.026529367173815, 22.840807316702822, 0.09999999999999906, 415.0, 901, 796638, 1053, 77.45413449999614
1054, 5.1923966062563895, 19.06441092709267, 22.89477438527375, 0.09999999999999734, 675.0, 1421, 798059, 1054, 122.64232610000181
1055, 5.427775112903901, 19.087455443222158, 22.9198254633994, 0.10000000000000056, 160.0, 685, 798744, 1055, 59.74342149999575
1056, 4.546754421194627, 19.088034951422568, 22.91420819739895, 0.09999999999999931, 225.0, 857, 799601, 1056, 74.57848179999564
1057, 4.846742119672749, 18.963352609188, 22.76213961280183, 0.09999999999999967, 190.0, 799, 800400, 1057, 68.82113250000111
1058, 4.909665859877803, 18.7914346378443, 22.557917651130644, 0.09999999999999898, 235.0, 916, 801316, 1058, 78.9532246000017
1059, 5.598973157472372, 18.803227924565387, 22.576578003019314, 0.1000000000000006, 100.0, 681, 801997, 1059, 58.663163299999724
1060, 4.845314939878881, 18.81468051161085, 22.594886226313456, 0.09999999999999813, 315.0, 1120, 803117, 1060, 96.78273850000551
1061, 4.320105099562923, 18.795772069513543, 22.56399698216516, 0.10000000000000084, 40.0, 466, 803583, 1061, 43.42357410000113
1062, 5.330395091445215, 18.784360839474587, 22.5556502157642, 0.10000000000000099, 120.0, 620, 804203, 1062, 55.10161640000297
1063, 5.022994767226182, 18.82010696708382, 22.602306905969396, 0.10000000000000071, 85.0, 385, 804588, 1063, 34.169397700003174
1064, 4.5936763929509965, 18.81412275032587, 22.58347844114719, 0.09999999999999887, 395.0, 941, 805529, 1064, 83.27070590000221
1065, 5.303274456298713, 18.827270478913277, 22.60466194152832, 0.10000000000000096, 120.0, 594, 806123, 1065, 52.60670789999858
1066, 5.192244720323239, 18.801470746658357, 22.573948273747604, 0.10000000000000087, 55.0, 483, 806606, 1066, 42.77889419999701
1067, 5.384370960854248, 18.789655849357906, 22.551573863946725, 0.10000000000000014, 175.0, 733, 807339, 1067, 66.21491329999844
1068, 4.609900849273686, 18.802103775699123, 22.57865272790126, 0.09999999999999916, 235.0, 882, 808221, 1068, 78.22116300000198
1069, 5.401141927188852, 18.794959522428968, 22.57633847415614, 0.10000000000000031, 185.0, 714, 808935, 1069, 63.18906409999909
1070, 4.696538420161473, 18.82071448208993, 22.599653074738903, 0.09999999999999873, 255.0, 969, 809904, 1070, 87.94235710000066
1071, 4.762003889074316, 18.893518516609262, 22.681638799749457, 0.0999999999999986, 340.0, 999, 810903, 1071, 99.33819779999612
1072, 4.918423838358701, 18.937371862439903, 22.74072941608582, 0.09999999999999921, 445.0, 873, 811776, 1072, 71.8356963000042
1073, 4.288273631607637, 18.90779486051644, 22.70747975623217, 0.10000000000000091, 60.0, 519, 812295, 1073, 42.61195790000056
1074, 4.849507032881809, 18.955093060867696, 22.75566503669642, 0.10000000000000099, 180.0, 632, 812927, 1074, 53.325699399996665
1075, 5.462331986296718, 18.956132241071483, 22.768239419784905, 0.100000000000001, 180.0, 639, 813566, 1075, 57.257083800002874
1076, 5.102383076583197, 18.92542414463109, 22.715833532192644, 0.10000000000000099, 90.0, 637, 814203, 1076, 57.01635750000423
1077, 5.443368185701824, 18.90894863037836, 22.692929821922665, 0.10000000000000078, 75.0, 420, 814623, 1077, 37.54133179999917
1078, 5.545107657191534, 18.933921566991465, 22.73482013827367, 0.10000000000000099, 135.0, 641, 815264, 1078, 57.178329599999415
1079, 5.341356611359227, 18.93749555982985, 22.75092435097909, 0.09999999999999817, 280.0, 1110, 816374, 1079, 98.97125240000605
1080, 4.819478440944321, 18.925332750225195, 22.743595998457728, 0.10000000000000009, 160.0, 741, 817115, 1080, 66.26215519999823
1081, 4.3232442201333265, 18.915511983375794, 22.706456174754134, 0.09999999999999824, 235.0, 1089, 818204, 1081, 96.9785200999977
1082, 4.884400799950177, 18.947612770610952, 22.747798923757625, 0.0999999999999989, 285.0, 935, 819139, 1082, 83.00049610000133
1083, 5.567777310035847, 18.95216310571741, 22.74926222624602, 0.10000000000000066, 175.0, 675, 819814, 1083, 59.95924620000005
1084, 4.944592705635147, 18.787488306501867, 22.55840846800883, 0.09999999999999903, 280.0, 907, 820721, 1084, 80.78528099999676
1085, 5.089256033476661, 18.7341459236893, 22.49399934095495, 0.0999999999999985, 300.0, 1020, 821741, 1085, 90.79989439999918
1086, 4.863774288324354, 18.72419360500686, 22.47807573542543, 0.09999999999999853, 370.0, 1013, 822754, 1086, 90.21871580000152
1087, 5.694251046710306, 18.70625361435705, 22.45927630911628, 0.10000000000000094, 70.0, 556, 823310, 1087, 49.639663299996755
1088, 5.065401189627842, 18.713989465286765, 22.466937113456584, 0.0999999999999996, 340.0, 809, 824119, 1088, 72.06527300000016
1089, 4.319185092173358, 18.68632695522714, 22.421109054950957, 0.1, 190.0, 752, 824871, 1089, 66.9544332000005
1090, 5.8382072208419675, 18.689031049940322, 22.435378510611397, 0.10000000000000099, 80.0, 630, 825501, 1090, 56.11902179999743
1091, 4.664686331314677, 18.68943123699002, 22.426307408000312, 0.09999999999999826, 235.0, 1087, 826588, 1091, 96.97191960000055
1092, 4.768110703468323, 18.68200081062317, 22.415861349105835, 0.09999999999999859, 345.0, 1000, 827588, 1092, 89.23403859999962
1093, 5.061255196469215, 18.703474618758854, 22.437704033669913, 0.09999999999999994, 220.0, 761, 828349, 1093, 67.77462709999963
1094, 4.884868569811755, 18.72187062424362, 22.458754647790137, 0.09999999999999903, 190.0, 907, 829256, 1094, 80.88841889999458
1095, 4.896237219421797, 18.709313932372968, 22.46118692270419, 0.0999999999999971, 910.0, 1539, 830795, 1095, 138.0731866999995
1096, 5.495472246126962, 18.695384650259783, 22.443145097893122, 0.10000000000000087, 125.0, 487, 831282, 1096, 47.926731200001086
1097, 4.90649993022283, 18.68905744905825, 22.41775839770282, 0.10000000000000092, 175.0, 540, 831822, 1097, 49.36433720000059
1098, 5.204943664512292, 18.7054556192304, 22.449899401472287, 0.09999999999999815, 410.0, 1115, 832937, 1098, 121.50484479999432
1099, 4.828227393855267, 18.737344574548118, 22.491698469279296, 0.09999999999999919, 445.0, 878, 833815, 1099, 82.20263229999546
1100, 5.419627662167861, 18.714590727072, 22.46211265925629, 0.09999999999999915, 210.0, 886, 834701, 1100, 77.68013019999489
1101, 5.540158177098484, 18.751993329474267, 22.50213211140734, 0.09999999999999735, 535.0, 1410, 836111, 1101, 123.49763539999549
1102, 5.71180340167573, 18.723258321620904, 22.48210245362214, 0.10000000000000052, 285.0, 689, 836800, 1102, 61.14609780000319
1103, 5.8050441516279685, 18.74157253312476, 22.498268602316273, 0.10000000000000087, 110.0, 486, 837286, 1103, 42.583679300005315
1104, 5.234040119462467, 18.700261374371884, 22.42380156503287, 0.10000000000000048, 175.0, 694, 837980, 1104, 59.703763500001514
1105, 5.26894649661671, 18.68298118313876, 22.421029898903587, 0.09999999999999744, 680.0, 1375, 839355, 1105, 122.10356239999965
1106, 5.432054466559337, 18.69358745281513, 22.439524817833533, 0.1000000000000009, 175.0, 650, 840005, 1106, 57.9205218000061
1107, 5.970774604002171, 18.984255974216293, 22.771226557628754, 0.10000000000000055, 195.0, 686, 840691, 1107, 59.393257199997606
1108, 6.057592881226428, 18.98296495618568, 22.75716095504642, 0.10000000000000096, 150.0, 643, 841334, 1108, 55.70286979999946
1109, 5.916838839575274, 18.941247990382976, 22.727723902793386, 0.09999999999999969, 425.0, 796, 842130, 1109, 69.23742330000096
1110, 5.598269740131004, 18.97077881213764, 22.766633751724605, 0.09999999999999806, 270.0, 1141, 843271, 1110, 99.07730509999965
1111, 5.555217800109754, 18.986854409983035, 22.782345847178824, 0.09999999999999855, 200.0, 1012, 844283, 1111, 88.08077620000404
1112, 5.062787958897832, 19.006721874562704, 22.778305393893543, 0.10000000000000084, 210.0, 656, 844939, 1112, 56.9364562999981
1113, 5.144427413395583, 18.97075166810467, 22.777482726778743, 0.10000000000000098, 210.0, 617, 845556, 1113, 53.8809420999969
1114, 5.369089340979235, 19.018302846323696, 22.821133571065914, 0.0999999999999982, 245.0, 1099, 846655, 1114, 98.03299079999852
1115, 5.976966515293828, 18.99435152689616, 22.792706380773474, 0.10000000000000066, 145.0, 675, 847330, 1115, 59.14401419999922
1116, 5.407079727149211, 19.015659621999234, 22.805617368673975, 0.09999999999999883, 185.0, 948, 848278, 1116, 82.97046540000156
1117, 4.9736574645868075, 19.025608452377615, 22.81165868855636, 0.1000000000000009, 115.0, 514, 848792, 1117, 45.15601250000327
1118, 5.570158679597797, 19.02389468706006, 22.83643920124725, 0.09999999999999706, 440.0, 1558, 850350, 1118, 136.11512849999417
1119, 5.774877097645343, 19.03382127372553, 22.840013108224973, 0.09999999999999797, 265.0, 1171, 851521, 1119, 102.14308419999725
1120, 5.938770434401271, 19.042274352591768, 22.835704723497674, 0.09999999999999813, 320.0, 1121, 852642, 1120, 99.39758189999702
1121, 5.460708671199057, 19.039862279184835, 22.83874307987924, 0.10000000000000088, 85.0, 499, 853141, 1121, 46.3236151999954
1122, 4.965451552548746, 18.99040032634585, 22.794295564786655, 0.10000000000000099, 175.0, 635, 853776, 1122, 58.73390769999969
1123, 4.901206753913711, 19.01573427968055, 22.808063330140502, 0.10000000000000099, 60.0, 636, 854412, 1123, 58.588524699996924
1124, 5.842206806691836, 18.9946646765108, 22.804960164156828, 0.100000000000001, 205.0, 638, 855050, 1124, 58.74158670000179
1125, 4.837658898296581, 18.98326913917105, 22.78956135515412, 0.10000000000000096, 105.0, 594, 855644, 1125, 54.72316819999833
1126, 5.390466996939631, 18.993634266676274, 22.79234020413876, 0.0999999999999998, 140.0, 781, 856425, 1126, 71.68330940000305
1127, 4.733674536685686, 18.961551001265242, 22.75035131299818, 0.1000000000000001, 205.0, 740, 857165, 1127, 68.02840450000076
1128, 5.408385938868042, 18.99244886294816, 22.791421730573788, 0.10000000000000095, 250.0, 645, 857810, 1128, 59.35515139999916
1129, 4.7769635204564445, 18.945205088817712, 22.740216645327482, 0.10000000000000091, 130.0, 528, 858338, 1129, 48.30448609999439
1130, 4.516284576754881, 18.936709484348995, 22.722684829905983, 0.10000000000000099, 165.0, 629, 858967, 1130, 57.70656230000168
1131, 5.359393786408468, 18.983162828548227, 22.783002575476488, 0.10000000000000088, 145.0, 501, 859468, 1131, 46.44533599999704
1132, 5.206940502676689, 18.924501312007934, 22.716023418364532, 0.10000000000000063, 110.0, 677, 860145, 1132, 62.78949630000716
1133, 5.026323915270961, 18.932684634268973, 22.718561325344993, 0.09999999999999812, 250.0, 1123, 861268, 1133, 104.28172839999752
1134, 5.417152183868218, 18.955314125490762, 22.739682633460724, 0.09999999999999827, 220.0, 1083, 862351, 1134, 100.32838039999478
1135, 5.465637417069743, 19.00148192920809, 22.786178899173365, 0.09999999999999895, 270.0, 922, 863273, 1135, 85.28612140000041
1136, 5.163142922375653, 18.983237242827546, 22.777706100876266, 0.09999999999999894, 200.0, 925, 864198, 1136, 90.46158399999695
1137, 5.37360145125429, 18.99340253534676, 22.790925392246645, 0.0999999999999979, 680.0, 1195, 865393, 1137, 155.87645019999763
1138, 5.858740062827156, 18.999250964210148, 22.800670689174108, 0.10000000000000091, 130.0, 525, 865918, 1138, 51.645693099999335
1139, 5.56689019705282, 18.981823497348362, 22.756783576590763, 0.09999999999999984, 190.0, 774, 866692, 1139, 75.74022169999807
1140, 5.430415050674031, 18.954849326883565, 22.758393921014918, 0.10000000000000091, 130.0, 524, 867216, 1140, 55.870297599998594
1141, 5.2953570161906764, 18.985128504060754, 22.77493185148349, 0.09999999999999706, 600.0, 1562, 868778, 1141, 153.83971120000933
1142, 5.214723066214858, 18.989802540307757, 22.784987688612663, 0.09999999999999923, 230.0, 870, 869648, 1142, 76.0061912000092
1143, 5.167809099390887, 19.11535039708234, 22.922437739717786, 0.09999999999999845, 350.0, 1035, 870683, 1143, 94.91719550000562
1144, 4.984486512742189, 19.171366758221623, 22.979545809816585, 0.10000000000000084, 170.0, 458, 871141, 1144, 44.21510010000202
1145, 5.2593739927680545, 19.1101936163076, 22.930532957669726, 0.09999999999999845, 360.0, 1033, 872174, 1145, 107.77240279999387
1146, 5.230758776432545, 19.116967047195253, 22.936854224306956, 0.0999999999999994, 175.0, 842, 873016, 1146, 88.63148300000466
1147, 5.124709234270365, 19.145049223919962, 22.979618778711632, 0.09999999999999883, 230.0, 948, 873964, 1147, 101.04970859999594
1148, 5.577754409203316, 19.158040907129894, 23.000118300901445, 0.10000000000000028, 295.0, 716, 874680, 1148, 78.23578210000414
1149, 4.859366504849734, 19.142542173361253, 22.975664756854652, 0.09999999999999928, 240.0, 861, 875541, 1149, 87.28550309999264
1150, 5.015376905313117, 19.157173556399485, 22.990046327513767, 0.10000000000000049, 135.0, 692, 876233, 1150, 74.59499090000463
1151, 5.357696450793225, 19.157509102199388, 22.97499221801758, 0.10000000000000095, 125.0, 575, 876808, 1151, 62.404703399995924
1152, 5.222355794338953, 19.169766580095942, 23.011880868710346, 0.09999999999999874, 265.0, 966, 877774, 1152, 96.24252509999496
1153, 5.375492190704963, 19.17965008570406, 23.0157577478811, 0.09999999999999878, 390.0, 958, 878732, 1153, 98.8152747000131
1154, 5.42723860581865, 19.20834144105607, 23.03443941255895, 0.10000000000000091, 40.0, 533, 879265, 1154, 54.826321200001985
1155, 5.046219113335181, 19.213098590293626, 23.05812944990865, 0.10000000000000032, 300.0, 712, 879977, 1155, 70.68955850000202
1156, 4.852896173338906, 19.217322291160116, 23.059404671597644, 0.09999999999999795, 285.0, 1176, 881153, 1156, 125.12935380000272
1157, 5.128929788215904, 19.22648599223726, 23.085872769203917, 0.09999999999999977, 225.0, 785, 881938, 1157, 83.36901410001155
1158, 5.28701294659012, 19.200043645913546, 23.050535729908756, 0.0999999999999999, 180.0, 766, 882704, 1158, 86.02648339999723
1159, 4.977868351180858, 19.229507469836577, 23.0690016465259, 0.10000000000000019, 450.0, 729, 883433, 1159, 72.02430780000577
1160, 5.182018002767242, 19.22255253256037, 23.065562033921147, 0.10000000000000032, 125.0, 712, 884145, 1160, 70.3310635999951
1161, 5.804426125662667, 19.261032337733678, 23.119567613874164, 0.0999999999999992, 280.0, 875, 885020, 1161, 93.99194649999845
1162, 5.490122968134497, 19.213294504061025, 23.070710665063014, 0.10000000000000085, 135.0, 474, 885494, 1162, 51.85946009999316
1163, 5.457995129696815, 19.227919233850685, 23.080390853575434, 0.0999999999999986, 155.0, 996, 886490, 1163, 104.9597025999974
1164, 5.916898017424359, 19.23960062999599, 23.09103920286065, 0.10000000000000082, 95.0, 453, 886943, 1164, 50.57398390000162
1165, 4.939287580702518, 19.19577492642735, 23.037960022761258, 0.09999999999999783, 420.0, 1219, 888162, 1165, 137.85607809999783
1166, 5.182850433687858, 19.208779929306708, 23.059946668559107, 0.09999999999999959, 100.0, 812, 888974, 1166, 85.01577410000027
1167, 5.2722192543966715, 19.204260112825505, 23.054120552441304, 0.09999999999999873, 385.0, 968, 889942, 1167, 109.20222969999304
1168, 5.528691230341792, 19.215209416804775, 23.067257087076865, 0.09999999999999863, 195.0, 992, 890934, 1168, 107.13730109999597
1169, 4.7757600187890015, 19.20770310819819, 23.0625974637617, 0.09999999999999869, 265.0, 979, 891913, 1169, 112.19119509999291
1170, 5.085913873025401, 19.255753502242204, 23.123141258459047, 0.09999999999999648, 570.0, 1983, 893896, 1170, 215.19409629999427
1171, 5.740066653618249, 19.28939916959373, 23.1585208851804, 0.09999999999999891, 315.0, 930, 894826, 1171, 95.30425950000063
1172, 4.783110381275591, 19.301153969022785, 23.166189195329746, 0.09999999999999791, 470.0, 1189, 896015, 1172, 134.96645449999778
1173, 4.997955357774775, 19.292537576481525, 23.167418649010624, 0.10000000000000078, 90.0, 423, 896438, 1173, 48.552774800002226
1174, 4.831190675847671, 19.30311736499562, 23.160059036928065, 0.1000000000000006, 180.0, 680, 897118, 1174, 78.06438569999591
1175, 4.774766436292468, 19.28320595764713, 23.151461730799113, 0.09999999999999985, 380.0, 773, 897891, 1175, 88.59515870000178
1176, 4.891070435240818, 19.316521218898544, 23.17648537753132, 0.09999999999999769, 340.0, 1268, 899159, 1176, 157.1965019999916
1177, 6.078453674123693, 19.343820902069922, 23.218910913099034, 0.10000000000000044, 210.0, 699, 899858, 1177, 72.31245179999678
1178, 4.79891622130974, 19.120111875809155, 22.95167177915573, 0.09999999999999945, 285.0, 832, 900690, 1178, 85.17050370000652
1179, 4.836320629374554, 19.084439389340513, 22.89965953851452, 0.09999999999999983, 260.0, 777, 901467, 1179, 86.4470760999975
1180, 5.6997779620965, 19.118181144207774, 22.9755742976843, 0.10000000000000088, 65.0, 497, 901964, 1180, 57.50517099999706
1181, 4.716242005185383, 19.06990858940425, 22.87771039966347, 0.10000000000000091, 120.0, 533, 902497, 1181, 61.60264129999268
1182, 5.110824949984603, 19.08401033983511, 22.897410213947296, 0.09999999999999824, 260.0, 1088, 903585, 1182, 123.7764884000062
1183, 5.127449868712154, 19.080333651240824, 22.91627367258717, 0.09999999999999817, 235.0, 1109, 904694, 1183, 127.36481620000268
1184, 5.449117290033471, 19.11982376234872, 22.966611720266798, 0.10000000000000069, 70.0, 672, 905366, 1184, 76.76753350000945
1185, 5.167901018857956, 19.12639047552038, 22.966581262659144, 0.0999999999999975, 610.0, 1350, 906716, 1185, 153.94039249999332
1186, 5.210118253978751, 19.101416029168305, 22.918736989399385, 0.09999999999999938, 155.0, 845, 907561, 1186, 96.81781619999674
1187, 4.817295883238203, 19.13247930530339, 22.96274781903157, 0.10000000000000091, 115.0, 529, 908090, 1187, 60.38123519999499
1188, 4.767244359909319, 19.097634887695314, 22.930315690882065, 0.1000000000000009, 120.0, 510, 908600, 1188, 58.05148549999285
1189, 4.8814238550734785, 19.10456917969814, 22.936757560766253, 0.10000000000000099, 350.0, 631, 909231, 1189, 71.52185999999347
1190, 4.506202114924512, 19.094264061836384, 22.93853573396653, 0.10000000000000044, 135.0, 699, 909930, 1190, 80.38246980000986
1191, 5.284641353778108, 19.329783517847616, 23.211182591776367, 0.09999999999999998, 145.0, 756, 910686, 1191, 86.49812750000274
1192, 4.3603291674039255, 19.342911919837505, 23.216766739275375, 0.09999999999999862, 530.0, 994, 911680, 1192, 113.01395149999007
1193, 4.533056231940578, 19.37968769187699, 23.260506627088535, 0.10000000000000071, 250.0, 668, 912348, 1193, 76.039560300007
1194, 5.456959857132659, 19.38899420532412, 23.271737704523428, 0.10000000000000081, 190.0, 658, 913006, 1194, 74.77117500000168
1195, 5.22039411391888, 19.379226402564722, 23.265117119361353, 0.09999999999999859, 335.0, 1001, 914007, 1195, 113.87436129999696
1196, 4.800455747929044, 19.39145872485291, 23.282179026229187, 0.09999999999999697, 615.0, 1617, 915624, 1196, 185.6736380000075
1197, 4.573623867400668, 19.431938960335472, 23.314671674641694, 0.09999999999999917, 375.0, 880, 916504, 1197, 99.70642270000826
1198, 4.639788690302521, 19.44421360194683, 23.334991908073427, 0.100000000000001, 195.0, 640, 917144, 1198, 72.98009569999704
1199, 5.331905335884589, 19.471837204772157, 23.367212540762765, 0.09999999999999987, 140.0, 770, 917914, 1199, 87.41571080000722
1200, 4.824796704037233, 19.44343390500635, 23.33785567811173, 0.09999999999999891, 200.0, 931, 918845, 1200, 105.80271189998894
1201, 4.626287403796393, 19.515030967718552, 23.418005106431835, 0.09999999999999776, 445.0, 1241, 920086, 1201, 140.643811499991
1202, 4.944316043335102, 19.98595332689359, 23.9930917062538, 0.099999999999998, 310.0, 1163, 921249, 1202, 132.11009370000102
1203, 4.907917876129833, 20.011700167570627, 24.02891542044122, 0.09999999999999856, 215.0, 1006, 922255, 1203, 114.72755390001112
1204, 4.830449843386575, 20.007937326801166, 24.03461900489125, 0.10000000000000096, 80.0, 593, 922848, 1204, 67.40828420000616
1205, 4.3273837876043855, 20.00973223673797, 24.01947672632772, 0.1000000000000005, 150.0, 691, 923539, 1205, 78.68523410000489
1206, 5.192144062321502, 20.05950398507287, 24.086297154204583, 0.0999999999999983, 290.0, 1074, 924613, 1206, 122.02288200000476
1207, 5.143268294565713, 20.04651462782675, 24.06520592988427, 0.1000000000000007, 145.0, 670, 925283, 1207, 75.81915399999707
1208, 4.81924875804557, 20.05497034315793, 24.082527812921775, 0.09999999999999935, 250.0, 848, 926131, 1208, 96.27802150000934
1209, 5.020039583837557, 20.061675578933674, 24.087082778317775, 0.10000000000000024, 185.0, 722, 926853, 1209, 82.28516830000444
1210, 5.178331427389595, 20.098658501194212, 24.123213830938194, 0.09999999999999974, 110.0, 788, 927641, 1210, 89.73266489998787
1211, 3.957119520235535, 20.10788143549534, 24.135261387225018, 0.10000000000000098, 160.0, 604, 928245, 1211, 68.63928719999967
1212, 4.902883237355376, 20.083104875352646, 24.116661754010114, 0.10000000000000082, 200.0, 657, 928902, 1212, 74.71808449999662
1213, 4.645223632719389, 20.086930040777084, 24.119095370614318, 0.10000000000000064, 190.0, 676, 929578, 1213, 77.0076107000059
1214, 4.551999123692513, 20.060606212615966, 24.07591417857579, 0.10000000000000042, 190.0, 700, 930278, 1214, 80.02761530000134
1215, 5.144526624303115, 19.9785899674265, 23.981797597784745, 0.10000000000000085, 110.0, 475, 930753, 1215, 54.211690199997975
1216, 4.893379021833822, 19.947706854459152, 23.9551579419849, 0.0999999999999995, 200.0, 824, 931577, 1216, 93.64862450001237
1217, 5.399677768613385, 19.94688020554264, 23.954137683969684, 0.10000000000000082, 45.0, 452, 932029, 1217, 51.267558499996085
1218, 4.942827248665104, 19.919129120897015, 23.92537605067422, 0.09999999999999902, 385.0, 909, 932938, 1218, 103.21497329999693
1219, 4.682824097284077, 19.921469571245588, 23.9296374521211, 0.10000000000000096, 245.0, 643, 933581, 1219, 73.24011919999612
1220, 4.888185019133648, 19.93729241905667, 23.943037164678362, 0.09999999999999797, 245.0, 1174, 934755, 1220, 122.66008500001044
1221, 5.564952666600866, 19.985489952948786, 23.99988014851847, 0.10000000000000088, 125.0, 496, 935251, 1221, 48.46515640000871
1222, 4.939638559307371, 19.97816901099413, 23.99335545704777, 0.09999999999999967, 310.0, 798, 936049, 1222, 78.02579040000273
1223, 5.373872517937682, 19.995892925039488, 24.013902260823915, 0.09999999999999887, 220.0, 941, 936990, 1223, 92.64046349999262
1224, 4.596548164668291, 20.037939652152684, 24.06906084392382, 0.10000000000000013, 90.0, 736, 937726, 1224, 72.36915730001056
1225, 4.432735264674218, 20.04963648480842, 24.080431237086515, 0.09999999999999877, 460.0, 959, 938685, 1225, 93.81833330000518
1226, 4.83741933665472, 20.059240916248566, 24.090380190017072, 0.10000000000000092, 105.0, 534, 939219, 1226, 53.4682851999969
1227, 4.844441319337655, 20.09867305177631, 24.130176468225784, 0.09999999999999802, 630.0, 1155, 940374, 1227, 113.27993250000873
1228, 4.811872053897143, 20.132239557081654, 24.1665459880448, 0.10000000000000088, 210.0, 651, 941025, 1228, 63.88270970000303
1229, 4.973604236874075, 20.137793617082437, 24.19684061844913, 0.10000000000000052, 160.0, 689, 941714, 1229, 67.70017090000329
1230, 4.992643762129401, 20.165716105776283, 24.21385233801322, 0.10000000000000044, 135.0, 699, 942413, 1230, 69.23823999999149
1231, 4.659856598811461, 20.15468905963439, 24.209347816677028, 0.099999999999998, 295.0, 1164, 943577, 1231, 113.98032629999216
1232, 5.455490127596841, 20.21776111109727, 24.287462607069543, 0.09999999999999848, 300.0, 1029, 944606, 1232, 100.82775129999209
1233, 5.354782694958027, 20.22958098350783, 24.287576828483143, 0.09999999999999769, 250.0, 1271, 945877, 1233, 124.352936100011
1234, 5.5200076094509045, 20.246116408466424, 24.31641040579246, 0.10000000000000092, 165.0, 548, 946425, 1234, 53.755697300002794
1235, 4.701769654702696, 20.20530428797562, 24.268194500703988, 0.10000000000000096, 45.0, 644, 947069, 1235, 63.29296439999598
1236, 4.974304930311847, 20.19301246972608, 24.24622697979992, 0.09999999999999991, 190.0, 764, 947833, 1236, 75.59485930000665
1237, 4.374398389986224, 20.199572465903316, 24.258173158831223, 0.09999999999999933, 210.0, 853, 948686, 1237, 84.38905589999922
1238, 4.57502344131171, 20.200864366421424, 24.263778607648117, 0.09999999999999967, 230.0, 798, 949484, 1238, 78.4894951999886
1239, 4.976666951464751, 20.32576468554237, 24.40387707764463, 0.09999999999999858, 335.0, 1003, 950487, 1239, 98.47655269999814
1240, 4.603880750163207, 20.446279120823693, 24.53589055273268, 0.10000000000000088, 120.0, 504, 950991, 1240, 49.692313199993805
1241, 5.4792665625717625, 20.429154054492923, 24.531868708049153, 0.10000000000000095, 245.0, 564, 951555, 1241, 55.92662569999811
1242, 4.732348759407582, 20.469256662285847, 24.58051876814469, 0.10000000000000084, 70.0, 460, 952015, 1242, 45.14992940000957
1243, 5.543792150116393, 20.467037459214527, 24.57256469272432, 0.10000000000000069, 200.0, 672, 952687, 1243, 66.17575039999792
1244, 4.794936520473298, 20.418088145827316, 24.523821847071567, 0.09999999999999955, 295.0, 818, 953505, 1244, 80.4820655999938
1245, 4.869015408997041, 20.407518533372084, 24.519606506015517, 0.0999999999999998, 260.0, 781, 954286, 1245, 76.5731769999984
1246, 4.67181979214537, 20.4635636618219, 24.56413181872738, 0.09999999999999731, 280.0, 1431, 955717, 1246, 140.72017020000203
1247, 5.2090563260220195, 20.44495188051516, 24.550759537155564, 0.09999999999999817, 200.0, 1110, 956827, 1247, 109.06992370000808
1248, 5.024207242289368, 20.451234574220617, 24.555635191469776, 0.09999999999999869, 355.0, 980, 957807, 1248, 95.94464390000212
1249, 4.883880145303281, 20.46603546210576, 24.596790980102757, 0.10000000000000094, 175.0, 561, 958368, 1249, 54.97779720000108
1250, 4.590429665444657, 20.469885172571082, 24.587358946371467, 0.09999999999999724, 620.0, 1468, 959836, 1250, 144.01064429999678
1251, 4.767136772961168, 20.5524395354218, 24.686118404422185, 0.09999999999999776, 220.0, 1243, 961079, 1251, 122.00538209998922
1252, 4.838189471942574, 20.60532031535769, 24.738307034527814, 0.09999999999999731, 535.0, 1431, 962510, 1252, 140.79463069999474
1253, 4.116700136123743, 20.59953908991993, 24.726017939058462, 0.10000000000000074, 130.0, 665, 963175, 1253, 65.16903140000068
1254, 4.677054002431104, 20.597094852589798, 24.727047381561984, 0.09999999999999812, 385.0, 1126, 964301, 1254, 110.54681939999864
1255, 4.774849055015513, 20.627394834235453, 24.755507042871965, 0.09999999999999844, 375.0, 1038, 965339, 1255, 101.80756370000017
1256, 5.039962657104582, 20.61667583172138, 24.76532365245932, 0.09999999999999938, 280.0, 845, 966184, 1256, 82.91189800000575
1257, 5.279496036623783, 20.5813248558382, 24.723918003318584, 0.10000000000000063, 80.0, 339, 966523, 1257, 32.99982719999389
1258, 5.0936617706830685, 20.570214171776406, 24.706236859835112, 0.1000000000000009, 140.0, 650, 967173, 1258, 63.80014839999785
1259, 4.348014030841027, 20.562353186707828, 24.693439019943558, 0.10000000000000098, 135.0, 617, 967790, 1259, 60.548735000003944
1260, 4.788805062749556, 20.53899864128658, 24.6759297983987, 0.10000000000000094, 90.0, 560, 968350, 1260, 54.93649579999328
1261, 5.185476732794875, 20.584792744678467, 24.711279736153983, 0.09999999999999831, 350.0, 1069, 969419, 1261, 104.88648089999333
1262, 5.109038293981623, 20.53686489144902, 24.665269542767778, 0.10000000000000067, 170.0, 673, 970092, 1262, 65.96627259999514
1263, 4.914600150323342, 20.432427580530312, 24.53086922312236, 0.09999999999999883, 215.0, 947, 971039, 1263, 92.69696639999165
1264, 4.938471700986226, 20.475230275472004, 24.588914693196614, 0.1000000000000007, 50.0, 375, 971414, 1264, 36.97320269999909
1265, 4.452317539590174, 20.418905777675256, 24.52075166114519, 0.09999999999999716, 355.0, 1509, 972923, 1265, 147.60192970000207
1266, 5.1926396082110085, 20.431776558772736, 24.527076146291975, 0.10000000000000099, 195.0, 637, 973560, 1266, 63.40387660000124
1267, 4.490229381189945, 20.392204896082863, 24.48354203194276, 0.09999999999999803, 235.0, 1148, 974708, 1267, 112.19381930000964
1268, 4.796558147339733, 20.389759508378667, 24.49865160514972, 0.09999999999999956, 330.0, 815, 975523, 1268, 79.92635400001018
1269, 4.558788102687957, 20.433581249421415, 24.54117400229642, 0.10000000000000092, 115.0, 538, 976061, 1269, 54.27855699999782
1270, 4.280385787917089, 20.40969659105132, 24.490894438345222, 0.10000000000000099, 105.0, 632, 976693, 1270, 62.276586699998006
1271, 5.3536374755728415, 20.405417301285436, 24.508254794447634, 0.09999999999999934, 365.0, 852, 977545, 1271, 82.2503132999991
1272, 4.871656697031788, 20.38633818788962, 24.476547773588788, 0.09999999999999737, 530.0, 1408, 978953, 1272, 137.88509520000662
1273, 4.978034387591253, 20.400514982479475, 24.48613304149193, 0.10000000000000049, 120.0, 693, 979646, 1273, 68.9737557000044
1274, 4.27897320881763, 20.411527529977082, 24.506820023827288, 0.09999999999999738, 675.0, 1398, 981044, 1274, 134.2919305999967
1275, 5.018715349140219, 20.452758804653907, 24.548876744200165, 0.10000000000000069, 60.0, 367, 981411, 1275, 35.31186260000686
1276, 5.749950698047292, 20.451622794656192, 24.552484619851207, 0.10000000000000075, 70.0, 408, 981819, 1276, 41.34988730000623
1277, 4.4445342869641635, 20.403456537926523, 24.494661614664363, 0.10000000000000049, 210.0, 693, 982512, 1277, 66.1956729000085
1278, 4.604314535292165, 20.42272649277648, 24.51453230283238, 0.10000000000000099, 110.0, 634, 983146, 1278, 60.1929184999899
1279, 4.893724442963885, 20.411635909696077, 24.519749062598784, 0.09999999999999844, 265.0, 1038, 984184, 1279, 99.46783769999456
1280, 4.993528469441236, 20.378364551866714, 24.46238607567879, 0.10000000000000055, 120.0, 686, 984870, 1280, 65.7775227999955
1281, 5.172329743564462, 20.400630972238893, 24.50145945202705, 0.10000000000000028, 200.0, 716, 985586, 1281, 72.44004549999954
1282, 5.732628173279491, 20.419820156964388, 24.52626984769648, 0.10000000000000066, 25.0, 352, 985938, 1282, 35.95365880000463
1283, 5.008812803794176, 20.364230794662085, 24.445770283234424, 0.0999999999999987, 205.0, 975, 986913, 1283, 97.96420109999599
1284, 4.723558326356144, 20.35705331746968, 24.454760122101337, 0.09999999999999876, 185.0, 964, 987877, 1284, 92.8617760000052
1285, 4.56021718257352, 20.345775405984178, 24.444424069555183, 0.09999999999999995, 230.0, 760, 988637, 1285, 73.14450589999615
1286, 4.848668239712715, 20.313426582813264, 24.393787884712218, 0.09999999999999966, 190.0, 800, 989437, 1286, 77.06462190000457
1287, 5.206574194238417, 20.34545473007245, 24.424807285656932, 0.09999999999999834, 585.0, 1063, 990500, 1287, 102.52458060000208
1288, 4.8597919886233285, 20.34142854064703, 24.418554794043303, 0.1000000000000009, 110.0, 512, 991012, 1288, 49.43717280001147
1289, 4.727462794506949, 20.30362608786405, 24.393903631913034, 0.09999999999999944, 420.0, 836, 991848, 1289, 80.72116450000613
1290, 4.687569252461284, 20.345608053763943, 24.430148638792254, 0.09999999999999855, 330.0, 1011, 992859, 1290, 97.25584600000002
1291, 5.215690214009512, 20.367899713062105, 24.455657909442852, 0.09999999999999895, 150.0, 924, 993783, 1291, 89.5331981999916
1292, 5.238263673223983, 20.366725732540264, 24.449935359516363, 0.10000000000000046, 275.0, 696, 994479, 1292, 66.99848059999931
1293, 4.982382546559624, 20.34217322598333, 24.434966560032056, 0.09999999999999896, 305.0, 920, 995399, 1293, 88.75747189999674
1294, 4.757415423984814, 20.339119806504787, 24.423851239770876, 0.10000000000000074, 395.0, 665, 996064, 1294, 64.04708750000282
1295, 5.032761935360542, 20.35207299066688, 24.428084339464935, 0.09999999999999751, 510.0, 1346, 997410, 1295, 129.58155519999855
1296, 5.06432024856971, 20.2928900796859, 24.385122844963245, 0.10000000000000069, 135.0, 671, 998081, 1296, 64.74728749999485
1297, 5.841566053001171, 20.29265008074172, 24.373434442154906, 0.1000000000000007, 60.0, 376, 998457, 1297, 36.3694669999968
1298, 4.878970675050893, 20.301652622732888, 24.386209923953295, 0.10000000000000003, 245.0, 748, 999205, 1298, 73.18286040000385
