,loss,mae,mean_q,mean_eps,episode_reward,nb_episode_steps,nb_steps,episode,duration
0,0,0,0,0,410.0,1164,1164,0,2.5930343999999987
1, 0, 0, 0, 0, 50.0, 397, 1561, 1, 0.9074693000000007
2, 0, 0, 0, 0, 80.0, 385, 1946, 2, 0.9671883999999995
3, 0, 0, 0, 0, 355.0, 960, 2906, 3, 2.089281700000001
4, 0, 0, 0, 0, 105.0, 674, 3580, 4, 1.692654700000002
5, 0, 0, 0, 0, 20.0, 395, 3975, 5, 0.9979555000000033
6, 0, 0, 0, 0, 180.0, 703, 4678, 6, 1.6644912000000005
7, 0, 0, 0, 0, 50.0, 687, 5365, 7, 1.5364302000000016
8, 0, 0, 0, 0, 110.0, 633, 5998, 8, 1.5676717999999994
9, 0, 0, 0, 0, 35.0, 393, 6391, 9, 0.9090863999999996
10, 0, 0, 0, 0, 85.0, 588, 6979, 10, 1.2596573000000006
11, 0, 0, 0, 0, 110.0, 707, 7686, 11, 1.6613155000000006
12, 0, 0, 0, 0, 210.0, 732, 8418, 12, 1.8334103000000006
13, 0, 0, 0, 0, 155.0, 587, 9005, 13, 1.2838511999999973
14, 0, 0, 0, 0, 75.0, 413, 9418, 14, 0.9200518999999971
15, 0, 0, 0, 0, 145.0, 929, 10347, 15, 2.0406774
16, 0, 0, 0, 0, 195.0, 855, 11202, 16, 1.8334021000000007
17, 0, 0, 0, 0, 120.0, 771, 11973, 17, 1.678381899999998
18, 0, 0, 0, 0, 285.0, 939, 12912, 18, 1.9830034000000012
19, 0, 0, 0, 0, 140.0, 788, 13700, 19, 1.6952983999999987
20, 0, 0, 0, 0, 75.0, 609, 14309, 20, 1.3131039000000015
21, 0, 0, 0, 0, 80.0, 592, 14901, 21, 1.2909773000000015
22, 0, 0, 0, 0, 110.0, 654, 15555, 22, 1.4011951000000025
23, 0, 0, 0, 0, 180.0, 661, 16216, 23, 1.4343024
24, 0, 0, 0, 0, 90.0, 642, 16858, 24, 1.3630562000000026
25, 0, 0, 0, 0, 90.0, 641, 17499, 25, 1.3621057000000008
26, 0, 0, 0, 0, 105.0, 660, 18159, 26, 1.4115469999999988
27, 0, 0, 0, 0, 110.0, 781, 18940, 27, 1.6882326000000063
28, 0, 0, 0, 0, 215.0, 836, 19776, 28, 1.772936399999999
29, 0, 0, 0, 0, 165.0, 961, 20737, 29, 2.0707959000000002
30, 0, 0, 0, 0, 370.0, 1006, 21743, 30, 2.1587320000000005
31, 0, 0, 0, 0, 45.0, 397, 22140, 31, 0.8704144000000014
32, 0, 0, 0, 0, 245.0, 935, 23075, 32, 1.9689347000000055
33, 0, 0, 0, 0, 530.0, 1292, 24367, 33, 2.702053499999998
34, 0, 0, 0, 0, 65.0, 556, 24923, 34, 1.1785899000000057
35, 0, 0, 0, 0, 105.0, 535, 25458, 35, 1.1653445000000033
36, 0, 0, 0, 0, 110.0, 466, 25924, 36, 1.0089848000000075
37, 0, 0, 0, 0, 120.0, 496, 26420, 37, 1.0825418000000013
38, 0, 0, 0, 0, 155.0, 665, 27085, 38, 1.4060001
39, 0, 0, 0, 0, 105.0, 696, 27781, 39, 1.5047706000000005
40, 0, 0, 0, 0, 210.0, 722, 28503, 40, 1.5750811000000056
41, 0, 0, 0, 0, 50.0, 399, 28902, 41, 0.8528804000000036
42, 0, 0, 0, 0, 50.0, 521, 29423, 42, 1.1292825000000022
43, 0, 0, 0, 0, 105.0, 607, 30030, 43, 1.3226120000000066
44, 0, 0, 0, 0, 120.0, 442, 30472, 44, 0.9724001000000015
45, 0, 0, 0, 0, 110.0, 729, 31201, 45, 1.5663413999999989
46, 0, 0, 0, 0, 110.0, 690, 31891, 46, 1.5325444000000061
47, 0, 0, 0, 0, 135.0, 710, 32601, 47, 1.5529981999999904
48, 0, 0, 0, 0, 120.0, 597, 33198, 48, 1.2883804000000083
49, 0, 0, 0, 0, 105.0, 503, 33701, 49, 1.085554099999996
50, 0, 0, 0, 0, 110.0, 707, 34408, 50, 1.5111276999999887
51, 0, 0, 0, 0, 105.0, 733, 35141, 51, 1.633322800000002
52, 0, 0, 0, 0, 260.0, 975, 36116, 52, 2.1496997999999934
53, 0, 0, 0, 0, 60.0, 594, 36710, 53, 1.3259195999999918
54, 0, 0, 0, 0, 50.0, 414, 37124, 54, 0.9263296999999966
55, 0, 0, 0, 0, 455.0, 1461, 38585, 55, 3.2224853000000024
56, 0, 0, 0, 0, 155.0, 771, 39356, 56, 1.6500567000000075
57, 0, 0, 0, 0, 105.0, 632, 39988, 57, 1.3979108000000053
58, 0, 0, 0, 0, 135.0, 645, 40633, 58, 1.4422720999999967
59, 0, 0, 0, 0, 75.0, 690, 41323, 59, 1.4737539999999996
60, 0, 0, 0, 0, 45.0, 378, 41701, 60, 0.8596401000000071
61, 0, 0, 0, 0, 125.0, 433, 42134, 61, 0.9453973000000104
62, 0, 0, 0, 0, 80.0, 371, 42505, 62, 0.846741300000005
63, 0, 0, 0, 0, 15.0, 612, 43117, 63, 1.3742665999999986
64, 0, 0, 0, 0, 415.0, 1273, 44390, 64, 2.635562099999987
65, 0, 0, 0, 0, 210.0, 710, 45100, 65, 1.5592773999999991
66, 0, 0, 0, 0, 185.0, 895, 45995, 66, 1.9114192000000116
67, 0, 0, 0, 0, 260.0, 1232, 47227, 67, 2.6249667000000017
68, 0, 0, 0, 0, 55.0, 511, 47738, 68, 1.1353256000000016
69, 0, 0, 0, 0, 55.0, 363, 48101, 69, 0.8113584999999972
70, 0, 0, 0, 0, 80.0, 617, 48718, 70, 1.3628682000000083
71, 0, 0, 0, 0, 120.0, 500, 49218, 71, 1.0867788999999988
72, 0, 0, 0, 0, 90.0, 587, 49805, 72, 1.2981017000000037
73, 0, 0, 0, 0, 50.0, 419, 50224, 73, 0.89969099999999
74, 0, 0, 0, 0, 65.0, 556, 50780, 74, 1.2343094999999948
75, 0, 0, 0, 0, 90.0, 640, 51420, 75, 1.3844205000000045
76, 0, 0, 0, 0, 145.0, 705, 52125, 76, 1.5281326000000064
77, 0, 0, 0, 0, 155.0, 793, 52918, 77, 1.7208834000000053
78, 0, 0, 0, 0, 105.0, 540, 53458, 78, 1.1858153000000158
79, 0, 0, 0, 0, 140.0, 633, 54091, 79, 1.3670036000000039
80, 0, 0, 0, 0, 85.0, 713, 54804, 80, 1.6142714999999725
81, 0, 0, 0, 0, 30.0, 603, 55407, 81, 1.428381700000017
82, 0, 0, 0, 0, 105.0, 655, 56062, 82, 1.4054208999999958
83, 0, 0, 0, 0, 40.0, 370, 56432, 83, 0.8218076999999937
84, 0, 0, 0, 0, 335.0, 1153, 57585, 84, 2.4318540000000155
85, 0, 0, 0, 0, 120.0, 518, 58103, 85, 1.1290950000000066
86, 0, 0, 0, 0, 65.0, 663, 58766, 86, 1.4256244999999979
87, 0, 0, 0, 0, 180.0, 626, 59392, 87, 1.4058945999999821
88, 0, 0, 0, 0, 170.0, 653, 60045, 88, 1.4747255999999993
89, 0, 0, 0, 0, 265.0, 988, 61033, 89, 2.118049600000006
90, 0, 0, 0, 0, 165.0, 799, 61832, 90, 1.7275915999999825
91, 0, 0, 0, 0, 75.0, 649, 62481, 91, 1.425030200000009
92, 0, 0, 0, 0, 110.0, 389, 62870, 92, 0.8545951999999772
93, 0, 0, 0, 0, 135.0, 550, 63420, 93, 1.2080411999999967
94, 0, 0, 0, 0, 50.0, 627, 64047, 94, 1.3764797000000044
95, 0, 0, 0, 0, 640.0, 1531, 65578, 95, 3.2196997000000067
96, 0, 0, 0, 0, 130.0, 1166, 66744, 96, 2.4669508000000064
97, 0, 0, 0, 0, 80.0, 387, 67131, 97, 0.8544575999999893
98, 0, 0, 0, 0, 280.0, 991, 68122, 98, 2.106985100000003
99, 0, 0, 0, 0, 5.0, 471, 68593, 99, 1.0454546999999934
100, 0, 0, 0, 0, 15.0, 468, 69061, 100, 1.0255267000000003
101, 0, 0, 0, 0, 155.0, 687, 69748, 101, 1.5150562000000036
102, 0, 0, 0, 0, 35.0, 591, 70339, 102, 1.3335806000000048
103, 0, 0, 0, 0, 485.0, 1452, 71791, 103, 3.0375444999999957
104, 0, 0, 0, 0, 180.0, 704, 72495, 104, 1.5203349999999887
105, 0, 0, 0, 0, 135.0, 492, 72987, 105, 1.0802769000000012
106, 0, 0, 0, 0, 120.0, 752, 73739, 106, 1.6303612999999757
107, 0, 0, 0, 0, 80.0, 472, 74211, 107, 1.0314275000000066
108, 0, 0, 0, 0, 210.0, 706, 74917, 108, 1.5331606999999963
109, 0, 0, 0, 0, 485.0, 1421, 76338, 109, 2.993019000000004
110, 0, 0, 0, 0, 185.0, 776, 77114, 110, 1.674490800000001
111, 0, 0, 0, 0, 135.0, 771, 77885, 111, 1.6819050000000004
112, 0, 0, 0, 0, 120.0, 650, 78535, 112, 1.3972753000000182
113, 0, 0, 0, 0, 170.0, 795, 79330, 113, 1.716700099999997
114, 0, 0, 0, 0, 105.0, 578, 79908, 114, 1.2888834000000031
115, 0, 0, 0, 0, 65.0, 533, 80441, 115, 1.2085572000000013
116, 0, 0, 0, 0, 80.0, 432, 80873, 116, 0.9647601000000066
117, 0, 0, 0, 0, 150.0, 688, 81561, 117, 1.4829213000000152
118, 0, 0, 0, 0, 105.0, 550, 82111, 118, 1.1854397999999833
119, 0, 0, 0, 0, 110.0, 575, 82686, 119, 1.2726425999999833
120, 0, 0, 0, 0, 120.0, 677, 83363, 120, 1.4698517000000209
121, 0, 0, 0, 0, 150.0, 763, 84126, 121, 1.656263800000005
122, 0, 0, 0, 0, 210.0, 989, 85115, 122, 2.136447599999997
123, 0, 0, 0, 0, 50.0, 598, 85713, 123, 1.2815278999999862
124, 0, 0, 0, 0, 200.0, 780, 86493, 124, 1.6858905999999934
125, 0, 0, 0, 0, 90.0, 627, 87120, 125, 1.3989272000000028
126, 0, 0, 0, 0, 200.0, 886, 88006, 126, 1.9752231000000222
127, 0, 0, 0, 0, 45.0, 548, 88554, 127, 1.1945929999999976
128, 0, 0, 0, 0, 65.0, 383, 88937, 128, 0.8799738000000161
129, 0, 0, 0, 0, 135.0, 585, 89522, 129, 1.257494500000007
130, 0, 0, 0, 0, 215.0, 629, 90151, 130, 1.386412000000007
131, 0, 0, 0, 0, 210.0, 911, 91062, 131, 1.9199703999999826
132, 0, 0, 0, 0, 20.0, 478, 91540, 132, 1.0408160000000066
133, 0, 0, 0, 0, 85.0, 546, 92086, 133, 1.1806971999999973
134, 0, 0, 0, 0, 135.0, 674, 92760, 134, 1.4521258000000046
135, 0, 0, 0, 0, 80.0, 490, 93250, 135, 1.0900179999999864
136, 0, 0, 0, 0, 110.0, 590, 93840, 136, 1.2805941000000018
137, 0, 0, 0, 0, 105.0, 618, 94458, 137, 1.327439400000003
138, 0, 0, 0, 0, 120.0, 596, 95054, 138, 1.320095600000002
139, 0, 0, 0, 0, 155.0, 762, 95816, 139, 1.659834399999994
140, 0, 0, 0, 0, 105.0, 603, 96419, 140, 1.322445799999997
141, 0, 0, 0, 0, 120.0, 412, 96831, 141, 0.9208177999999805
142, 0, 0, 0, 0, 75.0, 395, 97226, 142, 0.8828114000000085
143, 0, 0, 0, 0, 110.0, 861, 98087, 143, 1.8428369000000089
144, 0, 0, 0, 0, 155.0, 626, 98713, 144, 1.370098899999988
145, 0, 0, 0, 0, 130.0, 867, 99580, 145, 1.8705967000000214
146, 15.883026898444236, 23.826845340900594, 30.4093524486095, 0.8197992999999997, 180.0, 643, 100223, 146, 3.534011000000021
147, 9.1795015404926, 23.9685179612608, 29.47318431127881, 0.8189236000000003, 120.0, 751, 100974, 147, 7.220779399999998
148, 12.290803850012482, 23.973732140959886, 29.54553334675138, 0.8179075000000001, 30.0, 378, 101352, 148, 3.6418407000000173
149, 6.721919090269012, 23.954451563951253, 29.155416053986325, 0.8167023999999992, 465.0, 961, 102313, 149, 9.086282399999988
150, 5.750056247819554, 23.92251368002458, 29.036893853893528, 0.8152831000000001, 30.0, 616, 102929, 150, 5.855686099999986
151, 5.21287494172682, 23.86748047893762, 28.916944667918038, 0.8141220999999996, 125.0, 674, 103603, 151, 6.4664030999999795
152, 5.146645700174664, 23.88163073479183, 28.951561632610503, 0.8130619, 110.0, 504, 104107, 152, 4.889887999999985
153, 5.593065214918015, 23.885824899626638, 29.017877787888146, 0.8120584000000001, 70.0, 611, 104718, 153, 5.820985599999972
154, 5.753065074500391, 23.87628041283559, 28.98452796936035, 0.8109775000000002, 110.0, 590, 105308, 154, 5.679879500000027
155, 4.4272688049350295, 23.90707920771565, 28.847973445950426, 0.8100918999999999, 20.0, 394, 105702, 155, 3.8147210999999857
156, 5.3852644528167835, 23.863524796306223, 28.797677998381538, 0.8093647000000002, 35.0, 414, 106116, 156, 4.0750896000000125
157, 7.8727729303467555, 23.92990642765957, 29.208125188294485, 0.8084574999999997, 110.0, 594, 106710, 157, 5.778984700000024
158, 5.33230800900543, 23.89727621206435, 28.845534170129106, 0.8070508000000002, 295.0, 969, 107679, 158, 9.309472000000028
159, 6.060336727696129, 23.89026614684093, 28.904506779924223, 0.8056098999999998, 160.0, 632, 108311, 159, 6.12814979999996
160, 8.508189121096194, 23.926565813112862, 28.984970379479325, 0.8044722999999997, 80.0, 632, 108943, 160, 6.171726600000056
161, 6.901386538206717, 23.935500282438102, 28.977997196643233, 0.8033104, 225.0, 659, 109602, 161, 6.5042598
162, 6.8445293657429565, 23.860233938221608, 28.800757548192163, 0.8023312000000001, 65.0, 429, 110031, 162, 4.1806353999999715
163, 4.305677002088891, 24.148488269911873, 29.141604291068184, 0.8014266999999998, 100.0, 576, 110607, 163, 5.701283199999978
164, 4.3360214400840436, 24.157703254097388, 29.205550826223273, 0.8002242999999998, 155.0, 760, 111367, 164, 7.449251600000025
165, 4.587239499413356, 24.144380645921874, 29.250635563397992, 0.7991362, 55.0, 449, 111816, 165, 4.419907099999989
166, 5.477633792537176, 24.169262994576886, 29.223892719924596, 0.7979887000000001, 160.0, 826, 112642, 166, 8.036233299999992
167, 5.311308311283493, 24.135749789251797, 29.182222596689122, 0.7966864000000002, 50.0, 621, 113263, 167, 6.087648100000024
168, 5.119145896869736, 24.112572185413256, 29.15214739103575, 0.7957944999999998, 65.0, 370, 113633, 168, 3.697985200000005
169, 5.390537995254172, 24.158383020861397, 29.1987959105393, 0.7946784999999996, 145.0, 870, 114503, 169, 8.616329199999996
170, 7.2064686715602875, 24.10744222930464, 29.156871046197143, 0.7934626, 50.0, 481, 114984, 170, 4.779841499999975
171, 4.928780164037432, 24.124719601585753, 29.192952274140858, 0.7926517000000002, 75.0, 420, 115404, 171, 4.172951399999988
172, 5.461448531983228, 24.151484561788624, 29.20015682023147, 0.7917516999999997, 60.0, 580, 115984, 172, 5.7043765000000235
173, 6.5549277464302245, 24.155126533792274, 29.23515240785206, 0.7908669999999999, 80.0, 403, 116387, 173, 4.0894490999999675
174, 7.251967917484452, 24.161904993784955, 29.238026687897833, 0.7900560999999999, 110.0, 498, 116885, 174, 4.999112299999979
175, 3.9796421867072214, 24.096602875253428, 29.08601082333867, 0.7890282999999998, 125.0, 644, 117529, 175, 6.3894771999999875
176, 4.334791962860039, 24.128592232972878, 29.161900242828313, 0.7874713000000004, 275.0, 1086, 118615, 176, 10.710095899999999
177, 6.451558755628516, 24.17596399206648, 29.24872350949389, 0.7856577999999994, 180.0, 929, 119544, 177, 9.210815699999955
178, 5.786533270008075, 24.274527618850488, 29.36738718321111, 0.7843870000000001, 55.0, 483, 120027, 178, 5.0526234999999815
179, 8.645313820504628, 27.460322407985505, 33.13601945544979, 0.7833681999999997, 120.0, 649, 120676, 179, 6.950165800000036
180, 7.5155249493035345, 27.494452286245235, 33.122925575285066, 0.7820668000000002, 200.0, 797, 121473, 180, 7.933008900000004
181, 8.097114767564982, 27.526232224957074, 33.19431760525816, 0.7803999999999993, 165.0, 1055, 122528, 181, 11.057566300000019
182, 6.8293437862588515, 27.504990156235234, 33.0821707817816, 0.7788924999999999, 30.0, 620, 123148, 182, 6.308835799999997
183, 4.891850422535624, 27.470766397347127, 33.06506759242008, 0.7778556999999999, 100.0, 532, 123680, 183, 5.302775799999949
184, 6.363673896246164, 27.437120444948633, 33.0259719096439, 0.7766740000000004, 210.0, 781, 124461, 184, 7.93626549999999
185, 9.906462221510974, 27.513472311405398, 33.26766991205858, 0.7752898, 120.0, 757, 125218, 185, 7.623792899999955
186, 6.913180608320706, 27.44223303630434, 33.06133287880808, 0.7738777000000003, 150.0, 812, 126030, 186, 8.676714000000004
187, 7.168556130874683, 27.484391699819003, 33.12271989443723, 0.7726573, 80.0, 544, 126574, 187, 6.959600499999965
188, 5.8118681242558035, 27.457740796390134, 33.04699348673205, 0.7714918000000002, 120.0, 751, 127325, 188, 7.979699500000038
189, 4.282263187533718, 27.413210778317207, 32.94774746329097, 0.7702849, 80.0, 590, 127915, 189, 6.540751799999953
190, 9.975315117173725, 27.58750150821827, 33.36867952346802, 0.7691706999999998, 150.0, 648, 128563, 190, 7.321921100000054
191, 10.795537980446904, 27.534032584717554, 33.420293754672414, 0.7682977000000001, 20.0, 322, 128885, 191, 3.664216099999976
192, 4.874569566481936, 27.48014779555059, 33.07876577799299, 0.7674993999999999, 120.0, 565, 129450, 192, 6.53195119999998
193, 5.558178798917806, 27.673795467606375, 33.315918055574976, 0.7663779999999998, 130.0, 681, 130131, 193, 7.388492900000074
194, 7.41054483310121, 28.22875076043801, 34.011018212115175, 0.7652160999999998, 120.0, 610, 130741, 194, 6.517896000000064
195, 6.498459363580856, 28.21250496901475, 33.98940202787325, 0.764182, 100.0, 539, 131280, 195, 6.0483666000000085
196, 3.8831036246786215, 28.212539907898567, 33.99528828245221, 0.7632514000000004, 95.0, 495, 131775, 196, 5.628231199999959
197, 6.610079539267816, 28.21817407340647, 34.10919275016428, 0.7623243999999998, 60.0, 535, 132310, 197, 5.861925299999939
198, 8.363719805273051, 28.177421602243744, 33.97719562627776, 0.7615252000000001, 30.0, 353, 132663, 198, 3.849807599999963
199, 6.807624956715607, 28.25808002848825, 34.182406616781996, 0.7606062999999998, 120.0, 668, 133331, 199, 7.224106600000027
200, 3.9895286367482123, 28.16292739310534, 33.94057783969613, 0.7594632999999997, 80.0, 602, 133933, 200, 6.984443499999998
201, 4.295834620721544, 28.224523350461208, 34.02451501005142, 0.7584256, 155.0, 551, 134484, 201, 5.8197198999999955
202, 3.9441298991441727, 28.21387339241897, 33.972493171691895, 0.7573609000000003, 150.0, 632, 135116, 202, 6.598815000000059
203, 6.3837014998104555, 28.206094246722284, 34.03796842859146, 0.7561576000000003, 220.0, 705, 135821, 203, 7.301580399999921
204, 8.015243831853853, 28.209551629367702, 34.15968513766404, 0.7549047999999997, 60.0, 687, 136508, 204, 7.211894700000016
205, 5.324635578782519, 28.186861810982776, 33.935651578955884, 0.7537977999999997, 20.0, 543, 137051, 205, 5.727252300000032
206, 5.341684988549141, 28.18586905863275, 34.04514766234085, 0.7528753, 125.0, 482, 137533, 206, 5.066642399999978
207, 3.996183826593356, 28.13003348226601, 33.837259605105984, 0.7519636000000003, 55.0, 531, 138064, 207, 5.5000810999999885
208, 6.144652411263323, 28.210757174326417, 34.047397820104685, 0.7506297999999999, 190.0, 951, 139015, 208, 9.94651829999998
209, 6.248663302965924, 28.233405246565827, 34.053848752722274, 0.7492653999999999, 120.0, 565, 139580, 209, 5.984051499999964
210, 3.541909370571375, 27.987290280880313, 33.680216793966764, 0.7480296999999999, 155.0, 808, 140388, 210, 8.513205399999947
211, 2.9412495111412182, 27.721090779317496, 33.41149453311265, 0.7469721999999999, 45.0, 367, 140755, 211, 3.8894020000000182
212, 5.17975716410747, 27.813742637634277, 33.62899800795543, 0.7460731000000002, 90.0, 632, 141387, 212, 6.730558299999984
213, 4.448015306430857, 27.73893466438215, 33.49878916571094, 0.7447186000000002, 195.0, 873, 142260, 213, 9.499444400000016
214, 2.878515930941337, 27.73591252935725, 33.424467478874476, 0.7433506000000004, 150.0, 647, 142907, 214, 6.984319300000038
215, 5.680385053824312, 27.785250642429144, 33.56673638178264, 0.7419232000000002, 225.0, 939, 143846, 215, 9.879764500000078
216, 2.8651708372918256, 27.778306797098153, 33.46731410893055, 0.7402510000000008, 455.0, 919, 144765, 216, 9.662518099999943
217, 4.073547094264778, 27.76833123352568, 33.47745084600933, 0.7388929000000001, 90.0, 590, 145355, 217, 6.341702899999973
218, 4.804348997521575, 27.75938336448948, 33.471258132823195, 0.7377454000000004, 90.0, 685, 146040, 218, 7.19436660000008
219, 3.548048755788289, 27.733661607527768, 33.421307003920546, 0.7365448, 110.0, 649, 146689, 219, 6.76611360000004
220, 5.016867211961746, 27.744822174072265, 33.44946159362793, 0.7353981999999997, 120.0, 625, 147314, 220, 6.657845899999984
221, 3.1191034841595817, 27.745058358396246, 33.41644463220195, 0.7342839999999998, 90.0, 613, 147927, 221, 6.579657200000042
222, 2.6881771940782135, 27.70442410043106, 33.387021747031234, 0.7332768999999999, 35.0, 506, 148433, 222, 5.366287100000022
223, 7.0619064203479835, 27.75464662473801, 33.54393123604401, 0.7322059000000002, 140.0, 684, 149117, 223, 7.276226599999973
224, 2.870600760657163, 27.699215675535655, 33.36021553675334, 0.7312122999999998, 105.0, 420, 149537, 224, 4.5321795999999495
225, 3.476597308639496, 27.73886271885463, 33.44993115076943, 0.7302673, 85.0, 630, 150167, 225, 6.784930599999939
226, 4.690872060130408, 27.947140262745044, 33.72059367144549, 0.7289713000000003, 210.0, 810, 150977, 226, 8.729361899999958
227, 4.269168420942726, 27.997197723388673, 33.757291375907364, 0.7275358, 155.0, 785, 151762, 227, 8.412108899999907
228, 4.218305726231713, 27.968731057016473, 33.7201072943838, 0.7264873000000001, 55.0, 380, 152142, 228, 4.1365293000000065
229, 4.444817150798109, 27.9805503739251, 33.7478674809138, 0.7248492999999998, 225.0, 1440, 153582, 229, 15.399704199999974
230, 3.9599316349064093, 27.97853420091712, 33.705540509615545, 0.7231806999999999, 75.0, 414, 153996, 230, 4.483604999999898
231, 4.4748367027306095, 28.052036614814547, 33.849178627355776, 0.7223860000000001, 110.0, 469, 154465, 231, 5.129601200000025
232, 3.68004320960431, 27.98111944212779, 33.76434822422611, 0.7213581999999995, 155.0, 673, 155138, 232, 7.3266058000000385
233, 5.541510467100522, 27.9508171774075, 33.76062265935716, 0.7201575999999998, 175.0, 661, 155799, 233, 7.1337206999999125
234, 2.4356639070305857, 27.967058845082665, 33.72291018492097, 0.7188561999999998, 210.0, 785, 156584, 234, 8.435103199999958
235, 2.9249718733607453, 27.983580219999272, 33.793989120645726, 0.7177266999999999, 140.0, 470, 157054, 235, 5.167812499999968
236, 5.039889247603714, 28.022627730369567, 33.85857996702194, 0.7165837000000004, 110.0, 800, 157854, 236, 8.867840500000057
237, 2.6898122608546364, 27.956434010075878, 33.69234542920465, 0.7153984000000002, 65.0, 517, 158371, 237, 5.826397600000064
238, 3.800443663267918, 28.010723353990542, 33.793592004215014, 0.7143822999999998, 160.0, 612, 158983, 238, 6.815346299999987
239, 4.6665789857257565, 27.988735967655245, 33.830127958469966, 0.7127550999999993, 205.0, 1196, 160179, 239, 13.367908100000022
240, 10.761176858405422, 27.888980459151114, 34.03023941116524, 0.7113196000000002, 100.0, 399, 160578, 240, 4.467802600000027
241, 7.243232045114131, 27.892354085117173, 33.79364200944078, 0.7103655999999998, 85.0, 661, 161239, 241, 7.363904899999966
242, 6.285863696242109, 27.888636825476517, 33.592059956287606, 0.7094476, 30.0, 359, 161598, 242, 4.019611899999973
243, 3.6058951692830306, 27.795306380838156, 33.44928425177932, 0.7086636999999997, 55.0, 512, 162110, 243, 5.9164299000000256
244, 2.4248085286682106, 27.792042931040967, 33.44997594723889, 0.7076070999999999, 140.0, 662, 162772, 244, 7.505442600000038
245, 3.8575041910124903, 27.863617260737257, 33.61542643792025, 0.7064542, 95.0, 619, 163391, 245, 6.841383500000006
246, 5.00973241842378, 27.871134100673356, 33.647160588023816, 0.7051267, 225.0, 856, 164247, 246, 9.543208999999933
247, 4.784728660803774, 27.835246877255646, 33.61782632578974, 0.7038388000000001, 150.0, 575, 164822, 247, 6.480889100000013
248, 3.536175817760647, 27.833570809106202, 33.526994153644964, 0.7026895000000002, 160.0, 702, 165524, 248, 7.92853260000004
249, 5.561420335918665, 27.86127221107483, 33.6313391828537, 0.7016976999999999, 115.0, 400, 165924, 249, 4.728222200000005
250, 2.402542552675109, 27.746139457426874, 33.369578231837785, 0.7008148000000001, 110.0, 581, 166505, 250, 6.654919100000029
251, 4.2316405586808346, 27.87024051786045, 33.616629810148964, 0.6995467000000003, 410.0, 828, 167333, 251, 9.257264100000043
252, 4.039076176376975, 27.802085459962182, 33.529265485491074, 0.6983605000000002, 95.0, 490, 167823, 252, 5.614389299999971
253, 2.3268118150654025, 27.81164676615246, 33.505564526675535, 0.6973137999999999, 110.0, 673, 168496, 253, 7.618106500000067
254, 5.247898431907887, 27.845825925531745, 33.5832947567417, 0.6962778999999998, 105.0, 478, 168974, 254, 5.500405200000046
255, 4.353050070898482, 27.824377333456884, 33.54378218860517, 0.6953769999999999, 90.0, 523, 169497, 255, 5.994587499999966
256, 4.654097355175018, 27.899857354736326, 33.68711979980469, 0.6943438000000003, 120.0, 625, 170122, 256, 7.061447299999941
257, 3.791884114872144, 28.119950612386067, 33.90656177513648, 0.6932979999999996, 60.0, 537, 170659, 257, 6.134358799999973
258, 3.421877474589121, 28.124831342767997, 33.879179284264396, 0.6922089999999999, 125.0, 673, 171332, 258, 7.790310599999998
259, 5.695967245131623, 28.145388858905736, 34.02627188226451, 0.6911065000000001, 15.0, 552, 171884, 259, 6.278446799999983
260, 2.678065264801474, 28.153158313166486, 33.89801795291204, 0.6901165000000001, 80.0, 548, 172432, 260, 6.268816000000015
261, 2.393077188649906, 28.123462588288064, 33.888765050795314, 0.6887719000000001, 310.0, 946, 173378, 261, 10.748592700000017
262, 2.498402195219589, 28.098470970106273, 33.843032697279504, 0.6873426999999999, 210.0, 642, 174020, 262, 7.380614700000024
263, 1.9380392755462428, 28.090482391397472, 33.812862706622425, 0.6864219999999998, 50.0, 381, 174401, 263, 4.386301300000014
264, 7.28953316665281, 28.22353726764058, 34.08444229145691, 0.6857307999999998, 75.0, 387, 174788, 264, 4.526809500000013
265, 3.843151188005918, 28.104724766879247, 33.89418377958495, 0.6845472999999996, 280.0, 928, 175716, 265, 11.314904399999932
266, 4.34294985134421, 28.186495102806145, 34.00355231243631, 0.6830704, 110.0, 713, 176429, 266, 8.387152400000105
267, 3.9057225297506566, 28.129065254579178, 33.93259854597633, 0.6812524000000002, 520.0, 1307, 177736, 267, 14.892992899999854
268, 4.761430333204129, 28.154052897570605, 33.96957503334086, 0.6792345999999997, 230.0, 935, 178671, 268, 10.94295800000009
269, 5.037024584567238, 28.117397685250836, 33.9348602713701, 0.6779421999999997, 45.0, 501, 179172, 269, 5.858951400000024
270, 5.287234199912967, 28.126831686174548, 33.928700532139956, 0.6768252999999999, 245.0, 740, 179912, 270, 8.822122499999978
271, 4.9704574415230685, 27.51283436234224, 33.201544251177296, 0.6752026000000003, 475.0, 1063, 180975, 271, 11.855369899999914
272, 5.514774490134603, 27.53654841586683, 33.27474886200132, 0.6734853999999996, 165.0, 845, 181820, 272, 9.323372000000063
273, 3.1601084497314136, 27.480005081879348, 33.12855855182887, 0.6719626000000001, 160.0, 847, 182667, 273, 9.206650400000171
274, 6.631251199366385, 27.473929913702563, 33.27834917595351, 0.6703596999999997, 95.0, 934, 183601, 274, 10.324408399999811
275, 4.580224273313812, 27.477880557911508, 33.14248144546611, 0.6689827000000004, 80.0, 596, 184197, 275, 6.550420099999883
276, 3.0814468403912385, 27.39212533714548, 33.027796192111566, 0.6678504999999997, 120.0, 662, 184859, 276, 7.34514850000005
277, 6.06511669785437, 27.451497385623682, 33.157828513375165, 0.6666381999999997, 90.0, 685, 185544, 277, 7.472054200000002
278, 3.484736293579308, 27.485451791110457, 33.14967087611256, 0.6654853, 85.0, 596, 186140, 278, 6.653064400000176
279, 2.081192379552372, 27.423752637253592, 33.06783153494609, 0.6640759000000004, 175.0, 970, 187110, 279, 10.808832100000018
280, 4.632723095609729, 27.510117089325835, 33.22622928557924, 0.6623649999999995, 180.0, 931, 188041, 280, 10.228772799999888
281, 7.360238710631772, 27.47415467600028, 33.2376816223065, 0.6611815, 125.0, 384, 188425, 281, 4.3319431999998415
282, 2.3855284011685627, 27.43952690368961, 33.04188688127026, 0.6603022000000001, 95.0, 593, 189018, 282, 6.398566999999957
283, 2.258952256527883, 27.422767624673963, 33.09404060750068, 0.659413, 50.0, 395, 189413, 283, 4.507247300000017
284, 3.7743297124890884, 27.51768546978448, 33.17764152340988, 0.6582817, 90.0, 862, 190275, 284, 9.575780200000054
285, 4.024833207529059, 27.658797681668386, 33.354064804012495, 0.6568686999999998, 160.0, 708, 190983, 285, 7.9573266999998395
286, 4.799775126927199, 27.697817990379612, 33.445179585992854, 0.6552451, 260.0, 1096, 192079, 286, 12.114002400000118
287, 3.359874431852507, 27.697670832193406, 33.371218067374436, 0.6537735999999997, 80.0, 539, 192618, 287, 6.130829899999981
288, 4.796460239374661, 27.716325165487135, 33.485548060791494, 0.6528322000000001, 105.0, 507, 193125, 288, 5.7227569000001495
289, 2.8099374388062928, 27.678596046060388, 33.34940305924574, 0.6515605, 470.0, 906, 194031, 289, 10.216432299999951
290, 3.7453847856912224, 27.70107032797929, 33.43617458150566, 0.6494995000000002, 415.0, 1384, 195415, 290, 15.587424800000008
291, 3.1668751966185913, 27.73992009191456, 33.44189291628535, 0.6475024000000001, 275.0, 835, 196250, 291, 9.5293443999999
292, 2.9560610213654757, 27.662415854762354, 33.337593416764314, 0.6459742000000002, 235.0, 863, 197113, 292, 10.352354900000137
293, 4.334452456338065, 27.717503550938197, 33.432953798566544, 0.6444100000000001, 315.0, 875, 197988, 293, 10.453009500000007
294, 2.1623285942657477, 27.68181192334685, 33.35686945266954, 0.6433246, 30.0, 331, 198319, 294, 4.011601500000097
295, 3.881528497792195, 27.701760356665304, 33.4786518686186, 0.6426946, 65.0, 369, 198688, 295, 4.496163300000035
296, 2.417074516789997, 27.65939709169781, 33.3412613030055, 0.6420043, 80.0, 398, 199086, 296, 4.809882299999799
297, 4.342447042372847, 27.767684993271, 33.507120039443336, 0.6405571000000001, 320.0, 1210, 200296, 297, 14.57477989999984
298, 2.7752046200588376, 27.8179648683209, 33.49927439475213, 0.6390478, 60.0, 467, 200763, 298, 5.6659239999999045
299, 6.781093545633074, 27.85860945234363, 33.66891330360566, 0.6380911000000001, 155.0, 596, 201359, 299, 7.293244400000049
300, 4.694373512302923, 27.852883043344956, 33.54128698159379, 0.6372469, 20.0, 342, 201701, 300, 3.9844081999999617
301, 6.553678694486006, 27.82413693233387, 33.679103310209186, 0.6362380000000001, 195.0, 779, 202480, 301, 9.465618499999891
302, 3.358201667598186, 27.776421522184183, 33.430559510675096, 0.6349474, 120.0, 655, 203135, 302, 7.95742580000001
303, 5.674270400632192, 27.879733490572026, 33.70318652769515, 0.6338386000000003, 120.0, 577, 203712, 303, 7.016424400000005
304, 5.8642779913317815, 27.825009974281933, 33.642048427751995, 0.6329763999999999, 110.0, 381, 204093, 304, 4.733852699999943
305, 5.262285907064261, 27.87627640627743, 33.62988108517079, 0.6322329999999998, 35.0, 445, 204538, 305, 5.529289100000142
306, 2.3054816957030977, 27.808675130208332, 33.44293128003131, 0.6313410999999998, 110.0, 546, 205084, 306, 6.657722900000181
307, 3.4270705283889846, 27.839022233067446, 33.58009902721665, 0.6303474999999998, 35.0, 558, 205642, 307, 6.889507999999978
308, 5.703417681979976, 27.916358715227055, 33.71440702686593, 0.6292989999999999, 135.0, 607, 206249, 308, 7.522534199999882
309, 3.476333240346833, 27.823383928715497, 33.536537271806566, 0.6281263000000004, 295.0, 696, 206945, 309, 8.492161500000066
310, 4.1661415905043295, 27.763770912266985, 33.475585741332814, 0.6269311, 80.0, 632, 207577, 310, 7.862025399999993
311, 4.286310693276907, 27.84795831424087, 33.64334330487607, 0.6257592999999996, 105.0, 670, 208247, 311, 8.366712400000097
312, 4.025352628966366, 27.786738134392113, 33.537360802810944, 0.6245091999999998, 135.0, 719, 208966, 312, 8.768851600000062
313, 5.96729748148656, 27.86302229969214, 33.5986503546965, 0.6232275999999999, 60.0, 705, 209671, 313, 8.816000600000052
314, 5.38146309036973, 27.762955495755968, 33.52399067029561, 0.6216733000000002, 290.0, 1022, 210693, 314, 12.649486600000046
315, 6.381176442849009, 27.839803217837684, 33.649178326255395, 0.6203259999999999, 90.0, 475, 211168, 315, 5.887290000000121
316, 4.057790908181012, 27.727207597549967, 33.449381731192595, 0.6190147000000003, 340.0, 982, 212150, 316, 12.2173757999999
317, 2.304632262007232, 27.74992747041137, 33.466386347572126, 0.617824, 10.0, 341, 212491, 317, 4.281719799999792
318, 4.058028999978478, 27.744389742100772, 33.42803273577871, 0.6164695000000007, 405.0, 1164, 213655, 318, 14.439685100000133
319, 4.720193190758463, 27.773412734632654, 33.509351447260876, 0.6146820999999998, 210.0, 822, 214477, 319, 10.378508699999884
320, 3.3095506516263438, 27.67095356561667, 33.349331795172546, 0.6134041, 90.0, 598, 215075, 320, 7.421853300000066
321, 4.965192509832836, 27.815880025227866, 33.590503209431965, 0.6123934, 90.0, 525, 215600, 321, 6.6337453000001005
322, 4.707623926609972, 27.72000972719958, 33.42723831295097, 0.6109345000000006, 200.0, 1096, 216696, 322, 13.771135500000128
323, 7.693558940960436, 27.799839315609056, 33.62196436122972, 0.6095070999999999, 125.0, 490, 217186, 323, 6.1019997999999305
324, 3.52508669223288, 27.774404370241598, 33.45628204162744, 0.6086908000000002, 80.0, 417, 217603, 324, 5.26525219999985
325, 3.5512676583622467, 27.741136284113427, 33.47140736868585, 0.6074533, 180.0, 958, 218561, 325, 12.145940999999993
326, 4.701861498157122, 27.775542299148483, 33.516863334355094, 0.6058602999999998, 225.0, 812, 219373, 326, 10.271584299999859
327, 4.9906087260113825, 27.802580648351597, 33.50479291845251, 0.6045219999999999, 190.0, 675, 220048, 327, 8.57292429999984
328, 3.855026886155064, 28.446450323298357, 34.30587593253684, 0.6031692999999997, 335.0, 828, 220876, 328, 10.519665000000032
329, 4.008560346041037, 28.486058558588443, 34.354631933129355, 0.6013891, 330.0, 1150, 222026, 329, 14.62065470000016
330, 3.309111998535884, 28.423217984346245, 34.29931752498333, 0.5997925000000001, 145.0, 624, 222650, 330, 8.021111399999882
331, 5.195472724687977, 28.50937467558771, 34.4032634547633, 0.5983885000000002, 205.0, 936, 223586, 331, 11.930292200000167
332, 4.34776525828056, 28.476038913977774, 34.37149955410706, 0.5969989, 180.0, 608, 224194, 332, 7.8550526000001355
333, 2.0534352352644536, 28.399457632227147, 34.18292078566044, 0.5957749000000003, 170.0, 752, 224946, 333, 9.592173700000103
334, 2.361357195623584, 28.495368041510076, 34.27605787762345, 0.5945284000000002, 105.0, 633, 225579, 334, 8.419068299999935
335, 2.37867775136146, 28.388462453648664, 34.17845687866211, 0.5936481999999998, 60.0, 345, 225924, 335, 4.398842599999853
336, 4.930409084288152, 28.463653709437395, 34.358203217789935, 0.5922720999999997, 345.0, 1184, 227108, 336, 15.17186370000013
337, 4.269890375381821, 28.467296966612533, 34.369296166727075, 0.5898285999999997, 565.0, 1531, 228639, 337, 19.712366500000144
338, 2.427341809208904, 28.41394818987165, 34.203323402404784, 0.5881357, 75.0, 350, 228989, 338, 4.585839300000089
339, 2.272052458285372, 28.496216731251412, 34.287583773990846, 0.5870575, 225.0, 848, 229837, 339, 11.01441409999984
340, 5.317340717952584, 28.37751812855966, 34.26200158319857, 0.5859135999999999, 90.0, 423, 230260, 340, 5.618878099999847
341, 5.303467264902666, 28.289283088168258, 34.122256647865726, 0.5843881, 365.0, 1272, 231532, 341, 16.483104700000013
342, 3.987247538529861, 28.27182525536264, 34.081167294945516, 0.5824764999999998, 215.0, 852, 232384, 342, 11.257099300000164
343, 3.3722399484859893, 28.289040081267103, 34.09722696195986, 0.5811867999999999, 105.0, 581, 232965, 343, 7.670717299999978
344, 2.9180180061333365, 28.30298513982367, 34.108406209893104, 0.5798475999999999, 230.0, 907, 233872, 344, 11.866483499999958
345, 4.300928799282102, 28.350927936329562, 34.23490374789518, 0.5784193, 135.0, 680, 234552, 345, 9.009696200000008
346, 3.431822714105849, 28.22600930951017, 34.01988401517763, 0.5773159000000001, 65.0, 546, 235098, 346, 7.277320599999939
347, 2.1880383173781115, 28.22085611838994, 34.008862851360654, 0.5762530000000002, 100.0, 635, 235733, 347, 8.276632600000084
348, 4.716817757531646, 28.301565326963154, 34.15497139522007, 0.5749255, 250.0, 840, 236573, 348, 11.123388900000009
349, 4.099238659062196, 28.258065964374502, 34.06784569569517, 0.5732749000000001, 245.0, 994, 237567, 349, 13.129928800000016
350, 5.048183336137258, 28.369099819686856, 34.19765119104577, 0.571978, 80.0, 447, 238014, 350, 5.96713920000002
351, 5.539390111994713, 28.3875949742544, 34.26905990073748, 0.5712238, 60.0, 391, 238405, 351, 5.247229299999844
352, 4.052226949965514, 28.309844562256952, 34.15993389570381, 0.5699682999999998, 270.0, 1004, 239409, 352, 13.310957599999938
353, 2.4455016179806006, 28.33273708279776, 34.05651722546124, 0.5686876, 25.0, 419, 239828, 353, 5.610633200000166
354, 3.18307855077824, 28.15503483618091, 33.91349970937489, 0.5677093000000003, 125.0, 668, 240496, 354, 9.024910600000112
355, 5.371353759347091, 28.16599719588821, 33.968604418938966, 0.5662423000000003, 240.0, 962, 241458, 355, 12.775670399999854
356, 3.7326899161847304, 28.156455491718493, 33.92557510460021, 0.5646412000000001, 230.0, 817, 242275, 356, 10.9496165999999
357, 3.6482011325498847, 28.15097911307152, 33.98799727318135, 0.5635675, 30.0, 376, 242651, 357, 5.089139899999964
358, 5.9523476236081585, 28.1829907651433, 34.03881232610006, 0.5626278999999997, 180.0, 668, 243319, 358, 8.926363600000059
359, 4.318209197631055, 28.253247310027614, 34.08802908640974, 0.5614309, 120.0, 662, 243981, 359, 8.957192999999961
360, 4.528402398698605, 28.194758341862606, 34.047836223015416, 0.5603670999999999, 40.0, 520, 244501, 360, 7.102814900000112
361, 4.504539232586144, 28.156743576716643, 33.95943732862301, 0.5591989000000003, 140.0, 778, 245279, 361, 10.495490100000097
362, 2.161172525056384, 28.127918253811924, 33.8794561143355, 0.5580037000000002, 15.0, 550, 245829, 362, 7.512339699999984
363, 3.426958021535602, 28.181200654539342, 33.93675423321659, 0.5564574999999999, 245.0, 1168, 246997, 363, 15.782483200000115
364, 6.191613516959991, 28.161604681204874, 34.036467463097566, 0.5548185999999999, 120.0, 653, 247650, 364, 8.952022299999953
365, 2.8661333104744555, 28.099043312072755, 33.82045037651062, 0.5533309000000001, 310.0, 1000, 248650, 365, 13.840770799999973
366, 2.1982936365497445, 28.12191766479705, 33.85796315329416, 0.5519142999999999, 135.0, 574, 249224, 366, 7.906714099999817
367, 3.320431738806228, 28.13869594232724, 33.943268815549416, 0.5508343000000002, 110.0, 626, 249850, 367, 8.59333330000004
368, 4.948596511856278, 28.252534496250437, 34.09170614427595, 0.5497884999999999, 135.0, 536, 250386, 368, 7.3345924000000196
369, 3.630458504908671, 28.200320457559073, 33.962381154579404, 0.5483503000000002, 235.0, 1062, 251448, 369, 14.617179799999803
370, 2.78995441945742, 28.137920827947113, 33.90973577472219, 0.5467627, 140.0, 702, 252150, 370, 9.711727500000052
371, 3.728573222876582, 28.171746053760263, 33.951090468958505, 0.5449347999999998, 550.0, 1329, 253479, 371, 18.173532799999975
372, 6.673980124719268, 28.232841380806857, 34.070160258093544, 0.5433517, 65.0, 430, 253909, 372, 5.876240999999936
373, 6.108300055747163, 28.177750772226112, 34.051010773839785, 0.5425048000000001, 95.0, 511, 254420, 373, 7.0234245999999985
374, 2.342227473292327, 28.149155333000927, 33.89265347481642, 0.5410558, 480.0, 1099, 255519, 374, 15.241630400000076
375, 4.668607422406167, 28.29029154819725, 34.104057278253336, 0.5395582000000001, 110.0, 565, 256084, 375, 7.914297300000044
376, 4.4475387556489405, 28.15978308231873, 33.95595651886167, 0.5382892, 305.0, 845, 256929, 376, 11.728792500000282
377, 2.3956768917917866, 28.23652857695746, 34.023719399569714, 0.5372145999999999, 85.0, 349, 257278, 377, 4.898741200000131
378, 3.8746469310526526, 28.120736842724813, 33.890409818336146, 0.5359356999999996, 300.0, 1072, 258350, 378, 14.86888480000016
379, 6.093033014326296, 28.221272630042865, 34.08773575712389, 0.5343489999999997, 185.0, 691, 259041, 379, 9.708370100000138
380, 3.240641660227126, 28.153611587666138, 33.89923695366449, 0.5331456999999997, 195.0, 646, 259687, 380, 9.127952300000288
381, 4.145708836180171, 28.404700174286035, 34.219290007814834, 0.5316238, 330.0, 1045, 260732, 381, 14.625050099999953
382, 3.426515344876883, 28.536869866507395, 34.41624541932166, 0.5301414999999997, 160.0, 602, 261334, 382, 8.517241000000013
383, 2.230753667652607, 28.509241340234794, 34.32191113737864, 0.5287636, 345.0, 929, 262263, 383, 12.993717399999696
384, 5.136939042077495, 28.529417672236573, 34.435001151295566, 0.5275485999999998, 90.0, 421, 262684, 384, 5.938491500000055
385, 5.365871108579258, 28.514448731613605, 34.424235879466515, 0.5264019999999999, 265.0, 853, 263537, 385, 12.149308800000199
386, 4.1781698606578, 28.569033012953884, 34.47391287704994, 0.5247207999999999, 335.0, 1015, 264552, 386, 14.38245919999963
387, 3.0468431447197672, 28.509834230331677, 34.31289475701296, 0.5231115999999998, 215.0, 773, 265325, 387, 10.907689000000119
388, 3.3034189736794137, 28.461119968193426, 34.28597145796942, 0.5212657, 315.0, 1278, 266603, 388, 18.189355800000158
389, 3.342801090446966, 28.546955639975412, 34.38863174983433, 0.5194854999999999, 95.0, 700, 267303, 389, 10.072161000000051
390, 4.300165304326606, 28.531373605363946, 34.403841547446675, 0.5182192, 155.0, 707, 268010, 390, 10.02562510000007
391, 2.4091436677047464, 28.50987066362725, 34.29846075089252, 0.5170339000000002, 105.0, 610, 268620, 391, 8.740302500000325
392, 4.396179707256412, 28.486891552844206, 34.359057860386706, 0.5157847, 115.0, 778, 269398, 392, 11.19593120000036
393, 2.237819371331069, 28.45632800892887, 34.29253714716332, 0.5146632999999999, 125.0, 468, 269866, 393, 6.812822100000176
394, 3.4898516845773315, 27.991776517843707, 33.73055905238218, 0.5133249999999999, 320.0, 1019, 270885, 394, 14.714861499999643
395, 3.441635757247625, 27.861478426826558, 33.54062068505408, 0.5114107, 370.0, 1108, 271993, 395, 15.90970389999984
396, 3.412282106902031, 27.948032891987175, 33.66719405066888, 0.5097339999999999, 150.0, 755, 272748, 396, 10.904319400000077
397, 4.637727147908437, 27.92513180427811, 33.68921872353067, 0.508393, 165.0, 735, 273483, 397, 10.697585100000197
398, 2.449026500825219, 27.9240015234266, 33.57835521260086, 0.5070259000000001, 175.0, 784, 274267, 398, 11.528538400000343
399, 5.21622570567598, 27.927290556366785, 33.74883687289029, 0.5057506, 65.0, 633, 274900, 399, 9.213232300000072
400, 2.363807789670924, 27.938161034642913, 33.65301592556047, 0.5045977000000001, 160.0, 648, 275548, 400, 9.515584600000238
401, 3.6572469329336266, 27.8971934891524, 33.603953887877296, 0.5035725999999998, 100.0, 491, 276039, 401, 7.197573999999804
402, 5.883875998793189, 27.96279073007328, 33.732602792916836, 0.5027815, 45.0, 388, 276427, 402, 5.664986900000258
403, 2.860051575621727, 27.906855619577783, 33.59023640995652, 0.5014180000000004, 215.0, 1127, 277554, 403, 16.47103849999985
404, 3.6004329427226183, 27.91104634742444, 33.66227247319813, 0.4995837999999998, 450.0, 911, 278465, 404, 13.39416829999982
405, 4.569038954773251, 27.878100198903386, 33.623640873443755, 0.49820860000000006, 110.0, 617, 279082, 405, 9.183682200000021
406, 3.0501166684448644, 27.91859032237812, 33.63289619056255, 0.49693059999999983, 115.0, 803, 279885, 406, 11.817680999999993
407, 1.989941736940521, 27.603053635655186, 33.235927918997916, 0.4957192, 70.0, 543, 280428, 407, 8.004184299999906
408, 2.6037795651976654, 27.764468932733305, 33.442887213171986, 0.4948615000000001, 30.0, 410, 280838, 408, 6.195034599999872
409, 3.9894684879360973, 27.687513134194155, 33.39475261658775, 0.4940263000000001, 50.0, 518, 281356, 409, 7.768892200000209
410, 3.4727096954663086, 27.672023940290142, 33.44782402168991, 0.4931388999999998, 85.0, 468, 281824, 410, 6.949514299999919
411, 4.6466476898541496, 27.615719148754017, 33.24997266921322, 0.49220919999999996, 110.0, 565, 282389, 411, 8.407533300000068
412, 4.845088200406445, 27.64526345642698, 33.38427229128275, 0.49088799999999966, 245.0, 903, 283292, 412, 13.452402800000073
413, 6.7137857423783345, 27.662607218089857, 33.40896722346402, 0.48932289999999995, 170.0, 836, 284128, 413, 12.743497700000262
414, 5.4028505347581675, 27.632677828202226, 33.34532981075591, 0.48780369999999995, 240.0, 852, 284980, 414, 12.629407699999774
415, 3.1844747018086195, 27.57926139011178, 33.21649036026587, 0.48645099999999997, 95.0, 651, 285631, 415, 9.800188000000162
416, 2.8708610228924867, 27.63129773657006, 33.27435272400638, 0.4851180999999999, 240.0, 830, 286461, 416, 12.563601599999856
417, 3.4241796891899328, 27.581782348782163, 33.19480339971297, 0.48381939999999984, 115.0, 613, 287074, 417, 9.151109699999779
418, 2.4097994990166156, 27.63952655946055, 33.28051803573485, 0.4828213000000001, 120.0, 496, 287570, 418, 7.544296000000031
419, 4.084559862381882, 27.640018386840822, 33.30572217870642, 0.4817673999999999, 115.0, 675, 288245, 419, 10.312234999999873
420, 2.263345438601642, 27.544218179420334, 33.17100755873365, 0.4807162, 95.0, 493, 288738, 420, 7.524494899999809
421, 4.610694200177944, 27.661992676632696, 33.37207179832738, 0.47904670000000027, 365.0, 1362, 290100, 421, 20.51062869999987
422, 3.486330649062475, 27.86272952512908, 33.56731570568201, 0.47737900000000005, 35.0, 491, 290591, 422, 7.423842200000308
423, 3.4828201662303444, 27.866428740286942, 33.619465102419326, 0.4765609, 45.0, 418, 291009, 423, 6.31905340000003
424, 5.636222580575287, 27.874670359845553, 33.60117993808549, 0.47564560000000006, 110.0, 599, 291608, 424, 9.236888100000215
425, 3.550828659859106, 27.816581688721, 33.5588268270691, 0.47437119999999994, 160.0, 817, 292425, 425, 12.402482899999995
426, 5.954819334058467, 27.827112699582194, 33.544969664679634, 0.4728420999999998, 210.0, 882, 293307, 426, 13.537315099999887
427, 3.4926493525548765, 27.817258708055185, 33.49354860113746, 0.4711275999999999, 285.0, 1023, 294330, 427, 15.550863299999946
428, 2.278733985361122, 27.76764146369648, 33.389342036339265, 0.46941400000000016, 200.0, 881, 295211, 428, 13.422955900000034
429, 5.486525392360412, 27.89517814440605, 33.72143576695369, 0.46827009999999997, 45.0, 390, 295601, 429, 6.079348399999617
430, 3.6142348978123646, 27.817599240027867, 33.549510537400074, 0.4674637000000001, 40.0, 506, 296107, 430, 7.817199900000105
431, 2.2500128020453296, 27.8818061554354, 33.57230318293852, 0.4664574999999999, 90.0, 612, 296719, 431, 9.61969739999995
432, 6.924184166209278, 27.85391055029024, 33.623871486181066, 0.46518130000000024, 310.0, 806, 297525, 432, 12.385293499999989
433, 5.322978759089769, 27.86928394400756, 33.592416924945375, 0.4640842, 30.0, 413, 297938, 433, 6.485807999999906
434, 2.6893004257818895, 27.876339013936818, 33.53853029657918, 0.46287279999999964, 235.0, 933, 298871, 434, 14.404175099999975
435, 3.191575104079117, 27.832253319005996, 33.530260049496974, 0.46146969999999987, 130.0, 626, 299497, 435, 9.74597219999987
436, 4.7030703358045995, 28.370425699834954, 34.247017925732756, 0.46024929999999986, 230.0, 730, 300227, 436, 11.431522800000039
437, 7.021688901463946, 29.557541266145652, 35.67478927016159, 0.45850959999999996, 555.0, 1203, 301430, 437, 18.84742950000009
438, 3.640087692819213, 29.4683120550826, 35.46371576937304, 0.45653320000000014, 230.0, 993, 302423, 438, 15.498703199999909
439, 5.299704632939227, 29.495483468732903, 35.61925269461967, 0.4552732, 70.0, 407, 302830, 439, 6.467166800000086
440, 3.206443069723703, 29.420814634655216, 35.39927601924479, 0.4543227999999998, 120.0, 649, 303479, 440, 10.217023400000016
441, 2.915080037419614, 29.506479014104336, 35.54546807758772, 0.45230589999999976, 500.0, 1592, 305071, 441, 24.8678589000001
442, 5.671865964245275, 29.52271568840319, 35.62430219806608, 0.4500496, 290.0, 915, 305986, 442, 14.495394300000044
443, 4.150520040330763, 29.52022163184707, 35.57622822778736, 0.4483279000000001, 260.0, 998, 306984, 443, 15.91371079999999
444, 5.622039946479888, 29.504350860209403, 35.550351256358475, 0.44707420000000003, 125.0, 395, 307379, 444, 6.239936700000271
445, 4.855496277037753, 29.576107341122913, 35.69896738021728, 0.4458222999999999, 520.0, 996, 308375, 445, 16.027459600000384
446, 3.284911818104372, 29.48235112649423, 35.48850916777301, 0.4440997000000002, 405.0, 918, 309293, 446, 14.691434899999877
447, 3.4009732630723777, 29.54535961580062, 35.578300882136446, 0.44267320000000027, 105.0, 667, 309960, 447, 10.69933140000012
448, 2.423516464209746, 28.973273395356678, 34.88113762083508, 0.44150590000000006, 120.0, 630, 310590, 448, 10.109458700000232
449, 6.031693662935868, 29.025517591834067, 35.0566585958004, 0.4403628999999998, 170.0, 640, 311230, 449, 10.432566899999983
450, 2.469194181129202, 28.965583723944587, 34.831833149219776, 0.4391875, 130.0, 666, 311896, 450, 10.784359600000244
451, 3.6511251593546907, 28.927257466464926, 34.85759154972069, 0.4377222999999999, 230.0, 962, 312858, 451, 15.60708909999994
452, 3.393710043677901, 28.945548781549743, 34.86231931383489, 0.4363408, 75.0, 573, 313431, 452, 9.160197600000174
453, 3.3200322522802344, 28.89664478658213, 34.806691731580855, 0.435295, 35.0, 589, 314020, 453, 9.625590199999806
454, 6.943114882237033, 29.07663264453859, 35.084010759511386, 0.4341664, 150.0, 665, 314685, 454, 10.82343690000016
455, 4.397429657321827, 28.930772746524045, 34.87988752395314, 0.43282900000000024, 120.0, 821, 315506, 455, 13.367534700000306
456, 3.865583595021305, 28.892826559200095, 34.80077717137575, 0.43145920000000015, 160.0, 701, 316207, 456, 11.383993300000384
457, 4.0730399421839785, 28.87281608316265, 34.77761824373078, 0.43018120000000004, 90.0, 719, 316926, 457, 11.732212299999901
458, 2.3768401572049545, 28.96568904839126, 34.83915497399316, 0.4288033, 180.0, 812, 317738, 458, 13.25689340000008
459, 3.7594035418323823, 28.997643154204205, 34.91798443819216, 0.4272130000000003, 300.0, 955, 318693, 459, 15.50004029999991
460, 5.428339636603896, 29.00776817924098, 35.02387123929257, 0.42597729999999995, 30.0, 418, 319111, 460, 6.931408200000078
461, 2.8022863336886137, 28.996664912013685, 34.88666323079901, 0.4247514999999999, 285.0, 944, 320055, 461, 15.452047900000252
462, 3.826970938149887, 29.335018423539175, 35.34828839845295, 0.42354639999999993, 55.0, 395, 320450, 462, 6.546999600000163
463, 3.299631041141807, 29.325901516148303, 35.257612675526104, 0.42264189999999996, 125.0, 610, 321060, 463, 9.934384900000168
464, 2.0815795788021063, 29.194310305323988, 35.124563077722456, 0.4217482000000001, 80.0, 383, 321443, 464, 6.343512200000077
465, 3.5320951036756254, 29.308135162307416, 35.30828804407955, 0.42050979999999993, 255.0, 993, 322436, 465, 16.37404319999996
466, 4.0068736902882005, 29.346573780630237, 35.33694777978915, 0.4192308999999999, 55.0, 428, 322864, 466, 7.022080000000187
467, 3.1325453550734434, 29.296026996507443, 35.30457811649267, 0.4182903999999999, 210.0, 617, 323481, 467, 10.253750200000013
468, 3.6561453643873447, 29.294311573357202, 35.279608939700196, 0.4169097999999999, 215.0, 917, 324398, 468, 15.057048300000133
469, 2.3558010467586947, 29.33484805125898, 35.293025152427624, 0.41526189999999985, 115.0, 914, 325312, 469, 15.118617500000255
470, 3.920165751420252, 29.34979177595259, 35.34523506279106, 0.4138398999999999, 305.0, 666, 325978, 470, 10.96734619999961
471, 3.8487906761056796, 29.313676638866035, 35.33185034581325, 0.4124403999999999, 165.0, 889, 326867, 471, 14.770304499999838
472, 2.5092650084996855, 29.38311666526542, 35.37502386712081, 0.4110966999999999, 135.0, 604, 327471, 472, 9.99892920000002
473, 3.491698692083685, 29.359490970625494, 35.35964346280063, 0.4095666999999998, 560.0, 1096, 328567, 473, 18.294960100000026
474, 5.707922940621268, 29.27039291899083, 35.32143878397969, 0.40826169999999995, 40.0, 354, 328921, 474, 5.886524200000167
475, 7.235961460772364, 29.353324267953475, 35.46696914836047, 0.4076065, 55.0, 374, 329295, 475, 6.230251000000408
476, 4.369144753048075, 29.37876726220257, 35.40896600380611, 0.4067037999999999, 215.0, 629, 329924, 476, 10.419230299999981
477, 3.7399400707303743, 29.724438006760643, 35.7568944086794, 0.4052592999999998, 145.0, 976, 330900, 477, 16.254849699999795
478, 3.436486767313142, 29.74263380003185, 35.81764335688176, 0.40376619999999985, 205.0, 683, 331583, 478, 11.21453049999991
479, 3.0019292333265293, 29.752065307728564, 35.84076132113046, 0.4025349999999999, 125.0, 685, 332268, 479, 11.333851600000344
480, 1.8935686446288054, 29.645135819411077, 35.67065131964804, 0.4014900999999999, 35.0, 476, 332744, 480, 7.946315400000003
481, 3.5602981913807934, 29.79058660917296, 35.853735870097104, 0.4004379999999999, 175.0, 693, 333437, 481, 11.518282
482, 2.1947591166896157, 29.757368623757664, 35.786249648468406, 0.39945879999999984, 65.0, 395, 333832, 482, 6.594249000000218
483, 2.259131312628767, 29.690973540776454, 35.71455914078795, 0.39850659999999993, 110.0, 663, 334495, 483, 11.08316079999986
484, 4.518147485981505, 29.774936407158172, 35.8780272334455, 0.3971628999999999, 230.0, 830, 335325, 484, 13.75161849999995
485, 2.8207932831353495, 29.722057434148663, 35.77272570414314, 0.39538539999999983, 400.0, 1145, 336470, 485, 18.954574400000183
486, 3.1861309182933844, 29.707516659705067, 35.787816226542176, 0.39345760000000013, 165.0, 997, 337467, 486, 16.64760810000007
487, 5.956345797946611, 29.791958465188895, 36.02355472932612, 0.39220569999999993, 80.0, 394, 337861, 487, 6.620679499999824
488, 5.813706463981509, 29.78835452590858, 35.88594148611276, 0.3913624, 105.0, 543, 338404, 488, 9.096014700000069
489, 4.842188793943057, 29.792342675411984, 35.88018760097541, 0.39022660000000003, 110.0, 719, 339123, 489, 11.944960100000117
490, 3.1944648222137877, 29.740693544557956, 35.86726284176344, 0.3890044, 130.0, 639, 339762, 490, 10.688634199999797
491, 4.223180814386313, 30.16815309251236, 36.35701085431543, 0.3878325999999999, 135.0, 663, 340425, 491, 11.099778000000242
492, 4.075877482936973, 30.45713979299301, 36.666758743053904, 0.3862306, 290.0, 1117, 341542, 492, 18.702468899999985
493, 6.004050730563926, 30.529596360524497, 36.87283759261623, 0.38463129999999995, 65.0, 660, 342202, 493, 11.068207600000278
494, 3.4350277920525905, 30.414740701465657, 36.62329144164831, 0.3829815999999998, 220.0, 1173, 343375, 494, 19.65804829999979
495, 5.999786922445068, 30.4960657108975, 36.78480818581446, 0.3816072999999999, 95.0, 354, 343729, 495, 5.958173299999999
496, 3.375462960765382, 30.472602670100887, 36.69078703375584, 0.38065779999999994, 215.0, 701, 344430, 496, 11.75197160000016
497, 6.7552398397321145, 30.521035776819502, 36.77743941375187, 0.37952289999999994, 110.0, 560, 344990, 497, 9.427046599999812
498, 3.616720867369117, 30.479325457855506, 36.69059352080027, 0.37824130000000006, 70.0, 864, 345854, 498, 14.486031099999764
499, 2.417286018245883, 30.51391685726308, 36.72822065817934, 0.37714959999999986, 45.0, 349, 346203, 499, 5.8632087000000865
500, 2.948323508374172, 30.494404844718403, 36.649904241656316, 0.37647189999999986, 75.0, 404, 346607, 500, 6.813589800000045
501, 3.5014271765543397, 30.533168781234558, 36.75213943619326, 0.37551069999999986, 145.0, 664, 347271, 501, 11.235506500000156
502, 2.7635768101513385, 30.4207534160614, 36.60812519454956, 0.37401310000000004, 305.0, 1000, 348271, 502, 16.819553299999825
503, 4.237888032311125, 30.50544581835783, 36.79615293389518, 0.3721888, 265.0, 1027, 349298, 503, 17.2496842999999
504, 4.249307703672036, 30.356473285022915, 36.51090430924824, 0.37066960000000004, 140.0, 661, 349959, 504, 11.088552000000163
505, 3.9568178394075595, 30.346694185276224, 36.598620149824356, 0.36936189999999997, 250.0, 792, 350751, 505, 13.365308500000083
506, 2.2813633838005725, 30.20220787962724, 36.310282625062634, 0.36816849999999995, 95.0, 534, 351285, 506, 8.977357199999915
507, 3.3715964840783474, 30.338513228120704, 36.54470635789612, 0.3671712999999999, 125.0, 574, 351859, 507, 9.702099999999973
508, 2.3874959601073273, 30.25043589339973, 36.420207450221035, 0.36613359999999995, 55.0, 579, 352438, 508, 9.750409000000218
509, 4.276208777803402, 30.27913228134436, 36.49486337361404, 0.36473229999999984, 250.0, 978, 353416, 509, 16.488488299999972
510, 4.420037900743721, 30.38600663021878, 36.56535039792906, 0.36325269999999993, 175.0, 666, 354082, 510, 11.27943550000009
511, 4.077434252906519, 30.252423310082808, 36.4407386569609, 0.3619999, 120.0, 726, 354808, 511, 12.267342000000099
512, 3.4096242496068925, 30.365350810143767, 36.5556680193599, 0.36091179999999984, 155.0, 483, 355291, 512, 8.179405899999892
513, 4.969150189188432, 30.34495293737984, 36.555005422187904, 0.35984439999999995, 175.0, 703, 355994, 513, 11.998867099999643
514, 3.2868227682221844, 30.282059787241824, 36.45385759186764, 0.358111, 330.0, 1223, 357217, 514, 20.627401599999757
515, 2.1211420668440244, 30.26577023013993, 36.40080805686495, 0.3564226000000001, 110.0, 653, 357870, 515, 11.396891699999742
516, 2.583346426516187, 30.375866968491497, 36.55317828608494, 0.3553758999999999, 65.0, 510, 358380, 516, 8.645025400000122
517, 2.236114836768555, 30.240032261114386, 36.39010227260305, 0.35449479999999983, 5.0, 469, 358849, 517, 7.949728099999902
518, 2.3010919883088197, 30.282233583383842, 36.417166487461124, 0.35373699999999986, 20.0, 373, 359222, 518, 6.443613800000094
519, 5.9985295265674115, 30.310720122648863, 36.629456338519326, 0.35295219999999994, 145.0, 499, 359721, 519, 8.464117299999998
520, 3.5543696903287785, 30.334307352701824, 36.50385623508029, 0.3520414, 120.0, 513, 360234, 520, 8.756985600000007
521, 5.587535494863183, 30.528403773140713, 36.80648749558002, 0.3505779999999997, 375.0, 1113, 361347, 521, 18.86969259999978
522, 3.622874788576155, 30.465002715587616, 36.67699094116688, 0.34911549999999986, 125.0, 512, 361859, 522, 8.725357099999655
523, 3.0363938163549817, 30.47745775669179, 36.68623295236141, 0.3479779, 140.0, 752, 362611, 523, 12.876580300000114
524, 4.519626594179928, 30.4554293150949, 36.6474238782826, 0.3468465999999999, 125.0, 505, 363116, 524, 8.625025300000289
525, 3.536196294584199, 30.483167152280256, 36.71674096623235, 0.345565, 315.0, 919, 364035, 525, 15.60118040000043
526, 3.844610430200451, 30.463543417198316, 36.73055592605046, 0.34393149999999995, 170.0, 896, 364931, 526, 15.33380729999999
527, 2.283563015385739, 30.499760603055986, 36.70740799764985, 0.3425688999999999, 140.0, 618, 365549, 527, 10.555266200000005
528, 4.405273095965385, 30.519924776995623, 36.81568640814887, 0.34140519999999996, 160.0, 675, 366224, 528, 11.60126050000008
529, 3.5581555286299524, 30.499135168690945, 36.71836939385018, 0.34029280000000006, 165.0, 561, 366785, 529, 9.626083300000118
530, 5.185874488785628, 30.478084419588846, 36.71415217649272, 0.3391588, 130.0, 699, 367484, 530, 12.001797200000055
531, 4.119920754298484, 30.488155644114425, 36.735125328765356, 0.33804999999999996, 95.0, 533, 368017, 531, 9.195092699999805
532, 2.0378870511846126, 30.476063885120606, 36.70489808049497, 0.3369736, 135.0, 663, 368680, 532, 11.35462729999972
533, 3.4797943916473484, 30.44161006766306, 36.66292452812195, 0.33535449999999983, 325.0, 1136, 369816, 533, 19.519225099999858
534, 3.2556837530791265, 30.42619523923259, 36.6312965140855, 0.3337876, 105.0, 605, 370421, 534, 10.449716999999964
535, 3.552355180366188, 30.429097641565875, 36.610258266876194, 0.3323349999999998, 395.0, 1009, 371430, 535, 17.38995010000008
536, 5.104589080845134, 30.48939140806807, 36.73859120706525, 0.33096159999999997, 85.0, 517, 371947, 536, 8.95919049999975
537, 4.1507666541412735, 30.495559376706645, 36.71070620905647, 0.3294630999999998, 340.0, 1148, 373095, 537, 19.976360999999997
538, 2.3411710936938768, 30.438111880817246, 36.587001888308905, 0.3279213999999998, 105.0, 565, 373660, 538, 9.843515600000046
539, 3.347534274475442, 30.41362939763952, 36.62372187155265, 0.3269269, 210.0, 540, 374200, 539, 9.403283499999816
540, 3.073726312553916, 30.44131543782836, 36.69843173426623, 0.3257965, 180.0, 716, 374916, 540, 12.220542500000192
541, 4.231671848367491, 30.483077850992956, 36.73262278962441, 0.3245193999999999, 190.0, 703, 375619, 541, 12.333800500000052
542, 3.7599957119607983, 30.449102149060014, 36.638949189627716, 0.32311900000000005, 205.0, 853, 376472, 542, 14.91347050000013
543, 4.708446419348319, 30.42471167755127, 36.694915710449216, 0.3216762999999999, 190.0, 750, 377222, 543, 13.235302000000047
544, 2.499461424143811, 30.421153535104615, 36.5909710767644, 0.3198735999999998, 605.0, 1253, 378475, 544, 21.786347800000385
545, 2.3450401775716316, 30.506431505793618, 36.69613484541575, 0.3181410999999999, 115.0, 672, 379147, 545, 11.901853200000005
546, 2.3638718138738803, 30.478017589521244, 36.67105773699596, 0.3167469999999999, 260.0, 877, 380024, 546, 15.494654600000104
547, 3.270127233333927, 30.613310034103815, 36.85514041205138, 0.3153060999999999, 75.0, 724, 380748, 547, 12.859825
548, 2.6871669728629635, 30.491594811412146, 36.665106135488344, 0.31424679999999994, 85.0, 453, 381201, 548, 8.056996400000116
549, 4.0583781084974575, 30.628011872039604, 36.86659514183822, 0.31284099999999987, 350.0, 1109, 382310, 549, 19.643657399999938
550, 3.980422269377517, 30.568717641293286, 36.825980129224334, 0.31086820000000004, 305.0, 1083, 383393, 550, 19.03721029999997
551, 7.0054515729725795, 30.69490914552108, 37.02734889431276, 0.3086514999999998, 555.0, 1380, 384773, 551, 24.29430790000015
552, 3.303831933310291, 30.648023139722937, 36.860311501771044, 0.3066058, 275.0, 893, 385666, 552, 15.99320699999953
553, 3.110240092541342, 30.623606239373867, 36.855845932777115, 0.3043044999999999, 750.0, 1664, 387330, 553, 29.517216699999153
554, 3.279323120873412, 30.67206944113246, 36.91888088650174, 0.3021102999999999, 235.0, 774, 388104, 554, 13.93166519999977
555, 5.374010959154553, 30.685992329964844, 36.96775771857236, 0.30048850000000005, 285.0, 1028, 389132, 555, 18.42346820000057
556, 5.163386382905233, 30.621622514878055, 36.883085962277136, 0.2990034999999999, 10.0, 622, 389754, 556, 11.207502899999781
557, 4.133517161786129, 30.525368174344408, 36.7397586863528, 0.2974392999999999, 435.0, 1116, 390870, 557, 20.099534400000266
558, 2.8885765370133236, 30.34432018677034, 36.531311993145835, 0.2954404, 245.0, 1105, 391975, 558, 19.90257119999933
559, 3.0484681407947076, 30.374862218640516, 36.5669246724147, 0.2938348, 115.0, 679, 392654, 559, 12.353086500000245
560, 4.245923529887199, 30.426403619384764, 36.65446943359375, 0.2926612, 90.0, 625, 393279, 560, 11.310013999999683
561, 4.381464450387827, 30.432257743426415, 36.658423703867236, 0.2913265, 220.0, 858, 394137, 561, 15.790114299999914
562, 3.7332860505739354, 30.39535711685457, 36.551126734703374, 0.2897587, 220.0, 884, 395021, 562, 16.13671559999966
563, 6.289560091084215, 30.427899465086234, 36.67586709622344, 0.28796859999999996, 415.0, 1105, 396126, 563, 20.138554199999817
564, 3.8086847646816357, 30.380885199290184, 36.55432314934377, 0.28620819999999997, 265.0, 851, 396977, 564, 15.679176199999347
565, 2.8705809883400106, 30.448141731446217, 36.62141531694798, 0.2844720999999999, 465.0, 1078, 398055, 565, 19.759825600000113
566, 4.421850208646759, 30.37982755479866, 36.59642961811087, 0.2826963999999999, 125.0, 895, 398950, 566, 16.50312430000031
567, 3.522770179716865, 30.426412946478255, 36.601900448486674, 0.28125910000000004, 110.0, 702, 399652, 567, 12.988932199999908
568, 3.7706233948095593, 30.329427692551466, 36.52424886166883, 0.2803042, 50.0, 359, 400011, 568, 6.58392189999995
569, 4.568885813488706, 30.192427666479876, 36.364348248172355, 0.27924039999999994, 275.0, 823, 400834, 569, 15.30794700000024
570, 4.565522677415543, 30.226495347687408, 36.408725823191915, 0.2777698, 175.0, 811, 401645, 570, 14.839774500000203
571, 4.227285969634372, 30.188029925794485, 36.34120393776032, 0.2762928999999999, 180.0, 830, 402475, 571, 15.466468999999961
572, 3.1347675419948455, 30.171293996565836, 36.304099554456144, 0.2749015, 115.0, 716, 403191, 572, 13.512717900000098
573, 3.153023532656965, 30.232480922179935, 36.35590582763188, 0.2735757999999999, 210.0, 757, 403948, 573, 14.086132099999304
574, 5.5242687499918475, 30.20874177207068, 36.396622728222034, 0.2717613999999998, 670.0, 1259, 405207, 574, 23.426314000000275
575, 3.5720813145299495, 30.24138875042691, 36.39394079236423, 0.2696491000000001, 320.0, 1088, 406295, 575, 20.23520230000031
576, 4.226027855973619, 30.249947063047877, 36.46501561688253, 0.26786799999999994, 190.0, 891, 407186, 576, 16.67189899999994
577, 3.5815243277317865, 30.159401192034867, 36.30676205318765, 0.26670519999999986, 75.0, 401, 407587, 577, 7.557946599999923
578, 4.611896560368618, 30.247513018509206, 36.42799427723005, 0.2658322, 100.0, 569, 408156, 578, 10.719775499999741
579, 3.304968077205687, 30.200059913262148, 36.30981294139843, 0.2647863999999999, 110.0, 593, 408749, 579, 11.259909399999742
580, 4.013022070213168, 30.238212925810387, 36.42186707002677, 0.26347599999999993, 225.0, 863, 409612, 580, 16.088804200000595
581, 5.217003047488586, 30.253715646481087, 36.46910299369675, 0.2620980999999999, 150.0, 668, 410280, 581, 12.870143899999675
582, 3.1765565735365864, 30.15734308221367, 36.2637137033222, 0.26077599999999995, 175.0, 801, 411081, 582, 15.227805100000296
583, 5.758947759763754, 30.22209792640341, 36.406309137392284, 0.2593386999999999, 205.0, 796, 411877, 583, 15.042628600000171
584, 3.2165400967537576, 30.2945502131593, 36.43599843978882, 0.25807149999999995, 115.0, 612, 412489, 584, 11.617888000000676
585, 4.1641703337152425, 30.25505397730421, 36.419275123382285, 0.2568465999999999, 65.0, 749, 413238, 585, 14.5295356000006
586, 4.101321694897135, 30.294779119619665, 36.42498355907398, 0.2554354, 230.0, 819, 414057, 586, 15.624831600000107
587, 3.395395498011345, 30.234806238619008, 36.411885701803335, 0.2540997999999999, 95.0, 665, 414722, 587, 12.744606499999463
588, 3.863268083522591, 30.297765456573874, 36.4402115640761, 0.2524347999999999, 305.0, 1185, 415907, 588, 22.66136270000061
589, 3.6262056407799856, 30.306984219244146, 36.472578081561565, 0.2503755999999999, 350.0, 1103, 417010, 589, 21.25954610000008
590, 2.0804501130424575, 30.33292129966019, 36.44865036545763, 0.2487411999999999, 190.0, 713, 417723, 590, 13.84889320000002
591, 4.11176375572079, 30.323579424171037, 36.52725274075744, 0.24776469999999987, 40.0, 372, 418095, 591, 7.190244200000052
592, 2.4653124331303364, 30.134556700919838, 36.20565270477871, 0.2470959999999999, 100.0, 371, 418466, 592, 7.21759480000037
593, 2.1838329049126473, 30.238343227300824, 36.3380701990737, 0.24624100000000002, 85.0, 579, 419045, 593, 11.248525500000142
594, 4.230286275973003, 30.262676135634344, 36.41100858155951, 0.2450556999999999, 145.0, 738, 419783, 594, 14.333104899999853
595, 4.1951094172170595, 30.215538885858322, 36.410191700193614, 0.24374349999999992, 225.0, 720, 420503, 595, 13.986329299999852
596, 5.848174259980398, 30.266585100862315, 36.485390442654605, 0.2421378999999999, 265.0, 1064, 421567, 596, 20.557728800000405
597, 3.034463918794479, 30.20237040292649, 36.3291383993058, 0.2404243, 410.0, 840, 422407, 597, 16.55428000000029
598, 6.63325043493589, 30.18677755502554, 36.38948356347738, 0.2391300999999999, 225.0, 598, 423005, 598, 11.63206910000008
599, 2.2029996075552183, 30.197519310507634, 36.315146065029616, 0.2379591999999999, 170.0, 703, 423708, 599, 13.613615000000209
600, 4.082894598027472, 30.268145522669037, 36.4683858841291, 0.23630229999999997, 380.0, 1138, 424846, 600, 22.313459899999543
601, 2.4103891962273853, 30.1785800693542, 36.29173478254183, 0.2347066, 120.0, 635, 425481, 601, 12.609508399999868
602, 2.2830702367485785, 30.171838523284404, 36.281486433379506, 0.2336499999999999, 185.0, 539, 426020, 602, 10.601597300000321
603, 2.9149465646679427, 30.255763842842796, 36.41172040159052, 0.23237289999999994, 175.0, 880, 426900, 603, 17.294868099999803
604, 7.545456156872951, 30.290560633570582, 36.5556179329201, 0.2306817999999999, 260.0, 999, 427899, 604, 19.573758600000474
605, 3.155948996064998, 30.21034423046939, 36.35837448587689, 0.22857849999999982, 390.0, 1338, 429237, 605, 26.40562470000077
606, 5.626841120646732, 30.272167679377215, 36.49292920482829, 0.2267181999999999, 195.0, 729, 429966, 606, 14.540681700000277
607, 6.301118162322067, 29.8689551685714, 35.99223380439025, 0.22510629999999995, 565.0, 1062, 431028, 607, 20.95917449999979
608, 3.530319593350528, 29.88384175112538, 35.91122832034994, 0.22312359999999995, 140.0, 1141, 432169, 608, 21.622667000000547
609, 1.9691477367423829, 29.868964680262973, 35.90579825265067, 0.22162419999999988, 170.0, 525, 432694, 609, 9.566984300000513
610, 3.976837467857831, 29.845539724226477, 35.913228662065464, 0.22052619999999987, 80.0, 695, 433389, 610, 12.799997900000562
611, 4.481774573669621, 29.96801722384426, 36.06525712531621, 0.21865059999999983, 330.0, 1389, 434778, 611, 25.323172299999896
612, 3.4107162250795557, 29.963264088335148, 36.02162721208991, 0.21686319999999987, 30.0, 597, 435375, 612, 10.978725199999644
613, 4.42229156560368, 29.9158407249836, 36.00740798796066, 0.21543489999999993, 350.0, 990, 436365, 613, 18.222519200000534
614, 6.735437588958905, 29.944721014227063, 36.12532718125359, 0.214048, 60.0, 551, 436916, 614, 10.2327652999993
615, 3.3191174455874024, 29.922108366375877, 36.009613037109375, 0.21309849999999997, 50.0, 504, 437420, 615, 9.32730040000024
616, 4.132160787242982, 29.961971542570325, 36.0554963959588, 0.21232089999999995, 80.0, 360, 437780, 616, 6.698253100000329
617, 2.3004591208177882, 29.861178396783423, 35.87511470530293, 0.2113605999999999, 165.0, 707, 438487, 617, 13.095642100000077
618, 3.950457911322867, 29.872960759493246, 35.993490926492754, 0.2099889999999999, 215.0, 817, 439304, 618, 15.029917599999862
619, 4.319153910922207, 30.017994026401634, 36.11608698797085, 0.20833839999999995, 300.0, 1017, 440321, 619, 18.87873899999977
620, 6.380479883402586, 30.289621214761343, 36.49634552001953, 0.20685249999999997, 115.0, 634, 440955, 620, 11.822896099999525
621, 3.5949441058308396, 30.349611071082247, 36.48018600118699, 0.20570499999999997, 60.0, 641, 441596, 621, 11.915581299999758
622, 3.922064410228737, 30.298704552729138, 36.485562558063975, 0.20376459999999996, 615.0, 1515, 443111, 622, 27.82003050000003
623, 4.131356045684627, 30.30682257622521, 36.46985827695725, 0.2010745, 395.0, 1474, 444585, 623, 27.256889300000694
624, 3.0947529442537096, 30.34159782563715, 36.482165747063824, 0.19890099999999988, 175.0, 941, 445526, 624, 17.537622300000294
625, 3.234387847421904, 30.284733861488473, 36.43799178936422, 0.19737099999999988, 150.0, 759, 446285, 625, 14.204117500000393
626, 3.4316549725472805, 30.27503183241428, 36.38917333646707, 0.19625679999999998, 45.0, 479, 446764, 626, 9.055963300000258
627, 3.957363157292957, 30.26433399402656, 36.46239563804003, 0.19482399999999994, 235.0, 1113, 447877, 627, 20.834805700000288
628, 4.46115901420619, 30.29305985418417, 36.49259107395754, 0.19297269999999997, 280.0, 944, 448821, 628, 17.782959900000606
629, 3.3281275868364033, 30.328941729778762, 36.43957916029911, 0.19134639999999997, 105.0, 863, 449684, 629, 16.423318299999664
630, 5.027981906108758, 30.093595906692446, 36.23662353018691, 0.1896301, 205.0, 1044, 450728, 630, 19.686303300000873
631, 4.748328397788785, 30.00728446266868, 36.104279461484964, 0.18794799999999995, 280.0, 825, 451553, 631, 15.691399399999682
632, 5.0403209494097245, 29.944379787680543, 36.04724122663584, 0.18611199999999994, 320.0, 1215, 452768, 632, 22.879134599999816
633, 5.048808305514528, 29.975703140474714, 36.07893938688362, 0.18330129999999997, 495.0, 1908, 454676, 633, 35.87161139999989
634, 3.9505045600654034, 29.927498763866637, 36.019012904281986, 0.18102339999999992, 75.0, 623, 455299, 634, 11.824544900000546
635, 3.7435464217401866, 29.982355708807287, 36.09199805550732, 0.1796958999999999, 175.0, 852, 456151, 635, 16.203423300000395
636, 5.21813833453681, 30.033978309160396, 36.20075138115588, 0.17834589999999995, 120.0, 648, 456799, 636, 12.444897299999866
637, 3.260695568858272, 29.970405433821853, 36.00240043584448, 0.17714619999999995, 110.0, 685, 457484, 637, 13.084513899999365
638, 4.698003381020454, 30.008677920881343, 36.14859267616648, 0.17607339999999996, 110.0, 507, 457991, 638, 9.718700999999783
639, 5.234032594280595, 29.948316933220898, 36.05222008251579, 0.17497179999999996, 165.0, 717, 458708, 639, 14.143748999999843
640, 4.413696371389622, 29.96332947744795, 36.10748341837434, 0.17376579999999986, 215.0, 623, 459331, 640, 12.225273900000502
641, 4.425297989658415, 29.957226311903327, 36.06847069407804, 0.1719117999999999, 725.0, 1437, 460768, 641, 27.333083599999554
642, 2.333024218171789, 29.804309945202316, 35.8146615124191, 0.17003619999999992, 180.0, 647, 461415, 642, 12.481854599999679
643, 3.168645395274933, 29.863482747426847, 35.92543036298054, 0.16871589999999992, 190.0, 820, 462235, 643, 15.86423459999969
644, 3.980417919008672, 29.857092299047306, 35.86028162104075, 0.16765659999999988, 90.0, 357, 462592, 644, 6.881905499999448
645, 5.6680857342976045, 29.868083098959637, 36.017529693030085, 0.16635339999999998, 265.0, 1091, 463683, 645, 20.92198830000052
646, 4.57786837581403, 29.8264350151353, 35.907834684918136, 0.1639791999999999, 525.0, 1547, 465230, 646, 29.79836020000039
647, 5.0249533184040125, 29.85553368343396, 35.937331253223206, 0.1617858999999999, 305.0, 890, 466120, 647, 17.197458699999515
648, 2.402288127415774, 29.918898380653168, 35.996694119694446, 0.16024059999999996, 190.0, 827, 466947, 648, 16.07786380000016
649, 2.482673079889688, 29.922073835655763, 35.96497211045337, 0.1587861999999999, 150.0, 789, 467736, 649, 15.316977000000406
650, 2.477497746004808, 29.94957207175842, 35.97500763605776, 0.15766389999999994, 80.0, 458, 468194, 650, 8.954332700000123
651, 4.485891590169113, 29.909098207950592, 35.98343784279294, 0.15595569999999997, 630.0, 1440, 469634, 651, 27.689717799999926
652, 3.395050358295737, 30.023604453844577, 36.11780534663671, 0.15357339999999994, 400.0, 1207, 470841, 652, 23.552001500000188
653, 3.2727720044956814, 30.08693183334532, 36.16316440839276, 0.15180579999999996, 120.0, 757, 471598, 653, 14.847806700000547
654, 3.616917536528182, 30.065024512154714, 36.1803302914606, 0.15055119999999997, 90.0, 637, 472235, 654, 12.498258999999962
655, 2.9403349939514607, 30.074267837780866, 36.16429293816831, 0.14890689999999995, 420.0, 1190, 473425, 655, 23.496009200000117
656, 4.679333301128946, 30.1596323153903, 36.32972997949253, 0.14718879999999993, 170.0, 719, 474144, 656, 14.214373900000282
657, 4.703429903891106, 30.13396095536059, 36.29865996074772, 0.14564439999999992, 300.0, 997, 475141, 657, 19.687274000000798
658, 2.2598247229669886, 30.05349478439684, 36.17756328239539, 0.14439699999999997, 105.0, 389, 475530, 658, 7.696442999999817
659, 5.015607625007803, 30.04865665491237, 36.16977155485819, 0.1434276999999999, 75.0, 688, 476218, 659, 13.71647909999956
660, 3.0213969542893913, 30.090137456333267, 36.175189808517295, 0.14219919999999997, 180.0, 677, 476895, 660, 13.384336300000541
661, 2.3395371865955266, 30.052549081282184, 36.12141510703347, 0.1410948999999999, 70.0, 550, 477445, 661, 10.904174700000112
662, 3.2407686948312193, 30.04242229791661, 36.09959078000079, 0.14007969999999995, 115.0, 578, 478023, 662, 11.379829299999983
663, 2.895964818290614, 30.087930775563652, 36.205548277688685, 0.1385784999999999, 350.0, 1090, 479113, 663, 21.712341399999787
664, 4.164418073243474, 30.141179835233878, 36.290319094374844, 0.1370061999999999, 145.0, 657, 479770, 664, 13.139781199999561
665, 4.100458274266937, 29.9655533322421, 36.02855426672733, 0.13567239999999992, 210.0, 825, 480595, 665, 16.364281899999696
666, 4.049273288564008, 29.904824075130332, 35.9571124860762, 0.13385799999999992, 400.0, 1191, 481786, 666, 23.5188277999996
667, 2.1720575473802475, 29.841836758586755, 35.86626888967841, 0.13243419999999995, 60.0, 391, 482177, 667, 7.944288799999413
668, 7.180317980859579, 29.942707746018208, 36.09328486352758, 0.13127949999999994, 165.0, 892, 483069, 668, 17.841239700000187
669, 2.7983048401003434, 29.92884922923057, 35.976553628888674, 0.12932649999999993, 465.0, 1278, 484347, 669, 25.374619599999278
670, 2.1728372505637092, 29.84921967110983, 35.86596434917056, 0.12769659999999988, 70.0, 533, 484880, 670, 10.781981900000574
671, 3.296439935884273, 29.87399219055639, 35.926456639546004, 0.12662379999999995, 150.0, 659, 485539, 671, 13.284344199999396
672, 2.4412393723038814, 29.922645733016942, 35.97288290211852, 0.12545559999999997, 175.0, 639, 486178, 672, 12.907183299999815
673, 6.11058938141013, 29.950865289534647, 36.104163976647385, 0.12409749999999993, 215.0, 870, 487048, 673, 17.46801619999951
674, 3.9202022705831143, 29.93886746171488, 36.00477641927045, 0.1223541999999999, 190.0, 1067, 488115, 674, 21.60260460000063
675, 3.5294443230414734, 29.889107295144616, 35.944110739980275, 0.12057759999999994, 245.0, 907, 489022, 675, 18.390673800000513
676, 4.585928263408797, 29.95229052290132, 35.994665073443066, 0.11926359999999994, 15.0, 553, 489575, 676, 11.235670300000493
677, 4.600520785983806, 29.950721734862906, 35.98613197279782, 0.11817999999999991, 195.0, 651, 490226, 677, 13.25663489999988
678, 4.764229921391516, 30.209488386674362, 36.36280146512118, 0.11610909999999991, 700.0, 1650, 491876, 678, 33.3266579000001
679, 3.975693448474913, 30.303549236721462, 36.44103800166737, 0.11426769999999989, 100.0, 396, 492272, 679, 8.152799699999377
680, 4.232011222314224, 30.238485666642706, 36.39827875631401, 0.11331369999999993, 195.0, 664, 492936, 680, 13.57801019999988
681, 3.9872540678935033, 30.206813293086423, 36.36445686365891, 0.11164149999999992, 360.0, 1194, 494130, 681, 24.35432149999997
682, 2.4804301143388883, 30.314366887885832, 36.39328153378496, 0.11008539999999993, 40.0, 535, 494665, 682, 10.952580499999385
683, 3.641397696510907, 30.14982522988797, 36.24287273497312, 0.10910979999999987, 50.0, 549, 495214, 683, 11.281926999999996
684, 4.554052135303067, 30.212636062224878, 36.40003820406899, 0.10778589999999992, 245.0, 922, 496136, 684, 18.796940500000346
685, 5.712777517515074, 30.210470299628334, 36.40021650168616, 0.1061667999999999, 160.0, 877, 497013, 685, 18.060175999999956
686, 5.541222822123112, 30.254364934875564, 36.43293000229671, 0.10466379999999988, 220.0, 793, 497806, 686, 16.28180539999994
687, 5.064897071472877, 30.33761186204198, 36.51690356229674, 0.1033641999999999, 90.0, 651, 498457, 687, 13.476457100000516
688, 4.241970349806933, 30.25551402143632, 36.40347159019077, 0.10209699999999992, 155.0, 757, 499214, 688, 15.646641499999532
689, 4.464066802245843, 30.250606047642695, 36.435148443494526, 0.10086129999999995, 70.0, 616, 499830, 689, 12.756553299999723
690, 4.415372020307001, 30.065003118977675, 36.17138988572481, 0.10004094366197284, 155.0, 639, 500469, 690, 13.20361320000029
691, 2.457560634780405, 29.866337270936338, 35.89169417947963, 0.09999999999999776, 180.0, 1242, 501711, 691, 25.457942500000172
692, 4.9708606582050425, 29.852935868925478, 35.92586518776759, 0.10000000000000078, 180.0, 661, 502372, 692, 13.789549899999656
693, 4.491099927578615, 29.915843618010612, 36.002891598849445, 0.09999999999999916, 345.0, 883, 503255, 693, 18.48031170000013
694, 3.711796836527925, 29.86851865411226, 35.95250083484294, 0.09999999999999648, 905.0, 1981, 505236, 694, 40.989898099999664
695, 4.121957841173744, 29.890530156417633, 35.98936118350422, 0.09999999999999862, 510.0, 994, 506230, 695, 20.83795149999969
696, 3.673460783596996, 29.967723956397993, 36.03660915982548, 0.0999999999999988, 380.0, 954, 507184, 696, 20.026073400000314
697, 3.015685252259096, 29.88078685007998, 35.91012177853383, 0.09999999999999919, 170.0, 877, 508061, 697, 18.577639799999815
698, 5.380000719327631, 29.973501005142833, 36.071268302893564, 0.100000000000001, 90.0, 638, 508699, 698, 13.566700800000035
699, 3.2820793125068857, 29.90731310682232, 35.97935875743425, 0.10000000000000096, 35.0, 588, 509287, 699, 12.456987399999889
700, 3.04296072870963, 29.894817496699865, 35.92898924192796, 0.10000000000000099, 185.0, 634, 509921, 700, 13.513067699999738
701, 3.587089995837576, 30.048726907879626, 36.12632297785743, 0.10000000000000091, 120.0, 523, 510444, 701, 11.092605199999525
702, 6.100811767412805, 29.984048794770704, 36.06166457272005, 0.10000000000000073, 100.0, 667, 511111, 702, 14.051430800000162
703, 4.8848707000568865, 29.957104471601234, 36.02483406597147, 0.09999999999999781, 445.0, 1223, 512334, 703, 25.97226630000023
704, 3.7403858995276207, 29.997906109992574, 36.09595692671888, 0.0999999999999986, 165.0, 997, 513331, 704, 21.223251599999458
705, 3.790391037902849, 29.95845270553752, 36.032052753371374, 0.0999999999999994, 210.0, 841, 514172, 705, 17.78710730000057
706, 3.6407303356115714, 29.844229338120442, 35.88928182108872, 0.10000000000000096, 250.0, 588, 514760, 706, 12.487583099999938
707, 3.130422517108512, 29.983332804174665, 36.0453168474581, 0.10000000000000038, 95.0, 706, 515466, 707, 15.052288799999587
708, 3.3149715042002845, 29.9227355743123, 35.99186498695445, 0.10000000000000092, 170.0, 535, 516001, 708, 11.515814700000192
709, 2.9681011293356385, 29.958086637766616, 36.01078202333244, 0.09999999999999873, 365.0, 969, 516970, 709, 20.774065900000096
710, 5.310406054205754, 29.937908268776262, 36.043339548992506, 0.10000000000000085, 145.0, 476, 517446, 710, 10.241330700000617
711, 3.6664400588177344, 29.94663302447345, 36.06021632220294, 0.09999999999999894, 95.0, 925, 518371, 711, 19.767743399999745
712, 4.710611517941209, 29.93573720532634, 36.0486312187966, 0.09999999999999817, 270.0, 1108, 519479, 712, 24.116225000000668
713, 4.260164903191068, 29.89719921119112, 35.960891219472266, 0.09999999999999827, 255.0, 1082, 520561, 713, 23.34249119999913
714, 4.075767541732092, 29.921657751673038, 35.95549901161787, 0.09999999999999801, 250.0, 1158, 521719, 714, 24.91535920000024
715, 3.369498332791116, 29.905222098032635, 35.99977200058685, 0.10000000000000046, 100.0, 696, 522415, 715, 14.942538600000262
716, 6.216879023112702, 29.96293877888034, 36.099914513825084, 0.09999999999999892, 155.0, 929, 523344, 716, 20.070484199999555
717, 3.0467018772491175, 29.909235070831148, 35.95022605212767, 0.09999999999999858, 360.0, 1005, 524349, 717, 21.55887580000035
718, 2.6066330855043187, 29.901169162737897, 35.904150515312516, 0.10000000000000055, 30.0, 309, 524658, 718, 6.678804500000297
719, 3.5680123108864743, 29.921552169391347, 35.954179654385804, 0.10000000000000091, 155.0, 523, 525181, 719, 11.441314300000158
720, 3.408322787102163, 29.900792734661692, 35.90504502897953, 0.10000000000000063, 145.0, 677, 525858, 720, 14.720421500000157
721, 3.8864840815755466, 29.936058991407624, 35.997904087397195, 0.10000000000000078, 105.0, 427, 526285, 721, 9.233525599999666
722, 4.033107821553586, 29.945003419899077, 36.056875350676385, 0.09999999999999946, 215.0, 830, 527115, 722, 18.00363170000037
723, 5.169647824321712, 29.795541130473055, 35.87602170603458, 0.1000000000000008, 35.0, 431, 527546, 723, 9.465944900000068
724, 5.985445812879026, 29.95017646340763, 36.08175509218848, 0.10000000000000045, 95.0, 697, 528243, 724, 15.170031600000584
725, 3.704059933731067, 29.950720242350105, 35.999381704167575, 0.10000000000000091, 120.0, 527, 528770, 725, 11.56068090000008
726, 3.652306209482691, 29.90474952369177, 35.975191785507846, 0.09999999999999881, 205.0, 952, 529722, 726, 20.845962600000348
727, 3.6980170712571594, 29.856856801762685, 35.905686860209585, 0.09999999999999919, 155.0, 877, 530599, 727, 19.20120330000009
728, 3.4863835093064086, 29.83519888950654, 35.853138563451004, 0.1000000000000009, 65.0, 511, 531110, 728, 11.211681300000237
729, 4.035487348888899, 29.78302338723706, 35.84582382657469, 0.10000000000000055, 195.0, 687, 531797, 729, 15.198940799999946
730, 3.6307469374189774, 29.81284163157145, 35.83709555519952, 0.09999999999999906, 240.0, 900, 532697, 730, 19.872227899999416
731, 4.508879998104679, 29.833470945488916, 35.87370303279033, 0.0999999999999985, 185.0, 1022, 533719, 731, 22.56299609999951
732, 2.448384175446766, 29.736868763697967, 35.70018071254701, 0.10000000000000091, 75.0, 524, 534243, 732, 11.51056509999944
733, 2.6507365710473474, 29.88264514393889, 35.86120637441646, 0.10000000000000064, 60.0, 346, 534589, 733, 7.624731400000201
734, 3.9015849506353386, 29.89868716910334, 36.021540929775426, 0.10000000000000075, 40.0, 404, 534993, 734, 9.69114669999999
735, 4.295721908134443, 29.871426741282146, 35.96684709596045, 0.10000000000000092, 205.0, 648, 535641, 735, 21.810927800000172
736, 3.5964519191764306, 29.924838953063674, 35.969316952558316, 0.10000000000000099, 125.0, 629, 536270, 736, 22.127839400000084
737, 3.4873969666841553, 29.8499142809612, 35.88239138223292, 0.0999999999999978, 710.0, 1230, 537500, 737, 37.07731650000005
738, 5.656718294814801, 29.95252974593651, 36.06253059259675, 0.09999999999999852, 220.0, 1017, 538517, 738, 29.228084499999568
739, 4.481365202721263, 29.826325657081046, 35.86253252057386, 0.10000000000000059, 120.0, 682, 539199, 739, 25.514980200000537
740, 5.226027909354898, 29.960524606261828, 36.048953956863826, 0.10000000000000094, 130.0, 646, 539845, 740, 18.944171400000414
741, 2.319397069372955, 29.725525828976263, 35.71710735097499, 0.10000000000000091, 80.0, 529, 540374, 741, 14.882070399999975
742, 3.050646877998474, 29.697603139197593, 35.69702944333301, 0.09999999999999894, 170.0, 926, 541300, 742, 27.83319279999978
743, 3.3750248708407504, 29.699404749776235, 35.715261583805805, 0.10000000000000081, 140.0, 659, 541959, 743, 20.364943999999923
744, 4.721941822160404, 29.748991940975856, 35.763707316570205, 0.10000000000000028, 135.0, 717, 542676, 744, 23.645651400000133
745, 6.550968759721968, 29.848880268133488, 35.98990362571578, 0.09999999999999887, 190.0, 939, 543615, 745, 31.154169000000365
746, 5.650165247193299, 29.75074510845472, 35.805604272189335, 0.0999999999999996, 150.0, 809, 544424, 746, 26.101922799999556
747, 3.744672499161134, 29.6607407306103, 35.61797417478358, 0.1000000000000007, 40.0, 376, 544800, 747, 12.525214600000254
748, 3.230599806915484, 29.718645837096712, 35.739810698413706, 0.10000000000000071, 180.0, 669, 545469, 748, 22.581899000000703
749, 5.247797065749205, 29.666169902256556, 35.7086391707112, 0.10000000000000074, 130.0, 665, 546134, 749, 22.566999300000134
750, 4.792203374308068, 29.760008015210115, 35.81604238444599, 0.09999999999999819, 225.0, 1106, 547240, 750, 36.572538299999906
751, 5.813423837535083, 29.787947098414104, 35.842042967384934, 0.09999999999999956, 220.0, 816, 548056, 751, 26.804355999999643
752, 4.466331668630395, 29.738479842098094, 35.76743807700443, 0.09999999999999919, 185.0, 879, 548935, 752, 27.964589700000033
753, 5.619670718081477, 29.759746819007688, 35.807933391012796, 0.09999999999999953, 180.0, 820, 549755, 753, 27.19844599999942
754, 2.488604313799773, 29.63302710381421, 35.604709262197666, 0.10000000000000066, 55.0, 352, 550107, 754, 11.108865299999707
755, 5.024485419029794, 29.621773379489714, 35.579221053270516, 0.1000000000000006, 45.0, 681, 550788, 755, 26.82705369999985
756, 3.804182272958894, 29.623634533549463, 35.60915497402812, 0.09999999999999928, 140.0, 860, 551648, 756, 29.788004899999578
757, 2.398897226477407, 29.655241953138635, 35.577306101821954, 0.10000000000000096, 45.0, 582, 552230, 757, 19.8314362000001
758, 5.548577947444038, 29.653511218992275, 35.70500377726272, 0.10000000000000096, 120.0, 589, 552819, 758, 20.148046900000736
759, 4.523627195715904, 29.669442693074544, 35.7566230875651, 0.1000000000000007, 30.0, 375, 553194, 759, 12.967617999999675
760, 5.524046407097957, 29.605625228149123, 35.63756773308689, 0.09999999999999945, 310.0, 833, 554027, 760, 31.450300999999854
761, 4.542731888637508, 29.636652901279824, 35.66461516295719, 0.09999999999999952, 420.0, 823, 554850, 761, 30.036159100000077
762, 5.129194958860637, 29.710122620483087, 35.73520394115755, 0.09999999999999794, 275.0, 1179, 556029, 762, 38.678021000000626
763, 2.5653869675990255, 29.5863462380733, 35.53437140387141, 0.10000000000000088, 180.0, 651, 556680, 763, 20.997725100000025
764, 4.246812476847342, 29.507741309048836, 35.51543614181162, 0.10000000000000057, 110.0, 684, 557364, 764, 22.512396600000102
765, 4.069426617388072, 29.730520499044644, 35.76075437074249, 0.10000000000000082, 80.0, 449, 557813, 765, 15.429741900000408
766, 3.700578721293139, 29.591469922027763, 35.57476631963077, 0.09999999999999919, 185.0, 879, 558692, 766, 29.535555499999646
767, 3.7749322726726002, 29.627891117991926, 35.63810737616651, 0.09999999999999812, 435.0, 1124, 559816, 767, 37.91778400000021
768, 3.1377156909628967, 29.66051459076381, 35.6617647539271, 0.0999999999999996, 355.0, 808, 560624, 768, 27.401334700000007
769, 4.743575007726724, 29.690585136413574, 35.74564068573074, 0.09999999999999964, 390.0, 802, 561426, 769, 27.962429500000326
770, 2.252368485357926, 29.6565470376231, 35.63100052291837, 0.09999999999999894, 245.0, 926, 562352, 770, 30.54974349999975
771, 7.398013017020629, 29.697030533817493, 35.806019020678484, 0.100000000000001, 145.0, 638, 562990, 771, 22.40325489999941
772, 6.408252694496983, 29.64119451506096, 35.63373117279588, 0.099999999999999, 215.0, 912, 563902, 772, 31.988704899999902
773, 3.7759610035178, 29.692087563284993, 35.72137618702983, 0.09999999999999952, 265.0, 822, 564724, 773, 28.27164569999968
774, 4.475126846079586, 29.61856459396331, 35.60823882727652, 0.0999999999999987, 230.0, 974, 565698, 774, 34.936793699999726
775, 4.5450014703266834, 29.710475425371406, 35.722375351294616, 0.09999999999999787, 335.0, 1203, 566901, 775, 41.42117379999945
776, 5.226113849337704, 29.684717084251474, 35.739445293304975, 0.09999999999999871, 225.0, 973, 567874, 776, 32.36678120000033
777, 5.892311111234098, 29.6907827980321, 35.7185869967436, 0.09999999999999723, 820.0, 1474, 569348, 777, 49.663982100000794
778, 4.931662337134764, 29.71214922562386, 35.71631029369762, 0.09999999999999847, 260.0, 1030, 570378, 778, 35.65280590000111
779, 5.009040108892355, 29.73842962029275, 35.76553919931476, 0.09999999999999912, 335.0, 890, 571268, 779, 29.888729099999182
780, 4.729036173393959, 29.886219809295007, 35.921889073003534, 0.09999999999999998, 80.0, 756, 572024, 780, 26.42076249999991
781, 5.355737408523059, 29.681634498069354, 35.77222762632248, 0.10000000000000073, 55.0, 391, 572415, 781, 13.637710900000457
782, 4.505926035730835, 29.738689011155962, 35.76820951799884, 0.0999999999999979, 465.0, 1196, 573611, 782, 40.65656889999991
783, 3.587842955927346, 29.7277971189645, 35.712110271233705, 0.0999999999999988, 275.0, 953, 574564, 783, 31.93604469999991
784, 3.2970360772531264, 29.791518856087205, 35.77590159275668, 0.09999999999999913, 350.0, 889, 575453, 784, 28.215376500000275
785, 4.608850075181067, 29.68857968798756, 35.736539249307306, 0.09999999999999938, 170.0, 845, 576298, 785, 28.817439899999954
786, 5.896973919280995, 29.85042964786846, 35.90702777223539, 0.10000000000000096, 110.0, 591, 576889, 786, 20.91975730000013
787, 4.142001273070766, 29.730252603718093, 35.777661723737864, 0.1000000000000004, 115.0, 703, 577592, 787, 23.94436300000052
788, 4.580357006877801, 29.765685665029128, 35.79111290575007, 0.100000000000001, 155.0, 639, 578231, 788, 22.018260400000145
789, 3.068369776362999, 29.729748628577408, 35.73147560714127, 0.09999999999999828, 195.0, 1078, 579309, 789, 38.06422509999902
790, 3.2337546067046268, 29.6960569158777, 35.68065819182953, 0.09999999999999987, 170.0, 770, 580079, 790, 25.921254200000476
791, 3.607256331889569, 29.925309966592227, 35.98683619459136, 0.09999999999999791, 370.0, 1190, 581269, 791, 41.93797000000086
792, 2.7920284516921563, 29.872481418257, 35.90356457333605, 0.09999999999999791, 315.0, 1190, 582459, 792, 40.188126700000794
793, 3.0898374544964042, 29.933600687086095, 35.97135532155122, 0.0999999999999978, 325.0, 1226, 583685, 793, 42.20641070000056
794, 4.084490396176542, 29.906070244441395, 35.979523990989165, 0.09999999999999817, 330.0, 1108, 584793, 794, 37.984178800001246
795, 6.754495969893904, 30.008187546689285, 36.09622886445787, 0.09999999999999888, 215.0, 936, 585729, 795, 34.18667720000121
796, 4.809654877793212, 30.019609535672537, 36.14971714059021, 0.09999999999999871, 255.0, 972, 586701, 796, 34.11349370000062
797, 3.849998124661934, 29.95651951525585, 36.0075168578979, 0.09999999999999776, 625.0, 1245, 587946, 797, 45.54621319999933
798, 5.54568647683116, 29.98795054386209, 36.081811864971115, 0.0999999999999979, 385.0, 1194, 589140, 798, 41.80298430000039
799, 4.537786742799903, 30.264014553883772, 36.37304998797213, 0.0999999999999985, 375.0, 1022, 590162, 799, 37.5514017000005
800, 2.210899152027728, 31.91944100491891, 38.2885679440548, 0.10000000000000067, 155.0, 673, 590835, 800, 25.227522500001214
801, 4.24083910812859, 31.930703334134034, 38.3536273590242, 0.09999999999999971, 210.0, 792, 591627, 801, 29.871562600001198
802, 4.599217846243407, 31.899047818728643, 38.350253372311776, 0.100000000000001, 80.0, 639, 592266, 802, 22.76862770000116
803, 7.517938816082477, 31.966842221069335, 38.48420496826172, 0.10000000000000099, 105.0, 625, 592891, 803, 23.316030899999532
804, 3.685933387877411, 31.99045750809309, 38.449481501364225, 0.10000000000000096, 120.0, 643, 593534, 804, 23.404443600000377
805, 4.383511791432528, 31.97318417602678, 38.43175769973778, 0.09999999999999758, 665.0, 1318, 594852, 805, 48.98390870000003
806, 5.732836256335042, 31.868604399113742, 38.35020750173203, 0.09999999999999885, 190.0, 943, 595795, 806, 34.6265285999998
807, 3.7079898564261384, 32.02074420154095, 38.453170067071916, 0.100000000000001, 140.0, 640, 596435, 807, 20.41912869999942
808, 4.7388630057093195, 32.030964014541134, 38.50315635529265, 0.10000000000000087, 135.0, 653, 597088, 808, 20.85693209999954
809, 4.245721282218468, 32.0603754876833, 38.554429789240025, 0.10000000000000052, 85.0, 689, 597777, 809, 22.339901800000007
810, 3.3577962661951277, 31.924441528320312, 38.346727683719266, 0.09999999999999915, 265.0, 885, 598662, 810, 29.095078899999862
811, 3.3555071473731632, 31.99013896481103, 38.45523647583484, 0.09999999999999848, 270.0, 1026, 599688, 811, 36.45564410000043
812, 2.6115891723971627, 32.093745737768415, 38.55533944561495, 0.10000000000000028, 195.0, 716, 600404, 812, 24.991367000000537
813, 5.645123820751905, 32.239307933792645, 38.87093328969359, 0.1000000000000009, 100.0, 518, 600922, 813, 18.12107880000076
814, 5.304548158974448, 32.24024593636686, 38.78660196162614, 0.09999999999999797, 330.0, 1171, 602093, 814, 42.89084650000041
815, 2.5816955712697567, 32.21469272899821, 38.670685696553505, 0.10000000000000088, 40.0, 493, 602586, 815, 18.868770799999766
816, 4.423980510212653, 32.281300187272215, 38.7747912013321, 0.1000000000000001, 165.0, 739, 603325, 816, 27.78324429999884
817, 4.5871514467092664, 32.22120115206792, 38.77482638725868, 0.10000000000000091, 110.0, 520, 603845, 817, 19.11494810000113
818, 5.438379621059158, 32.3049836785786, 38.84807724908951, 0.10000000000000085, 65.0, 654, 604499, 818, 22.77289490000112
819, 7.636664819086568, 32.3758673757877, 38.99102780054201, 0.09999999999999935, 170.0, 848, 605347, 819, 30.468171700000312
820, 4.98464287634147, 32.20703242895171, 38.73528625458244, 0.1000000000000009, 55.0, 508, 605855, 820, 18.074856799999907
821, 4.404800352564292, 32.23249518107898, 38.78203745123201, 0.09999999999999853, 245.0, 1015, 606870, 821, 35.280228599998736
822, 3.3254757544286497, 32.321315206662575, 38.86173372695284, 0.10000000000000049, 120.0, 693, 607563, 822, 25.277658800001518
823, 3.8085615206416414, 32.246647644425586, 38.75911555773277, 0.0999999999999986, 250.0, 997, 608560, 823, 36.895155899999736
824, 3.541050594423774, 32.25110930329436, 38.78589895555189, 0.09999999999999805, 230.0, 1144, 609704, 824, 39.949323200000435
825, 3.774970010183063, 32.17560773218926, 38.67282613640693, 0.10000000000000087, 45.0, 487, 610191, 825, 17.320025400000304
826, 4.0585712795065145, 32.19398661936362, 38.68225302508497, 0.10000000000000099, 120.0, 635, 610826, 826, 22.255262599999696
827, 4.148831355144957, 32.138405707649966, 38.65615667298783, 0.09999999999999955, 415.0, 817, 611643, 827, 29.120276000001468
828, 4.259213603985709, 32.09915278893866, 38.55760551860737, 0.09999999999999819, 245.0, 1103, 612746, 828, 40.87382389999948
829, 3.9363199838459493, 32.14076016693115, 38.63196822814941, 0.09999999999999774, 285.0, 1250, 613996, 829, 46.22767120000026
830, 3.006231490325853, 32.09232059844178, 38.592179519530376, 0.09999999999999815, 565.0, 1117, 615113, 830, 43.011159300000145
831, 7.269822063488511, 32.18669135697925, 38.78242643128218, 0.09999999999999976, 230.0, 786, 615899, 831, 29.41922169999998
832, 2.262539360772919, 32.095636459181875, 38.556523911197296, 0.09999999999999958, 135.0, 814, 616713, 832, 30.47290459999931
833, 4.513095529083117, 32.115988543004164, 38.59743078255359, 0.10000000000000092, 125.0, 648, 617361, 833, 24.536149300000034
834, 3.21653037845269, 32.152776871582155, 38.628478576598, 0.09999999999999867, 180.0, 982, 618343, 834, 36.50139669999953
835, 4.444468880313284, 32.0880699858946, 38.590465556873994, 0.1000000000000006, 110.0, 680, 619023, 835, 24.363427700000102
836, 4.680278200610384, 32.053176754381205, 38.5635660989338, 0.09999999999999742, 455.0, 1383, 620406, 836, 53.57580120000057
837, 5.423612954833641, 32.018672562878706, 38.556727405252126, 0.09999999999999892, 195.0, 928, 621334, 837, 35.83904950000033
838, 3.269665314509272, 31.901051126111, 38.30749910194219, 0.09999999999999865, 495.0, 987, 622321, 838, 39.446823199999926
839, 3.327086797554456, 32.01145206113751, 38.47896298495206, 0.09999999999999944, 365.0, 836, 623157, 839, 33.37296679999963
840, 5.190630413182726, 31.977050544209565, 38.4874416968726, 0.10000000000000049, 100.0, 692, 623849, 840, 25.74660120000044
841, 5.03012940110656, 31.934688341639703, 38.46157559481534, 0.10000000000000092, 80.0, 539, 624388, 841, 19.707895100000314
842, 3.507036612245278, 32.057540960993606, 38.51652332162234, 0.09999999999999762, 405.0, 1301, 625689, 842, 45.65929219999998
843, 2.55655652248251, 32.012379327469326, 38.45112401070679, 0.10000000000000064, 165.0, 676, 626365, 843, 25.440051200001108
844, 4.104264712224617, 31.989968762585992, 38.453514986916595, 0.09999999999999783, 320.0, 1216, 627581, 844, 44.06899709999925
845, 5.640484204702366, 32.061236074415305, 38.58736884612332, 0.10000000000000091, 160.0, 649, 628230, 845, 23.561708799999906
846, 3.8365949270368183, 31.896251242115813, 38.34090477115703, 0.09999999999999935, 245.0, 848, 629078, 846, 31.493363899999167
847, 4.500469701378353, 31.980042672473306, 38.49097096551325, 0.10000000000000062, 105.0, 679, 629757, 847, 26.85590090000005
848, 4.409497456941402, 32.58757920835003, 39.16943379168241, 0.10000000000000099, 130.0, 636, 630393, 848, 23.92903329999899
849, 6.415166689700633, 33.115304793120984, 39.816451339324836, 0.0999999999999971, 490.0, 1538, 631931, 849, 58.67381260000002
850, 3.816815520678438, 33.154410659377255, 39.84471170937837, 0.09999999999999831, 200.0, 1072, 633003, 850, 41.10047660000055
851, 4.32117167685612, 32.99095879959423, 39.643338687342066, 0.10000000000000062, 35.0, 337, 633340, 851, 12.797071900000446
852, 3.5711856994237148, 33.08141395738048, 39.75173783302307, 0.10000000000000088, 60.0, 496, 633836, 852, 18.516523100000995
853, 4.829797820386961, 33.131798020101044, 39.85837104275319, 0.09999999999999784, 495.0, 1213, 635049, 853, 46.116671300000235
854, 6.394476084898297, 33.14383744687554, 39.83954194116972, 0.09999999999999716, 540.0, 1508, 636557, 854, 56.29373919999853
855, 5.263576459126422, 33.08256992771432, 39.85115815556934, 0.09999999999999809, 330.0, 1132, 637689, 855, 44.102666800001316
856, 4.149840103024506, 33.07003027572733, 39.744319647273535, 0.09999999999999999, 220.0, 753, 638442, 856, 27.292977899998732
857, 4.133760067229052, 33.07924386138528, 39.72320928403743, 0.10000000000000073, 60.0, 393, 638835, 857, 15.351893799999743
858, 4.7380561085621, 33.043397009703234, 39.74640365360845, 0.09999999999999827, 320.0, 1082, 639917, 858, 41.70722579999892
859, 4.634605043741093, 33.400299876682844, 40.189953516499806, 0.10000000000000098, 125.0, 607, 640524, 859, 24.558428100001038
860, 5.71658572247755, 33.38936330540586, 40.19919149494074, 0.09999999999999867, 385.0, 981, 641505, 860, 31.380151999999725
861, 7.511424388599359, 33.39417458750719, 40.17357638423428, 0.10000000000000088, 140.0, 652, 642157, 861, 21.13618099999985
862, 3.637354649413187, 33.4013900298614, 40.13920372169655, 0.10000000000000074, 110.0, 666, 642823, 862, 21.276958600001308
863, 5.233956000481087, 33.38817266317514, 40.133432930351326, 0.09999999999999888, 235.0, 936, 643759, 863, 29.942862300000343
864, 3.6460418240200703, 33.38302722423197, 40.099571818070444, 0.10000000000000094, 100.0, 556, 644315, 864, 17.601094299998294
865, 3.8406456000920013, 33.37321650416098, 40.10836205740022, 0.10000000000000098, 125.0, 611, 644926, 865, 19.759703799998533
866, 4.603749615504439, 33.29932928601225, 40.0375671593078, 0.09999999999999763, 360.0, 1294, 646220, 866, 41.18303519999972
867, 3.782801289435314, 33.27164238927946, 39.98662100937957, 0.09999999999999835, 305.0, 1058, 647278, 867, 33.697058200001266
868, 3.7725562009821445, 33.33811669286551, 40.035572524822435, 0.09999999999999946, 210.0, 831, 648109, 868, 26.43050100000073
869, 6.803410593746726, 33.40795710045817, 40.21026622887814, 0.09999999999999781, 440.0, 1221, 649330, 869, 39.368532599999526
870, 4.730541917802014, 33.4391739985464, 40.1632216949147, 0.09999999999999874, 225.0, 966, 650296, 870, 31.409957300000315
871, 5.473368835653851, 33.59723966220942, 40.42784833106967, 0.09999999999999745, 495.0, 1369, 651665, 871, 46.73048059999928
872, 3.920321332364345, 33.55606102100777, 40.35091225140969, 0.09999999999999729, 630.0, 1443, 653108, 872, 47.21966170000087
873, 6.066905361714593, 33.64840068594057, 40.52825246777451, 0.10000000000000057, 150.0, 684, 653792, 873, 22.039253999999346
874, 4.699068258663871, 33.58116624331233, 40.34355906926422, 0.09999999999999791, 475.0, 1188, 654980, 874, 37.502914700000474
875, 3.885886909230374, 33.69128103223677, 40.48485394630823, 0.10000000000000096, 35.0, 586, 655566, 875, 18.38632310000139
876, 3.4838230310243192, 33.65520616225255, 40.428924354053294, 0.09999999999999838, 260.0, 1053, 656619, 876, 34.276935500000036
877, 5.230214579582809, 33.615143959773604, 40.46119487902855, 0.099999999999997, 530.0, 1603, 658222, 877, 58.89794979999897
878, 5.1429978596383945, 33.611423103413806, 40.43852421428152, 0.10000000000000082, 105.0, 657, 658879, 878, 21.162267600000632
879, 3.751792862845349, 33.53668852583397, 40.29681211529356, 0.09999999999999813, 445.0, 1122, 660001, 879, 38.25004859999899
880, 6.046041628386339, 33.686031776925795, 40.584238238956615, 0.10000000000000069, 20.0, 368, 660369, 880, 11.891490500000145
881, 3.6639933132621794, 33.59426914429918, 40.39190263327217, 0.10000000000000082, 120.0, 657, 661026, 881, 20.896972900000037
882, 6.1919457321013285, 33.679164025160645, 40.52682277748177, 0.09999999999999913, 125.0, 888, 661914, 882, 28.00007800000094
883, 4.97333368751566, 33.75094821917936, 40.50911703049762, 0.10000000000000099, 175.0, 636, 662550, 883, 20.050980699999855
884, 2.885302964492769, 33.70937686653761, 40.47003915228426, 0.10000000000000067, 110.0, 673, 663223, 884, 21.239249099999142
885, 5.780616873262034, 33.722602129276524, 40.59485717002031, 0.09999999999999959, 135.0, 811, 664034, 885, 25.741359399999055
886, 2.7544430641848883, 33.75156620493729, 40.53294752414203, 0.10000000000000035, 215.0, 709, 664743, 886, 22.52951589999975
887, 4.729516982150297, 33.676474869571955, 40.493095746872335, 0.09999999999999762, 395.0, 1301, 666044, 887, 40.9292547999994
888, 3.6244969397741946, 33.689167697287466, 40.4816213494035, 0.10000000000000024, 210.0, 721, 666765, 888, 23.026308100001188
889, 3.32846207523031, 33.68318482758619, 40.46046324669599, 0.09999999999999774, 815.0, 1249, 668014, 889, 39.77534829999968
890, 2.463597011674224, 33.67433579641444, 40.43557474995387, 0.10000000000000091, 50.0, 524, 668538, 890, 16.75678379999954
891, 3.8433116426567238, 33.658913952862775, 40.49180060210051, 0.0999999999999975, 430.0, 1350, 669888, 891, 43.367324999999255
892, 2.6858332769712434, 33.81639266312122, 40.59520322084427, 0.100000000000001, 160.0, 640, 670528, 892, 20.435512299998663
893, 6.473206608094599, 33.90283118538235, 40.82490470996802, 0.10000000000000052, 135.0, 690, 671218, 893, 21.94602859999941
894, 5.762648854059754, 33.96866008970473, 40.82494424301901, 0.10000000000000092, 95.0, 648, 671866, 894, 20.949277599998823
895, 5.986797737290096, 34.00168572877014, 40.93215070837956, 0.09999999999999735, 275.0, 1412, 673278, 895, 45.36041420000038
896, 4.702526240360698, 33.981420915702294, 40.85278842778042, 0.09999999999999892, 240.0, 928, 674206, 896, 28.219966699998622
897, 6.21175817705902, 33.96785035788825, 40.87740179023863, 0.0999999999999988, 180.0, 953, 675159, 897, 28.183455099999264
898, 3.787107571102537, 33.84837960471672, 40.68276412949363, 0.09999999999999838, 180.0, 1052, 676211, 898, 31.1732135000002
899, 5.668253679885029, 34.048323225032135, 40.88403259535967, 0.09999999999999915, 315.0, 885, 677096, 899, 26.118530499999906
900, 3.9764945115809645, 33.96447879275947, 40.819537729105946, 0.09999999999999819, 325.0, 1103, 678199, 900, 32.552855300000374
901, 3.902743215891087, 33.96661399676697, 40.86158409261793, 0.09999999999999833, 270.0, 1066, 679265, 901, 31.71524490000047
902, 3.418319085041353, 33.65850928603419, 40.4424205847397, 0.09999999999999903, 275.0, 906, 680171, 902, 28.759760899998582
903, 5.939837525738037, 33.04773925671115, 39.71752180264691, 0.09999999999999992, 135.0, 762, 680933, 903, 24.628108599999905
904, 4.42535455805751, 32.91393406696809, 39.578206282395584, 0.0999999999999998, 125.0, 780, 681713, 904, 25.301543800000218
905, 6.68219328201061, 33.039210339882196, 39.75350383337707, 0.09999999999999812, 145.0, 1124, 682837, 905, 36.79839560000073
906, 5.67354588453939, 32.96861599803676, 39.69449923814401, 0.09999999999999938, 210.0, 845, 683682, 906, 27.690977999998722
907, 5.376230032521377, 33.05997809435243, 39.73175136264391, 0.09999999999999866, 285.0, 986, 684668, 907, 32.14738980000038
908, 3.9100179335699474, 33.01088620218252, 39.63421925554599, 0.10000000000000063, 420.0, 677, 685345, 908, 22.239059499999712
909, 5.095978989182966, 33.01668854824952, 39.694227847753396, 0.10000000000000095, 95.0, 573, 685918, 909, 18.738532100000157
910, 6.529095350768621, 32.98017150943289, 39.70217805371506, 0.09999999999999883, 315.0, 948, 686866, 910, 30.95375249999961
911, 4.462008539347205, 32.990193879120675, 39.69423397856282, 0.10000000000000078, 80.0, 419, 687285, 911, 13.778472500000134
912, 7.5541680306276495, 33.02281956837095, 39.75196288782975, 0.09999999999999892, 305.0, 928, 688213, 912, 30.382943000000523
913, 2.659582032476771, 32.96929817901346, 39.58885173668358, 0.09999999999999845, 265.0, 1033, 689246, 913, 33.994310099998984
914, 4.879439822961625, 33.105273342023075, 39.855629983369845, 0.09999999999999923, 260.0, 871, 690117, 914, 28.470114899999317
915, 5.208120005540842, 34.002846862255126, 40.86910893711658, 0.0999999999999999, 140.0, 766, 690883, 915, 25.43795929999942
916, 5.998640157369324, 33.99593289940583, 40.84428927746883, 0.09999999999999987, 175.0, 771, 691654, 916, 25.590576599999622
917, 8.571182656696617, 33.876031980762804, 40.81549645346485, 0.10000000000000087, 135.0, 653, 692307, 917, 21.691484400000263
918, 4.867668927706327, 33.999277376882084, 40.81822584932629, 0.10000000000000063, 140.0, 677, 692984, 918, 22.37056510000002
919, 7.628440453808593, 34.01241635446963, 40.92389336876247, 0.09999999999999896, 480.0, 920, 693904, 919, 30.545636299999387
920, 4.11444135471718, 33.92185995016205, 40.76476782895206, 0.10000000000000032, 355.0, 712, 694616, 920, 23.48058029999993
921, 2.8571262987059725, 33.884715776415185, 40.68527625788567, 0.10000000000000066, 180.0, 674, 695290, 921, 22.503237199998694
922, 3.7203951979281156, 33.87607690266201, 40.700210906647065, 0.10000000000000019, 115.0, 728, 696018, 922, 24.423013300000093
923, 6.950344651075505, 33.982666402338296, 40.88769851107778, 0.09999999999999921, 240.0, 873, 696891, 923, 29.042903999999908
924, 7.266984217103336, 33.971270771293376, 40.95784121960193, 0.10000000000000095, 155.0, 572, 697463, 924, 18.821700300000884
925, 4.080902007413101, 33.878465171332834, 40.695857173091056, 0.0999999999999986, 360.0, 999, 698462, 925, 33.39667709999958
926, 3.4557581529913453, 33.91916859650812, 40.746627839673465, 0.09999999999999881, 220.0, 952, 699414, 926, 31.64013519999935
927, 3.566895869366564, 33.86169347972796, 40.715033552162396, 0.09999999999999985, 200.0, 773, 700187, 927, 26.411122600000454
928, 4.161741998876653, 33.876838304901696, 40.72625381000402, 0.09999999999999754, 315.0, 1333, 701520, 928, 45.66449199999988
929, 2.6060016147933807, 33.79845769495903, 40.60290587702884, 0.10000000000000099, 125.0, 632, 702152, 929, 21.360476600000766
930, 6.657555349459837, 33.870180337631396, 40.72912636366278, 0.09999999999999826, 525.0, 1084, 703236, 930, 36.10059739999997
931, 3.730533233852965, 33.855438071902434, 40.69385058022175, 0.09999999999999784, 325.0, 1212, 704448, 931, 40.64985780000097
932, 6.137354614979718, 33.88368353094936, 40.748595822547095, 0.09999999999999785, 595.0, 1210, 705658, 932, 40.64241880000009
933, 3.55960187271867, 33.86026947666222, 40.66647170160858, 0.10000000000000034, 185.0, 710, 706368, 933, 24.050047200000336
934, 6.329990983946701, 33.90124057641135, 40.80241948683129, 0.0999999999999971, 840.0, 1542, 707910, 934, 52.06216979999954
935, 3.7813997344143044, 33.81203716060294, 40.654334558307795, 0.10000000000000092, 120.0, 543, 708453, 935, 18.317752799999653
936, 3.3618654312730967, 33.912969588026215, 40.73802549627763, 0.09999999999999704, 480.0, 1580, 710033, 936, 53.529014700001426
937, 4.960756822876867, 33.99960712413883, 40.91144532667068, 0.10000000000000098, 105.0, 603, 710636, 937, 20.549491900001158
938, 4.840373513327657, 34.05254575331434, 40.940218556356086, 0.10000000000000046, 130.0, 695, 711331, 938, 23.637778599999365
939, 3.7947612415382332, 34.01936233035051, 40.867445812652875, 0.09999999999999742, 425.0, 1383, 712714, 939, 46.97069139999985
940, 5.850687904518192, 34.02676677818344, 40.92028342403856, 0.09999999999999945, 135.0, 833, 713547, 940, 28.297819899999013
941, 4.013963594524491, 34.012375473830936, 40.841659622564094, 0.09999999999999692, 520.0, 1642, 715189, 941, 55.9249222999988
942, 4.381227639460604, 33.91915382296834, 40.78367088330503, 0.09999999999999785, 530.0, 1208, 716397, 942, 41.395582499999364
943, 7.629043990018171, 34.138541394854904, 41.1390587902944, 0.10000000000000092, 55.0, 545, 716942, 943, 18.72706840000137
944, 6.025139612947379, 34.024907216446174, 40.98152059902802, 0.09999999999999905, 250.0, 905, 717847, 944, 31.131288399999903
945, 5.363283710670757, 34.07059023578451, 40.96602291966874, 0.09999999999999798, 325.0, 1167, 719014, 945, 39.99021979999998
946, 3.445273041553075, 34.02676728691578, 40.86611997540737, 0.09999999999999798, 350.0, 1169, 720183, 946, 40.01185799999985
947, 4.039472015781535, 34.05729114567792, 40.92432348816483, 0.10000000000000092, 140.0, 648, 720831, 947, 22.516614800000752
948, 7.9728890574434725, 34.04461336272755, 40.97522254469292, 0.09999999999999841, 240.0, 1045, 721876, 948, 36.21014880000075
949, 6.119239510526344, 34.035871109720006, 40.91482577081454, 0.09999999999999885, 410.0, 944, 722820, 949, 32.45455199999924
950, 4.191335062121248, 34.03115448355675, 40.9415641758177, 0.10000000000000095, 125.0, 576, 723396, 950, 20.10455130000082
951, 6.558071375743107, 33.99933808503327, 40.90290175826461, 0.0999999999999975, 460.0, 1350, 724746, 951, 46.56336310000006
952, 2.87853933876737, 33.998732784961135, 40.798023967878194, 0.0999999999999981, 460.0, 1128, 725874, 952, 39.23044530000152
953, 6.518150616740699, 34.068816805882854, 40.97193982950113, 0.09999999999999741, 360.0, 1387, 727261, 953, 48.70378720000008
954, 4.747473985422403, 34.14487728005961, 41.017731290114554, 0.10000000000000098, 155.0, 608, 727869, 954, 21.53731879999941
955, 6.233538942771914, 33.967966417610505, 40.80252863032557, 0.1000000000000008, 45.0, 429, 728298, 955, 15.3609505000004
956, 5.364810349097516, 34.03707652838716, 40.876203082112966, 0.09999999999999869, 260.0, 977, 729275, 956, 34.22218339999927
957, 3.381621526269183, 34.003233093614185, 40.82674300750938, 0.09999999999999844, 270.0, 1039, 730314, 957, 36.26700400000118
958, 6.058903939147407, 34.09164035904815, 41.02311622086818, 0.10000000000000067, 100.0, 673, 730987, 958, 23.74935170000026
959, 6.353241445005468, 34.15071798510256, 41.07510445518831, 0.0999999999999981, 360.0, 1130, 732117, 959, 39.58714230000078
960, 5.877655798752629, 34.141368248349146, 41.03063956366645, 0.10000000000000099, 80.0, 630, 732747, 960, 26.104777899998226
961, 7.375724622199835, 34.14718302130112, 41.05868179809871, 0.09999999999999959, 195.0, 812, 733559, 961, 34.722023099999205
962, 4.125047893149497, 34.14049739460293, 41.006285461590444, 0.09999999999999816, 470.0, 1112, 734671, 962, 40.52315380000073
963, 6.028320307712338, 34.15272403881653, 41.04339261797534, 0.09999999999999833, 125.0, 1066, 735737, 963, 39.474167399999715
964, 5.814579085773746, 34.18366880879003, 41.05870774839068, 0.1000000000000006, 120.0, 681, 736418, 964, 29.82448409999961
965, 3.1477565856822114, 34.09671420985928, 40.9909659037411, 0.09999999999999724, 405.0, 1465, 737883, 965, 57.84838099999979
966, 3.9363424138237653, 34.21957585444817, 41.120171612959645, 0.09999999999999842, 335.0, 1040, 738923, 966, 37.37309559999994
967, 7.911143729856105, 34.25092056149342, 41.22915244597555, 0.09999999999999899, 300.0, 915, 739838, 967, 32.74751370000013
968, 4.756706866114764, 33.63314901396286, 40.416099467690856, 0.09999999999999884, 425.0, 946, 740784, 968, 33.999451300000146
969, 4.510645249813555, 33.54831024660821, 40.330339713007135, 0.1000000000000007, 50.0, 373, 741157, 969, 13.290758799999821
970, 3.5805698113637745, 33.574889674891, 40.31418682126098, 0.09999999999999949, 215.0, 826, 741983, 970, 29.757841200000257
971, 5.8530805578421345, 33.64604907031685, 40.4236941068303, 0.09999999999999803, 220.0, 1151, 743134, 971, 47.07398230000035
972, 6.24830221426021, 33.66605351103245, 40.4522500509289, 0.09999999999999896, 130.0, 921, 744055, 972, 32.31506050000098
973, 5.2614720396064465, 33.61766046012928, 40.437008221944176, 0.09999999999999781, 250.0, 1224, 745279, 973, 42.691489900000306
974, 6.250271396604196, 33.71397968112486, 40.553945982768276, 0.0999999999999988, 215.0, 955, 746234, 974, 33.55373790000158
975, 6.110005433220998, 33.5826007521061, 40.462105051026015, 0.10000000000000073, 45.0, 391, 746625, 975, 13.920734400000583
976, 8.96967050147696, 33.6003139137765, 40.42501079807793, 0.10000000000000091, 155.0, 522, 747147, 976, 18.416713299999174
977, 8.224080885403131, 33.54461182613441, 40.316827231342984, 0.09999999999999937, 210.0, 847, 747994, 977, 30.461578800001007
978, 7.566982352639324, 33.61697444726457, 40.41998465658713, 0.09999999999999962, 240.0, 806, 748800, 978, 29.423468100001628
979, 5.290181754266515, 33.646244949680444, 40.40703607628948, 0.10000000000000099, 115.0, 629, 749429, 979, 22.68552490000002
980, 4.2538986274472474, 33.396622407297215, 40.09737638184069, 0.09999999999999848, 260.0, 1028, 750457, 980, 37.7182714999999
981, 6.904456798563804, 33.258993232551184, 40.02650251503702, 0.099999999999999, 395.0, 911, 751368, 981, 32.72795390000101
982, 4.782696509498289, 33.19988751137394, 39.904383812827625, 0.10000000000000046, 125.0, 696, 752064, 982, 25.292844900001
983, 6.796042864418079, 33.313791368210886, 40.048448737098866, 0.09999999999999876, 440.0, 962, 753026, 983, 35.198766699999396
984, 5.384884194695616, 33.20755303872598, 39.91211302168257, 0.0999999999999986, 110.0, 999, 754025, 984, 36.60509010000169
985, 8.16415649463721, 33.22282476808499, 39.94838664418452, 0.09999999999999952, 125.0, 821, 754846, 985, 29.957910099999935
986, 5.671171576155634, 33.25008923320447, 39.9625585119603, 0.09999999999999885, 180.0, 944, 755790, 986, 34.567841000000044
987, 4.652043620416941, 33.18565321953829, 39.91311406301073, 0.09999999999999873, 270.0, 968, 756758, 987, 39.33259779999935
988, 5.75798688587897, 33.24449428670547, 39.9667657178991, 0.1000000000000006, 110.0, 680, 757438, 988, 24.92267990000073
989, 4.332913618044155, 33.29998160571587, 40.013677007163444, 0.09999999999999849, 250.0, 1025, 758463, 989, 37.518075100000715
990, 4.409045159449926, 33.26129729368689, 39.97813627968112, 0.09999999999999777, 535.0, 1239, 759702, 990, 45.64603999999963
991, 6.870217584671695, 34.50613172404952, 41.52943887385942, 0.09999999999999708, 525.0, 1557, 761259, 991, 57.38981840000088
992, 5.478614470459394, 34.64981143662513, 41.731715861207, 0.10000000000000092, 250.0, 647, 761906, 992, 23.7602138000002
993, 7.8259225677084, 34.79306347671064, 41.779238587907216, 0.1000000000000009, 90.0, 515, 762421, 993, 17.9248733000004
994, 3.9993976571637653, 34.7711430930889, 41.78405139150448, 0.09999999999999885, 225.0, 943, 763364, 994, 34.940076599999884
995, 3.8959220919648003, 34.84523289978597, 41.8324175963691, 0.10000000000000096, 70.0, 643, 764007, 995, 24.117470400000457
996, 5.478480326731016, 34.7795724666439, 41.82577111596265, 0.09999999999999735, 470.0, 1414, 765421, 996, 52.60158860000047
997, 4.384598385783706, 34.80503418797829, 41.86133520012228, 0.09999999999999953, 200.0, 819, 766240, 997, 30.413087099999757
998, 3.812446158947711, 34.711799240112306, 41.727930938091475, 0.09999999999999873, 230.0, 970, 767210, 998, 36.029148200001146
999, 2.678762697375813, 34.79313920566673, 41.79867457327977, 0.09999999999999845, 370.0, 1033, 768243, 999, 38.75087679999888
1000, 4.379944792982551, 34.79911229840785, 41.827863456314454, 0.09999999999999969, 210.0, 797, 769040, 1000, 29.93519169999854
1001, 3.3468724995650905, 34.82572643562494, 41.84697598990167, 0.09999999999999752, 335.0, 1337, 770377, 1001, 51.1298239000007
1002, 5.036081264876822, 35.01892896764939, 42.07733674121207, 0.09999999999999927, 425.0, 863, 771240, 1002, 32.31266399999913
1003, 5.3621789654969865, 35.13765855964375, 42.22698944999823, 0.09999999999999985, 290.0, 773, 772013, 1003, 29.255933399999776
1004, 3.7798456426352356, 34.98581128076134, 42.05736018555821, 0.10000000000000094, 130.0, 646, 772659, 1004, 24.431883199998992
1005, 4.437807256406615, 35.0443212061386, 42.12036517745635, 0.09999999999999987, 165.0, 771, 773430, 1005, 30.359893200000442
1006, 7.182628082496395, 35.03246697903812, 42.140845808450514, 0.0999999999999994, 40.0, 842, 774272, 1006, 31.996585799999593
1007, 5.017950417934751, 34.97516813815943, 42.03522465994498, 0.09999999999999924, 430.0, 869, 775141, 1007, 33.103040599999076
1008, 4.55385047807476, 35.05791779173992, 42.12027464662189, 0.1, 110.0, 751, 775892, 1008, 28.39704519999941
1009, 4.726906229513434, 35.063165073874615, 42.18262868557336, 0.10000000000000099, 75.0, 636, 776528, 1009, 25.630433399999674
1010, 6.592494516540671, 35.06204576720807, 42.18747512990559, 0.09999999999999971, 225.0, 793, 777321, 1010, 32.149230799999714
1011, 2.826745643982285, 35.02812823818449, 42.03305928663062, 0.10000000000000087, 55.0, 487, 777808, 1011, 19.550577500000145
1012, 5.6329195826810645, 35.06916369602918, 42.14962990382582, 0.10000000000000077, 110.0, 411, 778219, 1012, 16.675167000001238
1013, 4.720924998550969, 35.06923430264907, 42.14128277279915, 0.10000000000000085, 145.0, 654, 778873, 1013, 26.194345899999462
1014, 3.6774114997396548, 35.04197242798344, 42.0656345921178, 0.10000000000000099, 130.0, 620, 779493, 1014, 24.909812700001567
1015, 4.540846442985736, 34.949264839273596, 41.99399073822794, 0.09999999999999948, 130.0, 829, 780322, 1015, 33.25092930000028
1016, 5.325856919772646, 34.504924456750835, 41.50644333543253, 0.10000000000000067, 135.0, 673, 780995, 1016, 26.936748899999657
1017, 3.89688713700486, 34.54900902521779, 41.50645363983711, 0.10000000000000088, 140.0, 493, 781488, 1017, 20.086585500001092
1018, 5.945604785655304, 34.533545256388635, 41.50273314715645, 0.09999999999999867, 260.0, 983, 782471, 1018, 39.48183099999915
1019, 3.748329543204684, 34.46081962986996, 41.39070975052683, 0.10000000000000085, 120.0, 475, 782946, 1019, 20.557104899999104
1020, 4.204891908877149, 34.426464747912775, 41.37012579405836, 0.10000000000000075, 75.0, 406, 783352, 1020, 17.404230000000098
1021, 3.8508738101584705, 34.51814999751427, 41.483800762907414, 0.09999999999999806, 345.0, 1143, 784495, 1021, 46.33870449999995
1022, 3.917484748629836, 34.46925788950697, 41.4178666177197, 0.09999999999999931, 255.0, 856, 785351, 1022, 34.50602000000072
1023, 5.016211651770839, 34.48834386703332, 41.47899307330568, 0.09999999999999751, 340.0, 1342, 786693, 1023, 54.571066299999075
1024, 5.584769506669232, 34.49898308532627, 41.48089550422734, 0.10000000000000045, 155.0, 698, 787391, 1024, 28.698112500000207
1025, 4.543018834867391, 34.45509400271986, 41.438083725281984, 0.09999999999999776, 345.0, 1245, 788636, 1025, 58.126468000000386
1026, 5.672363050837324, 34.532738422014695, 41.552226724091526, 0.10000000000000096, 140.0, 644, 789280, 1026, 28.058004000000437
1027, 6.408756252368291, 34.51125540161133, 41.54158759562174, 0.1000000000000007, 55.0, 375, 789655, 1027, 17.211186500000622
1028, 4.867014174483283, 34.66281247393516, 41.69412292987285, 0.0999999999999994, 180.0, 843, 790498, 1028, 37.12562849999995
1029, 4.218993008844979, 34.69044338704968, 41.68312884525352, 0.09999999999999974, 165.0, 789, 791287, 1029, 30.86001060000126
1030, 2.5322374501300287, 34.72440080031553, 41.68133323203256, 0.10000000000000069, 75.0, 671, 791958, 1030, 27.44100350000008
1031, 3.84750868893805, 34.63096584865025, 41.60275947934105, 0.10000000000000091, 75.0, 525, 792483, 1031, 21.76058440000088
1032, 5.218157319012739, 34.694908216540256, 41.77435433908909, 0.09999999999999828, 325.0, 1076, 793559, 1032, 43.42453190000015
1033, 5.0761399018059254, 34.655254179102776, 41.683628626816144, 0.09999999999999759, 200.0, 1310, 794869, 1033, 51.94818160000068
1034, 3.802289886518996, 34.759042383996245, 41.754653587278874, 0.10000000000000098, 80.0, 611, 795480, 1034, 24.895321600000898
1035, 4.729583720413868, 34.69332261195429, 41.701058627483484, 0.09999999999999667, 655.0, 1822, 797302, 1035, 82.18403690000014
1036, 5.357514880325311, 34.67096398439122, 41.68802461170015, 0.09999999999999905, 300.0, 903, 798205, 1036, 34.76226979999956
1037, 4.207418967208075, 34.72489427681048, 41.713220138233886, 0.09999999999999874, 325.0, 966, 799171, 1037, 36.497683899997355
1038, 3.6005771863714977, 34.52796262340937, 41.46925107348762, 0.09999999999999716, 575.0, 1511, 800682, 1038, 59.68148260000089
1039, 4.671881613706549, 34.40271906534831, 41.358502610524496, 0.09999999999999788, 290.0, 1200, 801882, 1039, 45.92512899999929
1040, 3.491006337299248, 34.34531514014605, 41.25902581585503, 0.09999999999999985, 90.0, 772, 802654, 1040, 30.891895199998544
1041, 5.379471756304459, 34.405384941895804, 41.35611664851506, 0.09999999999999877, 100.0, 960, 803614, 1041, 36.390690500000346
1042, 4.977289239814722, 34.35029121193074, 41.311872491949124, 0.09999999999999792, 310.0, 1186, 804800, 1042, 45.264758000001166
1043, 5.790417290263877, 34.446704726858236, 41.50342583410519, 0.10000000000000073, 125.0, 388, 805188, 1043, 15.149058000002697
1044, 3.8579064299530894, 34.398972127920764, 41.35470167901429, 0.09999999999999905, 330.0, 903, 806091, 1044, 34.74354740000126
1045, 5.096248305260581, 34.333935169542045, 41.292125657581714, 0.09999999999999765, 220.0, 1291, 807382, 1045, 51.493878200002655
1046, 3.8450664746195105, 34.42498122483012, 41.337890159082775, 0.09999999999999794, 580.0, 1179, 808561, 1046, 45.79558090000137
1047, 5.566658723330576, 34.37324765475561, 41.33395949358341, 0.09999999999999833, 430.0, 1066, 809627, 1047, 41.26637280000068
1048, 2.3434411488406157, 34.183941639294716, 41.04687963349888, 0.0999999999999986, 305.0, 997, 810624, 1048, 38.83404609999707
1049, 4.66498626539389, 34.198413777755476, 41.113663783315886, 0.09999999999999794, 495.0, 1180, 811804, 1049, 46.47851549999905
1050, 5.4060607433287915, 34.21420734397537, 41.113788931938394, 0.09999999999999878, 245.0, 956, 812760, 1050, 34.45600050000212
1051, 3.65983063636276, 34.14065106556966, 41.048691731232864, 0.10000000000000077, 70.0, 416, 813176, 1051, 15.250754699998652
1052, 3.812208581283963, 34.138822164979814, 41.04083720214447, 0.09999999999999895, 165.0, 923, 814099, 1052, 33.518123599998944
1053, 4.857291500049239, 34.269668558702115, 41.25496506818475, 0.10000000000000003, 130.0, 748, 814847, 1053, 27.345808999998553
1054, 7.057576696331635, 34.2860904728494, 41.25486129667701, 0.10000000000000084, 150.0, 656, 815503, 1054, 23.95251410000128
1055, 4.565165698886379, 34.20536064325377, 41.11177382949711, 0.10000000000000095, 105.0, 645, 816148, 1055, 23.254944699998305
1056, 9.290518121222656, 34.13885967000326, 41.10599691772461, 0.1000000000000007, 75.0, 375, 816523, 1056, 14.446238599997741
1057, 6.624900103297109, 34.1677825617857, 41.10721316724932, 0.09999999999999831, 345.0, 1071, 817594, 1057, 42.74279480000041
1058, 4.278282089659382, 34.13644102735863, 40.95825452091291, 0.10000000000000067, 55.0, 361, 817955, 1058, 14.794124199997896
1059, 5.787900353982843, 34.273793642676715, 41.20815197136781, 0.09999999999999959, 190.0, 811, 818766, 1059, 32.644256399998994
1060, 11.443127459101884, 34.37933914577412, 41.478309248844134, 0.10000000000000069, 20.0, 369, 819135, 1060, 14.95683790000112
1061, 2.4669772663902854, 34.17015512356025, 41.02429104803089, 0.09999999999999859, 320.0, 1002, 820137, 1061, 40.923839600000065
1062, 2.430655503747475, 34.355350242918405, 41.24501221690012, 0.10000000000000075, 75.0, 402, 820539, 1062, 16.396680599998945
1063, 7.202862955047197, 34.41513611581088, 41.429467946997185, 0.10000000000000078, 40.0, 422, 820961, 1063, 17.659639100002096
1064, 4.603678909893488, 34.40844278824436, 41.37033648448227, 0.0999999999999978, 525.0, 1229, 822190, 1064, 49.860012400000414
1065, 3.8788043465551145, 34.395933722570746, 41.32131151706209, 0.10000000000000088, 125.0, 651, 822841, 1065, 26.38175019999835
1066, 4.375001694971437, 34.394162392502196, 41.31504735079679, 0.10000000000000077, 105.0, 418, 823259, 1066, 16.998315699998784
1067, 5.737333381317329, 34.32703474701428, 41.231057522168484, 0.09999999999999933, 485.0, 854, 824113, 1067, 34.946975400001975
1068, 3.1342873194292262, 34.35616801980653, 41.28206879512306, 0.09999999999999849, 270.0, 1023, 825136, 1068, 41.74524360000214
1069, 3.4202170170797324, 34.29270954250549, 41.213107631517495, 0.09999999999999963, 165.0, 805, 825941, 1069, 33.47369909999907
1070, 6.511188179725545, 34.34315107060575, 41.28859772079292, 0.10000000000000046, 120.0, 696, 826637, 1070, 28.562855399999535
1071, 2.8901821384047484, 34.31186815007962, 41.21489089991859, 0.10000000000000096, 125.0, 586, 827223, 1071, 24.16410100000212
1072, 3.4578174406988746, 34.41525031999293, 41.31052164058437, 0.1000000000000005, 170.0, 691, 827914, 1072, 28.302769999998418
1073, 4.843160755508315, 34.33836584599468, 41.311743442497495, 0.09999999999999817, 610.0, 1107, 829021, 1073, 45.48166180000044
1074, 3.391494751059449, 34.30429611394668, 41.21665278883888, 0.0999999999999996, 215.0, 809, 829830, 1074, 33.14477320000151
1075, 3.6060541314296066, 35.12644285134995, 42.192967606809574, 0.10000000000000099, 205.0, 626, 830456, 1075, 25.60699620000014
1076, 7.231625644275595, 35.47993348590634, 42.6698940493289, 0.09999999999999823, 290.0, 1094, 831550, 1076, 44.76678890000039
1077, 4.518418116106351, 35.3322604002915, 42.46757481417318, 0.09999999999999852, 215.0, 1016, 832566, 1077, 41.77774169999975
1078, 3.505056286873161, 35.32695207181184, 42.433856870126036, 0.09999999999999742, 470.0, 1380, 833946, 1078, 56.988363099997514
1079, 3.6061483456039336, 35.2760752857034, 42.37970001685438, 0.09999999999999974, 210.0, 788, 834734, 1079, 32.54965929999889
1080, 6.681303173979851, 35.4108694617156, 42.67252905049901, 0.10000000000000099, 40.0, 628, 835362, 1080, 26.15574310000011
1081, 4.319513040992045, 35.40133253042849, 42.56653873367376, 0.09999999999999803, 490.0, 1151, 836513, 1081, 47.649751599998126
1082, 7.085067866658982, 35.45389871402663, 42.70534406389509, 0.09999999999999869, 370.0, 980, 837493, 1082, 41.03643699999884
1083, 4.479774594395177, 35.334663812737716, 42.438560149544166, 0.09999999999999995, 280.0, 760, 838253, 1083, 31.673977999998897
1084, 6.459899204490829, 35.484427180603475, 42.724363814305214, 0.09999999999999952, 185.0, 822, 839075, 1084, 34.54392039999948
1085, 5.683709017074861, 35.461257521468816, 42.67106593009269, 0.0999999999999996, 185.0, 808, 839883, 1085, 33.985757500002364
1086, 4.770464325366108, 35.42087300061762, 42.59514081791278, 0.09999999999999806, 155.0, 1142, 841025, 1086, 48.093827699998656
1087, 6.7080198764902, 35.41605928537345, 42.597634314567514, 0.09999999999999845, 260.0, 1033, 842058, 1087, 43.50360770000043
1088, 4.3937130404047915, 35.44216485557945, 42.619282995943074, 0.10000000000000055, 125.0, 687, 842745, 1088, 28.79549169999882
1089, 5.5986265198957215, 35.38513684573391, 42.53610408572059, 0.09999999999999847, 485.0, 1031, 843776, 1089, 43.52599510000073
1090, 4.11371593382489, 35.44125379341846, 42.598897949111006, 0.09999999999999809, 370.0, 1133, 844909, 1090, 47.41481589999967
1091, 5.372754133057423, 35.438412639658935, 42.61654883490668, 0.0999999999999974, 375.0, 1395, 846304, 1091, 58.875276399998256
1092, 3.944504243665419, 35.3703778556415, 42.49631437233516, 0.10000000000000069, 100.0, 672, 846976, 1092, 28.410815200000798
1093, 3.667568226203774, 35.46571184794108, 42.57744193799568, 0.1000000000000008, 130.0, 660, 847636, 1093, 28.151763999998366
1094, 4.041759372119186, 35.42637474817237, 42.570784765282625, 0.09999999999999892, 440.0, 927, 848563, 1094, 39.25290959999984
1095, 3.92501138818244, 35.37664243198881, 42.501652288756915, 0.0999999999999972, 505.0, 1490, 850053, 1095, 63.28765310000017
1096, 6.021636323774004, 35.788887665436434, 43.072870294611015, 0.0999999999999986, 550.0, 999, 851052, 1096, 42.4838450999996
1097, 6.126724066944119, 35.756590697906745, 42.99377718927426, 0.09999999999999651, 520.0, 1956, 853008, 1097, 83.03248639999947
1098, 7.520342619725938, 35.79328924664379, 43.02685952045508, 0.09999999999999853, 240.0, 1014, 854022, 1098, 43.05651260000013
1099, 5.184540106487625, 35.64671257617427, 42.822854068232516, 0.1000000000000009, 20.0, 510, 854532, 1099, 22.047102299999096
1100, 5.620312802823762, 35.79239847457264, 43.032896146849275, 0.09999999999999738, 305.0, 1399, 855931, 1100, 59.53076440000223
1101, 3.0659936487066504, 35.83140652520316, 43.01808417573267, 0.10000000000000073, 105.0, 392, 856323, 1101, 16.65312350000022
1102, 9.887456768884872, 35.73808727508936, 42.98419413199792, 0.10000000000000099, 45.0, 624, 856947, 1102, 29.17054510000162
1103, 3.7496328076523877, 35.73133004864521, 42.914980565070096, 0.09999999999999887, 215.0, 941, 857888, 1103, 50.492666400001326
1104, 3.4676293470765365, 35.76932762590654, 42.95400552808142, 0.10000000000000088, 75.0, 652, 858540, 1104, 34.252212399998825
1105, 7.193128263399334, 35.80541435447899, 43.14272237585569, 0.09999999999999958, 385.0, 814, 859354, 1105, 67.48557240000082
1106, 5.662049336151944, 35.793767916967, 43.00286729600695, 0.10000000000000099, 135.0, 630, 859984, 1106, 54.461490499998035
1107, 3.756771430108592, 35.92772259222013, 43.18625276512075, 0.09999999999999831, 495.0, 1070, 861054, 1107, 92.10116659999767
1108, 2.710701360086293, 35.90451435804933, 43.12571598515091, 0.0999999999999994, 200.0, 842, 861896, 1108, 101.72363529999711
1109, 4.888169416293905, 35.931964614455765, 43.23104086386191, 0.09999999999999894, 215.0, 925, 862821, 1109, 108.1584483000006
1110, 5.301258845990186, 35.874776986472966, 43.17224893520533, 0.09999999999999874, 255.0, 965, 863786, 1110, 50.88593910000054
1111, 2.460433735383809, 35.92076863762586, 43.14882730029083, 0.10000000000000082, 105.0, 457, 864243, 1111, 18.972216899997875
1112, 4.133633772990643, 35.965175721584224, 43.235216267903645, 0.10000000000000073, 70.0, 390, 864633, 1112, 16.322778099998686
1113, 3.452704840008371, 35.75095911710189, 42.95579968364486, 0.10000000000000057, 145.0, 683, 865316, 1113, 30.914884599998913
1114, 3.703738156565863, 35.913654929877495, 43.14135506812563, 0.09999999999999781, 580.0, 1222, 866538, 1114, 52.22919819999879
1115, 4.255087823309005, 35.92843413829804, 43.19363411903382, 0.10000000000000074, 105.0, 400, 866938, 1115, 20.2661420000004
1116, 4.396629606789438, 35.867497686970275, 43.126719151035886, 0.09999999999999826, 350.0, 1084, 868022, 1116, 45.41011929999877
1117, 5.843815636476502, 35.90105649232864, 43.1492661523819, 0.09999999999999966, 185.0, 800, 868822, 1117, 41.02850519999993
1118, 3.3195459945570853, 35.79332341662377, 43.037457358073716, 0.10000000000000098, 115.0, 609, 869431, 1118, 39.24468210000123
1119, 3.250121501599719, 35.842346629220806, 43.032222629783156, 0.09999999999999859, 315.0, 1002, 870433, 1119, 53.69779539999945
1120, 4.674786506674017, 35.788697628802566, 43.05817103328475, 0.0999999999999969, 490.0, 1660, 872093, 1120, 162.62494720000177
1121, 7.255080083333103, 35.83870567826722, 43.17904208635964, 0.09999999999999874, 205.0, 967, 873060, 1121, 96.83049709999977
1122, 4.890535822141133, 35.82056768998904, 43.06347219337596, 0.10000000000000099, 160.0, 633, 873693, 1122, 44.20204889999877
1123, 4.819456113764986, 35.75546673008653, 43.01310068349369, 0.10000000000000098, 135.0, 610, 874303, 1123, 35.119693200002075
1124, 4.715736637458591, 35.77901871227524, 42.98548223131297, 0.09999999999999777, 605.0, 1236, 875539, 1124, 88.68992380000054
1125, 5.140040977451266, 35.91559966989115, 43.23960578036146, 0.10000000000000013, 90.0, 735, 876274, 1125, 115.86453650000112
1126, 4.491284200810636, 35.767508746772414, 42.99309014958261, 0.10000000000000098, 230.0, 604, 876878, 1126, 95.16635319999841
1127, 4.002269952831416, 35.836037296859374, 43.053371976806105, 0.09999999999999903, 290.0, 906, 877784, 1127, 138.96214220000184
1128, 5.7297045536423, 35.74185762083932, 42.9748704417368, 0.09999999999999912, 380.0, 890, 878674, 1128, 66.611231400002
1129, 5.518483533357319, 35.730126580259856, 43.002715272831736, 0.10000000000000074, 300.0, 665, 879339, 1129, 46.67252920000101
1130, 3.509386464108405, 35.806144017896216, 43.030535269245235, 0.10000000000000023, 200.0, 723, 880062, 1130, 50.691535300000396
1131, 3.9695036215341806, 35.417918807962366, 42.55654040178211, 0.09999999999999727, 745.0, 1451, 881513, 1131, 162.84452630000305
1132, 5.721205119426449, 35.419070786791956, 42.65275121940874, 0.10000000000000098, 75.0, 613, 882126, 1132, 122.61066690000007
1133, 6.55522714047471, 35.590081862040925, 42.78045077550979, 0.10000000000000062, 50.0, 336, 882462, 1133, 59.40594880000208
1134, 5.7847108064324555, 35.54587318889327, 42.73944733071565, 0.10000000000000098, 110.0, 602, 883064, 1134, 112.6603756000004
1135, 3.792546878855136, 35.43055791652666, 42.54244031670237, 0.09999999999999809, 450.0, 1132, 884196, 1135, 177.01997299999857
1136, 4.2659459636907355, 35.395458344917074, 42.52322986580733, 0.09999999999999926, 285.0, 865, 885061, 1136, 161.42443980000098
1137, 3.9468974505082652, 35.430553036163396, 42.61440379653589, 0.10000000000000087, 30.0, 491, 885552, 1137, 92.00690700000268
1138, 6.3595053384800035, 35.595150241782946, 42.82610999152118, 0.09999999999999741, 405.0, 1385, 886937, 1138, 230.24540979999801
1139, 4.4669913365384035, 35.453026040541594, 42.62013924945884, 0.10000000000000088, 125.0, 651, 887588, 1139, 106.10825019999902
1140, 6.0543875286615645, 35.439885643925535, 42.63054079887195, 0.09999999999999838, 185.0, 1053, 888641, 1140, 168.52562799999941
1141, 3.5213510855588885, 35.44472748665583, 42.57957873117356, 0.09999999999999941, 215.0, 840, 889481, 1141, 137.233454600002
1142, 4.131430179912311, 35.67299861795098, 42.861119341427056, 0.09999999999999938, 185.0, 845, 890326, 1142, 125.12621630000285
1143, 4.903790225183554, 35.88288748965544, 43.13084260155173, 0.09999999999999956, 195.0, 816, 891142, 1143, 118.52751680000074
1144, 7.565247111833157, 35.780424829591745, 42.988751831449996, 0.10000000000000073, 75.0, 386, 891528, 1144, 63.441753700000845
1145, 6.982321686568097, 35.92559793820748, 43.26926409739714, 0.09999999999999945, 170.0, 832, 892360, 1145, 133.54733730000225
1146, 5.010244617146169, 35.92518255896602, 43.16779246905171, 0.10000000000000095, 40.0, 564, 892924, 1146, 88.21377909999865
1147, 4.772402247297785, 35.894658746566364, 43.133329381279765, 0.10000000000000094, 75.0, 561, 893485, 1147, 59.627287300001626
1148, 5.106082798421508, 35.90834082714767, 43.18261404268122, 0.09999999999999881, 255.0, 951, 894436, 1148, 63.13798440000028
1149, 4.675261067829958, 35.85617331091317, 43.10628106069665, 0.09999999999999733, 705.0, 1423, 895859, 1149, 77.82009789999938
1150, 4.65294223475911, 35.779007992187104, 42.99850743776792, 0.10000000000000098, 80.0, 616, 896475, 1150, 53.254866700001
1151, 6.523215877286457, 35.89776095691289, 43.14218153669505, 0.09999999999999974, 95.0, 789, 897264, 1151, 114.5345570999998
1152, 5.411804560739338, 35.87617332479927, 43.11126219824459, 0.10000000000000032, 105.0, 712, 897976, 1152, 97.01783760000035
1153, 4.129479204015162, 35.81233754667846, 43.04620511516835, 0.0999999999999997, 155.0, 795, 898771, 1153, 107.65382590000081
1154, 5.508370427898665, 35.852384990361806, 43.10632921990409, 0.0999999999999994, 200.0, 843, 899614, 1154, 118.15906579999864
1155, 2.9615102097307258, 36.0742586848858, 43.34565173878389, 0.10000000000000091, 60.0, 527, 900141, 1155, 77.52182149999862
1156, 6.507998177657525, 36.296092519306, 43.68746245702108, 0.09999999999999941, 160.0, 840, 900981, 1156, 91.61726279999857
1157, 4.829216310608328, 36.228643665126725, 43.55987650740381, 0.09999999999999956, 185.0, 816, 901797, 1157, 55.6065445000022
1158, 5.748507795420858, 36.249827766194855, 43.59538171104082, 0.09999999999999933, 205.0, 853, 902650, 1158, 56.200727800001914
1159, 4.9819255128568205, 36.35645883794417, 43.703081207944635, 0.09999999999999806, 465.0, 1140, 903790, 1159, 84.16135009999925
1160, 4.3456809711314515, 36.27569638712081, 43.602459627449896, 0.09999999999999823, 380.0, 1093, 904883, 1160, 101.05591549999735
1161, 5.4524545888896245, 36.293848887356845, 43.664848402774695, 0.1000000000000008, 165.0, 660, 905543, 1161, 115.26555139999982
1162, 3.8671300083285933, 36.218454801675044, 43.55560781738975, 0.10000000000000091, 90.0, 528, 906071, 1162, 93.3290072000018
1163, 6.041782451249086, 36.284792273385186, 43.634432987590415, 0.09999999999999902, 175.0, 910, 906981, 1163, 163.16540769999847
1164, 5.28661685832096, 36.23428915216682, 43.56601195174657, 0.09999999999999912, 125.0, 890, 907871, 1164, 93.61251659999834
1165, 6.689359058482261, 36.251760236808664, 43.66632354687939, 0.09999999999999884, 130.0, 946, 908817, 1165, 65.94787029999861
1166, 6.794071599365549, 36.25350203946616, 43.59029315807518, 0.0999999999999991, 180.0, 893, 909710, 1166, 64.63817520000157
1167, 2.7864109203109035, 36.330914866129554, 43.607383728027344, 0.10000000000000066, 135.0, 675, 910385, 1167, 49.31509709999955
1168, 5.700763938364424, 36.233086847375944, 43.539234754774306, 0.10000000000000075, 60.0, 405, 910790, 1168, 31.263485600000422
1169, 4.412248562710404, 36.36278389557394, 43.72729489710424, 0.09999999999999828, 175.0, 1078, 911868, 1169, 159.26925929999925
1170, 5.14811644127103, 36.44520183772356, 43.85318275841062, 0.10000000000000091, 75.0, 529, 912397, 1170, 93.73993610000252
1171, 4.052833638959249, 36.31213148733727, 43.638814252122, 0.10000000000000091, 220.0, 532, 912929, 1171, 93.20439569999871
1172, 4.630522053026226, 36.24737276436802, 43.584257477261644, 0.09999999999999887, 295.0, 939, 913868, 1172, 132.36751070000173
1173, 2.8414718634182115, 36.38785983101498, 43.68403462605644, 0.10000000000000092, 145.0, 541, 914409, 1173, 86.87053229999947
1174, 9.011327958482457, 36.28285723908993, 43.697679214277294, 0.10000000000000071, 90.0, 381, 914790, 1174, 65.94846789999792
1175, 3.896205973581991, 36.30984176019704, 43.65428091329571, 0.09999999999999874, 310.0, 966, 915756, 1175, 157.1951751000015
1176, 4.349938026521762, 36.21796616494013, 43.52137008102723, 0.10000000000000091, 140.0, 649, 916405, 1176, 85.20441670000218
1177, 4.191971899902228, 36.42727654972432, 43.82265900795504, 0.09999999999999963, 145.0, 805, 917210, 1177, 135.40095379999912
1178, 4.911015288215994, 36.25215959359478, 43.599747118413056, 0.09999999999999998, 290.0, 755, 917965, 1178, 102.21896750000087
1179, 4.10389934319121, 36.38635753318307, 43.73660647811521, 0.09999999999999948, 315.0, 828, 918793, 1179, 86.13155800000095
1180, 3.7994927461844323, 36.309012418236236, 43.64146032142292, 0.09999999999999822, 455.0, 1098, 919891, 1180, 164.14578640000036
1181, 2.6928023376956363, 35.76106825077125, 42.95180479426174, 0.0999999999999978, 365.0, 1226, 921117, 1181, 179.2516230000001
1182, 5.774388819989098, 35.86379042582296, 43.193703541204556, 0.10000000000000074, 110.0, 398, 921515, 1182, 59.7970435999996
1183, 5.52100284047834, 35.74213022791132, 42.96135371798982, 0.09999999999999763, 305.0, 1293, 922808, 1183, 163.02476019999813
1184, 4.098601737468128, 35.73332759790253, 42.94458226153725, 0.099999999999999, 360.0, 912, 923720, 1184, 66.20561839999937
1185, 6.506606194751718, 35.6969770523439, 42.989090885024474, 0.10000000000000075, 150.0, 664, 924384, 1185, 67.54937739999878
1186, 7.574426794617946, 35.77652722934507, 43.03904320608895, 0.09999999999999935, 250.0, 848, 925232, 1186, 118.03430700000172
1187, 4.28581875768091, 35.73897472563244, 42.980624778384254, 0.0999999999999984, 255.0, 1050, 926282, 1187, 133.10810309999943
1188, 4.096252593308032, 35.74951047582941, 42.97826367891752, 0.09999999999999902, 450.0, 910, 927192, 1188, 122.62396829999852
1189, 4.555274849785408, 35.742282437660165, 42.95646728713396, 0.09999999999999858, 225.0, 1003, 928195, 1189, 138.34984319999785
1190, 3.811614328194398, 35.71014413755792, 42.895796010124556, 0.09999999999999701, 555.0, 1593, 929788, 1190, 205.360411200003
1191, 5.328782167654288, 35.72455474050422, 42.92953706038626, 0.09999999999999881, 165.0, 950, 930738, 1191, 132.78641840000273
1192, 4.789891224558958, 35.733324237151905, 42.96910694201164, 0.09999999999999737, 655.0, 1403, 932141, 1192, 191.84232169999814
1193, 4.650192367031538, 35.76123543822797, 43.01687061249103, 0.09999999999999716, 370.0, 1508, 933649, 1193, 211.7151698000016
1194, 4.61662778845213, 35.82460894131793, 43.09243211799494, 0.10000000000000067, 95.0, 358, 934007, 1194, 54.22182790000079
1195, 9.477887313510177, 35.86391176496233, 43.256606116083454, 0.09999999999999959, 190.0, 812, 934819, 1195, 119.15643119999731
1196, 7.248916371155761, 35.84049988593535, 43.20619655581111, 0.0999999999999988, 150.0, 953, 935772, 1196, 140.0647640999996
1197, 4.395553339634772, 35.757169601279244, 42.96413562667202, 0.09999999999999734, 475.0, 1420, 937192, 1197, 229.7089832999991
1198, 4.291428435630928, 35.717213617730465, 42.940884889628556, 0.09999999999999819, 315.0, 1105, 938297, 1198, 125.16843860000154
1199, 7.447314659347684, 35.8013770816833, 43.131051227239176, 0.10000000000000099, 160.0, 635, 938932, 1199, 100.93412979999994
1200, 6.5660703988469145, 35.74313385094604, 42.981872552533865, 0.09999999999999772, 365.0, 1259, 940191, 1200, 190.26511639999808
1201, 4.1209004259630495, 35.31039602972342, 42.40577932748785, 0.09999999999999877, 310.0, 961, 941152, 1201, 123.00837610000235
1202, 5.046639017004054, 35.31501863896847, 42.458991426974535, 0.09999999999999849, 420.0, 1024, 942176, 1202, 155.21788449999804
1203, 3.2946861254063267, 35.23941374130738, 42.315055483426804, 0.09999999999999774, 275.0, 1248, 943424, 1203, 190.25200889999905
1204, 4.235464194735517, 35.31559294358501, 42.46525286759042, 0.09999999999999785, 225.0, 1207, 944631, 1204, 180.93964190000042
1205, 5.823017434950647, 35.372852907944434, 42.56759506452905, 0.10000000000000092, 105.0, 537, 945168, 1205, 27.82290809999904
1206, 3.739397784891387, 35.31380607341898, 42.4132642924492, 0.09999999999999853, 270.0, 1015, 946183, 1206, 45.93138859999817
1207, 6.5945826373450105, 35.334483612694726, 42.48913640039093, 0.0999999999999997, 220.0, 794, 946977, 1207, 35.57840650000071
1208, 4.303045915033835, 35.31523096454677, 42.44722769438331, 0.1000000000000007, 125.0, 670, 947647, 1208, 30.52229740000257
1209, 2.341682278253138, 35.314951100349425, 42.39481282234192, 0.10000000000000074, 75.0, 400, 948047, 1209, 18.411960800000088
1210, 6.972333477121727, 35.35508765105399, 42.563688795954874, 0.10000000000000095, 105.0, 571, 948618, 1210, 26.36030799999935
1211, 6.11884919115469, 35.365668080387145, 42.55618005755356, 0.10000000000000057, 185.0, 683, 949301, 1211, 33.88338410000142
1212, 5.525188585317308, 35.15030785088283, 42.267310052264, 0.09999999999999769, 280.0, 1268, 950569, 1212, 63.57868959999905
1213, 4.745786377742586, 35.01865506524208, 42.108523902637046, 0.0999999999999972, 545.0, 1490, 952059, 1213, 74.07986240000173
1214, 6.986246060096694, 35.12156121411961, 42.22985741240298, 0.09999999999999859, 110.0, 1002, 953061, 1214, 49.626098799999454
1215, 7.703300082778197, 34.98906379745853, 42.119272239746586, 0.09999999999999863, 205.0, 992, 954053, 1215, 49.835520700002235
1216, 4.441438895870716, 34.95399171196983, 41.980446169967436, 0.10000000000000067, 90.0, 359, 954412, 1216, 17.908527700001287
1217, 4.543179830888016, 34.987620634191174, 42.05608377958599, 0.10000000000000094, 110.0, 646, 955058, 1217, 32.49802590000036
1218, 4.8322669521296095, 35.01840841623, 42.11137943797641, 0.09999999999999763, 580.0, 1296, 956354, 1218, 65.36602130000028
1219, 2.744977607273243, 34.97741827964783, 41.97292382500388, 0.10000000000000081, 95.0, 440, 956794, 1219, 22.406737399996928
1220, 5.170764418045438, 35.096625972354886, 42.188787440217226, 0.09999999999999779, 305.0, 1233, 958027, 1220, 62.57014419999905
1221, 4.751072498856635, 35.06619093693357, 42.13903086832438, 0.10000000000000073, 130.0, 667, 958694, 1221, 33.7715289000007
1222, 6.703300126234315, 35.03370388198949, 42.14359992645072, 0.0999999999999997, 175.0, 795, 959489, 1222, 39.83318489999874
1223, 4.376295304343928, 35.01526081968279, 42.071835971747106, 0.09999999999999934, 160.0, 851, 960340, 1223, 42.97945400000026
1224, 7.274784065178382, 34.9858212090434, 42.1535973449748, 0.09999999999999719, 420.0, 1491, 961831, 1224, 75.22505570000067
1225, 4.747479482826327, 34.957495922944986, 42.04074185343286, 0.09999999999999916, 150.0, 882, 962713, 1225, 44.904303600000276
1226, 7.4283987929649715, 35.04638447904153, 42.17613626487543, 0.09999999999999988, 260.0, 769, 963482, 1226, 39.04956250000032
1227, 5.843806577822343, 34.935560596081636, 41.98551929582305, 0.09999999999999984, 120.0, 774, 964256, 1227, 39.427243400001316
1228, 3.548376962362045, 34.90002455822257, 41.917825517728346, 0.09999999999999847, 480.0, 1032, 965288, 1228, 52.7648248000005
1229, 5.179192155857272, 34.972505416794725, 42.06528876609953, 0.09999999999999855, 420.0, 1012, 966300, 1229, 51.6138792999991
1230, 5.0170342862235655, 34.858789965481876, 41.864951423659605, 0.10000000000000091, 105.0, 523, 966823, 1230, 26.900058100000024
1231, 4.8874875550175565, 34.95924190680186, 42.01245965781035, 0.09999999999999927, 290.0, 864, 967687, 1231, 44.317554299999756
1232, 5.924477978075873, 34.965275947377535, 42.05969971310532, 0.09999999999999948, 465.0, 829, 968516, 1232, 42.39411410000321
1233, 5.293299159413929, 34.93804226891469, 41.97101168309228, 0.09999999999999885, 340.0, 944, 969460, 1233, 48.31660929999998
1234, 5.920902664747677, 34.85886926952161, 41.933123269332086, 0.09999999999999881, 220.0, 950, 970410, 1234, 48.98083880000195
1235, 2.6863306567262866, 34.64532403998036, 41.58774037178748, 0.10000000000000094, 100.0, 549, 970959, 1235, 27.94268529999681
1236, 4.11776191460289, 34.573283483420205, 41.57350043521565, 0.09999999999999977, 185.0, 785, 971744, 1236, 40.29884739999761
1237, 3.4362911133733367, 34.59020918381904, 41.58103140394035, 0.09999999999999738, 480.0, 1399, 973143, 1237, 71.27441080000062
1238, 6.030716184330969, 34.62979804605678, 41.67237676399341, 0.09999999999999819, 245.0, 1104, 974247, 1238, 57.346077900001546
1239, 6.1221469080753925, 34.62138263614192, 41.61517524719238, 0.10000000000000049, 95.0, 692, 974939, 1239, 36.83299650000117
1240, 4.159039853547761, 34.505928896753026, 41.48244996236558, 0.09999999999999763, 210.0, 1295, 976234, 1240, 66.60409830000208
1241, 4.785059343738957, 34.63620295331131, 41.64332610155347, 0.09999999999999942, 270.0, 838, 977072, 1241, 43.24683029999869
1242, 4.867444148501145, 34.595849780967185, 41.58212642831122, 0.09999999999999949, 125.0, 827, 977899, 1242, 42.72565039999972
1243, 3.572232229979175, 34.61846793229413, 41.57391060385734, 0.10000000000000099, 130.0, 628, 978527, 1243, 32.76152860000002
1244, 6.274802833078728, 34.66537961598388, 41.664150638413496, 0.10000000000000055, 210.0, 686, 979213, 1244, 35.56655719999981
1245, 5.363978362704874, 34.73680750243867, 41.7690226351021, 0.10000000000000071, 110.0, 669, 979882, 1245, 34.93803019999905
1246, 6.433318596082685, 34.62190033095835, 41.62951543149392, 0.09999999999999815, 330.0, 1115, 980997, 1246, 57.83174919999874
1247, 3.684918938887616, 34.59857808748881, 41.54505616505941, 0.10000000000000098, 90.0, 600, 981597, 1247, 31.301230600001873
1248, 2.545385071057912, 34.504089983462556, 41.42741321020433, 0.10000000000000087, 335.0, 653, 982250, 1248, 33.98620730000039
1249, 3.4147315032544303, 34.57363091367583, 41.52127641598531, 0.09999999999999698, 655.0, 1611, 983861, 1249, 83.04763190000085
1250, 4.830395390668111, 34.54823826532699, 41.556037114061496, 0.09999999999999949, 100.0, 827, 984688, 1250, 43.04713599999741
1251, 5.411863189813467, 34.639262804097555, 41.70795712034785, 0.10000000000000099, 145.0, 634, 985322, 1251, 33.04316739999922
1252, 4.93166690299364, 34.63980187957731, 41.662914710250874, 0.09999999999999883, 210.0, 949, 986271, 1252, 49.906163599996944
1253, 4.349399898150612, 34.6669207163479, 41.68790366856948, 0.10000000000000013, 230.0, 736, 987007, 1253, 38.86250569999902
1254, 5.372726936848273, 34.61894614507282, 41.639892051333476, 0.09999999999999772, 485.0, 1260, 988267, 1254, 65.79923029999918
1255, 3.8170375138782617, 34.617749706067535, 41.65104266607273, 0.09999999999999931, 220.0, 855, 989122, 1255, 44.94626939999944
1256, 4.202220477067724, 34.65277225581828, 41.644223554769695, 0.10000000000000045, 140.0, 698, 989820, 1256, 36.34609880000062
1257, 4.509865281359983, 34.71852497161732, 41.70802399589638, 0.10000000000000052, 135.0, 689, 990509, 1257, 36.42760819999967
1258, 4.655624927325887, 34.83780898797297, 41.89492798477949, 0.10000000000000098, 135.0, 609, 991118, 1258, 32.2004522999996
1259, 5.467358676125681, 34.81246722228545, 41.818081693721, 0.10000000000000074, 140.0, 665, 991783, 1259, 34.858261199999106
1260, 6.783175194884823, 34.81833602915169, 41.891807674897784, 0.0999999999999971, 635.0, 1542, 993325, 1260, 84.42600730000049
1261, 3.9267100128736203, 34.79360072927361, 41.81617678576753, 0.09999999999999898, 170.0, 917, 994242, 1261, 47.58484949999911
1262, 7.451345925140267, 34.853595928674764, 41.93370838264452, 0.09999999999999802, 560.0, 1154, 995396, 1262, 58.92875029999777
1263, 4.100987725403337, 34.79560814774226, 41.81513488103473, 0.09999999999999856, 225.0, 1008, 996404, 1263, 51.64871129999665
1264, 4.564687257675399, 34.77369028211188, 41.82737593190776, 0.0999999999999976, 525.0, 1306, 997710, 1264, 67.0911801000002
1265, 5.781518183471529, 34.773874436947786, 41.80730965835513, 0.09999999999999838, 205.0, 1052, 998762, 1265, 54.51999799999976
1266, 4.397158300349073, 34.82322080856585, 41.857559350239235, 0.09999999999999996, 90.0, 757, 999519, 1266, 39.011213699999644
