,loss,mae,mean_q,mean_eps,episode_reward,nb_episode_steps,nb_steps,episode,duration
0,0,0,0,0,65.0,630,630,0,1.4852857000000004
1, 0, 0, 0, 0, 105.0, 644, 1274, 1, 1.5592168000000015
2, 0, 0, 0, 0, 335.0, 727, 2001, 2, 1.6514290000000003
3, 0, 0, 0, 0, 225.0, 860, 2861, 3, 1.9397170999999993
4, 0, 0, 0, 0, 210.0, 778, 3639, 4, 1.7913746999999987
5, 0, 0, 0, 0, 45.0, 536, 4175, 5, 1.2509706999999999
6, 0, 0, 0, 0, 60.0, 581, 4756, 6, 1.3816125999999969
7, 0, 0, 0, 0, 180.0, 718, 5474, 7, 1.624886
8, 0, 0, 0, 0, 110.0, 622, 6096, 8, 1.5261530000000008
9, 0, 0, 0, 0, 175.0, 859, 6955, 9, 1.9213615999999973
10, 0, 0, 0, 0, 105.0, 512, 7467, 10, 1.2681666000000007
11, 0, 0, 0, 0, 135.0, 646, 8113, 11, 1.6989927999999992
12, 0, 0, 0, 0, 75.0, 385, 8498, 12, 0.8453801000000034
13, 0, 0, 0, 0, 45.0, 342, 8840, 13, 0.762911900000006
14, 0, 0, 0, 0, 120.0, 588, 9428, 14, 1.306764600000001
15, 0, 0, 0, 0, 65.0, 494, 9922, 15, 1.167244199999999
16, 0, 0, 0, 0, 160.0, 867, 10789, 16, 1.8466357000000002
17, 0, 0, 0, 0, 75.0, 684, 11473, 17, 1.5039905999999945
18, 0, 0, 0, 0, 80.0, 378, 11851, 18, 0.8608198000000016
19, 0, 0, 0, 0, 145.0, 778, 12629, 19, 1.6637320999999972
20, 0, 0, 0, 0, 215.0, 874, 13503, 20, 1.9046534000000008
21, 0, 0, 0, 0, 50.0, 512, 14015, 21, 1.110933100000004
22, 0, 0, 0, 0, 155.0, 708, 14723, 22, 1.8324891999999977
23, 0, 0, 0, 0, 325.0, 1118, 15841, 23, 2.4434247000000013
24, 0, 0, 0, 0, 410.0, 909, 16750, 24, 1.9989524000000003
25, 0, 0, 0, 0, 150.0, 776, 17526, 25, 1.6195980000000034
26, 0, 0, 0, 0, 105.0, 544, 18070, 26, 1.1246115000000003
27, 0, 0, 0, 0, 135.0, 729, 18799, 27, 1.5354740999999947
28, 0, 0, 0, 0, 30.0, 490, 19289, 28, 1.0204161999999997
29, 0, 0, 0, 0, 110.0, 642, 19931, 29, 1.3210546999999977
30, 0, 0, 0, 0, 135.0, 521, 20452, 30, 1.0707771000000008
31, 0, 0, 0, 0, 140.0, 628, 21080, 31, 1.3060659000000001
32, 0, 0, 0, 0, 65.0, 618, 21698, 32, 1.341974300000004
33, 0, 0, 0, 0, 210.0, 776, 22474, 33, 1.5556620999999993
34, 0, 0, 0, 0, 405.0, 1161, 23635, 34, 2.4240852000000004
35, 0, 0, 0, 0, 315.0, 1072, 24707, 35, 2.1388532
36, 0, 0, 0, 0, 125.0, 383, 25090, 36, 0.7975387999999981
37, 0, 0, 0, 0, 135.0, 760, 25850, 37, 1.5746172999999999
38, 0, 0, 0, 0, 180.0, 761, 26611, 38, 1.5357867999999968
39, 0, 0, 0, 0, 80.0, 439, 27050, 39, 0.8894723000000084
40, 0, 0, 0, 0, 50.0, 409, 27459, 40, 0.8347141999999934
41, 0, 0, 0, 0, 285.0, 855, 28314, 41, 1.7183179999999965
42, 0, 0, 0, 0, 45.0, 544, 28858, 42, 1.1311384999999916
43, 0, 0, 0, 0, 65.0, 436, 29294, 43, 0.9015780000000007
44, 0, 0, 0, 0, 120.0, 619, 29913, 44, 1.2711829999999935
45, 0, 0, 0, 0, 105.0, 494, 30407, 45, 1.0159665000000047
46, 0, 0, 0, 0, 110.0, 537, 30944, 46, 1.0990636999999879
47, 0, 0, 0, 0, 80.0, 547, 31491, 47, 1.1101089999999942
48, 0, 0, 0, 0, 105.0, 697, 32188, 48, 1.4103707000000014
49, 0, 0, 0, 0, 210.0, 1119, 33307, 49, 2.2251559999999984
50, 0, 0, 0, 0, 305.0, 1047, 34354, 50, 2.0589287999999897
51, 0, 0, 0, 0, 75.0, 395, 34749, 51, 0.8101902000000081
52, 0, 0, 0, 0, 105.0, 555, 35304, 52, 1.1523717000000033
53, 0, 0, 0, 0, 45.0, 382, 35686, 53, 0.7920059000000066
54, 0, 0, 0, 0, 120.0, 658, 36344, 54, 1.34943659999999
55, 0, 0, 0, 0, 105.0, 734, 37078, 55, 1.459835599999991
56, 0, 0, 0, 0, 50.0, 403, 37481, 56, 0.8371163000000053
57, 0, 0, 0, 0, 125.0, 610, 38091, 57, 1.235108000000011
58, 0, 0, 0, 0, 155.0, 806, 38897, 58, 1.6090909999999923
59, 0, 0, 0, 0, 335.0, 737, 39634, 59, 1.464425399999996
60, 0, 0, 0, 0, 120.0, 630, 40264, 60, 1.3114741999999922
61, 0, 0, 0, 0, 485.0, 1015, 41279, 61, 2.052463700000004
62, 0, 0, 0, 0, 210.0, 771, 42050, 62, 1.5554168999999973
63, 0, 0, 0, 0, 180.0, 773, 42823, 63, 1.6993592000000035
64, 0, 0, 0, 0, 150.0, 772, 43595, 64, 1.589809399999993
65, 0, 0, 0, 0, 425.0, 1322, 44917, 65, 2.595334500000007
66, 0, 0, 0, 0, 140.0, 751, 45668, 66, 1.5213111999999995
67, 0, 0, 0, 0, 50.0, 395, 46063, 67, 0.8177230000000009
68, 0, 0, 0, 0, 100.0, 509, 46572, 68, 1.023226600000001
69, 0, 0, 0, 0, 180.0, 769, 47341, 69, 1.5493109999999888
70, 0, 0, 0, 0, 105.0, 649, 47990, 70, 1.3106887
71, 0, 0, 0, 0, 110.0, 728, 48718, 71, 1.4730577999999923
72, 0, 0, 0, 0, 55.0, 462, 49180, 72, 0.9517927999999927
73, 0, 0, 0, 0, 185.0, 1022, 50202, 73, 2.013871100000003
74, 0, 0, 0, 0, 200.0, 1078, 51280, 74, 2.1182515999999936
75, 0, 0, 0, 0, 55.0, 418, 51698, 75, 0.8601481999999976
76, 0, 0, 0, 0, 120.0, 693, 52391, 76, 1.3831929999999915
77, 0, 0, 0, 0, 70.0, 673, 53064, 77, 1.3684176000000008
78, 0, 0, 0, 0, 175.0, 764, 53828, 78, 1.5373273999999952
79, 0, 0, 0, 0, 110.0, 733, 54561, 79, 1.4656930000000017
80, 0, 0, 0, 0, 110.0, 949, 55510, 80, 1.908495400000021
81, 0, 0, 0, 0, 155.0, 441, 55951, 81, 0.9112551000000053
82, 0, 0, 0, 0, 75.0, 564, 56515, 82, 1.1581713000000207
83, 0, 0, 0, 0, 110.0, 507, 57022, 83, 1.0278286999999864
84, 0, 0, 0, 0, 180.0, 907, 57929, 84, 1.8396248999999898
85, 0, 0, 0, 0, 90.0, 459, 58388, 85, 0.921942300000012
86, 0, 0, 0, 0, 145.0, 643, 59031, 86, 1.2997097000000224
87, 0, 0, 0, 0, 45.0, 542, 59573, 87, 1.101880499999993
88, 0, 0, 0, 0, 180.0, 753, 60326, 88, 1.5309837000000073
89, 0, 0, 0, 0, 50.0, 539, 60865, 89, 1.105657199999996
90, 0, 0, 0, 0, 50.0, 417, 61282, 90, 0.8439472999999964
91, 0, 0, 0, 0, 80.0, 445, 61727, 91, 0.8998978999999849
92, 0, 0, 0, 0, 95.0, 711, 62438, 92, 1.4267233000000203
93, 0, 0, 0, 0, 105.0, 625, 63063, 93, 1.2899086999999838
94, 0, 0, 0, 0, 135.0, 767, 63830, 94, 1.6204530999999918
95, 0, 0, 0, 0, 390.0, 1104, 64934, 95, 2.1584584000000007
96, 0, 0, 0, 0, 180.0, 807, 65741, 96, 1.6562707999999873
97, 0, 0, 0, 0, 65.0, 793, 66534, 97, 1.6039611999999863
98, 0, 0, 0, 0, 280.0, 965, 67499, 98, 1.9216536000000133
99, 0, 0, 0, 0, 85.0, 623, 68122, 99, 1.2741305000000125
100, 0, 0, 0, 0, 225.0, 921, 69043, 100, 1.8359164999999962
101, 0, 0, 0, 0, 110.0, 667, 69710, 101, 1.354162300000013
102, 0, 0, 0, 0, 155.0, 783, 70493, 102, 1.580902000000009
103, 0, 0, 0, 0, 75.0, 405, 70898, 103, 0.8349161000000151
104, 0, 0, 0, 0, 155.0, 770, 71668, 104, 1.5315258999999912
105, 0, 0, 0, 0, 50.0, 458, 72126, 105, 0.9425351000000148
106, 0, 0, 0, 0, 215.0, 1236, 73362, 106, 2.51087050000001
107, 0, 0, 0, 0, 120.0, 760, 74122, 107, 1.530802499999993
108, 0, 0, 0, 0, 135.0, 674, 74796, 108, 1.3856639999999913
109, 0, 0, 0, 0, 180.0, 767, 75563, 109, 1.5605113999999958
110, 0, 0, 0, 0, 240.0, 937, 76500, 110, 1.8737124999999821
111, 0, 0, 0, 0, 210.0, 812, 77312, 111, 1.628854700000005
112, 0, 0, 0, 0, 160.0, 761, 78073, 112, 1.5274536000000012
113, 0, 0, 0, 0, 155.0, 615, 78688, 113, 1.2466636999999992
114, 0, 0, 0, 0, 180.0, 663, 79351, 114, 1.3360939000000087
115, 0, 0, 0, 0, 230.0, 1090, 80441, 115, 2.1509240000000034
116, 0, 0, 0, 0, 50.0, 475, 80916, 116, 0.9862817000000064
117, 0, 0, 0, 0, 135.0, 705, 81621, 117, 1.40737519999999
118, 0, 0, 0, 0, 155.0, 790, 82411, 118, 1.5864272999999969
119, 0, 0, 0, 0, 130.0, 656, 83067, 119, 1.3241662999999733
120, 0, 0, 0, 0, 90.0, 629, 83696, 120, 1.2645201999999927
121, 0, 0, 0, 0, 210.0, 781, 84477, 121, 1.624980899999997
122, 0, 0, 0, 0, 135.0, 731, 85208, 122, 1.4803315000000055
123, 0, 0, 0, 0, 200.0, 1027, 86235, 123, 2.0473408999999947
124, 0, 0, 0, 0, 55.0, 594, 86829, 124, 1.2017036000000019
125, 0, 0, 0, 0, 285.0, 929, 87758, 125, 1.8617498000000126
126, 0, 0, 0, 0, 105.0, 388, 88146, 126, 0.8163817999999878
127, 0, 0, 0, 0, 240.0, 957, 89103, 127, 1.9049176000000045
128, 0, 0, 0, 0, 210.0, 828, 89931, 128, 1.6801311999999768
129, 0, 0, 0, 0, 130.0, 746, 90677, 129, 1.5274785000000008
130, 0, 0, 0, 0, 155.0, 790, 91467, 130, 1.6044397000000004
131, 0, 0, 0, 0, 75.0, 438, 91905, 131, 0.908043599999985
132, 0, 0, 0, 0, 335.0, 711, 92616, 132, 1.4364704999999844
133, 0, 0, 0, 0, 15.0, 448, 93064, 133, 0.930552199999994
134, 0, 0, 0, 0, 190.0, 965, 94029, 134, 1.9209926999999993
135, 0, 0, 0, 0, 180.0, 744, 94773, 135, 1.4850610999999958
136, 0, 0, 0, 0, 75.0, 389, 95162, 136, 0.8011482000000001
137, 0, 0, 0, 0, 110.0, 523, 95685, 137, 1.0591981999999973
138, 0, 0, 0, 0, 205.0, 972, 96657, 138, 1.9436887999999897
139, 0, 0, 0, 0, 155.0, 791, 97448, 139, 1.5975932999999998
140, 0, 0, 0, 0, 285.0, 929, 98377, 140, 1.8599221000000057
141, 0, 0, 0, 0, 415.0, 810, 99187, 141, 1.6551680999999974
142, 0, 0, 0, 0, 110.0, 556, 99743, 142, 1.1194427000000076
143, 25.23853655937297, 14.528243652037407, 19.530080450652434, 0.9095288499999992, 285.0, 1304, 101047, 143, 10.15600169999999
144, 16.3450266425674, 14.836473210652668, 18.514882101454177, 0.9088084000000001, 90.0, 555, 101602, 144, 4.942909300000025
145, 14.831758728824804, 14.685531089669103, 18.082352896053493, 0.9081658000000001, 235.0, 873, 102475, 145, 7.912796400000019
146, 15.951085171449497, 14.782225174850293, 18.292182345515332, 0.9075326500000003, 150.0, 534, 103009, 146, 4.934734399999996
147, 13.75358809840983, 14.73734957302039, 18.008269180193533, 0.9065682999999997, 320.0, 1609, 104618, 147, 14.729656000000006
148, 12.505981090996, 14.651901697670972, 18.009669833713108, 0.9054554500000003, 225.0, 864, 105482, 148, 7.964780000000019
149, 12.069065394709186, 14.661909143386348, 17.880159211927843, 0.9047876500000002, 110.0, 620, 106102, 149, 5.780104600000016
150, 12.693298888367575, 14.63893222325557, 17.95868689466167, 0.9042422499999998, 155.0, 592, 106694, 150, 5.482450500000027
151, 13.063944979479713, 14.656400361722403, 17.89568602847357, 0.9036675999999999, 105.0, 685, 107379, 151, 6.394968100000028
152, 13.009187029108574, 14.678969272599094, 18.005289665837907, 0.9030025000000006, 155.0, 793, 108172, 152, 7.392421500000012
153, 12.029234377632427, 14.716794499743743, 17.954215589980507, 0.9021650500000004, 115.0, 1068, 109240, 153, 9.972192600000028
154, 13.729940191805362, 14.697819688320159, 17.990194054841997, 0.9013244499999995, 155.0, 800, 110040, 154, 7.471479400000021
155, 8.468517419337442, 15.312984728931006, 18.44394678574614, 0.90041815, 260.0, 1214, 111254, 155, 11.289539999999988
156, 7.514032376293417, 15.318347376116774, 18.46479530901413, 0.8996598999999998, 35.0, 471, 111725, 156, 4.456311599999992
157, 8.529002250565423, 15.274457016697637, 18.386265643437703, 0.8992049500000001, 100.0, 540, 112265, 157, 5.078564299999982
158, 6.043758178743067, 15.259633518470192, 18.366681110621595, 0.8986680999999999, 230.0, 653, 112918, 158, 6.176449400000024
159, 6.5945645484371465, 15.235810929450436, 18.326376364097833, 0.8981569, 80.0, 483, 113401, 159, 4.563638400000002
160, 6.591565145596835, 15.220515133422097, 18.30530928051661, 0.8976844000000002, 120.0, 567, 113968, 160, 5.388506000000007
161, 7.779026055841574, 15.317414797842503, 18.436060248741082, 0.8970260500000004, 155.0, 896, 114864, 161, 8.330886700000008
162, 5.469922229920551, 15.258926945291597, 18.385546811771043, 0.8963771500000002, 135.0, 546, 115410, 162, 5.242580299999986
163, 7.494534115728117, 15.279414521050207, 18.366616400773466, 0.8958258999999998, 180.0, 679, 116089, 163, 6.481204400000024
164, 5.161622627104368, 15.185590503388301, 18.30804548281243, 0.8952778000000002, 110.0, 539, 116628, 164, 5.199184699999989
165, 6.469989190282086, 15.238028935816958, 18.39511209318558, 0.8947261000000002, 135.0, 687, 117315, 165, 6.554882399999997
166, 5.090446104089935, 15.23169572012765, 18.337364228979332, 0.8940704499999999, 215.0, 770, 118085, 166, 7.3518730999999775
167, 6.365046565916579, 15.279729671801551, 18.464314598148153, 0.8934584499999999, 105.0, 590, 118675, 167, 5.665951799999959
168, 5.8499942673996035, 15.204239806324754, 18.28936401311902, 0.8928513999999994, 90.0, 759, 119434, 168, 7.268522399999995
169, 8.426756224882455, 15.356164495150248, 18.48546044178951, 0.89221825, 120.0, 648, 120082, 169, 6.269611300000008
170, 7.210498436492041, 16.046036829214476, 19.330601395849797, 0.8914618000000005, 170.0, 1033, 121115, 170, 9.93625579999997
171, 5.483381321705995, 16.00855044678904, 19.28335029633383, 0.8903395000000002, 470.0, 1461, 122576, 171, 14.10780920000002
172, 5.3308962418482855, 16.005239505767822, 19.277545258448676, 0.8893895499999999, 120.0, 650, 123226, 172, 6.330273199999965
173, 6.979910289087603, 16.0920917956155, 19.484898882075097, 0.8888598999999999, 30.0, 527, 123753, 173, 5.131656899999996
174, 6.381793355350227, 16.02835706548269, 19.31831803059501, 0.8882056000000003, 385.0, 927, 124680, 174, 9.040382899999997
175, 4.397479110328775, 15.954799063163891, 19.20530503088968, 0.88753195, 155.0, 570, 125250, 175, 5.5563649000000055
176, 5.093685866306301, 16.01106891032805, 19.318104130216952, 0.8868600999999993, 155.0, 923, 126173, 176, 9.027051500000027
177, 5.707505457189552, 15.977655742159222, 19.27926021561199, 0.8860951000000006, 135.0, 777, 126950, 177, 7.608973500000047
178, 4.16434230377127, 15.93949712980133, 19.178786062116, 0.8854768000000004, 120.0, 597, 127547, 178, 5.888620000000003
179, 5.524468339107316, 15.989354329466133, 19.259455995687826, 0.8849737000000003, 110.0, 521, 128068, 179, 5.124976200000049
180, 4.845327250189164, 15.95480504146842, 19.228313397727536, 0.8841974499999994, 290.0, 1204, 129272, 180, 11.854436299999975
181, 5.570384602546692, 16.01283389215884, 19.26202532229216, 0.8833969, 60.0, 575, 129847, 181, 5.737953100000027
182, 6.288108580387556, 15.9110153341468, 19.222903758178262, 0.8828924499999996, 120.0, 546, 130393, 182, 5.43218619999999
183, 4.967355428078291, 15.88016569679081, 19.138743119472622, 0.8821490500000002, 320.0, 1106, 131499, 183, 10.857825700000035
184, 3.7435251481503062, 15.873077092680541, 19.174119687830128, 0.8812935999999991, 155.0, 795, 132294, 184, 7.942893900000058
185, 5.233966153417879, 15.869578903457171, 19.178817747518032, 0.8803657000000007, 430.0, 1267, 133561, 185, 12.519313799999964
186, 3.459273184392903, 15.840745078765595, 19.11335419835271, 0.87929605, 390.0, 1110, 134671, 186, 11.041276799999991
187, 4.733975654980267, 15.840039751422939, 19.154675070919208, 0.8785854999999998, 30.0, 469, 135140, 187, 4.709845599999994
188, 4.5875934368629565, 15.832377503419242, 19.139260665848074, 0.8780724999999999, 130.0, 671, 135811, 188, 6.706612500000006
189, 5.803322179009252, 15.85751383567491, 19.160520785661706, 0.8775338499999998, 155.0, 526, 136337, 189, 5.278984400000013
190, 3.5629531713289637, 15.842662965025857, 19.113116955088678, 0.87710455, 80.0, 428, 136765, 190, 4.2839771000000155
191, 6.363576412066441, 15.91298271860887, 19.220389700108058, 0.87641335, 245.0, 1108, 137873, 191, 11.098063400000001
192, 5.53931849211412, 15.953326390783275, 19.25597112175411, 0.8755983999999999, 155.0, 703, 138576, 192, 7.104491400000029
193, 4.501212972081054, 15.970068609730996, 19.292251979991445, 0.8749567000000003, 370.0, 723, 139299, 193, 7.300131999999962
194, 5.875221470264885, 15.973059190967218, 19.310305607028123, 0.8744099499999997, 115.0, 492, 139791, 194, 5.031459500000096
195, 3.8945624509542798, 16.170589702058145, 19.524383637169176, 0.8738722000000003, 75.0, 703, 140494, 195, 7.0662395000000515
196, 3.9797396761971875, 16.236435209501774, 19.59977630125273, 0.8730653499999994, 240.0, 1090, 141584, 196, 11.077403000000004
197, 5.888281012901716, 16.28200682093588, 19.671403450146915, 0.8722945000000001, 105.0, 623, 142207, 197, 6.350156900000002
198, 3.672958828497582, 16.224441320560704, 19.564291548620734, 0.8717166999999998, 55.0, 661, 142868, 198, 6.744835400000056
199, 2.7055687303264295, 16.20955477068501, 19.540313425371725, 0.8711402500000003, 110.0, 620, 143488, 199, 6.354286600000023
200, 3.48095019755401, 16.253706283268965, 19.630287374661663, 0.8705755000000001, 150.0, 635, 144123, 200, 6.476644599999986
201, 3.720902381775793, 16.277715489095893, 19.615105523353765, 0.8700174999999998, 110.0, 605, 144728, 201, 6.2181576000000405
202, 2.6971890195801453, 16.255977591952764, 19.57938324696309, 0.8695787500000004, 60.0, 370, 145098, 202, 3.8250633999999764
203, 3.7777596018461965, 16.235804733572024, 19.624091777549122, 0.8689361500000005, 320.0, 1058, 146156, 203, 10.827720900000031
204, 3.7219068537847995, 16.250414325093892, 19.613775109616153, 0.8677432000000003, 755.0, 1593, 147749, 204, 16.308633600000007
205, 4.924899652167953, 16.23285081815443, 19.62106234699891, 0.8667937000000001, 35.0, 517, 148266, 205, 5.352278800000022
206, 7.11554594510621, 16.3259931834904, 19.705605664096037, 0.8661106000000004, 195.0, 1001, 149267, 206, 10.398758300000054
207, 6.1506111750384225, 16.202875021654318, 19.581726608893298, 0.8654932, 60.0, 371, 149638, 207, 3.868302999999969
208, 4.493362517442583, 16.055089375589013, 19.366712824335828, 0.86498515, 185.0, 758, 150396, 208, 7.907088300000055
209, 4.239120274081865, 15.938018176325308, 19.298413657644087, 0.8644717, 55.0, 383, 150779, 209, 4.016443699999968
210, 3.411482822272804, 15.90505287224307, 19.193257237528705, 0.8640126999999999, 130.0, 637, 151416, 210, 6.637114499999939
211, 6.4243419688256065, 16.013343295112985, 19.39624975939266, 0.8635064499999999, 125.0, 488, 151904, 211, 5.101765499999942
212, 3.2676755626889866, 15.915426584334323, 19.244511360413814, 0.8629930000000002, 155.0, 653, 152557, 212, 6.839570800000047
213, 3.1008258966345283, 15.871421258054188, 19.177923411460377, 0.8622513999999999, 260.0, 995, 153552, 213, 10.450259500000016
214, 6.215757828816527, 15.92648974403006, 19.253051646420214, 0.8615840499999999, 60.0, 488, 154040, 214, 5.114480200000003
215, 3.3734017562359884, 15.912986502384465, 19.233616574510556, 0.8610625000000001, 210.0, 671, 154711, 215, 7.0049320000000534
216, 4.520063040202729, 15.892880083953203, 19.259283590754237, 0.8604662499999999, 190.0, 654, 155365, 216, 6.875112599999966
217, 3.845482045821952, 15.9108989395863, 19.2190927680379, 0.8598578500000003, 155.0, 698, 156063, 217, 7.38117509999995
218, 2.4006518961426084, 15.843502076291248, 19.13440867682188, 0.8592993999999999, 85.0, 543, 156606, 218, 5.753712299999961
219, 4.361241001507822, 15.871765300517774, 19.20542947117609, 0.8585834499999992, 255.0, 1048, 157654, 219, 11.057885699999929
220, 2.518129708221066, 15.871233783716388, 19.13603048781352, 0.8578018000000001, 85.0, 689, 158343, 220, 7.32379549999996
221, 3.8339047744964274, 15.857832420879024, 19.182854236160193, 0.8569216000000004, 195.0, 1267, 159610, 221, 13.44202580000001
222, 5.589871667371889, 16.03302244825351, 19.405360995015943, 0.8559900999999993, 135.0, 803, 160413, 222, 8.544034900000042
223, 3.1240819485150007, 16.18933935026857, 19.52277410521057, 0.8552570500000005, 105.0, 826, 161239, 223, 8.869747899999993
224, 3.172590485893381, 16.17418690216847, 19.536677464460716, 0.85460455, 110.0, 624, 161863, 224, 6.667082700000037
225, 5.014897666031814, 16.218403696091794, 19.624039697383648, 0.8539165000000001, 185.0, 905, 162768, 225, 9.704780099999994
226, 3.4303462726407146, 16.169725640823966, 19.57774442434311, 0.8532356499999998, 25.0, 608, 163376, 226, 6.534226399999966
227, 4.733926657532506, 16.211350984433118, 19.56188982374528, 0.8527172500000001, 95.0, 544, 163920, 227, 5.8702088
228, 6.035428078426664, 16.205570852528936, 19.669950899748724, 0.8521660000000001, 80.0, 681, 164601, 228, 7.325753500000019
229, 3.315329294285991, 16.199061709317295, 19.54567952589555, 0.8516120500000004, 20.0, 550, 165151, 229, 5.936868699999991
230, 7.354619233882779, 16.236160174966447, 19.659862034426535, 0.8511818500000001, 105.0, 406, 165557, 230, 4.392518099999961
231, 5.491327817326549, 16.264916706248787, 19.737884861731814, 0.8507367999999996, 55.0, 583, 166140, 231, 6.326995399999987
232, 2.237462946499486, 16.14046557301069, 19.484754543380433, 0.8502485500000003, 90.0, 502, 166642, 232, 5.429040299999997
233, 2.0125967211762332, 16.17199823266402, 19.479673763969437, 0.8498026000000002, 120.0, 489, 167131, 233, 5.366158599999949
234, 3.8639682595389915, 16.203156775100485, 19.586217019771794, 0.8492464, 75.0, 747, 167878, 234, 8.118424000000005
235, 4.203347290499112, 16.235337165137953, 19.61264108085361, 0.8485939000000001, 180.0, 703, 168581, 235, 7.669552199999998
236, 4.2682974486421035, 16.1926218386156, 19.55765284113137, 0.8479787499999997, 205.0, 664, 169245, 236, 7.248153300000013
237, 3.2884152449769517, 16.202361603305764, 19.582073088868025, 0.84735145, 140.0, 730, 169975, 237, 7.959149900000057
238, 4.714739020849132, 16.612092804967915, 20.093674574537253, 0.8466602500000004, 105.0, 806, 170781, 238, 8.807509600000003
239, 3.9667525042227423, 16.542371678884805, 20.066432659442608, 0.8461162000000002, 80.0, 403, 171184, 239, 4.435107500000072
240, 5.495111989931226, 16.528668076118116, 20.007951200220507, 0.84542905, 265.0, 1124, 172308, 240, 12.306436800000029
241, 4.585944121782209, 16.571090673057125, 20.04827445661518, 0.8446676500000002, 65.0, 568, 172876, 241, 6.272781900000041
242, 4.244741268774243, 16.58361191451876, 20.022511092621553, 0.8440012000000008, 205.0, 913, 173789, 242, 10.086441299999933
243, 4.2770511745719535, 16.627264188090265, 20.046983630933898, 0.8433073000000003, 155.0, 629, 174418, 243, 6.995646800000031
244, 3.600840689585641, 16.543429749878747, 19.966563412384442, 0.8425873, 310.0, 971, 175389, 244, 10.671340299999997
245, 3.6876452819511876, 16.451655118825048, 19.81213876521787, 0.8419892499999999, 70.0, 358, 175747, 245, 4.0185637000000725
246, 2.153838600963354, 16.552913804523282, 19.991771783985076, 0.8416085500000002, 80.0, 488, 176235, 246, 5.454203099999972
247, 2.9064857375188544, 16.47684612673285, 19.877014029918787, 0.8409803500000005, 215.0, 908, 177143, 247, 10.067056799999932
248, 6.780407021831692, 16.556844276326302, 20.072755620679782, 0.8403359500000003, 110.0, 524, 177667, 248, 5.8739570000000185
249, 3.022986323175848, 16.55160274669806, 19.999477597186008, 0.8397865000000002, 190.0, 697, 178364, 249, 7.826030299999957
250, 4.546254815530616, 16.553594085860613, 20.045851438885798, 0.8392059999999996, 130.0, 593, 178957, 250, 6.62260619999995
251, 6.863477944228932, 16.576961736884908, 20.04199083588964, 0.83868895, 60.0, 556, 179513, 251, 6.242804100000058
252, 2.3930738018594395, 16.719954458370164, 20.176509525652126, 0.8380400500000004, 290.0, 886, 180399, 252, 9.862665500000048
253, 2.108752215306471, 16.9712152513517, 20.43683468890028, 0.8373767500000002, 120.0, 588, 180987, 253, 6.58212380000009
254, 3.3560938905852407, 16.92755303300241, 20.44580556809234, 0.8366706999999997, 165.0, 981, 181968, 254, 10.997341099999858
255, 2.6913570335699535, 16.877926577919958, 20.37304148523569, 0.8359012, 90.0, 729, 182697, 255, 8.201737299999877
256, 5.4458955609004756, 17.01404918690838, 20.629754909131893, 0.8353179999999998, 110.0, 567, 183264, 256, 6.4104661000001215
257, 7.473182186697211, 16.926051280262705, 20.552938444535812, 0.8348581000000004, 65.0, 455, 183719, 257, 5.177377000000206
258, 5.575382845113015, 16.988124096541977, 20.55785269361314, 0.83421955, 540.0, 964, 184683, 258, 10.822881999999936
259, 4.779799341542368, 16.917468798542952, 20.434703930651292, 0.8334630999999998, 150.0, 717, 185400, 259, 8.098952499999996
260, 4.2776187616640025, 16.964638846565947, 20.52490956564611, 0.8327381500000007, 215.0, 894, 186294, 260, 10.158043899999939
261, 5.220876049192338, 16.937866931392396, 20.44101559410214, 0.8320469500000002, 70.0, 642, 186936, 261, 7.283374999999978
262, 1.8846251587846026, 16.9018972295799, 20.34575045503528, 0.8314183, 140.0, 755, 187691, 262, 8.618980899999997
263, 1.7622446942885843, 16.902456008935278, 20.377794875374324, 0.8307941499999995, 125.0, 632, 188323, 263, 7.206290699999954
264, 3.48586174509861, 16.908728179890797, 20.4003971945295, 0.8300894500000003, 305.0, 934, 189257, 264, 10.636924299999919
265, 3.676953440413196, 16.91276209405128, 20.431804286672715, 0.8294999499999998, 50.0, 376, 189633, 265, 4.363953200000196
266, 4.43854944456166, 17.115520798466665, 20.7191385372942, 0.8288510500000003, 345.0, 1066, 190699, 266, 12.186914200000047
267, 3.7440625378309584, 17.09803145701491, 20.647406941010882, 0.8281998999999995, 15.0, 381, 191080, 267, 4.3891247000001385
268, 3.0448202199788175, 17.161663883567876, 20.694353843754172, 0.8277652000000003, 135.0, 585, 191665, 268, 6.673469599999862
269, 2.2746648746398614, 17.12097107503832, 20.661731149732454, 0.82732735, 85.0, 388, 192053, 269, 4.516450700000178
270, 3.251467487394444, 17.175002616405976, 20.771335941498208, 0.8267131000000002, 265.0, 977, 193030, 270, 11.203842899999927
271, 4.793201097650973, 17.21771917425, 20.779480418422192, 0.82606375, 60.0, 466, 193496, 271, 5.386648700000023
272, 3.3643870754392897, 17.224683933861872, 20.8633678798569, 0.8256123999999999, 55.0, 537, 194033, 272, 6.243259200000011
273, 2.042807523114928, 17.213796277539483, 20.750669534617458, 0.8250444999999998, 460.0, 725, 194758, 273, 8.39203879999991
274, 3.8253136922370667, 17.144619566605108, 20.7426452703702, 0.8242057000000009, 195.0, 1139, 195897, 274, 13.163150000000087
275, 1.914558958964514, 17.168685246686465, 20.711790448329488, 0.8234735500000003, 80.0, 488, 196385, 275, 5.697174799999857
276, 2.2313952824848444, 17.192195722035, 20.72410841053035, 0.82298935, 65.0, 588, 196973, 276, 6.8398901999999
277, 4.176535217175021, 17.21356995900472, 20.802843005229267, 0.822163149999999, 285.0, 1248, 198221, 277, 14.472968300000048
278, 2.743929152403559, 17.16663420132228, 20.702555394853864, 0.82128655, 350.0, 700, 198921, 278, 8.225245600000108
279, 3.703006880331125, 17.22515367434926, 20.781466173783443, 0.8207834500000004, 35.0, 418, 199339, 279, 4.9436152000000675
280, 3.174462280802135, 17.028513459031092, 20.550660651180934, 0.8201503, 220.0, 989, 200328, 280, 11.702564400000028
281, 3.0235279190148843, 16.784728570173016, 20.212670601020424, 0.8193866499999998, 140.0, 708, 201036, 281, 8.362454200000002
282, 3.355422972178317, 16.78547541173806, 20.27701800372971, 0.8188421500000003, 80.0, 502, 201538, 282, 5.96083550000003
283, 3.08532671808898, 16.85934429727093, 20.338045325962533, 0.8183241999999997, 145.0, 649, 202187, 283, 7.6330648000000565
284, 1.781750426680914, 16.755958674635206, 20.19711275441306, 0.8177801500000003, 105.0, 560, 202747, 284, 6.6370792000000165
285, 2.7973796811493026, 16.80369500870745, 20.299903529223908, 0.8172104499999999, 155.0, 706, 203453, 285, 8.433089599999903
286, 2.9636219526888805, 16.783208708674945, 20.250307441266468, 0.8165763999999998, 165.0, 703, 204156, 286, 8.357166900000038
287, 2.0891900360890867, 16.82107333881865, 20.280814567220556, 0.8158226500000008, 485.0, 972, 205128, 287, 11.54543990000002
288, 1.9501884846957689, 16.8161186852406, 20.251278115302018, 0.8152106500000001, 35.0, 388, 205516, 288, 4.659128100000089
289, 2.7659384208389475, 16.849263046361223, 20.31839937701004, 0.81460945, 500.0, 948, 206464, 289, 11.305154700000003
290, 1.9204398156832094, 16.790930036876514, 20.278621802122696, 0.8139758499999998, 65.0, 460, 206924, 290, 5.532932099999925
291, 3.77858110138717, 16.840536355622188, 20.33185540421944, 0.8134624000000001, 90.0, 681, 207605, 291, 8.168805600000042
292, 5.506117142650707, 16.819681559318354, 20.369672639704934, 0.8126114500000006, 330.0, 1210, 208815, 292, 14.412657300000092
293, 2.0759935710495547, 16.86066598250087, 20.317096087106147, 0.8118865000000004, 105.0, 401, 209216, 293, 4.844272900000078
294, 3.532099838842767, 16.76669402159848, 20.26151888177538, 0.8115336999999999, 80.0, 383, 209599, 294, 4.63062930000001
295, 5.749855559406706, 17.081658307375484, 20.693230503601647, 0.8109779499999993, 165.0, 852, 210451, 295, 10.384286700000075
296, 5.06631915486127, 17.192351477486746, 20.821164206852988, 0.8104244500000001, 80.0, 378, 210829, 296, 4.5671440000000985
297, 1.677660351363121, 17.14454433326661, 20.639086471726355, 0.8099694999999997, 125.0, 633, 211462, 297, 7.6708979
298, 3.5330867583144565, 17.193625174403508, 20.75740019396066, 0.8095150000000002, 45.0, 377, 211839, 298, 4.593215600000121
299, 5.0825162915467414, 17.221997272295418, 20.856470803804726, 0.8088111999999998, 255.0, 1187, 213026, 299, 14.358677400000033
300, 2.5239573341433528, 17.16977494214032, 20.70029184839747, 0.8077775499999997, 430.0, 1110, 214136, 300, 13.526743399999987
301, 4.790095435536799, 17.253348326409, 20.86484623832264, 0.80688655, 225.0, 870, 215006, 301, 10.650593800000024
302, 4.05835474561013, 17.20169777870178, 20.763625265303112, 0.8061170500000001, 165.0, 840, 215846, 302, 10.267898999999943
303, 5.202399279732825, 17.28128258117848, 20.957131128975675, 0.8055000999999996, 195.0, 531, 216377, 303, 6.504780200000141
304, 6.828566815765513, 17.2842110146533, 20.944256866371237, 0.8050973499999999, 80.0, 364, 216741, 304, 4.4984143000001495
305, 1.8989693434130697, 17.190797711761906, 20.673229821970764, 0.8047418500000001, 65.0, 426, 217167, 305, 5.2784897000001365
306, 3.167711398591153, 17.227434413587275, 20.77441854334589, 0.8040979000000001, 255.0, 1005, 218172, 306, 12.351847600000156
307, 6.84512349764302, 17.33218109044696, 21.02971270441764, 0.8034265000000003, 90.0, 487, 218659, 307, 6.023963199999798
308, 3.897415746098781, 17.260713841394594, 20.846903917924415, 0.8025395499999993, 425.0, 1484, 220143, 308, 18.156768300000067
309, 3.2742417849862395, 17.383560623475656, 20.97016047952163, 0.8014240000000004, 505.0, 995, 221138, 309, 12.35400259999983
310, 4.4041796926165295, 17.339171757207854, 21.00092212284837, 0.8006392000000002, 180.0, 749, 221887, 310, 9.261873499999865
311, 5.726202353483951, 17.35542995617038, 21.000776537129138, 0.8000825499999996, 35.0, 488, 222375, 311, 6.099480699999958
312, 1.8465679375720876, 17.287413499793228, 20.818611205840597, 0.79951015, 210.0, 784, 223159, 312, 9.797618200000215
313, 4.521540454650919, 17.35231821537018, 21.015608835220338, 0.79894135, 100.0, 480, 223639, 313, 6.116597699999829
314, 5.1512274731189835, 17.355254937968123, 21.072152209500654, 0.7984800999999996, 180.0, 545, 224184, 314, 6.916271299999835
315, 3.310352471385276, 17.303631881397497, 20.8911332764694, 0.79767055, 300.0, 1254, 225438, 315, 15.643408200000067
316, 4.307679690205965, 17.311376220181067, 20.931858152043777, 0.7967313999999998, 275.0, 833, 226271, 316, 10.478778599999941
317, 3.430938106591827, 17.416233180156304, 20.989606617683144, 0.7961774500000001, 65.0, 398, 226669, 317, 5.057082899999841
318, 3.337513188686025, 17.337216112153264, 20.93418570843423, 0.7956324999999999, 190.0, 813, 227482, 318, 10.31770030000007
319, 1.9254292543909766, 17.32113739013672, 20.887281920693137, 0.7950191500000002, 130.0, 550, 228032, 319, 6.951700399999936
320, 1.885229122241338, 17.32342039178919, 20.882159830729165, 0.7944678999999997, 155.0, 675, 228707, 320, 8.523766300000034
321, 5.1606530925556395, 17.44721638174618, 21.089945926185415, 0.7938964000000003, 55.0, 595, 229302, 321, 7.581091900000047
322, 3.9958083670893796, 17.524216582409693, 21.17333491489946, 0.7932088000000005, 160.0, 933, 230235, 322, 11.899279400000069
323, 4.577825689773342, 17.95174498445925, 21.689318798059908, 0.7924636000000004, 160.0, 723, 230958, 323, 9.162437200000113
324, 5.653620958416944, 17.95339948601193, 21.68069971932305, 0.79191145, 80.0, 504, 231462, 324, 6.4798324000000775
325, 5.088802227643148, 17.915746703821952, 21.729139752412966, 0.7915127499999999, 25.0, 382, 231844, 325, 4.867105400000128
326, 6.176768085587203, 17.92329115166034, 21.771180740318393, 0.7911604000000002, 50.0, 401, 232245, 326, 5.139553299999989
327, 2.6265550944199814, 17.902053460153834, 21.648022051540863, 0.7906910500000002, 135.0, 642, 232887, 327, 8.212172999999893
328, 1.8803403217897896, 17.95113149976549, 21.609916868318624, 0.7901654499999996, 80.0, 526, 233413, 328, 6.789167100000213
329, 5.148044654818839, 17.979294273951282, 21.80699548002792, 0.7896659500000003, 135.0, 584, 233997, 329, 7.611718799999835
330, 4.180511836147207, 17.873846970256576, 21.548324907743012, 0.7891398999999999, 125.0, 585, 234582, 330, 7.603137199999992
331, 3.3599757097641025, 17.847825882199047, 21.516275911540774, 0.7885490499999995, 180.0, 728, 235310, 331, 9.314481600000136
332, 2.926802944914203, 17.891297261068754, 21.597759241478464, 0.7877399500000009, 335.0, 1070, 236380, 332, 20.39693340000008
333, 4.2945913565012495, 17.959215849637985, 21.751204868157703, 0.7869560500000004, 240.0, 672, 237052, 333, 8.626823800000011
334, 1.9941708772667568, 17.89329937252685, 21.552417281770357, 0.78640705, 60.0, 548, 237600, 334, 6.78369859999998
335, 5.414643085728127, 17.935582768327837, 21.715846079837235, 0.7859237499999996, 155.0, 526, 238126, 335, 6.853870600000164
336, 2.086595251575154, 17.996043454969826, 21.673826185773674, 0.7855255, 75.0, 359, 238485, 336, 4.713616000000002
337, 1.743636435604301, 17.902669766305507, 21.57394275446048, 0.7849724500000007, 250.0, 870, 239355, 337, 11.18245109999998
338, 4.622681654788824, 17.869143786771357, 21.623667879093436, 0.7841971000000004, 250.0, 853, 240208, 338, 11.076901700000008
339, 3.716806829286839, 17.991703287170363, 21.770027619411294, 0.7832313999999996, 410.0, 1293, 241501, 339, 16.735647900000004
340, 2.9855354712831934, 17.992127450416262, 21.708890998343048, 0.7821248500000006, 260.0, 1166, 242667, 340, 15.230449299999918
341, 1.7770777261797213, 17.95419465135408, 21.609582337757086, 0.7812649000000005, 135.0, 745, 243412, 341, 9.75228960000004
342, 1.6911470503371546, 17.932189084573036, 21.642976129291863, 0.7807258000000001, 80.0, 453, 243865, 342, 6.014004799999839
343, 3.248720802501049, 17.9929419352672, 21.74942931441209, 0.7800975999999992, 580.0, 943, 244808, 343, 12.317528699999912
344, 1.9712765571350852, 18.0378738588757, 21.731327210532296, 0.7795112500000003, 100.0, 360, 245168, 344, 4.777127800000017
345, 2.4590152662604017, 17.99679102577163, 21.71037428830646, 0.7789073500000003, 200.0, 982, 246150, 345, 13.00102169999991
346, 2.972813811914099, 17.94387023331235, 21.65028094968399, 0.7780006, 270.0, 1033, 247183, 346, 13.735720799999854
347, 1.897310728761885, 17.97155738124141, 21.6606930231165, 0.7772319999999999, 155.0, 675, 247858, 347, 9.042499099999986
348, 3.736886064331365, 17.93687637157726, 21.693318790683335, 0.7766578000000003, 135.0, 601, 248459, 348, 8.043316100000084
349, 1.8364690626500013, 17.957791437337427, 21.655770990583633, 0.7760957499999995, 155.0, 648, 249107, 349, 8.649428299999954
350, 2.3862484302005003, 18.027562968595042, 21.751484583325954, 0.7753699000000003, 350.0, 965, 250072, 350, 12.901038699999845
351, 4.564269924635249, 18.59349962673356, 22.4702185909305, 0.7747322499999997, 100.0, 452, 250524, 351, 6.086769100000083
352, 2.361087497896873, 18.57916776828277, 22.38711408957457, 0.7741778500000001, 125.0, 780, 251304, 352, 10.454128899999887
353, 4.4056512059162785, 18.638559288378584, 22.52836667496637, 0.7734871000000001, 155.0, 755, 252059, 353, 10.191230200000064
354, 5.9544471043247915, 18.619768648282857, 22.575728944007388, 0.7728935500000004, 135.0, 564, 252623, 354, 7.6000082000000475
355, 3.2887980868430455, 18.596422770056307, 22.399901379088654, 0.7722491499999999, 240.0, 868, 253491, 355, 11.639747599999964
356, 5.1205281505656055, 18.568930927851024, 22.462737038021995, 0.7715088999999998, 185.0, 777, 254268, 356, 10.431528200000002
357, 6.174702448981073, 18.66104130995901, 22.59128266192497, 0.7707574000000005, 415.0, 893, 255161, 357, 12.014503399999967
358, 4.262231599064581, 18.60230163179071, 22.442850230699516, 0.7701296500000004, 80.0, 502, 255663, 358, 6.820100400000001
359, 5.185019644520976, 18.64570673607491, 22.533313802770667, 0.7695707500000001, 140.0, 740, 256403, 359, 10.041103499999963
360, 4.240681460346255, 18.583528321193732, 22.429901964582587, 0.7688052999999994, 210.0, 961, 257364, 360, 13.040311700000075
361, 3.2199738371201923, 18.58113855961391, 22.422617316109793, 0.7679791000000005, 165.0, 875, 258239, 361, 11.913141300000007
362, 2.7628022564399957, 18.6055051559057, 22.44035507267357, 0.7673221000000005, 140.0, 585, 258824, 362, 8.014430000000175
363, 2.883866065556361, 18.60521161313721, 22.445981257025252, 0.7667713000000003, 205.0, 639, 259463, 363, 8.759950899999922
364, 3.8882926508284963, 18.63157409755431, 22.51879180087404, 0.7662285999999996, 105.0, 567, 260030, 364, 7.813605900000084
365, 3.5812444323435044, 18.686185508202282, 22.630115686318813, 0.7656926500000002, 90.0, 624, 260654, 365, 8.627135599999974
366, 4.9051120949106055, 18.6950675097689, 22.65742492334574, 0.7651602999999999, 125.0, 559, 261213, 366, 7.706119000000172
367, 5.268841434996593, 18.73872216084505, 22.604420316551423, 0.7644403000000003, 210.0, 1041, 262254, 367, 14.297563199999786
368, 1.7491936920760351, 18.649543172023336, 22.439922192057626, 0.76375225, 70.0, 488, 262742, 368, 6.775131899999906
369, 2.480981452326811, 18.65368195450351, 22.46573526505735, 0.7631775999999998, 135.0, 789, 263531, 369, 10.899913699999615
370, 4.194243057188312, 18.681216850933467, 22.54363305487107, 0.7625858500000001, 85.0, 526, 264057, 370, 7.290646699999797
371, 1.8434179322126043, 18.753738196087287, 22.564110607034547, 0.7621358499999997, 35.0, 474, 264531, 371, 6.579821100000117
372, 4.795292170912244, 18.70030748007084, 22.628156396436346, 0.7615508500000004, 165.0, 826, 265357, 372, 11.473254799999722
373, 6.2804486433305815, 18.720435475587518, 22.719353422136294, 0.7608492999999997, 235.0, 733, 266090, 373, 10.193280799999684
374, 1.924967321408231, 18.67675608348071, 22.50385006850328, 0.7602980500000003, 80.0, 492, 266582, 374, 6.879297100000258
375, 4.64263517605668, 18.703361565212035, 22.579173530722564, 0.7595996500000008, 285.0, 1060, 267642, 375, 14.75464090000014
376, 4.020031009091367, 18.686104484226394, 22.583130807308375, 0.7588432000000004, 135.0, 621, 268263, 376, 8.713564900000165
377, 3.6213835736497146, 18.688760083434097, 22.55770078089147, 0.7580772999999997, 390.0, 1081, 269344, 377, 15.11837800000012
378, 5.227798559251305, 18.705991358299777, 22.574513398784482, 0.7572623500000002, 110.0, 730, 270074, 378, 10.300281899999845
379, 5.262557619186002, 18.719559007144454, 22.633731002880907, 0.7564654000000003, 185.0, 1041, 271115, 379, 14.54768869999998
380, 2.6089573874963787, 18.68712284619158, 22.57990162210031, 0.7556801500000002, 160.0, 704, 271819, 380, 9.926222200000211
381, 4.119407334855494, 18.681950061982523, 22.534201076012533, 0.7550096499999995, 165.0, 786, 272605, 381, 11.12423600000011
382, 1.8809321238322059, 18.727962014029867, 22.53621688610111, 0.7543017999999998, 155.0, 787, 273392, 382, 11.116145599999982
383, 3.603657575346352, 18.671889124881652, 22.514642607598077, 0.7536452499999995, 110.0, 672, 274064, 383, 9.567413000000215
384, 2.816841637601902, 18.7411809473559, 22.610349373035493, 0.7530629500000003, 185.0, 622, 274686, 384, 8.834888500000034
385, 4.530492487071125, 18.743884259878204, 22.672226085219272, 0.75247345, 105.0, 688, 275374, 385, 9.778563000000304
386, 1.833246044234022, 18.754582521512912, 22.564444797069996, 0.7519906000000001, 45.0, 385, 275759, 386, 5.580420899999808
387, 3.6859557587951866, 18.71561293219954, 22.59318644356657, 0.7515140500000002, 135.0, 674, 276433, 387, 9.625868900000114
388, 4.803858108453307, 18.801058706115274, 22.866500452453014, 0.7510271499999999, 45.0, 408, 276841, 388, 5.829447500000242
389, 1.930522354771576, 18.72959086175501, 22.55370995184844, 0.7506153999999999, 75.0, 507, 277348, 389, 7.320462399999997
390, 4.208272748497091, 18.748904711083522, 22.665403818782373, 0.7501028500000001, 150.0, 632, 277980, 390, 9.142209999999977
391, 3.109004288108089, 18.687548665167057, 22.541811248631152, 0.7494012999999994, 210.0, 927, 278907, 391, 13.265876299999945
392, 4.05467185752471, 18.738966960954787, 22.611897793628817, 0.7486250499999999, 210.0, 798, 279705, 392, 11.43428270000004
393, 5.496985072039756, 18.99627805390455, 23.019791016556287, 0.7479783999999996, 65.0, 639, 280344, 393, 9.34856579999996
394, 4.459254443676587, 19.15733802293686, 23.18751765989809, 0.7474753000000002, 15.0, 479, 280823, 394, 6.92484259999992
395, 2.257872308014302, 19.099626160240746, 23.015622625837814, 0.74696005, 115.0, 666, 281489, 395, 9.68254909999996
396, 4.980143130672509, 19.17751663840861, 23.166508072532267, 0.7463673999999997, 125.0, 651, 282140, 396, 9.442114099999799
397, 2.2762177554097507, 19.148199240051873, 23.09442235738924, 0.7458472, 15.0, 505, 282645, 397, 7.442593199999919
398, 4.955734433426011, 19.097612170030445, 23.081930903245777, 0.74542465, 50.0, 434, 283079, 398, 6.288972100000137
399, 5.112057302876523, 19.104359313563297, 23.117237165350662, 0.7448018500000003, 245.0, 950, 284029, 399, 13.821105100000295
400, 2.620993324826601, 19.10396285801497, 23.026539738168193, 0.7439477499999999, 210.0, 948, 284977, 400, 13.82880090000026
401, 3.9650762452166584, 19.211461597513928, 23.182758444194853, 0.7432322500000004, 80.0, 642, 285619, 401, 9.456882299999961
402, 3.4114259273682763, 19.159282651369825, 23.12945171051355, 0.7427350000000001, 80.0, 463, 286082, 402, 6.804539400000067
403, 4.740770393364655, 19.042824345697213, 23.10327602414184, 0.7423407999999997, 80.0, 413, 286495, 403, 6.056310200000098
404, 4.568894549237095, 19.147134279391683, 23.157699463259924, 0.7417459000000004, 215.0, 909, 287404, 404, 13.339606600000025
405, 3.859673713921895, 19.115774960234134, 23.071547169124784, 0.7410267999999995, 35.0, 689, 288093, 405, 10.147824000000128
406, 4.166318772466959, 19.178973498645128, 23.152614753883523, 0.7404170500000004, 155.0, 666, 288759, 406, 9.768903599999703
407, 3.5417709268803326, 19.198840301168904, 23.199164929959935, 0.7398086499999998, 100.0, 686, 289445, 407, 10.167877500000031
408, 3.452830169947795, 19.122943444899573, 23.09136304502134, 0.7391354500000005, 255.0, 810, 290255, 408, 11.936763600000177
409, 3.032980302393152, 19.198206727190122, 23.18372909594416, 0.7384879000000001, 120.0, 629, 290884, 409, 9.442432599999847
410, 6.943153006554969, 19.210303012993734, 23.20468382960114, 0.7379811999999998, 50.0, 497, 291381, 410, 7.40745650000008
411, 3.9131172876223945, 19.20773769247121, 23.17795979291543, 0.7374835000000002, 150.0, 609, 291990, 411, 9.053283300000203
412, 1.846108714634603, 19.14775671507861, 23.053993502178706, 0.7369430499999998, 105.0, 592, 292582, 412, 8.867750900000374
413, 1.653739707756646, 19.10595659062832, 23.013059935992278, 0.7363922500000004, 215.0, 632, 293214, 413, 9.391576299999997
414, 3.830095211220197, 19.2162716030411, 23.278979618164517, 0.7356227499999999, 305.0, 1078, 294292, 414, 16.10492860000022
415, 2.1223769417580436, 19.166033845789293, 23.070074777042166, 0.7348316500000004, 135.0, 680, 294972, 415, 10.233251499999824
416, 1.9003508388519745, 19.231867560950082, 23.151808819197633, 0.7341737500000001, 210.0, 782, 295754, 416, 11.69419169999992
417, 1.9400871292237312, 19.145041628806823, 23.04898609961233, 0.7335428500000003, 105.0, 620, 296374, 417, 9.347713599999679
418, 2.511365684198191, 19.155226624215576, 23.102837283878216, 0.7327895499999999, 260.0, 1054, 297428, 418, 15.87082479999981
419, 2.1116111109635947, 19.13072714029762, 23.05838842235056, 0.7320691000000003, 110.0, 547, 297975, 419, 8.286678500000107
420, 2.100496150161633, 19.193661757029933, 23.131336916531765, 0.7314976000000002, 175.0, 723, 298698, 420, 10.9278647000001
421, 3.68949421550216, 19.18916260763462, 23.167938845924503, 0.7308127000000003, 335.0, 799, 299497, 421, 12.1541244
422, 4.087781823782509, 19.235546021521845, 23.30267878423763, 0.7301687500000001, 135.0, 632, 300129, 422, 9.576647899999898
423, 4.247974875580492, 19.39565907095436, 23.407022002926492, 0.7295234499999993, 180.0, 802, 300931, 423, 12.134446000000025
424, 2.8114467660428604, 19.318123096520473, 23.350826713815923, 0.7288786000000002, 105.0, 631, 301562, 424, 9.723296000000119
425, 4.209555970547777, 19.35936860518022, 23.40498053810813, 0.7282233999999997, 285.0, 825, 302387, 425, 12.65204649999987
426, 3.2232401877057955, 19.42878326939032, 23.393226918250615, 0.7274385999999999, 300.0, 919, 303306, 426, 13.998214199999893
427, 4.011158736931416, 19.439042192549522, 23.479626640509267, 0.7268256999999998, 110.0, 443, 303749, 427, 6.828175600000122
428, 3.2314865828629182, 19.360617226445765, 23.32737711020373, 0.7260805000000002, 300.0, 1213, 304962, 428, 18.587479099999655
429, 3.9571417866935654, 19.487769424274404, 23.62205155177783, 0.72536725, 65.0, 372, 305334, 429, 5.770497400000295
430, 2.9257453645908114, 19.398419902570996, 23.38247201038383, 0.7249690000000001, 65.0, 513, 305847, 430, 7.946733499999937
431, 1.9220920144482887, 19.328362736243083, 23.268376573857903, 0.72452305, 20.0, 478, 306325, 431, 7.4962971999998445
432, 3.1740854139456305, 19.400425158573416, 23.422600890650894, 0.7238772999999993, 185.0, 957, 307282, 432, 14.790680100000372
433, 4.064632666014806, 19.3655910902336, 23.360729035783987, 0.7230074500000006, 185.0, 976, 308258, 433, 15.161595000000034
434, 3.777511901628341, 19.39825910828712, 23.428328798380893, 0.7222618000000004, 155.0, 681, 308939, 434, 10.505124899999828
435, 4.4819753812365395, 19.373223278062508, 23.42762011386158, 0.7216498, 155.0, 679, 309618, 435, 10.614431300000433
436, 2.944949252032694, 19.34515070424649, 23.36653615614024, 0.7211255499999998, 105.0, 486, 310104, 436, 7.73298479999994
437, 4.42025804216346, 19.250256228616053, 23.217117501657906, 0.7205896, 135.0, 705, 310809, 437, 11.094782299999679
438, 3.54303400942001, 19.22369131524879, 23.103982327932336, 0.7200855999999998, 55.0, 415, 311224, 438, 6.519466000000193
439, 3.854325961412453, 19.25259630356101, 23.293987845709932, 0.7196405500000002, 110.0, 574, 311798, 439, 9.025980899999922
440, 2.604350940352588, 19.16325954114548, 23.090158763557973, 0.71902585, 410.0, 792, 312590, 440, 12.426331799999843
441, 2.0502007948331893, 19.179779789393034, 23.10075052695384, 0.7184538999999995, 20.0, 479, 313069, 441, 7.534381800000119
442, 3.686345396202244, 19.225230115171613, 23.22552266671507, 0.7180318000000002, 155.0, 459, 313528, 442, 7.230909800000063
443, 2.4060323302835505, 19.215014471155722, 23.191324483638272, 0.7172510500000008, 275.0, 1276, 314804, 443, 20.174971700000242
444, 5.562967367216747, 19.269416632408905, 23.36470942866825, 0.7164388, 135.0, 529, 315333, 444, 8.392294199999924
445, 3.8242512274356115, 19.286275018024913, 23.270470182296677, 0.7159266999999999, 320.0, 609, 315942, 445, 9.606647700000394
446, 3.13154661849467, 19.24893041538671, 23.23786668986023, 0.7151999499999996, 305.0, 1006, 316948, 446, 16.388792400000057
447, 3.4200829566735127, 19.280617906433246, 23.331865359348377, 0.7145533000000002, 30.0, 431, 317379, 447, 6.9225759999999354
448, 3.3788728065447207, 19.2977561966875, 23.239055037700865, 0.7140942999999997, 110.0, 589, 317968, 448, 9.518822799999725
449, 1.8207485852777496, 19.25838816443155, 23.18053321542666, 0.713539, 155.0, 645, 318613, 449, 10.405310099999951
450, 3.9920690709391535, 19.2717689980586, 23.253163077008775, 0.7127334999999994, 445.0, 1145, 319758, 450, 18.178340500000104
451, 2.204454449554415, 19.265557740864, 23.242485357585707, 0.7120472500000001, 45.0, 380, 320138, 451, 6.117061100000228
452, 3.761856300667794, 19.26529176973961, 23.239259449528976, 0.7113650500000003, 515.0, 1136, 321274, 452, 18.148243600000114
453, 2.4408817892413794, 19.238837099957387, 23.149978982221835, 0.7104403000000001, 165.0, 919, 322193, 453, 14.853323999999702
454, 3.0015799083055987, 19.27919775439847, 23.258371242400138, 0.7098174999999999, 55.0, 465, 322658, 454, 7.491059500000119
455, 2.6612663004904302, 19.282101094481433, 23.254859509899227, 0.7092748, 245.0, 741, 323399, 455, 11.947128300000259
456, 5.861560153869591, 19.291537505796896, 23.415525301128415, 0.7087509999999997, 40.0, 423, 323822, 456, 6.848266499999681
457, 3.940610679749674, 19.31357178934599, 23.29323677339963, 0.7081516000000004, 580.0, 909, 324731, 457, 14.738689199999953
458, 4.797244179108564, 19.363944675221163, 23.427779738482307, 0.7075513, 75.0, 425, 325156, 458, 6.904890600000272
459, 3.219378865181326, 19.33328212130893, 23.2978749060416, 0.7070603499999994, 145.0, 666, 325822, 459, 10.942395399999896
460, 3.3921154661594928, 19.35897898042984, 23.338210515240668, 0.7063696000000003, 170.0, 869, 326691, 460, 14.141918600000281
461, 1.6636114564461222, 19.2701531293738, 23.201226580233975, 0.7057427499999998, 120.0, 524, 327215, 461, 8.602768100000048
462, 2.735644629620385, 19.279842779021404, 23.245724163031184, 0.7051528000000002, 125.0, 787, 328002, 462, 12.887291400000322
463, 4.848817514991615, 19.303066638233215, 23.35540686816704, 0.7045218999999997, 75.0, 615, 328617, 463, 10.053802299999916
464, 4.272108863327282, 19.318118984162496, 23.316303417944784, 0.7039013500000004, 120.0, 764, 329381, 464, 12.600443199999972
465, 2.9984131747303446, 19.23961718901876, 23.209479105046157, 0.7032681999999999, 140.0, 643, 330024, 465, 10.547055499999715
466, 4.498132393174413, 19.64431600432465, 23.734147585993227, 0.7026683500000005, 110.0, 690, 330714, 466, 11.31827850000036
467, 2.664929610248835, 19.689353179318346, 23.713163492380616, 0.7020779500000002, 145.0, 622, 331336, 467, 10.298896400000103
468, 5.711660162620018, 19.68730402753397, 23.81729726030783, 0.7014312999999994, 210.0, 815, 332151, 468, 13.48658370000021
469, 3.3165427128243996, 19.649347953765943, 23.726949560861062, 0.7005007000000009, 315.0, 1253, 333404, 469, 20.761693099999775
470, 3.4119845219754446, 19.69411359913857, 23.753044973500284, 0.6995377000000003, 275.0, 887, 334291, 470, 14.795063000000027
471, 2.5886328271014154, 19.691944638290845, 23.74241807529692, 0.6987492999999996, 155.0, 865, 335156, 471, 14.386092199999894
472, 2.0542157424845957, 19.750867156634577, 23.783593647385803, 0.69806395, 170.0, 658, 335814, 472, 10.896973700000217
473, 4.469403329280626, 19.74232241055456, 23.854262078305712, 0.6974118999999996, 135.0, 791, 336605, 473, 13.170208600000024
474, 5.507226403615131, 19.74885248345414, 23.819038760628118, 0.6965821000000001, 185.0, 1053, 337658, 474, 17.490350000000035
475, 4.449560670833278, 19.74002705292327, 23.859217834989554, 0.6957761499999997, 135.0, 738, 338396, 475, 12.31577870000001
476, 3.2412724564783275, 19.738902929217318, 23.879233745641486, 0.6951344500000001, 210.0, 688, 339084, 476, 11.510075200000301
477, 4.434926911793797, 19.68180057702475, 23.767926997170015, 0.6946209999999997, 105.0, 453, 339537, 477, 7.6225782000001345
478, 1.7582757222481258, 19.657699683277876, 23.652791083649085, 0.6941116000000004, 200.0, 679, 340216, 478, 11.31520810000029
479, 3.7962978109612577, 19.751333695423753, 23.845060576534138, 0.6934860999999999, 80.0, 711, 340927, 479, 11.936774900000273
480, 6.032523915446842, 19.793146518415387, 23.971841935432053, 0.69282505, 145.0, 758, 341685, 480, 12.646517600000152
481, 3.872100374321772, 19.799382140614526, 23.88470606662645, 0.6920434000000005, 210.0, 979, 342664, 481, 16.35432290000017
482, 3.786201080329023, 19.752776827923086, 23.83098412946213, 0.6912932500000004, 150.0, 688, 343352, 482, 11.664428499999758
483, 3.4484865797285438, 19.794545250969964, 23.87604168650559, 0.69061735, 130.0, 814, 344166, 483, 13.636515099999997
484, 3.408188767391619, 19.737375857683034, 23.770779423036142, 0.6900832000000001, 95.0, 373, 344539, 484, 6.260694199999762
485, 1.9278069479087143, 19.69903965875612, 23.676872270327088, 0.6896615500000001, 155.0, 564, 345103, 485, 9.500805599999694
486, 3.975836848633862, 19.766826948071664, 23.84785379543012, 0.6891435999999999, 120.0, 587, 345690, 486, 9.864136899999721
487, 4.641701861749293, 19.830960164934197, 23.93434674734504, 0.6886783000000003, 75.0, 447, 346137, 487, 7.519118400000025
488, 4.581359149028013, 19.748142700277437, 23.830523520676003, 0.6880591, 160.0, 929, 347066, 488, 15.641895100000056
489, 3.061907147027312, 19.679451215651728, 23.702760427228867, 0.6874178499999998, 85.0, 496, 347562, 489, 8.338683200000105
490, 1.8706673062234014, 19.77083760720712, 23.837240234253898, 0.68702455, 10.0, 378, 347940, 490, 6.398114600000099
491, 3.391114716559979, 19.844799364042416, 23.973003030813963, 0.68652955, 95.0, 722, 348662, 491, 12.115329099999599
492, 3.270102329952834, 19.780276584407012, 23.849812073347497, 0.6858113500000003, 215.0, 874, 349536, 492, 14.670228099999804
493, 5.2552007915395675, 19.820138562809337, 23.945393244425457, 0.6851804500000002, 45.0, 528, 350064, 493, 8.898149300000114
494, 3.77230301423628, 20.06777558202721, 24.188872743911684, 0.684371799999999, 490.0, 1269, 351333, 494, 21.367302500000278
495, 3.227162181743554, 20.040572808401926, 24.1828405216762, 0.6834069999999999, 240.0, 875, 352208, 495, 14.7930709999996
496, 3.2245024169118204, 20.053999284976523, 24.211295771862748, 0.6827693500000002, 125.0, 542, 352750, 496, 9.148618900000201
497, 1.8349188842261448, 19.992778196090306, 24.08792659074832, 0.6823499500000002, 105.0, 390, 353140, 497, 6.57842010000013
498, 3.4472418095767496, 20.117578030904134, 24.306810648600262, 0.6818369499999996, 380.0, 750, 353890, 498, 12.61895850000019
499, 2.770378428786548, 20.062508420801873, 24.194856341917124, 0.68119795, 135.0, 670, 354560, 499, 11.331177900000057
500, 1.774166638598199, 20.053125383206837, 24.101171649870324, 0.6806493999999997, 45.0, 549, 355109, 500, 9.297141199999714
501, 3.8470957029627333, 20.078837483199603, 24.22832190691986, 0.6800968000000004, 150.0, 679, 355788, 501, 11.405654499999855
502, 3.4300478209796714, 20.037295475419572, 24.243669107205232, 0.6793137999999999, 245.0, 1061, 356849, 502, 17.886374400000022
503, 4.000603841895622, 20.066415208483498, 24.20907410818433, 0.6785528500000002, 120.0, 630, 357479, 503, 10.613906399999905
504, 1.7452625378579287, 19.975409326924908, 24.010619849663275, 0.6780961, 75.0, 385, 357864, 504, 6.594136300000173
505, 2.7945542110789363, 20.065109275336134, 24.18006763934389, 0.6776163999999996, 185.0, 681, 358545, 505, 11.486472200000208
506, 2.8534234341015527, 20.072283147820958, 24.211040177927153, 0.67674205, 540.0, 1262, 359807, 506, 21.320954299999812
507, 2.9327763475001776, 20.376226593219236, 24.567589835448413, 0.6759698500000001, 105.0, 454, 360261, 507, 7.717521499999748
508, 3.297515149906592, 20.500464727504472, 24.660949260345387, 0.6755734000000001, 80.0, 427, 360688, 508, 7.229050899999947
509, 4.1330399050209765, 20.598382755075512, 24.901828772051793, 0.6751035999999997, 65.0, 617, 361305, 509, 10.484182800000326
510, 5.627672732178581, 20.595863452381725, 24.903801232157928, 0.6745375000000003, 120.0, 641, 361946, 510, 10.912735599999905
511, 3.1708920657981463, 20.569151855650404, 24.762481926839587, 0.67383325, 160.0, 924, 362870, 511, 15.721607200000108
512, 1.8007000195643594, 20.52146696637206, 24.673939297728566, 0.6731802999999998, 60.0, 527, 363397, 512, 8.961708900000303
513, 3.6527264436806277, 20.635890277074562, 24.87250239089152, 0.6726142000000002, 260.0, 731, 364128, 513, 12.402094699999907
514, 3.4052798296948446, 20.56315485092989, 24.823836856418186, 0.6719693499999995, 175.0, 702, 364830, 514, 11.921058099999755
515, 4.589252260938229, 20.603106023708065, 24.865302619349453, 0.6714185500000001, 65.0, 522, 365352, 515, 8.864692600000126
516, 2.906737403835367, 20.527686320952256, 24.736301958125875, 0.6709370499999999, 150.0, 548, 365900, 516, 9.32693909999989
517, 4.757109032443757, 20.643187827173374, 24.940649017749593, 0.6702278499999996, 485.0, 1028, 366928, 517, 17.464292300000125
518, 4.579098135413545, 20.59133407130386, 24.893834428112918, 0.6695425, 35.0, 495, 367423, 518, 8.368261899999652
519, 3.225782655459462, 20.571206771388198, 24.784610780658145, 0.6689485000000003, 125.0, 825, 368248, 519, 14.107709700000214
520, 1.905885358370867, 20.59644309481692, 24.743090191769856, 0.66832435, 50.0, 562, 368810, 520, 9.544610299999931
521, 3.0251980658688327, 20.590312891873445, 24.837605601224034, 0.6678239499999995, 80.0, 550, 369360, 521, 9.485490800000207
522, 2.2730259133892097, 20.55859944239799, 24.743619026091846, 0.6670553500000003, 290.0, 1158, 370518, 522, 19.6831659999998
523, 2.0841591599867457, 20.53714759100051, 24.695971040271576, 0.6662979999999997, 155.0, 525, 371043, 523, 9.02340920000006
524, 1.9179709940877987, 20.542360598708374, 24.74835109598891, 0.6656779000000002, 255.0, 853, 371896, 524, 14.53307679999989
525, 3.6840407505501496, 20.576303718626036, 24.81424806653991, 0.6648296499999993, 635.0, 1032, 372928, 525, 17.632465299999694
526, 1.9412307646316596, 20.56834126741458, 24.72909272756332, 0.6640142499999999, 145.0, 780, 373708, 526, 13.57135130000006
527, 3.813546893963888, 20.607180950909676, 24.8255058519939, 0.6633590500000002, 120.0, 676, 374384, 527, 11.681942000000163
528, 6.742374187608067, 20.606581728156684, 24.942968330667274, 0.6628735000000002, 70.0, 403, 374787, 528, 7.021840699999757
529, 2.922966332803076, 20.59109190327673, 24.78388319874262, 0.6624072999999998, 125.0, 633, 375420, 529, 11.07224449999967
530, 2.9092818598710855, 20.55979889221774, 24.77227692931663, 0.6618866500000002, 110.0, 524, 375944, 530, 9.152723599999717
531, 4.3526510702180605, 20.556895417664055, 24.77146033084754, 0.6612499000000004, 360.0, 891, 376835, 531, 15.4996414000002
532, 2.9879106544014715, 20.610650692072912, 24.794109552872563, 0.6605524000000003, 120.0, 659, 377494, 532, 11.469591000000037
533, 4.689628926889584, 20.597798144463265, 24.87325409143278, 0.6600740500000001, 40.0, 404, 377898, 533, 7.041715599999861
534, 1.7083053555358294, 20.535651130292884, 24.745781586996873, 0.65971315, 80.0, 398, 378296, 534, 7.030413399999816
535, 4.0639969783766965, 20.591600681111693, 24.83445623444348, 0.6590543499999993, 395.0, 1066, 379362, 535, 18.62775049999982
536, 2.818291891192974, 20.541006845493254, 24.76620819560713, 0.6583037499999999, 110.0, 602, 379964, 536, 10.430892800000038
537, 3.035243022549129, 21.029896057069532, 25.356391658115015, 0.6578015500000002, 75.0, 514, 380478, 537, 8.972408500000256
538, 1.810959000432772, 21.002407796714337, 25.260326689134263, 0.65736955, 55.0, 446, 380924, 538, 8.018995499999619
539, 1.998238501829835, 21.105162088406686, 25.400891352012852, 0.6569632000000001, 100.0, 457, 381381, 539, 7.980721299999914
540, 3.888358622272308, 21.031256789037982, 25.36443800379676, 0.6563295999999994, 165.0, 951, 382332, 540, 16.619323500000064
541, 1.746086379007241, 21.025378159534785, 25.315933024441755, 0.65561005, 155.0, 648, 382980, 541, 11.389584199999717
542, 3.2235623230914707, 21.07519505749578, 25.401769036832064, 0.6549044500000002, 280.0, 920, 383900, 542, 16.28202760000022
543, 2.9936452693412443, 21.046967932218994, 25.3689433762948, 0.6542465500000001, 120.0, 542, 384442, 543, 9.550387499999943
544, 4.927024833144462, 21.042355300182134, 25.385678315044043, 0.6538217499999995, 65.0, 402, 384844, 544, 7.109097600000041
545, 3.03589671593751, 21.018382679034712, 25.32025861453601, 0.6531165999999998, 230.0, 1165, 386009, 545, 19.881960700000036
546, 3.303820756841297, 21.048707612993585, 25.379715934131898, 0.6522111999999998, 125.0, 847, 386856, 546, 13.701977499999884
547, 1.7170120535508093, 20.995291966554465, 25.22927732710798, 0.6516712000000001, 45.0, 353, 387209, 547, 5.807753799999773
548, 3.4870367894506025, 21.019520137727874, 25.334490889126492, 0.6511631499999999, 145.0, 776, 387985, 548, 12.696526599999743
549, 2.0267749321785304, 21.093186876561383, 25.35464702266278, 0.6504503500000004, 455.0, 808, 388793, 549, 13.120244300000195
550, 3.025943784225256, 21.042754325907673, 25.36806226826636, 0.6496678000000001, 175.0, 931, 389724, 550, 15.278473600000325
551, 6.678206863229424, 21.28549217194143, 25.716877706861215, 0.6490198000000001, 15.0, 509, 390233, 551, 8.422216099999787
552, 5.520727688631199, 21.528757782998827, 26.018176541737375, 0.6482502999999997, 305.0, 1201, 391434, 552, 19.56809649999923
553, 3.1133938374724273, 21.500905080996247, 25.881235514022066, 0.6474663999999999, 120.0, 541, 391975, 553, 8.852530000000115
554, 4.199350631697047, 21.51815402507782, 25.959662914276123, 0.6469853499999998, 95.0, 528, 392503, 554, 8.73531389999971
555, 5.888136644595424, 21.555922405886285, 26.037604752756668, 0.6464836000000003, 110.0, 587, 393090, 555, 9.737573800000064
556, 5.462370008356491, 21.54203599545466, 26.006106831035147, 0.6459805000000001, 85.0, 531, 393621, 556, 8.768307199999981
557, 4.330869296111393, 21.51953721490126, 25.931431031483978, 0.6452820999999994, 360.0, 1021, 394642, 557, 16.85026139999991
558, 1.898134733142797, 21.45981211066246, 25.774706250429155, 0.6445346500000001, 70.0, 640, 395282, 558, 10.66495169999962
559, 4.422612526685996, 21.471367095039678, 25.85189359870542, 0.6440045499999997, 105.0, 538, 395820, 559, 8.90500830000019
560, 3.195851299256148, 21.529051458860284, 25.932664424983116, 0.6435451000000002, 50.0, 483, 396303, 560, 8.037631900000633
561, 7.40395410416388, 21.49092850274785, 26.06932428399604, 0.6431761000000003, 20.0, 337, 396640, 561, 5.7120786000004955
562, 2.651910751816626, 21.472350464653722, 25.807468535096024, 0.6427188999999998, 185.0, 679, 397319, 562, 11.319221499999912
563, 2.721735450418021, 21.513037876354222, 25.892243401185468, 0.6421159000000004, 140.0, 661, 397980, 563, 10.949002899999869
564, 3.3386574183729874, 21.510615703246604, 25.900264817940627, 0.6414660999999999, 210.0, 783, 398763, 564, 13.131508700000268
565, 3.2948816563483256, 21.515344947766348, 25.917975327315602, 0.6407605000000004, 185.0, 785, 399548, 565, 13.075679900000068
566, 3.4759570988701944, 22.504843344662916, 27.106715299228934, 0.64007065, 210.0, 748, 400296, 566, 12.539488500000516
567, 4.372285275883747, 24.118268918124112, 29.118858244924834, 0.6393628000000001, 235.0, 825, 401121, 567, 13.789011299999402
568, 4.174886468334259, 24.046795781589886, 28.941178819140653, 0.6385721500000001, 180.0, 932, 402053, 568, 15.563368700000865
569, 7.461857813821189, 24.06618859763587, 29.08718082476441, 0.6379048000000003, 120.0, 551, 402604, 569, 9.215554399999746
570, 5.322674692148396, 24.096802810319822, 29.021205519603047, 0.6373225000000001, 135.0, 743, 403347, 570, 12.56519389999994
571, 5.931650635094057, 24.045968439284252, 29.045946649542437, 0.6367005999999997, 155.0, 639, 403986, 571, 10.830878400000074
572, 3.779144441404869, 24.072407964489262, 28.955602815939404, 0.636085, 120.0, 729, 404715, 572, 12.293661900000188
573, 3.479424772019176, 24.0824813178963, 28.99046679273282, 0.6355629999999997, 65.0, 431, 405146, 573, 7.297155700000076
574, 5.760733843028546, 23.97490811767578, 28.911380068969727, 0.6350878000000003, 155.0, 625, 405771, 574, 10.542266100000234
575, 5.805188021627424, 24.02039383112458, 29.001955474596567, 0.63445915, 60.0, 772, 406543, 575, 13.085769099999197
576, 4.728573203413156, 24.086126154878713, 28.983071044587742, 0.6338035, 45.0, 685, 407228, 576, 11.69951300000048
577, 4.726079636873568, 24.062597876156076, 29.02324681225945, 0.6331127500000002, 85.0, 850, 408078, 577, 14.464730799999415
578, 4.569964078845467, 24.065849318301613, 28.976994424562577, 0.6324868000000001, 10.0, 541, 408619, 578, 9.216671600000154
579, 3.1928219511962923, 23.975834951562398, 28.852007847721293, 0.63181855, 255.0, 944, 409563, 579, 15.986884900000405
580, 3.1487248762390547, 23.94492264716856, 28.840486845662518, 0.6311705499999998, 125.0, 496, 410059, 580, 8.496470699999918
581, 2.6212751524743894, 24.314185463776024, 29.30532752255262, 0.6305225499999998, 335.0, 944, 411003, 581, 16.10949939999955
582, 5.722169316938426, 24.345824189073458, 29.33948484931405, 0.6298691499999997, 125.0, 508, 411511, 582, 8.731749800000216
583, 6.044239368189399, 24.38950599379969, 29.42665215388646, 0.6291559000000002, 185.0, 1077, 412588, 583, 18.299340500000653
584, 4.14784108943029, 24.330598795736158, 29.33097800048622, 0.6284048499999996, 150.0, 592, 413180, 584, 10.179789100000562
585, 3.3366015322107736, 24.33645856181116, 29.32734137474494, 0.6276002500000003, 405.0, 1196, 414376, 585, 20.495033199999853
586, 3.2988553542366574, 24.358077674344653, 29.363668587594223, 0.6266206000000004, 190.0, 981, 415357, 586, 16.906982900000003
587, 2.7794605331961066, 24.231459069252015, 29.17199081480503, 0.62589115, 115.0, 640, 415997, 587, 11.087778299999627
588, 3.199991155069708, 24.35693986472319, 29.298767187122003, 0.6253561000000001, 85.0, 549, 416546, 588, 9.521629900000335
589, 2.8616147045202616, 24.330366442383838, 29.292350746603574, 0.6248413000000003, 125.0, 595, 417141, 589, 10.30121699999927
590, 4.6347484224489035, 24.335298345682208, 29.346089192959063, 0.6243818499999997, 110.0, 426, 417567, 590, 7.378545600000507
591, 3.0278632617358006, 24.331201649675467, 29.2645406665224, 0.6239674000000002, 95.0, 495, 418062, 591, 8.627541199999541
592, 3.840376462610544, 24.32046777864974, 29.306048376518383, 0.6233086000000001, 315.0, 969, 419031, 592, 16.695115299999998
593, 3.354499324250825, 24.4086996440646, 29.443572109560424, 0.6226948, 65.0, 395, 419426, 593, 6.87625670000034
594, 3.716861839536888, 24.358663551472823, 29.3423252948016, 0.6220585000000002, 255.0, 1019, 420445, 594, 17.727706599999692
595, 1.7566148618934676, 24.23784877359867, 29.12543075531721, 0.6213695499999998, 120.0, 512, 420957, 595, 8.925123400000302
596, 2.0018360787015923, 24.25567733028921, 29.17727775019415, 0.6207985000000001, 195.0, 757, 421714, 596, 13.35164259999965
597, 3.023125610392318, 24.142491423778043, 29.081756154899924, 0.6201945999999997, 80.0, 585, 422299, 597, 10.164478800000325
598, 2.18732138723135, 24.287733973995334, 29.201210291154922, 0.6197081500000001, 90.0, 496, 422795, 598, 8.738400000000183
599, 3.5677276916037766, 24.244254938761394, 29.18201861259265, 0.61930945, 45.0, 390, 423185, 599, 6.887015100000099
600, 3.4640391234637447, 24.28551911283507, 29.259301677239538, 0.6187568499999996, 150.0, 838, 424023, 600, 14.551448199999868
601, 2.932397941515579, 24.25969203602184, 29.21886616953603, 0.6180580000000002, 190.0, 715, 424738, 601, 12.716798600000402
602, 3.4880367852034775, 24.331269925988238, 29.2689540730352, 0.6174775, 210.0, 575, 425313, 602, 10.18418759999986
603, 2.0502510349071303, 24.24504691722781, 29.168557620972624, 0.6169285000000001, 50.0, 645, 425958, 603, 11.390712200000053
604, 4.2987448410647255, 24.33921198817662, 29.342155299595426, 0.6162445000000002, 195.0, 875, 426833, 604, 15.356747699999687
605, 3.252825161653026, 24.349373552034486, 29.334542449915183, 0.6156599500000001, 85.0, 424, 427257, 605, 7.61677790000067
606, 1.8468164264482294, 24.250462596699343, 29.16368900449936, 0.6153098499999999, 20.0, 354, 427611, 606, 6.370616700000028
607, 2.0342020885539904, 24.255386635916572, 29.180336213793073, 0.6148355500000001, 195.0, 700, 428311, 607, 12.395896500000163
608, 2.508951420262536, 24.206520381726715, 29.15302176839171, 0.6141015999999997, 325.0, 931, 429242, 608, 16.412991399999555
609, 3.4910574328033137, 24.265987102179412, 29.276108810554298, 0.6133645, 160.0, 707, 429949, 609, 12.480557799999588
610, 3.360930271189266, 24.403420363015275, 29.384351815634627, 0.6128249499999999, 35.0, 492, 430441, 610, 8.783886300000631
611, 2.7598575214570973, 24.46375370400605, 29.41994252586115, 0.6122602, 465.0, 763, 431204, 611, 13.599926799999594
612, 2.9918846208089533, 24.457123908063323, 29.426694732922662, 0.6116225499999995, 90.0, 654, 431858, 612, 11.766858800000591
613, 3.924419627905023, 24.370925399729913, 29.357565948016312, 0.6109192, 500.0, 909, 432767, 613, 16.140366599999652
614, 2.7067495779316317, 24.388522835983625, 29.33725133709524, 0.6101969499999995, 175.0, 696, 433463, 614, 12.345353400000022
615, 4.345229120909514, 24.43410597265638, 29.3966135311724, 0.6094526500000003, 510.0, 958, 434421, 615, 17.45117879999998
616, 4.814110603459834, 24.404127550649118, 29.434444998646832, 0.6085301499999993, 230.0, 1092, 435513, 616, 19.610843999999815
617, 2.426366741088133, 24.39393580260397, 29.33433944437684, 0.6076103500000001, 375.0, 952, 436465, 617, 17.049548699999832
618, 5.470740462468148, 24.51597326701931, 29.573117638183945, 0.6068696500000003, 75.0, 694, 437159, 618, 12.439022999999906
619, 4.267115622598333, 24.505929905803182, 29.52505268343501, 0.6062022999999999, 155.0, 789, 437948, 619, 14.213284500000555
620, 3.828942486517866, 24.48249226422377, 29.506053075656084, 0.6056875000000002, 55.0, 355, 438303, 620, 6.455449199999748
621, 1.7807552139310874, 24.483042868532877, 29.421491024106047, 0.6050633500000004, 355.0, 1032, 439335, 621, 18.80067179999969
622, 5.514015077531657, 24.51426519690771, 29.60642173166565, 0.6043474000000001, 75.0, 559, 439894, 622, 10.120016699999724
623, 6.164487720319646, 24.237444415671288, 29.23248694315122, 0.6037066000000001, 195.0, 865, 440759, 623, 15.735778299999765
624, 5.582439342616762, 24.315991888942253, 29.365053213701284, 0.6029676999999997, 145.0, 777, 441536, 624, 14.23169180000059
625, 2.070643071918199, 24.192902775284665, 29.067956954055692, 0.6023282500000001, 150.0, 644, 442180, 625, 11.782470799999828
626, 3.7781284296741853, 24.218734402423138, 29.196092184106785, 0.6017166999999995, 155.0, 715, 442895, 626, 12.96076709999943
627, 3.306702751138761, 24.12189724242765, 29.06675275582374, 0.6011883999999998, 95.0, 459, 443354, 627, 8.458574599999338
628, 4.55862347774252, 24.174948785224444, 29.118382478566105, 0.6007555, 80.0, 503, 443857, 628, 9.19245570000021
629, 3.5090179670038366, 24.230689241945313, 29.18182883098471, 0.5999670999999993, 430.0, 1249, 445106, 629, 22.780220699999518
630, 2.9413168041991726, 24.14782201783947, 29.043265022934367, 0.5991017499999998, 375.0, 674, 445780, 630, 12.36768529999972
631, 2.7478281176564368, 24.16919393972917, 29.114930450142204, 0.5985212500000003, 95.0, 616, 446396, 631, 11.258371199999601
632, 2.0604006244957103, 24.118579971078272, 29.04269736626245, 0.5980105, 70.0, 519, 446915, 632, 9.572256899999957
633, 1.9099360291634884, 24.204688668795374, 29.098198209904826, 0.5974812999999995, 105.0, 657, 447572, 633, 12.159377500000119
634, 4.247192941032923, 24.244903851013916, 29.30313539963502, 0.5968112500000001, 200.0, 832, 448404, 634, 15.401147900000069
635, 4.603456446069122, 24.225301954050153, 29.190991738320367, 0.5959944999999999, 410.0, 983, 449387, 635, 18.197838499999307
636, 2.5026795507840456, 24.4762400827388, 29.42491282147826, 0.59511925, 385.0, 962, 450349, 636, 17.727584299999762
637, 4.00339125617525, 24.867032234084775, 29.974277005366712, 0.5943978999999999, 160.0, 641, 450990, 637, 11.830808300000172
638, 3.9124064656063653, 24.836897045298848, 29.859722622696037, 0.5939308000000001, 40.0, 397, 451387, 638, 7.407591000000139
639, 3.6831763934767032, 24.940114442692245, 30.026758342695953, 0.5934231999999997, 215.0, 731, 452118, 639, 13.532212699999945
640, 1.9507737817133175, 24.930344963608, 29.97433452980191, 0.5929336000000001, 35.0, 357, 452475, 640, 6.708916500000669
641, 4.36882964632954, 24.77221582138041, 29.84718802029801, 0.5924386000000001, 155.0, 743, 453218, 641, 13.802862399999867
642, 4.268436564103693, 24.82157880206441, 29.923854685568994, 0.5916398499999996, 225.0, 1032, 454250, 642, 19.184164000000237
643, 1.919367661990691, 24.870486563869886, 29.912651730435236, 0.5907722499999999, 395.0, 896, 455146, 643, 17.769932999999583
644, 3.434306957627215, 24.831316082652023, 29.913508526871844, 0.59018455, 90.0, 410, 455556, 644, 8.254617899999175
645, 2.9435921763909643, 24.91979907301606, 30.011805553123597, 0.5897255500000002, 100.0, 610, 456166, 645, 12.483583199999885
646, 2.970869530514155, 24.89796510015713, 29.979446868803556, 0.5890815999999995, 220.0, 821, 456987, 646, 15.373805199999879
647, 2.953479286146007, 25.030028714631733, 30.12918863296509, 0.58837015, 110.0, 760, 457747, 647, 14.331382700000177
648, 1.762723220500556, 24.902746428483688, 29.987008514644216, 0.5878850499999999, 5.0, 318, 458065, 648, 6.004306999999244
649, 3.470425390130818, 24.902086741551404, 30.0106316697541, 0.5875520500000001, 20.0, 422, 458487, 649, 7.998392499999682
650, 4.480308514882642, 24.91480425922546, 30.020030967471033, 0.587035, 140.0, 727, 459214, 650, 13.598163999999997
651, 4.450774022496372, 24.92175587764761, 30.089960179934845, 0.5863820499999995, 115.0, 724, 459938, 651, 13.656670700000177
652, 3.8277904444768387, 24.917051379666006, 29.901088989585457, 0.5859095500000001, 35.0, 326, 460264, 652, 6.362288199999966
653, 4.198283852931268, 25.005324440230865, 30.127274914130478, 0.5853871000000002, 260.0, 835, 461099, 653, 15.6978653999995
654, 3.384656060089234, 25.032127730073025, 30.134868456582403, 0.5843413000000002, 185.0, 1489, 462588, 654, 28.0183262999999
655, 3.751998507574703, 24.95025824428944, 30.06137735388252, 0.5833508499999995, 170.0, 712, 463300, 655, 13.510758200000055
656, 5.316067785024643, 25.070808036342296, 30.21986618519825, 0.5825993500000002, 225.0, 958, 464258, 656, 18.199394700000084
657, 5.349050416430826, 24.97791650409597, 30.08178756673213, 0.5819148999999999, 30.0, 563, 464821, 657, 10.722660299999916
658, 3.4225157487176663, 25.032276822431054, 30.128784725568952, 0.5812637500000002, 175.0, 884, 465705, 658, 16.92432960000042
659, 3.7329188139759344, 25.07412184797568, 30.145330859924936, 0.5806886499999997, 75.0, 394, 466099, 659, 7.5255379999998695
660, 4.64453589847151, 25.122401367591706, 30.278425878562675, 0.5801716000000003, 145.0, 755, 466854, 660, 14.51354420000007
661, 3.6532920993843665, 24.959360849289666, 30.05601006195325, 0.5796712, 20.0, 357, 467211, 661, 6.850179600000047
662, 4.043533546777515, 25.055457856231953, 30.139863581884477, 0.5790947499999998, 200.0, 924, 468135, 662, 17.650786799999878
663, 3.23119417113728, 25.012059326171876, 30.09866514078776, 0.5781727, 280.0, 1125, 469260, 663, 21.55291269999998
664, 5.581760918551471, 25.128725527655043, 30.325720156221454, 0.5772623500000003, 395.0, 898, 470158, 664, 17.261069200000748
665, 3.186582966483532, 25.19814294417274, 30.317115436900746, 0.5766057999999998, 30.0, 561, 470719, 665, 10.866536399999859
666, 2.724580331767349, 25.291662780331894, 30.38033321925572, 0.5759060500000003, 165.0, 994, 471713, 666, 19.120121500000096
667, 6.798374752692989, 25.293744082521336, 30.568022981653073, 0.5752760499999998, 110.0, 406, 472119, 667, 7.868762300000526
668, 4.542258106948187, 25.279446551294036, 30.4309977943247, 0.57485575, 70.0, 528, 472647, 668, 10.289326199999778
669, 2.0887609278175088, 25.178723852554754, 30.28553208103523, 0.5744430999999999, 105.0, 389, 473036, 669, 7.6468453000006775
670, 2.707131376900905, 25.270336343353033, 30.396419238937394, 0.5738661999999998, 100.0, 893, 473929, 670, 17.304612500000076
671, 4.283249875139512, 25.323894441905537, 30.56319200101696, 0.5730850000000004, 110.0, 843, 474772, 671, 16.403412200000275
672, 3.934581732539455, 25.29196976857056, 30.49929003987611, 0.5722245999999995, 650.0, 1069, 475841, 672, 20.547971700000744
673, 5.5653683230195234, 25.282534398338345, 30.433728324042427, 0.5715086500000001, 65.0, 522, 476363, 673, 10.172024699999383
674, 4.3963849037712395, 25.32587237542914, 30.540029794855634, 0.5706932499999999, 650.0, 1290, 477653, 674, 25.20310249999966
675, 4.111610967866675, 25.366820795093467, 30.543643103388256, 0.56981215, 200.0, 668, 478321, 675, 13.004530799999884
676, 1.9010249663438452, 25.272450903842323, 30.365219670847843, 0.5691695499999999, 240.0, 760, 479081, 676, 14.801522200000363
677, 3.921807460882495, 25.30231468234442, 30.533400071405733, 0.5685224500000001, 200.0, 678, 479759, 677, 13.396151000000827
678, 6.045044377381336, 25.127419091478178, 30.324307158023498, 0.56764855, 330.0, 1264, 481023, 678, 24.591348500000095
679, 4.518004157076968, 24.993635506205038, 30.114638088717317, 0.5666252499999995, 370.0, 1010, 482033, 679, 19.835561099999723
680, 3.350480605127961, 24.92878785693211, 30.022917299618122, 0.56594845, 90.0, 494, 482527, 680, 9.76746120000007
681, 3.4214436251648164, 24.985422754568763, 30.079410727225493, 0.5652680499999999, 280.0, 1018, 483545, 681, 19.99940500000048
682, 4.80568046868549, 25.0013972657773, 30.125617648697617, 0.56433205, 330.0, 1062, 484607, 682, 20.892559199999596
683, 2.791288221750869, 25.03924042523782, 30.09935172298919, 0.5634248500000001, 290.0, 954, 485561, 683, 18.88418879999972
684, 5.962905422122659, 25.139050947992427, 30.32173983046883, 0.5627219499999999, 180.0, 608, 486169, 684, 12.14287989999957
685, 2.8318525250008366, 24.984398054258804, 30.045468131596305, 0.5621072500000002, 90.0, 758, 486927, 685, 14.933751999999913
686, 9.322437156208961, 25.06010105150163, 30.35735094672005, 0.5614651000000002, 120.0, 669, 487596, 686, 13.369753299999502
687, 3.4637420704120108, 25.067700280850016, 30.16324392667084, 0.5609151999999998, 40.0, 553, 488149, 687, 10.996451799999704
688, 3.072380160102073, 24.950371585172764, 29.940787719277775, 0.5604368499999999, 70.0, 510, 488659, 688, 10.101196999999956
689, 4.393213887950258, 25.10470653463293, 30.276470229739235, 0.55986715, 250.0, 756, 489415, 689, 15.196215299999494
690, 7.540082890274673, 25.16442523487421, 30.40001871517106, 0.5592304000000001, 120.0, 659, 490074, 690, 13.215533900000082
691, 2.7661609520576604, 25.21196537106812, 30.311206924414744, 0.5586445000000002, 80.0, 643, 490717, 691, 12.810890499999914
692, 3.606078490238599, 25.345553494463065, 30.455500501574893, 0.5581769499999998, 75.0, 396, 491113, 692, 7.920586100000037
693, 3.0069152058186, 25.169504948480476, 30.27944797583244, 0.5574636999999999, 525.0, 1189, 492302, 693, 23.87345920000007
694, 3.6577811778075735, 25.302385139907873, 30.458881586167763, 0.5567346999999998, 50.0, 431, 492733, 694, 8.73050449999937
695, 2.6421152004446737, 25.32623467730661, 30.497567713158762, 0.5560142500000002, 645.0, 1170, 493903, 695, 23.417018999999527
696, 2.0066240651735354, 25.11118008499358, 30.20286390044231, 0.5553262, 55.0, 359, 494262, 696, 7.227677699999731
697, 5.707105133601942, 25.274943580283775, 30.544209392650707, 0.5549149000000001, 20.0, 555, 494817, 697, 11.193203900000299
698, 4.6245939447230535, 25.285148301808356, 30.49548052926349, 0.5541913, 170.0, 1053, 495870, 698, 21.367334099999425
699, 4.0756403994131, 25.264406659761775, 30.427841854182393, 0.5532238000000002, 450.0, 1097, 496967, 699, 22.060809300000074
700, 1.7948635463804514, 25.22883141417863, 30.323588034822414, 0.5525451999999997, 75.0, 411, 497378, 700, 8.519698500000231
701, 3.424791340766007, 25.278577137385867, 30.43071909696477, 0.55214155, 85.0, 486, 497864, 701, 9.823570300000029
702, 8.097428652622243, 25.25964637363658, 30.55256168982562, 0.5516168500000002, 80.0, 680, 498544, 702, 13.904709499999626
703, 4.906565660802333, 25.227381099354137, 30.348568934797353, 0.5510088999999997, 125.0, 671, 499215, 703, 13.653506100000413
704, 3.282957252010226, 25.271973625649306, 30.396195623506976, 0.550243, 475.0, 1031, 500246, 704, 20.9002731999999
705, 5.964831874121067, 25.077734951640284, 30.284713996473208, 0.5494887999999998, 210.0, 645, 500891, 705, 13.13412789999984
706, 3.994378945673616, 24.92068866840971, 29.993573399800585, 0.5489362000000002, 135.0, 583, 501474, 706, 11.936710799999673
707, 3.956502059755741, 25.097729550967426, 30.220843929914558, 0.5483876499999997, 150.0, 636, 502110, 707, 12.958130600000004
708, 4.729966850541088, 25.098124756699516, 30.240404024010612, 0.5477990500000002, 320.0, 672, 502782, 708, 13.625715799999853
709, 3.7351336384429006, 25.039999198437926, 30.10294186979755, 0.5473162000000001, 35.0, 401, 503183, 709, 8.252495799999451
710, 2.594478143756078, 25.10108447241284, 30.21356351211563, 0.5466843999999995, 215.0, 1003, 504186, 710, 20.58797830000003
711, 2.9202841916916573, 25.06676384588567, 30.168360951470166, 0.5459378500000001, 60.0, 656, 504842, 711, 13.55595059999996
712, 4.184109587374266, 25.023759577441567, 30.16400471635977, 0.5453667999999997, 160.0, 613, 505455, 712, 12.582191100000273
713, 5.8145731206054805, 25.202853091128237, 30.41429213217429, 0.5449410999999998, 45.0, 333, 505788, 713, 6.832038999999895
714, 4.073166403813658, 25.004900762674875, 30.063891298211388, 0.5444902, 130.0, 669, 506457, 714, 13.66882429999987
715, 4.195815736278421, 25.086170611024656, 30.230695968710485, 0.5436900999999998, 280.0, 1109, 507566, 715, 22.77927600000021
716, 2.6828785988070094, 25.061135973641782, 30.171096694572515, 0.5428787499999997, 85.0, 694, 508260, 716, 14.374334300000555
717, 3.6084754543376736, 25.153166205080737, 30.27074832666785, 0.5421880000000003, 235.0, 841, 509101, 717, 17.424087999999756
718, 1.8897249672336434, 25.021788094160538, 30.07462731287184, 0.5414972499999999, 185.0, 694, 509795, 718, 14.431388599999991
719, 4.587915029165186, 25.328401829283916, 30.512446306958612, 0.5408204500000003, 110.0, 810, 510605, 719, 16.718283900000642
720, 2.1523544515418536, 25.182152591365398, 30.25316368329643, 0.5402286999999999, 55.0, 505, 511110, 720, 10.52780040000016
721, 5.107388523750801, 25.293003965596682, 30.455327225513145, 0.5395622500000001, 370.0, 976, 512086, 721, 20.717000200000257
722, 5.063233719670131, 25.300425092624756, 30.54414150342411, 0.5386131999999997, 230.0, 1133, 513219, 722, 23.533075400000598
723, 1.970885351604345, 25.23582314771236, 30.319741798532625, 0.5378166999999999, 90.0, 637, 513856, 723, 13.366295499999978
724, 3.695363273582114, 25.402407090072437, 30.564148066293857, 0.5371781499999998, 210.0, 782, 514638, 724, 16.208133399999497
725, 1.977764357934738, 25.282544778407306, 30.38009902252548, 0.5366305, 20.0, 435, 515073, 725, 9.1945139999998
726, 2.413032873125191, 25.32072217422619, 30.445915436884118, 0.5358191499999998, 845.0, 1368, 516441, 726, 28.28347339999982
727, 4.806104892866972, 25.315488146525627, 30.524129227370953, 0.5348134, 325.0, 867, 517308, 727, 18.10964999999942
728, 4.390602114238089, 25.324309577791908, 30.488484741350927, 0.5340798999999998, 105.0, 763, 518071, 728, 16.05553719999989
729, 4.384839782981496, 25.31724920965974, 30.529093998117855, 0.53337745, 130.0, 798, 518869, 729, 16.839041700000053
730, 3.445972844979117, 25.296321549229116, 30.39355680263242, 0.5328572499999998, 60.0, 358, 519227, 730, 7.760077900000397
731, 3.5333850338103003, 25.11801951575487, 30.23667921193687, 0.5322313000000001, 270.0, 1033, 520260, 731, 22.231443099999524
732, 2.9791960883451103, 24.894043698466586, 29.920399785968787, 0.5314770999999996, 90.0, 643, 520903, 732, 13.774099300000671
733, 4.277104536838391, 24.940998389440423, 30.081135297522824, 0.53094295, 120.0, 544, 521447, 733, 11.58338989999993
734, 3.8995035949654726, 24.800729862034718, 29.85430600011269, 0.5302940499999999, 205.0, 898, 522345, 734, 19.00547159999951
735, 5.298568693532524, 24.925639815151026, 30.0259891987332, 0.5294476000000002, 325.0, 983, 523328, 735, 20.791771000000153
736, 3.0630443030229624, 24.829055833594055, 29.957783635259602, 0.5287158999999997, 205.0, 643, 523971, 736, 13.788308099999995
737, 2.1437048533119296, 24.830757920127635, 29.84513468873752, 0.5281489, 155.0, 617, 524588, 737, 13.173302199999853
738, 4.830535929450835, 24.962801695591747, 30.039723949644088, 0.5274252999999998, 375.0, 991, 525579, 738, 21.013195300000007
739, 2.828055603763996, 24.937153870020158, 29.979922559933783, 0.5262773500000005, 490.0, 1560, 527139, 739, 33.046883299999536
740, 3.305155767701672, 24.898312003691615, 29.965898595150048, 0.5251955500000001, 145.0, 844, 527983, 740, 17.89128719999917
741, 3.059511821385191, 24.93186646148938, 30.008907798959427, 0.5245479999999997, 120.0, 595, 528578, 741, 12.759745199999998
742, 1.8440057846932925, 24.770173700314004, 29.75841351984378, 0.5240039500000002, 55.0, 614, 529192, 742, 13.265973700000359
743, 3.889802438637146, 24.89764927260427, 30.012854981014556, 0.5234383, 155.0, 643, 529835, 743, 13.831836700000167
744, 2.236227318828089, 24.951516145899674, 30.021409269692242, 0.52283845, 140.0, 690, 530525, 744, 14.73123620000024
745, 2.6425958259866604, 24.97193810827445, 30.026521722683732, 0.5220122499999998, 310.0, 1146, 531671, 745, 24.71437910000077
746, 2.970522004233555, 25.05910309166478, 30.134105122747204, 0.5211622000000002, 220.0, 743, 532414, 746, 15.914759199999935
747, 2.938091080867651, 25.022678377882244, 30.175771011521377, 0.5205024999999999, 135.0, 723, 533137, 747, 15.615509700000075
748, 4.760910566076855, 25.012816700417975, 30.090949682196563, 0.5198702500000003, 155.0, 682, 533819, 748, 14.693012099999578
749, 5.358736288137315, 25.00176281875439, 30.089792974879234, 0.5194031500000001, 100.0, 356, 534175, 749, 7.773686800000178
750, 4.227004192987063, 24.960554787712375, 30.039064351659622, 0.5189963499999998, 80.0, 548, 534723, 750, 11.788323199999468
751, 3.5280325168013422, 24.953801680037497, 30.023440367112823, 0.5183974000000003, 255.0, 783, 535506, 751, 17.078404099999716
752, 5.8593846984672355, 25.011142274023783, 30.144658608695632, 0.5178214, 80.0, 497, 536003, 752, 10.765709500000412
753, 4.140249647989514, 25.081525402977352, 30.261257416861397, 0.51721975, 105.0, 840, 536843, 753, 21.1385980999994
754, 4.430943293343319, 24.997346864250392, 30.15609591880169, 0.5165308000000003, 165.0, 691, 537534, 754, 23.397174200000336
755, 7.946127034252081, 25.01575350206952, 30.187669354815817, 0.5158715499999997, 325.0, 774, 538308, 755, 24.280876900000294
756, 5.235694098037849, 25.014535031546675, 30.135781377368062, 0.5148739000000006, 500.0, 1443, 539751, 756, 44.905572499999835
757, 3.2019643155871518, 25.404742737930185, 30.531560675071105, 0.5139163, 180.0, 685, 540436, 757, 19.948333100000127
758, 8.533201614472507, 25.670823957594177, 30.944474284768962, 0.5132952999999998, 125.0, 695, 541131, 758, 20.230308799999875
759, 3.6022923053020524, 25.61012639987745, 30.796960965763226, 0.5126140000000001, 190.0, 819, 541950, 759, 25.297223399999893
760, 4.3501887536133905, 25.675881562633485, 30.899489900011645, 0.5119614999999998, 115.0, 631, 542581, 760, 19.261820499999885
761, 3.485671273802008, 25.54597948564802, 30.7335714503697, 0.5112838000000004, 215.0, 875, 543456, 761, 26.751788900000065
762, 5.776121330122272, 25.729709212742154, 31.033073236071875, 0.5106632499999999, 40.0, 504, 543960, 762, 15.355525300000409
763, 3.5701854565313886, 25.589861100949115, 30.722368339870286, 0.5100742, 100.0, 805, 544765, 763, 23.80078329999924
764, 4.920463465146553, 25.597331082162682, 30.852032091963753, 0.5092718499999999, 175.0, 978, 545743, 764, 30.135271799999828
765, 4.083898071477542, 25.51971880732356, 30.693444547910946, 0.5084155000000002, 435.0, 925, 546668, 765, 29.030378800000108
766, 4.762435382748362, 25.657490582780124, 30.90689057120868, 0.5077053999999999, 90.0, 653, 547321, 766, 20.240067400000044
767, 4.765768946982409, 25.629755885117085, 30.859169058142594, 0.5067487000000004, 685.0, 1473, 548794, 767, 47.24658229999932
768, 4.5636863439747195, 25.58769084900383, 30.791979723652517, 0.5055143500000003, 400.0, 1270, 550064, 768, 40.095498800000314
769, 3.794761710032059, 25.44788674681726, 30.586711251474647, 0.5046345999999995, 130.0, 685, 550749, 769, 21.10385479999968
770, 3.5020881422994306, 25.429718873818224, 30.625564429536077, 0.5038903000000001, 260.0, 969, 551718, 770, 31.042829699999857
771, 6.8875935697740704, 25.577450659148088, 30.923675297280035, 0.50315005, 120.0, 676, 552394, 771, 21.057737299999644
772, 3.697117312288866, 25.476413697731203, 30.684277450166096, 0.5025506500000001, 130.0, 656, 553050, 772, 20.811587499999405
773, 3.5479542198160807, 25.524457782147877, 30.66738360378158, 0.5020313499999997, 45.0, 498, 553548, 773, 15.69302020000032
774, 4.78629392568079, 25.468353392519628, 30.688404408795044, 0.5016016, 75.0, 457, 554005, 774, 14.546945399999458
775, 5.58196045343902, 25.454983378241224, 30.67236447377876, 0.5011498000000002, 105.0, 547, 554552, 775, 17.124891299999945
776, 1.976535600066806, 25.552476998170217, 30.707821420828502, 0.5006876499999999, 110.0, 480, 555032, 776, 15.383191300000362
777, 3.3113478359143627, 25.456049358683973, 30.56887388872503, 0.5002381, 135.0, 519, 555551, 777, 16.136420599999838
778, 6.169452655818817, 25.517409510225864, 30.765466424581167, 0.4996715500000002, 150.0, 740, 556291, 778, 23.80484549999983
779, 2.5435178948191757, 25.44506210799213, 30.581834852098876, 0.4988439999999997, 400.0, 1099, 557390, 779, 35.1642154000001
780, 3.093929629030726, 25.49847317295333, 30.668327980853142, 0.4981168, 115.0, 517, 557907, 780, 16.813720799999828
781, 4.231108186312485, 25.65858612060547, 30.898185649514197, 0.49759614999999985, 90.0, 640, 558547, 781, 19.812683399999514
782, 3.2283688407670557, 25.433128670261997, 30.586200729321444, 0.497026, 150.0, 627, 559174, 782, 19.822532899999715
783, 3.6312332188928282, 25.436701063676313, 30.61719838922674, 0.4965706, 50.0, 385, 559559, 783, 12.431306700000277
784, 2.935348353244211, 25.427845540581533, 30.568490787704974, 0.49582764999999973, 205.0, 1266, 560825, 784, 39.85742169999958
785, 2.981423270173611, 25.443915222537132, 30.612348996439287, 0.49497894999999964, 60.0, 620, 561445, 785, 19.409201099999336
786, 3.6933493436681566, 25.426893724214047, 30.595112758601477, 0.49420945000000016, 570.0, 1090, 562535, 786, 34.24378479999996
787, 6.489065815369407, 25.553439238714795, 30.842347281319753, 0.4932653499999999, 530.0, 1008, 563543, 787, 32.716231500000504
788, 4.6768840438894275, 25.411135386494756, 30.568825934697124, 0.49253365000000005, 65.0, 618, 564161, 788, 19.631549599999744
789, 4.2313394106765045, 25.525105286811105, 30.728621567425744, 0.49210839999999995, 15.0, 327, 564488, 789, 10.780546200000572
790, 3.788819536272847, 25.489332544620755, 30.67105567046027, 0.4913452000000002, 780.0, 1369, 565857, 790, 43.831244799999695
791, 3.6905979511045075, 25.44988258609378, 30.61183103488258, 0.4905766, 65.0, 339, 566196, 791, 11.40615809999963
792, 8.25988462073752, 25.60235562552733, 30.94433695603378, 0.49024539999999994, 60.0, 397, 566593, 792, 13.240466999999626
793, 3.8905076421797276, 25.511515349419817, 30.705446220236603, 0.4897688500000001, 205.0, 662, 567255, 793, 22.450425400000313
794, 4.447957889724536, 25.431970074828644, 30.610514063364857, 0.4891104999999998, 175.0, 801, 568056, 794, 26.341808800000763
795, 5.18268325684532, 25.42341212816136, 30.616405199932796, 0.48858265000000006, 70.0, 372, 568428, 795, 12.129116499999327
796, 5.930927222715671, 25.48329598848675, 30.701782704399317, 0.4879859499999997, 210.0, 954, 569382, 796, 31.927893099999892
797, 2.8182487744535947, 25.38825147474134, 30.506094927401158, 0.48722365, 235.0, 740, 570122, 797, 24.856258499999967
798, 3.3840741805921057, 25.27363443281683, 30.433728026600143, 0.4866597999999998, 75.0, 513, 570635, 798, 17.74011950000022
799, 4.518469653209836, 25.217743203689373, 30.334073962913845, 0.48618999999999984, 40.0, 531, 571166, 799, 18.357513599999947
800, 3.798235166601688, 25.323239062424506, 30.45956246315242, 0.48547809999999997, 350.0, 1051, 572217, 800, 35.170079099999384
801, 2.864530341909879, 25.244095780197213, 30.336690696350757, 0.4847140000000001, 105.0, 647, 572864, 801, 20.99329190000026
802, 5.48307794606199, 25.337697833074692, 30.51101180934457, 0.4841362000000002, 145.0, 637, 573501, 802, 20.50446860000011
803, 4.3826351595503805, 25.270819895407733, 30.38215882871665, 0.48348234999999995, 265.0, 816, 574317, 803, 23.511952000000747
804, 2.0517767853491855, 25.214997722525638, 30.28627534093384, 0.4829607999999999, 45.0, 343, 574660, 804, 8.682178900000508
805, 2.167961656190883, 25.177011329095482, 30.25007775916907, 0.48257155, 85.0, 522, 575182, 805, 13.316308800000115
806, 4.305034460817786, 25.333013706482372, 30.490937216923786, 0.4815878500000001, 630.0, 1664, 576846, 806, 44.27928930000053
807, 4.433818373815174, 25.317730417858794, 30.510423506690323, 0.4803584500000003, 375.0, 1068, 577914, 807, 28.087217500000406
808, 2.0985524890338945, 25.219069097288518, 30.317542041669302, 0.47951649999999973, 135.0, 803, 578717, 808, 20.73615780000091
809, 3.8734031176445627, 25.29251827192157, 30.46056148624719, 0.47886805000000005, 105.0, 638, 579355, 809, 16.654918399999588
810, 3.984890298752038, 25.274089124104748, 30.426683403041263, 0.47831815, 150.0, 584, 579939, 810, 15.044301499998255
811, 5.85517365837744, 25.614270737268864, 30.925470808415714, 0.4776490000000003, 215.0, 903, 580842, 811, 22.52254350000112
812, 3.2164855946076654, 25.644734049735757, 30.823503061268173, 0.47668959999999955, 230.0, 1229, 582071, 812, 31.014896299999236
813, 5.377644439151823, 25.707553939936894, 30.924555347953998, 0.47584450000000017, 180.0, 649, 582720, 813, 16.374469399999725
814, 5.110748625285394, 25.53188472675486, 30.702529862028726, 0.4753625499999999, 75.0, 422, 583142, 814, 10.6924723000011
815, 4.972843024123598, 25.62467927155671, 30.93423697012442, 0.47486890000000015, 215.0, 675, 583817, 815, 17.45705199999975
816, 4.64788455904151, 25.591249624888103, 30.82334685166677, 0.47402514999999973, 320.0, 1200, 585017, 816, 30.663531800000783
817, 3.0645563018086146, 25.575350653010307, 30.764793283476248, 0.4731723999999999, 185.0, 695, 585712, 817, 18.052913700001227
818, 6.595071500405721, 25.651981624352477, 30.92764584498422, 0.4725995499999998, 105.0, 578, 586290, 818, 15.056163600000218
819, 2.643475805361246, 25.63380291114324, 30.789551817791452, 0.47172835000000024, 500.0, 1358, 587648, 819, 34.45039489999908
820, 3.893098612893679, 25.61589677807818, 30.836191040518038, 0.47081619999999996, 145.0, 669, 588317, 820, 17.25710529999924
821, 5.633964671989141, 25.57922272095417, 30.791042004144174, 0.47019700000000003, 100.0, 707, 589024, 821, 18.367347100000188
822, 2.538915490222649, 25.739816278806874, 31.012462524628976, 0.4697190999999998, 50.0, 355, 589379, 822, 9.320277900000292
823, 3.889974812094037, 25.56437767261767, 30.753150121674285, 0.4692646000000002, 120.0, 655, 590034, 823, 17.066442400000597
824, 5.049005318675414, 25.854884536007802, 31.13910044244973, 0.46859635000000005, 185.0, 830, 590864, 824, 21.365747199999532
825, 4.038218772901384, 25.7718300330216, 30.998871621326654, 0.46775350000000027, 260.0, 1043, 591907, 825, 27.3268433000012
826, 6.213208789204389, 25.812680674788634, 31.130836006735457, 0.46708569999999994, 55.0, 441, 592348, 826, 11.57164990000092
827, 6.83099090365549, 26.021685845239503, 31.38889428802262, 0.4667068000000001, 55.0, 401, 592749, 827, 10.464273199999298
828, 5.879451230379943, 25.882901907323543, 31.169217721229177, 0.46592425, 560.0, 1338, 594087, 828, 34.51045499999964
829, 4.5863463851067445, 25.823460882709874, 31.084525850511366, 0.4648757500000003, 420.0, 992, 595079, 829, 26.479469300000346
830, 4.080827455035414, 25.892736531920352, 31.152505374501494, 0.4639779999999996, 165.0, 1003, 596082, 830, 26.497369400000025
831, 4.5228242611151135, 25.91682769647285, 31.189256892275456, 0.46328544999999993, 120.0, 536, 596618, 831, 14.050271500000235
832, 1.9872481707666036, 25.74297749686997, 30.91001618080249, 0.46273194999999984, 115.0, 694, 597312, 832, 18.135344700000132
833, 5.687467206835747, 25.927113670349122, 31.260196765899657, 0.46219465000000004, 165.0, 500, 597812, 833, 13.45618000000104
834, 2.99948230853412, 25.919558276242363, 31.16781917781857, 0.4616506, 170.0, 709, 598521, 834, 18.76652230000036
835, 2.8258775949173005, 25.885926089324776, 31.13481842101773, 0.4609360000000002, 145.0, 879, 599400, 835, 23.290115499999956
836, 7.0970891340377324, 25.71190014761127, 31.019144545534175, 0.46031500000000014, 150.0, 501, 599901, 836, 13.283808099999078
837, 4.861174376109821, 27.39537993452992, 32.986206683833814, 0.4596584499999995, 285.0, 958, 600859, 837, 25.527247199999692
838, 3.531198221068633, 27.620952610216644, 33.26614962929173, 0.4590136, 60.0, 475, 601334, 838, 12.894494500000292
839, 3.4751075190646974, 27.584776213633727, 33.18371149961165, 0.4581671499999999, 525.0, 1406, 602740, 839, 37.355651699999726
840, 4.83176306662493, 27.566077121729016, 33.2465566503494, 0.45722799999999997, 125.0, 681, 603421, 840, 18.19137000000046
841, 3.7209966119625304, 27.535687881213754, 33.117378001999654, 0.4564387000000003, 325.0, 1073, 604494, 841, 28.924735399999918
842, 6.306136802695692, 27.634264278411866, 33.414868302345276, 0.45559584999999964, 325.0, 800, 605294, 842, 21.636465800000224
843, 2.253307355682608, 27.58163102531054, 33.0950247648933, 0.45500949999999984, 60.0, 503, 605797, 843, 13.424714900000254
844, 3.4543535400423324, 27.69427486180294, 33.30310538133629, 0.45433854999999984, 630.0, 988, 606785, 844, 27.191246200000023
845, 2.693307231089433, 27.651510795760235, 33.252721532828076, 0.45335935000000016, 390.0, 1188, 607973, 845, 31.585009599999466
846, 8.856434274137577, 27.697355780200425, 33.46395098071232, 0.4523432500000003, 250.0, 1070, 609043, 846, 28.425801699999283
847, 2.311726736890919, 27.5954506855385, 33.162800717821305, 0.45163224999999996, 105.0, 510, 609553, 847, 13.401576500000374
848, 3.8581533801741896, 27.605771327018736, 33.15394731044769, 0.4512227500000001, 55.0, 400, 609953, 848, 10.47560700000031
849, 3.2907072277703406, 27.889837855031054, 33.54781994838195, 0.45058015, 320.0, 1028, 610981, 849, 27.160307300000568
850, 3.8063775669385054, 27.955892721212134, 33.61669661563897, 0.4497597999999998, 100.0, 795, 611776, 850, 21.02833660000033
851, 2.321761748558069, 27.947474748290553, 33.531052692175365, 0.4491640000000002, 45.0, 529, 612305, 851, 14.116406899998765
852, 4.211613281493884, 28.029873561039352, 33.69993705530904, 0.4487688999999999, 35.0, 349, 612654, 852, 9.33867199999986
853, 4.712174903486053, 27.94997240980249, 33.6310350560534, 0.4483648000000001, 155.0, 549, 613203, 853, 14.581282200000715
854, 6.8801150824540835, 27.92233441807463, 33.70281445082798, 0.44786664999999987, 115.0, 558, 613761, 854, 14.6910527
855, 2.3005312840538945, 27.853880578821357, 33.44533531449058, 0.4474175499999999, 80.0, 440, 614201, 855, 11.753584000000046
856, 5.372733641393674, 27.950652781182068, 33.677917682171184, 0.4465387000000003, 525.0, 1513, 615714, 856, 40.367360799999005
857, 4.1639574665923496, 27.87580707517721, 33.53862850746866, 0.44543305000000005, 265.0, 944, 616658, 857, 25.981451199999356
858, 3.35341108525237, 28.00349439941086, 33.652865930037066, 0.44475085000000003, 85.0, 572, 617230, 858, 15.18017399999917
859, 3.8261077558956087, 27.953595831455328, 33.61644461949666, 0.44414244999999974, 175.0, 780, 618010, 859, 20.551667899999302
860, 3.635124462331111, 27.90906015644701, 33.56395969785813, 0.44342200000000015, 155.0, 821, 618831, 860, 21.91259539999919
861, 4.060717116802208, 27.948258444858176, 33.66033453676058, 0.44273709999999983, 170.0, 701, 619532, 861, 18.599818599999708
862, 5.607714887972422, 27.647671408808808, 33.28843558303953, 0.4420216, 150.0, 889, 620421, 862, 23.65736840000136
863, 4.331640440454467, 27.589508435562973, 33.15239451922638, 0.4413520000000001, 85.0, 599, 621020, 863, 15.978566499999943
864, 3.4654877611818455, 27.487591415643692, 33.05019781419209, 0.44067924999999997, 375.0, 896, 621916, 864, 23.869530100000702
865, 4.9466273236116995, 27.53233607565792, 33.11451427650983, 0.4399529499999997, 330.0, 718, 622634, 865, 19.185654999999315
866, 5.2234120408150675, 27.547655567526817, 33.21863356232643, 0.43945704999999974, 35.0, 384, 623018, 866, 11.249662800000806
867, 8.236834372102305, 27.6658271808964, 33.37386495284452, 0.43910740000000004, 55.0, 393, 623411, 867, 11.415947200001028
868, 3.1228763817257903, 27.523929219376026, 33.09563464414251, 0.4386501999999998, 85.0, 623, 624034, 868, 18.00504010000077
869, 4.138245746634543, 27.480505663681456, 33.083604208734656, 0.4379662, 210.0, 897, 624931, 869, 26.010301500000423
870, 2.418179386382768, 27.57676212014206, 33.11687430108201, 0.43739469999999986, 50.0, 373, 625304, 870, 10.894482699999571
871, 5.6957056517917515, 27.616680545226295, 33.30758490234513, 0.4368277000000002, 180.0, 887, 626191, 871, 26.193173800000295
872, 4.662913329123416, 27.526611874355016, 33.17940117997703, 0.4357544499999999, 605.0, 1498, 627689, 872, 43.90605109999888
873, 3.2486647858986486, 27.554298424353966, 33.12851297231821, 0.4347878499999999, 205.0, 650, 628339, 873, 18.99559760000011
874, 3.293332672235391, 27.518232751399914, 33.139742023193605, 0.43405120000000025, 235.0, 987, 629326, 874, 29.239304700000503
875, 4.664479146813333, 27.645096342573282, 33.307279050108875, 0.43338475, 80.0, 494, 629820, 875, 14.676622700000735
876, 2.291520127614733, 27.392820780033325, 32.89597541506928, 0.4330261, 0.0, 303, 630123, 876, 8.968706999999995
877, 5.956959655025185, 27.42573577108334, 33.04067483409986, 0.4322809000000002, 370.0, 1353, 631476, 877, 40.24011160000009
878, 4.490890288732008, 27.348468682149072, 32.931586347259845, 0.4311572500000003, 420.0, 1144, 632620, 878, 33.83432390000053
879, 5.700307428822098, 27.481512405184418, 33.171701766756684, 0.4304147499999999, 40.0, 506, 633126, 879, 15.384350799999083
880, 4.252947046193498, 27.502759966044994, 33.08779433465773, 0.42994989999999994, 70.0, 527, 633653, 880, 15.44898110000031
881, 3.2830731255538534, 27.37441124578919, 32.917129994402025, 0.4294900000000002, 55.0, 495, 634148, 881, 14.70995049999874
882, 3.7014761902048567, 27.346484590785295, 32.90905617129418, 0.42887664999999964, 175.0, 868, 635016, 882, 25.878561599998648
883, 5.667243673229999, 27.3416629041362, 32.91945750625045, 0.42817015, 395.0, 702, 635718, 883, 20.784870100000262
884, 4.34766393577362, 27.440253004795167, 32.97369874105221, 0.4275590499999998, 120.0, 656, 636374, 884, 19.299708500000634
885, 7.430153257339387, 27.52658881110114, 33.220330965196766, 0.42709735000000004, 75.0, 370, 636744, 885, 11.017108500000177
886, 2.37111567594111, 27.292682894793423, 32.76483048959212, 0.42673284999999983, 95.0, 440, 637184, 886, 13.200166500000705
887, 7.533683386332911, 27.48465377920075, 33.14224610724497, 0.4259547999999994, 365.0, 1289, 638473, 887, 38.57310940000025
888, 2.8899846632626995, 27.463944321185085, 32.999429517087684, 0.42496795, 205.0, 904, 639377, 888, 26.83718399999998
889, 3.2519461138082995, 27.466565673648773, 33.03830856612966, 0.42406345000000023, 350.0, 1106, 640483, 889, 33.01002270000026
890, 5.4097086200704965, 27.896666265814506, 33.590985354255224, 0.42321384999999967, 185.0, 782, 641265, 890, 23.627292599998327
891, 3.0348533346082074, 27.787417230261376, 33.41070831942271, 0.4224884499999999, 265.0, 830, 642095, 891, 24.7937550000006
892, 5.570862460605297, 27.827372546250974, 33.553125736544516, 0.4218417999999999, 55.0, 607, 642702, 892, 18.68481199999951
893, 5.6918749816880725, 27.758676236492203, 33.41789504575973, 0.42130449999999986, 55.0, 587, 643289, 893, 18.121287199999642
894, 5.055598434049866, 27.838741834903907, 33.50871755840963, 0.4205808999999997, 325.0, 1021, 644310, 894, 36.48065629999837
895, 4.695261948312936, 27.858289118563192, 33.51495327753074, 0.41988114999999987, 110.0, 534, 644844, 895, 17.63756420000027
896, 2.9090369856088145, 27.88585824368185, 33.47045234912436, 0.4191530499999997, 495.0, 1084, 645928, 896, 33.90974170000118
897, 6.216438318616084, 27.889644152797054, 33.6478265609304, 0.41835114999999995, 160.0, 698, 646626, 897, 21.282934299999397
898, 4.5364840707827545, 27.898494788095462, 33.57675389026074, 0.41778324999999983, 55.0, 564, 647190, 898, 17.252644599999257
899, 5.0874314756314405, 27.887287880748815, 33.59656286551282, 0.41704750000000024, 445.0, 1071, 648261, 899, 32.42935519999992
900, 2.870226639224788, 27.83745266514584, 33.39932474989523, 0.4161812499999996, 355.0, 854, 649115, 900, 25.919786999998905
901, 7.591081820632928, 27.925562877715453, 33.71403322149355, 0.41537080000000004, 145.0, 947, 650062, 901, 28.801551600001403
902, 4.090666777455178, 28.038150420352114, 33.73686044288939, 0.4144582000000001, 265.0, 1081, 651143, 902, 33.083686099998886
903, 5.391700591074542, 28.152855030047856, 33.911472843732206, 0.41368464999999993, 160.0, 638, 651781, 903, 19.48591320000014
904, 3.8087587082272742, 28.080340131707146, 33.78193085596727, 0.4130542000000002, 260.0, 763, 652544, 904, 23.209088199999314
905, 4.466632207047739, 27.99625310362055, 33.67825424322921, 0.41231035, 165.0, 890, 653434, 905, 27.185538399999132
906, 3.5671493461776724, 27.936367844090316, 33.62126428208429, 0.4117168, 40.0, 429, 653863, 906, 13.355432799999107
907, 5.875165808677848, 28.02306765081599, 33.73815153908975, 0.4112173, 195.0, 681, 654544, 907, 20.862892799999827
908, 3.2178426159584363, 27.983957387633243, 33.66860696824931, 0.41043294999999974, 345.0, 1062, 655606, 908, 32.755252900000414
909, 3.0360724290194443, 27.952898396198826, 33.61675891269643, 0.409573, 190.0, 849, 656455, 909, 26.19862219999959
910, 4.214572477333703, 28.033154724909107, 33.71735126423724, 0.4088075500000003, 330.0, 852, 657307, 910, 26.22098509999887
911, 3.7828687141713857, 28.0700562330162, 33.76694739839566, 0.4078517499999995, 675.0, 1272, 658579, 911, 39.37558660000104
912, 3.1164562417775583, 27.931080719771657, 33.58713839828589, 0.40692609999999996, 230.0, 785, 659364, 912, 24.459568500000387
913, 5.033609608864295, 27.983059330133166, 33.68851891834445, 0.4060459, 530.0, 1171, 660535, 913, 36.34159600000021
914, 5.230971952911312, 27.945193127062193, 33.6360542126818, 0.40483449999999993, 635.0, 1521, 662056, 914, 47.14814579999984
915, 5.221368589546537, 27.947540417641797, 33.678913452551754, 0.40384359999999986, 165.0, 681, 662737, 915, 21.270239900000888
916, 2.3296499281436547, 27.915248070640125, 33.501982697125136, 0.40322395000000005, 150.0, 696, 663433, 916, 21.707492999999886
917, 3.501865657187492, 27.96035238284509, 33.626120682133056, 0.4024472499999999, 275.0, 1030, 664463, 917, 32.01111670000137
918, 6.416990037762259, 28.032995167197104, 33.7391778951902, 0.40169665, 125.0, 638, 665101, 918, 19.866213499999503
919, 4.563257749851553, 27.915864041743387, 33.52715817766595, 0.4009968999999999, 440.0, 917, 666018, 919, 28.568503800001054
920, 5.24059556619752, 27.92423946289789, 33.58917702720279, 0.40039525, 90.0, 420, 666438, 920, 13.254205699999147
921, 2.9130070112404174, 27.912424200110966, 33.566129216441404, 0.3998174500000001, 275.0, 864, 667302, 921, 26.866751900000963
922, 5.5381622919971845, 28.009738160265464, 33.73138766858791, 0.39895435000000035, 510.0, 1054, 668356, 922, 33.31426520000059
923, 2.2301189626762437, 27.85375053188223, 33.43784052582719, 0.39825910000000003, 120.0, 491, 668847, 923, 15.602355300001364
924, 6.0912409415680235, 27.934275047345594, 33.589135107668966, 0.3977213500000001, 110.0, 704, 669551, 924, 22.071031199999197
925, 3.694626166257416, 27.947862195354674, 33.60380377994586, 0.39698515, 385.0, 932, 670483, 925, 29.369149000000107
926, 7.043039928446038, 28.05159350191609, 33.89686774289053, 0.39628540000000007, 130.0, 623, 671106, 926, 19.95609119999972
927, 5.812187165893505, 28.032895237307983, 33.770374145765274, 0.395605, 230.0, 889, 671995, 927, 28.35302059999958
928, 3.446860368287168, 28.012114306811053, 33.67697596924467, 0.3949471000000001, 100.0, 573, 672568, 928, 18.477462799999557
929, 9.746493926159172, 28.1976966192556, 34.04708817947743, 0.3944957499999999, 55.0, 430, 672998, 929, 13.560295100000076
930, 5.073099274596023, 28.009856456547826, 33.63864154720781, 0.39412135000000004, 20.0, 402, 673400, 930, 13.35915869999917
931, 4.148974874392807, 28.155847356466253, 33.923494076099566, 0.39363354999999983, 135.0, 682, 674082, 931, 21.834867399998984
932, 4.711995027552324, 28.006180293471726, 33.6952590253618, 0.39284064999999996, 245.0, 1080, 675162, 932, 34.841502899998886
933, 4.5455098049819025, 28.13803042089186, 33.870198186002256, 0.39211255000000006, 70.0, 538, 675700, 933, 17.08015460000024
934, 5.134109509383472, 27.988216595007824, 33.6272706251878, 0.3914960500000001, 230.0, 832, 676532, 934, 26.402931300001
935, 3.9188927191936846, 28.03275916771013, 33.73010677950723, 0.3907688499999999, 90.0, 784, 677316, 935, 25.096784000001207
936, 2.0314831855298765, 27.982087344266056, 33.59149063303229, 0.3902558499999999, 65.0, 356, 677672, 936, 11.491292299999259
937, 3.806512345308028, 28.16528178360977, 33.83152878159497, 0.389881, 80.0, 477, 678149, 937, 15.389894799998729
938, 4.226266073683898, 28.18589278979179, 33.87754980233999, 0.38949085, 45.0, 390, 678539, 938, 12.496286699999473
939, 4.171470625988736, 27.989571433116193, 33.68206722879479, 0.38900799999999985, 190.0, 683, 679222, 939, 22.102941099999953
940, 4.600213916329451, 28.37202360286269, 34.13465506087902, 0.3882168999999997, 155.0, 1075, 680297, 940, 34.34784779999973
941, 5.321459996541018, 29.22479712272036, 35.17349687002707, 0.38723634999999995, 485.0, 1104, 681401, 941, 35.59843759999967
942, 5.67660087815001, 29.114439982684846, 35.03512323658, 0.38657619999999987, 70.0, 363, 681764, 942, 11.828622500001075
943, 4.6944391886385795, 29.223116073779718, 35.146839907069406, 0.38581165, 520.0, 1336, 683100, 943, 43.18194559999938
944, 2.481586754782103, 29.18498739277024, 35.06619954396443, 0.38491164999999994, 210.0, 664, 683764, 944, 21.400717200000145
945, 4.561355890802916, 29.25330768395524, 35.242600037379816, 0.3842056, 370.0, 905, 684669, 945, 29.174339899998813
946, 3.1939470078396437, 29.214435851625108, 35.14044363611246, 0.38337895000000016, 230.0, 932, 685601, 946, 30.091804700001376
947, 6.716867100986603, 29.381351410296926, 35.39361500740051, 0.38254914999999967, 365.0, 912, 686513, 947, 29.56391310000072
948, 3.980111409250205, 29.262550310361185, 35.19011566356077, 0.38160775, 345.0, 1180, 687693, 948, 38.30786690000059
949, 4.059897457170259, 29.173491408048836, 35.08397226249717, 0.3807698500000001, 125.0, 682, 688375, 949, 22.27668619999895
950, 3.42502950548427, 29.26973207368842, 35.224477981209645, 0.3799639, 340.0, 1109, 689484, 950, 35.76464750000014
951, 4.8375114630981395, 29.28984223618338, 35.22734528191005, 0.37923715, 35.0, 506, 689990, 951, 16.686411099999532
952, 5.6133415224346725, 29.475073428440343, 35.507973992170925, 0.3788371000000001, 35.0, 383, 690373, 952, 12.701101699998617
953, 2.1697730538299482, 29.248771410894527, 35.114056643739914, 0.3781863999999996, 475.0, 1063, 691436, 953, 34.49022230000082
954, 4.191732265823067, 29.25732348025011, 35.17656171155839, 0.3775465, 50.0, 359, 691795, 954, 11.776366799998868
955, 2.2857665909597507, 29.249975252310968, 35.1264302212259, 0.37711585, 105.0, 598, 692393, 955, 19.65308980000009
956, 4.999945608164192, 29.315887773146322, 35.24946897314229, 0.3766015000000001, 115.0, 545, 692938, 956, 17.95234569999957
957, 4.489221608294371, 29.220482434390895, 35.156811011161686, 0.37605835, 145.0, 662, 693600, 957, 21.734014699999534
958, 3.9576082835422444, 29.257681970893493, 35.1640199493754, 0.37544274999999977, 115.0, 706, 694306, 958, 23.024318300000232
959, 4.105549706984311, 29.34145428112575, 35.31748793636049, 0.37462105, 345.0, 1120, 695426, 959, 36.661815299999944
960, 3.6871981178298454, 29.21276790245183, 35.11778174310427, 0.37387360000000014, 80.0, 541, 695967, 960, 17.97227059999932
961, 5.800227192924385, 29.351745192767584, 35.30038961220903, 0.3732454, 610.0, 855, 696822, 961, 28.36065790000066
962, 5.145521117834868, 29.264043668166813, 35.21729683615186, 0.37244934999999973, 260.0, 914, 697736, 962, 30.39049840000007
963, 4.403005533244651, 29.417662492903585, 35.35874715437697, 0.3716245, 80.0, 919, 698655, 963, 30.248222399999577
964, 7.373172372461934, 29.30364203704031, 35.305360151592055, 0.37103995000000006, 30.0, 380, 699035, 964, 12.707490599999801
965, 4.203501733055014, 29.219543818223517, 35.1063919257484, 0.37046260000000003, 265.0, 903, 699938, 965, 29.955056500000865
966, 2.309648159304506, 29.25298731294397, 35.10836829551279, 0.36979344999999975, 85.0, 584, 700522, 966, 19.29057020000073
967, 5.1357310455119, 29.483020812074784, 35.501937413691415, 0.36912474999999995, 245.0, 902, 701424, 967, 30.20436559999871
968, 7.0158827608748275, 29.66687185398335, 35.783696241421424, 0.3684168999999999, 230.0, 671, 702095, 968, 22.334329199999047
969, 2.6187604586003532, 29.524582430342555, 35.440556163519204, 0.36795520000000004, 35.0, 355, 702450, 969, 11.906259400000636
970, 2.535546826486346, 29.596874744077272, 35.525146131877655, 0.36761770000000005, 30.0, 395, 702845, 970, 13.414758799999618
971, 2.959985834992912, 29.574962987358557, 35.52949032718188, 0.3669800499999996, 495.0, 1022, 703867, 971, 34.14694280000003
972, 6.524378514288161, 29.61810106791734, 35.655756786550405, 0.3661246000000001, 205.0, 879, 704746, 972, 29.481093800000963
973, 5.896824249962102, 29.672513653299085, 35.74534027763035, 0.36547030000000014, 95.0, 575, 705321, 973, 19.12592349999977
974, 6.256525395249901, 29.6049540730556, 35.65118061920211, 0.3649041999999999, 125.0, 683, 706004, 974, 22.991977300000144
975, 3.161363262636106, 29.574128631609316, 35.53469659430836, 0.3642048999999997, 450.0, 871, 706875, 975, 29.377291499999046
976, 6.303560292364666, 29.62440410350104, 35.696774961363595, 0.3634551999999999, 340.0, 795, 707670, 976, 26.778661700000157
977, 4.458934115898059, 29.6409967010626, 35.68600975892329, 0.36266814999999963, 155.0, 954, 708624, 977, 32.420016699999906
978, 3.3754777438872683, 29.519822213502056, 35.44887687604336, 0.36193375000000017, 190.0, 678, 709302, 978, 22.91211420000036
979, 5.353786658981271, 29.574510323934714, 35.611102693795715, 0.36114534999999987, 560.0, 1074, 710376, 979, 36.19599790000029
980, 3.91431103494209, 29.540621527720628, 35.49555420845784, 0.36030159999999994, 95.0, 801, 711177, 980, 26.991499199999453
981, 4.771720885315614, 29.524858946884546, 35.5335246312829, 0.35948305000000025, 265.0, 1018, 712195, 981, 34.432579799999075
982, 3.373675687885192, 29.520479474042983, 35.43871045730275, 0.3586775499999998, 145.0, 772, 712967, 982, 26.10666889999993
983, 6.829417910191427, 29.60558130838614, 35.66438986554908, 0.35808805, 15.0, 538, 713505, 983, 18.26337170000079
984, 4.491828766222233, 29.55211357448412, 35.480890168314396, 0.35743194999999994, 380.0, 920, 714425, 984, 31.402392199999667
985, 6.613480185682957, 29.595470765920787, 35.697282908512996, 0.35672544999999994, 170.0, 650, 715075, 985, 22.180114099999628
986, 5.415302160240355, 29.532655212449733, 35.56761773822224, 0.3559982499999999, 210.0, 966, 716041, 986, 32.821393700000044
987, 7.382533392785356, 29.522860682927647, 35.52270568639804, 0.3552827499999999, 55.0, 624, 716665, 987, 21.609118899999885
988, 5.286703912670364, 29.58267089399961, 35.575996981989036, 0.35463835, 345.0, 808, 717473, 988, 27.77124079999885
989, 5.4192550884895105, 29.50137913097787, 35.495437696543796, 0.3538598500000001, 145.0, 922, 718395, 989, 31.53765519999979
990, 4.670401333869159, 29.569566955398543, 35.56859436077122, 0.35303589999999985, 220.0, 909, 719304, 990, 31.404218499999843
991, 5.099417370328084, 29.37676645361859, 35.293435586771004, 0.3523991499999999, 60.0, 506, 719810, 991, 17.37196959999892
992, 6.712499097319905, 30.71932538764884, 37.04922089955953, 0.35182629999999987, 200.0, 767, 720577, 992, 26.311446400000932
993, 3.130304893242532, 31.126749784188064, 37.389139429199474, 0.3510482500000001, 195.0, 962, 721539, 993, 33.18699039999956
994, 6.447519605447938, 31.248117561454887, 37.59449016868889, 0.35031564999999987, 165.0, 666, 722205, 994, 20.35492979999981
995, 6.009637573063703, 31.100044804166746, 37.44024392100623, 0.34960825000000006, 280.0, 906, 723111, 995, 29.641558400000577
996, 2.5188715998794287, 31.090713257098017, 37.323005345031504, 0.34896474999999993, 95.0, 524, 723635, 996, 18.406897999999273
997, 4.13983294819897, 31.053668454219476, 37.31292090617435, 0.3483455500000001, 235.0, 852, 724487, 997, 29.238364300001194
998, 6.469802716230345, 31.20534693420217, 37.53505604013966, 0.34767819999999994, 135.0, 631, 725118, 998, 25.115456800000175
999, 2.508204642026951, 31.045404798635477, 37.33749496611413, 0.3472129, 105.0, 403, 725521, 999, 13.49849279999944
1000, 6.8351001574681645, 31.039455327631682, 37.36953018503245, 0.34657344999999995, 330.0, 1018, 726539, 1000, 31.87485089999973
1001, 9.098458759859847, 31.216076210166918, 37.686748089567985, 0.3458547999999999, 125.0, 579, 727118, 1001, 17.837189500000022
1002, 3.6840577045880902, 31.116653868908017, 37.42298233452745, 0.3453084999999998, 180.0, 635, 727753, 1002, 19.808159900001556
1003, 3.69964849070572, 31.027799650818157, 37.25877345071795, 0.3447333999999999, 120.0, 643, 728396, 1003, 19.658764299998438
1004, 3.84959322404943, 31.081864285212692, 37.36341150718234, 0.34398370000000017, 435.0, 1023, 729419, 1004, 30.834914099999878
1005, 3.8357009079408, 31.075254471237596, 37.39782134391166, 0.34335685, 85.0, 370, 729789, 1005, 11.286129699999947
1006, 4.623396249104561, 31.03227894042243, 37.32568215582203, 0.34269850000000024, 615.0, 1093, 730882, 1006, 33.69178590000047
1007, 4.177071286237578, 30.9850451232966, 37.233823125338404, 0.34171479999999965, 290.0, 1093, 731975, 1007, 33.34591739999996
1008, 5.702499059103429, 30.88197509765625, 37.079461512565615, 0.34104294999999996, 60.0, 400, 732375, 1008, 12.302949400000216
1009, 4.4149797029277105, 30.919291886938623, 37.14304043585996, 0.34056414999999995, 55.0, 664, 733039, 1009, 20.466678200000388
1010, 4.099122311402244, 30.93457599037025, 37.20431477497319, 0.3399350499999999, 335.0, 734, 733773, 1010, 23.018940199999633
1011, 4.602136723033272, 30.89880576464209, 37.18926458390239, 0.3390593499999998, 285.0, 1212, 734985, 1011, 37.0292845999993
1012, 4.907523892559372, 31.016557820193416, 37.32906575858732, 0.33812784999999995, 305.0, 858, 735843, 1012, 26.803348900000856
1013, 6.26965903593914, 31.003101301995162, 37.41901707618388, 0.33739389999999997, 130.0, 773, 736616, 1013, 23.950875699998505
1014, 3.111441068968313, 30.94694754809178, 37.157039213239486, 0.33668200000000004, 190.0, 809, 737425, 1014, 25.686124399999244
1015, 6.013269490362238, 30.981614957224675, 37.34449828456671, 0.3360038499999998, 275.0, 698, 738123, 1015, 26.22140809999837
1016, 5.853160310749612, 31.036214458132253, 37.3639140144521, 0.33527260000000003, 290.0, 927, 739050, 1016, 32.052192600000126
1017, 5.9289168989156735, 31.043611878430276, 37.38962010710654, 0.33435550000000025, 275.0, 1111, 740161, 1017, 38.82613180000044
1018, 3.25882281446478, 31.507772753823478, 37.857810425308514, 0.33347394999999985, 115.0, 848, 741009, 1018, 27.39677060000031
1019, 6.353067136719114, 31.37292346409389, 37.8004122706822, 0.33285610000000004, 35.0, 525, 741534, 1019, 17.838327299999946
1020, 3.97628354051014, 31.412292705280315, 37.75750492701755, 0.33225715000000006, 185.0, 806, 742340, 1020, 27.81614510000145
1021, 3.3161848512860392, 31.321950233327172, 37.651632150198, 0.33150520000000006, 155.0, 865, 743205, 1021, 28.852765899999213
1022, 3.7115768757209464, 31.44119835799595, 37.75095011153311, 0.33082975000000003, 120.0, 636, 743841, 1022, 21.441353500000332
1023, 5.413643917572998, 31.379200398584455, 37.78477066316529, 0.3301462000000002, 125.0, 883, 744724, 1023, 30.141920000000027
1024, 4.072017675727272, 31.454327335096384, 37.80313881366963, 0.3293875, 65.0, 803, 745527, 1024, 27.782581600000412
1025, 3.7201808521165756, 31.330375313569327, 37.63073726223459, 0.3287431, 100.0, 629, 746156, 1025, 21.777746600000683
1026, 7.924471690763304, 31.52477135861063, 37.961100806066746, 0.32804740000000004, 390.0, 917, 747073, 1026, 30.76761240000087
1027, 2.32832194271395, 31.374805779292664, 37.66362294540029, 0.3273607, 60.0, 609, 747682, 1027, 21.0472381999989
1028, 4.547541030670835, 31.420257040216953, 37.740264971045, 0.32680225000000007, 95.0, 632, 748314, 1028, 21.61012010000013
1029, 3.8364338183403017, 31.38735252380371, 37.775290058680945, 0.3262815999999998, 70.0, 525, 748839, 1029, 17.998208799999702
1030, 3.6737421898621165, 31.437053255930156, 37.797742211652135, 0.32559445, 475.0, 1002, 749841, 1030, 34.21878690000085
1031, 5.251388722541286, 31.246890299927955, 37.618805836696254, 0.32491404999999984, 45.0, 510, 750351, 1031, 17.776395900000352
1032, 2.390422083089627, 31.026637278845033, 37.247156426713275, 0.3243182499999999, 185.0, 814, 751165, 1032, 27.6709350000001
1033, 3.341074904831208, 30.886140470339676, 37.11261584438116, 0.32361399999999985, 195.0, 751, 751916, 1033, 27.147845899999083
1034, 2.6537620967206688, 31.11752260741541, 37.36673063949003, 0.32285125, 110.0, 944, 752860, 1034, 31.623937399999704
1035, 4.281246461175886, 31.152571025647614, 37.514142296009496, 0.32212719999999984, 140.0, 665, 753525, 1035, 23.428831000001082
1036, 4.648278883725472, 31.10924187436834, 37.40620041752721, 0.3214283499999999, 325.0, 888, 754413, 1036, 30.649878199999876
1037, 3.9967688772693424, 31.099710992756197, 37.41197880407098, 0.3204405999999999, 315.0, 1307, 755720, 1037, 46.5095610999997
1038, 4.061240065398098, 31.117806660177138, 37.422305473356644, 0.3192606999999996, 390.0, 1315, 757035, 1038, 45.43933010000001
1039, 4.68657370547188, 31.137304887736843, 37.4848100168592, 0.3182986000000001, 165.0, 823, 757858, 1039, 28.135882700000366
1040, 2.504748395774313, 31.15723520196894, 37.41232280321019, 0.31776085, 45.0, 372, 758230, 1040, 13.0942989999985
1041, 3.897315554490327, 31.078097340345124, 37.315659695560214, 0.3171781, 130.0, 923, 759153, 1041, 32.22339210000064
1042, 5.7194386343880685, 31.17709839031766, 37.49892254786793, 0.3164706999999998, 135.0, 649, 759802, 1042, 28.222389500000645
1043, 3.186958954726176, 31.01832922481944, 37.253682531126714, 0.31572729999999993, 225.0, 1003, 760805, 1043, 42.095229099999415
1044, 4.494268818153069, 31.255506545305252, 37.63547399044037, 0.31513194999999994, 5.0, 320, 761125, 1044, 13.030623500000729
1045, 3.1224790724898392, 30.977935283114157, 37.23243972921216, 0.3144353500000001, 440.0, 1228, 762353, 1045, 43.41547209999953
1046, 3.688289861226904, 31.147162341642595, 37.424575934345754, 0.3135825999999998, 110.0, 667, 763020, 1046, 23.680234100000234
1047, 5.273379653974038, 31.185740616606513, 37.517582969838664, 0.31298499999999985, 145.0, 661, 763681, 1047, 22.07802719999927
1048, 2.6262908788355253, 31.12685260959904, 37.3744767499984, 0.31227489999999986, 185.0, 917, 764598, 1048, 32.04139060000125
1049, 2.5685164318730433, 31.153686624103123, 37.41651585366991, 0.31170024999999996, 65.0, 360, 764958, 1049, 13.047178100001474
1050, 2.985478497544135, 31.072846332301395, 37.34841976256742, 0.31125520000000007, 220.0, 629, 765587, 1050, 22.102625499999704
1051, 6.037074580102066, 31.0763386691428, 37.412160042568026, 0.31054239999999994, 610.0, 955, 766542, 1051, 33.94055640000079
1052, 7.418412161357277, 31.173537365776305, 37.52680806709297, 0.3096774999999999, 540.0, 967, 767509, 1052, 32.94441949999964
1053, 7.02742861906454, 31.106525107360195, 37.46342381523303, 0.30885939999999995, 180.0, 851, 768360, 1053, 31.866214199999376
1054, 3.50847434892137, 31.07171919235933, 37.29352372780513, 0.30819339999999995, 190.0, 629, 768989, 1054, 21.792893699999695
1055, 3.939712469503584, 31.034994946372123, 37.28271822775564, 0.30746395000000004, 215.0, 992, 769981, 1055, 34.979323899999144
1056, 8.266384077449004, 31.745495219563328, 38.236451100194174, 0.3066305499999998, 340.0, 860, 770841, 1056, 30.54079290000118
1057, 2.4428490643394727, 31.94975342564077, 38.41780711552284, 0.30608244999999995, 25.0, 358, 771199, 1057, 12.581674400000338
1058, 3.621744185028707, 31.78733138477101, 38.23393351190231, 0.30567655000000005, 105.0, 544, 771743, 1058, 19.195700600001146
1059, 4.460377919332656, 31.742130998527344, 38.190781925684355, 0.3051153999999998, 165.0, 703, 772446, 1059, 25.17206679999981
1060, 6.880873114365013, 31.782853931431443, 38.31450219204318, 0.30441250000000003, 95.0, 859, 773305, 1060, 29.596917699998812
1061, 8.238017552835887, 31.900266706616613, 38.45206121785259, 0.30328750000000015, 800.0, 1641, 774946, 1061, 57.652239299999565
1062, 6.037831742388125, 31.803914596984438, 38.21835947370196, 0.30203425000000006, 340.0, 1144, 776090, 1062, 40.97803479999857
1063, 5.746329049500701, 31.822599003412954, 38.27395359196075, 0.30135519999999993, 20.0, 365, 776455, 1063, 12.689849299998968
1064, 5.8230133746453525, 31.838892836889432, 38.31881961365516, 0.3008340999999999, 490.0, 793, 777248, 1064, 28.113623799999914
1065, 7.5466925999915535, 31.782459530128442, 38.21383489812086, 0.30029994999999987, 35.0, 394, 777642, 1065, 14.030631699999503
1066, 4.021388175435619, 31.797581959993412, 38.19868220630874, 0.2997014499999998, 370.0, 936, 778578, 1066, 32.92326959999991
1067, 2.4304675908152307, 31.708923918477605, 38.071683171090115, 0.29912005, 60.0, 356, 778934, 1067, 12.129015599999548
1068, 5.060477896263667, 31.72901488095522, 38.21299032370249, 0.29861425000000014, 225.0, 768, 779702, 1068, 26.150392600000487
1069, 5.563554041571028, 31.850049902143933, 38.33960139864967, 0.2978906500000001, 255.0, 840, 780542, 1069, 28.596415300000444
1070, 8.508772749042366, 31.87960436268401, 38.42471739383761, 0.29721520000000007, 155.0, 661, 781203, 1070, 22.71574049999981
1071, 5.8626548334335284, 31.925545266696385, 38.45702114559355, 0.29676654999999985, 40.0, 336, 781539, 1071, 11.719292399999176
1072, 4.53525944989486, 31.899170285038903, 38.376742377738836, 0.29632465, 70.0, 646, 782185, 1072, 22.28941499999928
1073, 4.1507020202162215, 31.81010592890721, 38.25841356614057, 0.2954601999999998, 350.0, 1275, 783460, 1073, 44.0072295000009
1074, 6.170869325854532, 31.86329816735309, 38.36970537123473, 0.29455525, 95.0, 736, 784196, 1074, 26.224312099999224
1075, 5.215144720051857, 31.951035101682145, 38.4286354898617, 0.2938842999999998, 215.0, 755, 784951, 1075, 26.274739399999817
1076, 2.49137103212608, 31.806884845353398, 38.1902774553207, 0.29326464999999985, 165.0, 622, 785573, 1076, 21.527039999999033
1077, 4.8129562364681275, 31.868608911373812, 38.329328992246204, 0.2924775999999997, 285.0, 1127, 786700, 1077, 38.93223680000119
1078, 5.578972567039811, 31.925170804101864, 38.407487359260664, 0.29167930000000003, 110.0, 647, 787347, 1078, 23.091502700001
1079, 5.199425265872999, 31.95802860789829, 38.43968538254026, 0.29116134999999976, 75.0, 504, 787851, 1079, 18.294251299999814
1080, 3.5922512830785145, 31.839921906677603, 38.298155436971264, 0.2907037, 140.0, 513, 788364, 1080, 18.916129600000204
1081, 5.230214650100481, 31.89556411863076, 38.39900089855981, 0.2902438, 165.0, 509, 788873, 1081, 18.745388400000593
1082, 4.873340206037963, 31.92687893805103, 38.39933194178287, 0.2896295499999999, 160.0, 856, 789729, 1082, 31.65584359999957
1083, 4.147781393735292, 31.590716618561412, 37.970745712231206, 0.28882449999999993, 405.0, 933, 790662, 1083, 34.54031500000019
1084, 6.282497121339494, 31.584817470203745, 37.944461271112615, 0.2881571500000001, 105.0, 550, 791212, 1084, 19.601852400001007
1085, 5.323078017577457, 31.54064657976086, 37.907426694049924, 0.2874439, 355.0, 1035, 792247, 1085, 37.94167609999931
1086, 6.282661419952176, 31.440920230469416, 37.838266185072605, 0.28664875000000006, 260.0, 732, 792979, 1086, 27.01784790000056
1087, 3.9994694332696863, 31.430833118449716, 37.797882896335395, 0.28600705000000004, 155.0, 694, 793673, 1087, 25.14192709999952
1088, 4.913915106160349, 31.306261286624643, 37.64660206284634, 0.28530774999999997, 435.0, 860, 794533, 1088, 30.645816899999772
1089, 5.049484498870425, 31.46592505842317, 37.84752354351193, 0.2844054999999999, 290.0, 1145, 795678, 1089, 41.86804530000154
1090, 6.556486133325805, 31.49097813842117, 37.88001893669046, 0.28372285, 80.0, 372, 796050, 1090, 13.004096299999219
1091, 9.7443530833603, 31.55366025412135, 38.060430484721316, 0.2833511499999999, 110.0, 454, 796504, 1091, 15.779025300000285
1092, 5.508418222613956, 31.58875323171201, 37.98214377942293, 0.28293985, 65.0, 460, 796964, 1092, 16.007247699999425
1093, 5.786125358759805, 31.548564877333465, 37.973646764402034, 0.2822468500000001, 265.0, 1080, 798044, 1093, 37.59005190000062
1094, 7.438847772152948, 31.662003653960703, 38.14941777134441, 0.2813310999999999, 180.0, 955, 798999, 1094, 33.93934369999988
1095, 7.931510498558736, 31.560640876778322, 38.005804499811916, 0.28048779999999995, 330.0, 919, 799918, 1095, 32.17474979999861
1096, 4.997824575783706, 31.06332562239173, 37.32799680902196, 0.27970390000000006, 315.0, 823, 800741, 1096, 29.019507900000463
1097, 5.289954288554786, 31.148035858376357, 37.5226041551935, 0.27911709999999995, 110.0, 481, 801222, 1097, 16.89692919999834
1098, 5.239664340907565, 31.027074417701133, 37.27872299047617, 0.2785496499999998, 265.0, 780, 802002, 1098, 28.415246300000945
1099, 6.30491120596518, 31.138729923467242, 37.466486489088574, 0.277642, 425.0, 1237, 803239, 1099, 43.41923119999956
1100, 3.6139506790912326, 31.07944244138325, 37.313933974480406, 0.276751, 195.0, 743, 803982, 1100, 28.77627030000076
1101, 4.834655485033423, 31.18612083604064, 37.51651446125175, 0.2761322500000001, 215.0, 632, 804614, 1101, 24.592628099999274
1102, 9.28975877482252, 31.15083210345396, 37.544002666670025, 0.27562960000000003, 60.0, 485, 805099, 1102, 17.774607299999843
1103, 3.7767237401930682, 31.100922948079752, 37.374672979327805, 0.27490374999999995, 300.0, 1128, 806227, 1103, 40.784737300000415
1104, 5.068399020503549, 30.958536525801115, 37.19037834242278, 0.27416664999999996, 135.0, 510, 806737, 1104, 17.919836299999588
1105, 4.218978515148931, 31.009430298359643, 37.23806616212576, 0.27351819999999993, 80.0, 931, 807668, 1105, 33.36564120000003
1106, 3.4721728036868598, 31.082975035081375, 37.34138096919676, 0.2727023499999999, 465.0, 882, 808550, 1106, 32.360331800000495
1107, 5.262185222100705, 31.099781921062064, 37.39845048620346, 0.27209395, 35.0, 470, 809020, 1107, 16.707871999999043
1108, 6.421024369120414, 30.997912765008813, 37.32416317365495, 0.2712987999999998, 470.0, 1297, 810317, 1108, 45.339113299998644
1109, 3.4920592571930453, 30.77239918795499, 36.91849142594771, 0.2703438999999999, 175.0, 825, 811142, 1109, 29.10345529999904
1110, 4.913132354372838, 30.729751826635475, 36.976598720515796, 0.26947855, 520.0, 1098, 812240, 1110, 38.66651249999995
1111, 5.613275805915441, 30.934045196673193, 37.24167102848718, 0.2686901499999999, 120.0, 654, 812894, 1111, 23.242769399999816
1112, 4.638931306292398, 30.787030350928212, 37.04544606321983, 0.26795979999999997, 235.0, 969, 813863, 1112, 35.65793269999995
1113, 3.753112904556574, 30.70371742715165, 36.898487791008904, 0.2672294499999998, 145.0, 654, 814517, 1113, 26.06732480000028
1114, 4.150460994253713, 30.783872175970142, 36.991514894817, 0.2665364499999999, 175.0, 886, 815403, 1114, 35.10550040000089
1115, 4.46455844028576, 30.79078437186576, 36.992649612860866, 0.26582139999999976, 130.0, 703, 816106, 1115, 28.023920500001623
1116, 4.046617703594006, 30.786507644151385, 37.02213190731249, 0.26509464999999993, 295.0, 912, 817018, 1116, 36.62119429999984
1117, 7.701072204793464, 30.758658072851986, 37.10709671064608, 0.2645285499999999, 55.0, 346, 817364, 1117, 14.005323899998984
1118, 6.558965371302024, 30.75304510413702, 37.04605551868228, 0.2639250999999999, 370.0, 995, 818359, 1118, 39.9875334999997
1119, 5.967737116774886, 30.684271432915512, 36.82272706226427, 0.2633009499999999, 20.0, 392, 818751, 1119, 15.639754200001335
1120, 5.113847995376277, 30.80261778758571, 37.16525068778875, 0.2628302500000001, 190.0, 654, 819405, 1120, 26.161906200000885
1121, 4.200781165457227, 30.98382695169475, 37.267232789222376, 0.2620405, 280.0, 1101, 820506, 1121, 44.54246899999998
1122, 5.57569820540292, 31.11217662533458, 37.436374162091596, 0.26090245, 355.0, 1428, 821934, 1122, 57.06064729999889
1123, 5.567973093968585, 31.18268961225237, 37.53569567687529, 0.2599606000000001, 150.0, 665, 822599, 1123, 26.714697600000363
1124, 4.108919565628591, 31.086132144690154, 37.35314640558866, 0.25930045, 210.0, 802, 823401, 1124, 32.32457459999932
1125, 6.286107368240789, 31.16775216527403, 37.47551611625658, 0.25843645000000015, 440.0, 1118, 824519, 1125, 44.8016733000004
1126, 2.553843465882868, 31.294260777829948, 37.560884519139094, 0.25769619999999993, 130.0, 527, 825046, 1126, 21.325770499999635
1127, 4.620069873352392, 31.1247165754486, 37.423125023173974, 0.25690645000000006, 410.0, 1228, 826274, 1127, 49.00680689999899
1128, 5.832606510030773, 31.164025909495802, 37.4950081627324, 0.2560676499999998, 180.0, 636, 826910, 1128, 26.39555660000042
1129, 7.267905458961114, 31.30577471112715, 37.739432773225985, 0.255475, 175.0, 681, 827591, 1129, 28.334590300000855
1130, 5.866229789485609, 31.25092756419552, 37.514338629586355, 0.2549889999999999, 80.0, 399, 827990, 1130, 16.599847200001022
1131, 4.721640652271292, 31.11724576811413, 37.46095346133428, 0.2545308999999999, 130.0, 619, 828609, 1131, 25.653729600000588
1132, 3.6181771874065394, 31.211290032055246, 37.55437021978594, 0.25393779999999977, 165.0, 699, 829308, 1132, 29.372269100000267
1133, 2.524374595616457, 31.01530032083778, 37.25425159869416, 0.25327584999999986, 100.0, 772, 830080, 1133, 31.86255440000059
1134, 7.268969944578092, 31.19390059283696, 37.609777438773214, 0.2525643999999998, 175.0, 809, 830889, 1134, 33.61550480000005
1135, 5.588214458464264, 31.05091070379101, 37.431516881258986, 0.2519141499999999, 160.0, 636, 831525, 1135, 26.49061079999956
1136, 8.155332467439822, 31.106760903266863, 37.493258363109526, 0.25130934999999993, 110.0, 708, 832233, 1136, 29.55537859999822
1137, 10.025440569612654, 31.12767160243059, 37.491044427291975, 0.25079679999999993, 40.0, 431, 832664, 1137, 18.034607400000823
1138, 7.144719434773614, 31.048771564302772, 37.353579200547316, 0.25018524999999997, 200.0, 928, 833592, 1138, 38.61310189999858
1139, 3.8448719171147845, 31.04382000619044, 37.33657196407101, 0.24933160000000001, 215.0, 969, 834561, 1139, 40.31874279999829
1140, 3.3611762830222984, 31.12336714732305, 37.36280069813412, 0.24844059999999984, 305.0, 1011, 835572, 1140, 42.070210699999734
1141, 3.871875197260377, 31.144244283922056, 37.47021004541465, 0.2475702999999999, 195.0, 923, 836495, 1141, 38.63827399999718
1142, 4.242713320367222, 31.043844756234456, 37.36457573134324, 0.24678955, 325.0, 812, 837307, 1142, 34.25625229999787
1143, 3.660221763115416, 31.12233102962535, 37.39184598512547, 0.24608934999999987, 435.0, 744, 838051, 1143, 31.33526570000322
1144, 5.554480438977717, 31.02668488424931, 37.39086064425382, 0.2454723999999998, 110.0, 627, 838678, 1144, 27.34082169999965
1145, 2.5122970394634954, 31.05387207865715, 37.34343851606051, 0.24501745, 85.0, 384, 839062, 1145, 16.147739300002286
1146, 4.691762656492488, 31.006580532721753, 37.23263172764218, 0.24453460000000002, 215.0, 689, 839751, 1146, 29.140554900001007
1147, 3.8931319262431963, 31.456911260996268, 37.837856708986365, 0.24394824999999995, 115.0, 614, 840365, 1147, 26.286242700000003
1148, 4.840139807611545, 31.629764717353925, 38.02524564619135, 0.2432493999999999, 215.0, 939, 841304, 1148, 39.489512100000866
1149, 4.73902048847892, 31.62805971422454, 38.047808231919575, 0.24226254999999994, 390.0, 1254, 842558, 1149, 53.29900709999856
1150, 3.500415672439822, 31.554332219353018, 37.877436449361404, 0.24123384999999997, 410.0, 1032, 843590, 1150, 43.46056970000063
1151, 5.696852775276421, 31.67966741368872, 38.11952813639345, 0.24035589999999998, 365.0, 919, 844509, 1151, 38.9138959999982
1152, 6.89243079835276, 31.673913877837514, 38.17016139764733, 0.2396998, 140.0, 539, 845048, 1152, 22.883602199999586
1153, 11.32558171197575, 31.61203094871824, 38.09599686750617, 0.2392191999999999, 50.0, 529, 845577, 1153, 22.74102810000113
1154, 3.188046401638994, 31.502620998578582, 37.80893536895631, 0.23875344999999992, 75.0, 506, 846083, 1154, 21.32707880000089
1155, 5.865052321607828, 31.631427468307535, 38.05193347607051, 0.23802219999999993, 275.0, 1119, 847202, 1155, 48.03830069999822
1156, 8.028256925212407, 31.673139152650844, 38.15924125580462, 0.23710329999999988, 135.0, 923, 848125, 1156, 39.61744220000037
1157, 4.914942381145219, 31.510443393420797, 37.87624808450933, 0.2364602499999999, 15.0, 506, 848631, 1157, 22.318952500001615
1158, 4.367397834332484, 31.607940057238693, 37.96849839552394, 0.23587479999999988, 215.0, 795, 849426, 1158, 34.54576359999919
1159, 5.574191585913593, 31.781739391712403, 38.28758431056326, 0.23521869999999998, 85.0, 663, 850089, 1159, 28.5923208000022
1160, 4.0830196271839885, 31.7940579580311, 38.24503429180921, 0.23470569999999993, 80.0, 477, 850566, 1160, 20.269044299999223
1161, 4.964166497685875, 31.829708658272406, 38.286472488852105, 0.23407794999999998, 195.0, 918, 851484, 1161, 39.783808000000136
1162, 3.5651924796858148, 31.83082956494906, 38.258519650963834, 0.23337055000000007, 210.0, 654, 852138, 1162, 28.440014799998607
1163, 3.7608606638901794, 31.808068936846645, 38.23491676535463, 0.23250654999999998, 520.0, 1266, 853404, 1163, 55.537839599997824
1164, 6.299672400781004, 31.81121497560841, 38.25022811298223, 0.23170464999999998, 130.0, 516, 853920, 1164, 22.144110200002615
1165, 6.734685637436475, 31.928941127347844, 38.449987885299, 0.23104855000000002, 230.0, 942, 854862, 1165, 40.32263959999909
1166, 4.960248757646914, 31.874486402678635, 38.2809081611711, 0.23018274999999988, 340.0, 982, 855844, 1166, 42.511040199999115
1167, 4.473398927929924, 31.742533310680855, 38.15277517923494, 0.2292795999999999, 255.0, 1025, 856869, 1167, 44.514799100001255
1168, 4.442583383543802, 31.785659487456844, 38.23319756343074, 0.22850065000000006, 165.0, 706, 857575, 1168, 30.676733100001
1169, 10.491369694783971, 31.85967906871876, 38.38884591055917, 0.2279898999999999, 105.0, 429, 858004, 1169, 18.581970600000204
1170, 4.482308634512301, 31.88166493389638, 38.295028352785934, 0.22735449999999982, 105.0, 983, 858987, 1170, 38.02411249999932
1171, 6.102700428590023, 31.94847397615118, 38.46347284814759, 0.22648104999999985, 310.0, 958, 859945, 1171, 35.80810070000007
1172, 4.362261622307006, 31.233443833469003, 37.555866785263746, 0.22572954999999997, 110.0, 712, 860657, 1172, 26.38083220000044
1173, 4.744746746129549, 31.24429161484177, 37.5447306950887, 0.2249096499999999, 400.0, 1110, 861767, 1173, 40.11104189999969
1174, 5.446457095444202, 31.2720865615801, 37.64192157625127, 0.22409604999999996, 140.0, 698, 862465, 1174, 25.057355000000825
1175, 3.8428240980472714, 31.200881519384087, 37.47894369517469, 0.22352364999999996, 110.0, 574, 863039, 1175, 20.74808320000011
1176, 5.777855458308239, 31.333243880578824, 37.752796873754384, 0.22297869999999986, 170.0, 637, 863676, 1176, 23.056211099999928
1177, 4.122797910822555, 31.223703492432833, 37.50737576186657, 0.22246164999999993, 50.0, 512, 864188, 1177, 18.37044479999895
1178, 7.0094537485283785, 31.279659143271157, 37.63161970632145, 0.22194954999999997, 40.0, 626, 864814, 1178, 22.56142700000055
1179, 7.583530232147885, 31.209780328388543, 37.562003474361134, 0.22117239999999996, 150.0, 1101, 865915, 1179, 39.62443329999951
1180, 6.8096392797901455, 31.374400168350064, 37.74037666320801, 0.2204587, 110.0, 485, 866400, 1180, 17.308155899998383
1181, 7.06470262291938, 31.3017881230449, 37.61146615449055, 0.22004559999999995, 70.0, 433, 866833, 1181, 16.080867599997873
1182, 6.5377629287175685, 31.28004977983587, 37.59672211198246, 0.2194835499999998, 80.0, 816, 867649, 1182, 31.339810900000884
1183, 4.618040832821016, 31.230018573802905, 37.563993528836185, 0.21882969999999993, 80.0, 637, 868286, 1183, 24.268186099998275
1184, 6.238283295667282, 31.168302935141103, 37.465264549961795, 0.21830005, 80.0, 540, 868826, 1184, 19.847424099996715
1185, 5.747270005437316, 31.285059849657006, 37.6581072085689, 0.2177537499999999, 110.0, 674, 869500, 1185, 24.718052799998986
1186, 3.726415559817948, 31.26052874656179, 37.51442462355647, 0.21709225000000004, 210.0, 796, 870296, 1186, 29.1466995999981
1187, 4.900632732656312, 31.254679817366902, 37.59476542225346, 0.2163439, 210.0, 867, 871163, 1187, 32.044554300002346
1188, 6.0065261119298645, 31.249655496745167, 37.64470806948929, 0.21561129999999992, 210.0, 761, 871924, 1188, 28.03729690000182
1189, 5.065408143074727, 31.29688218100625, 37.640307984390326, 0.21476349999999986, 190.0, 1123, 873047, 1189, 41.23167040000044
1190, 5.076933211431015, 31.352424721786942, 37.72386608607527, 0.21400974999999994, 105.0, 552, 873599, 1190, 20.399334000001545
1191, 2.6906944410203724, 31.19988297951384, 37.455954568427906, 0.21353049999999993, 60.0, 513, 874112, 1191, 19.000633200001175
1192, 3.8889096211398013, 31.22099835591545, 37.56825265787227, 0.21299049999999997, 110.0, 687, 874799, 1192, 25.344374000000244
1193, 7.300041289541687, 31.323612913793447, 37.75829063314779, 0.21230649999999993, 410.0, 833, 875632, 1193, 30.610340200000792
1194, 6.552236594791923, 31.21341966017793, 37.56857456295647, 0.21169854999999993, 35.0, 518, 876150, 1194, 19.40927449999799
1195, 3.506130213674047, 31.298337856141647, 37.607799296331876, 0.2111018499999999, 200.0, 808, 876958, 1195, 30.235007499999483
1196, 4.166017565126746, 31.247819945993438, 37.5740403190988, 0.21013434999999997, 310.0, 1342, 878300, 1196, 49.603161900002306
1197, 4.597551124715073, 31.372722742823292, 37.69678015393086, 0.20925189999999996, 135.0, 619, 878919, 1197, 22.9185123999996
1198, 4.564270418110511, 31.26178243623363, 37.60051100751479, 0.20866059999999995, 175.0, 695, 879614, 1198, 25.8883029000026
1199, 7.515813412417013, 33.013765745896556, 39.73464124019329, 0.20787984999999998, 230.0, 1040, 880654, 1199, 38.72362969999813
1200, 5.3059836824686215, 33.93004127007805, 40.811039574254, 0.20695374999999988, 410.0, 1018, 881672, 1200, 37.82030569999915
1201, 2.7885410271294124, 33.89793244210092, 40.70601902638112, 0.20619594999999985, 165.0, 666, 882338, 1201, 24.922282200001064
1202, 3.087770805147111, 33.981888675416435, 40.81905579225381, 0.20573919999999996, 35.0, 349, 882687, 1202, 13.104580500003067
1203, 5.920229000922961, 34.00282228910006, 40.977417321194025, 0.20538909999999988, 10.0, 429, 883116, 1203, 15.996509700002207
1204, 4.864522593193145, 34.0127655492729, 40.88407927823354, 0.2047478499999999, 205.0, 996, 884112, 1204, 37.40577520000079
1205, 5.768086234739484, 33.86534409818396, 40.65490127946072, 0.2039945499999999, 30.0, 678, 884790, 1205, 25.42126289999942
1206, 5.823699878399852, 33.9780516834379, 40.950327213455296, 0.20340324999999995, 125.0, 636, 885426, 1206, 23.973081200001616
1207, 4.325001158123185, 33.927990255585634, 40.77706758085504, 0.20281824999999998, 95.0, 664, 886090, 1207, 24.73220979999678
1208, 4.715083149784481, 33.98671445819387, 40.8498046744583, 0.20220354999999993, 80.0, 702, 886792, 1208, 26.096882999998343
1209, 2.953259655136477, 33.94752842408639, 40.73722148824621, 0.20169324999999994, 25.0, 432, 887224, 1209, 16.303893100001005
1210, 6.505798762457834, 33.950525152082925, 40.89539701063856, 0.20118609999999992, 90.0, 695, 887919, 1210, 26.251621600000362
1211, 4.597746079465501, 33.95463278060569, 40.80611586351642, 0.2003347, 365.0, 1197, 889116, 1211, 44.912219699999696
1212, 4.071597128406039, 33.96668399908604, 40.83946554069845, 0.19958544999999997, 5.0, 468, 889584, 1212, 17.567726200002653
1213, 3.845505215239374, 34.04876523070614, 40.88179270426432, 0.19908999999999993, 110.0, 633, 890217, 1213, 23.983474800003023
1214, 4.049257221926513, 34.214924536163004, 41.13727176446709, 0.19830474999999995, 385.0, 1112, 891329, 1214, 41.7472130999995
1215, 4.178316717326877, 34.350628871691555, 41.2363474095763, 0.19757664999999996, 60.0, 506, 891835, 1215, 19.132095700002537
1216, 5.4759061893531795, 34.26878255907602, 41.1915309977773, 0.19703799999999988, 150.0, 691, 892526, 1216, 26.16365180000139
1217, 3.849398751019932, 34.152783196731654, 41.052217009347245, 0.19640484999999988, 250.0, 716, 893242, 1217, 27.068436599998677
1218, 8.623237807348016, 34.31489083596638, 41.32930545579819, 0.19578024999999993, 240.0, 672, 893914, 1218, 25.44197279999935
1219, 8.179427819431952, 34.317042653896294, 41.33107245435563, 0.19516779999999995, 145.0, 689, 894603, 1219, 26.295213800000056
1220, 5.391394008992251, 34.31029247349093, 41.23605603757112, 0.19427814999999987, 355.0, 1288, 895891, 1220, 48.72581319999881
1221, 5.623183972769867, 34.30615609460296, 41.276355051761556, 0.19337590000000002, 165.0, 717, 896608, 1221, 27.13271159999931
1222, 5.9736979569694615, 34.29008447833178, 41.231992297056244, 0.19275804999999993, 125.0, 656, 897264, 1222, 24.91757620000135
1223, 5.153698907276297, 34.276158531755875, 41.19904429163373, 0.1919602, 330.0, 1117, 898381, 1223, 42.04086680000182
1224, 5.838753418992707, 34.1884845768243, 41.16251041991911, 0.19125909999999993, 165.0, 441, 898822, 1224, 16.801757099998213
1225, 5.842853919913371, 34.3493798208096, 41.33561682349461, 0.1907555499999999, 165.0, 678, 899500, 1225, 25.824917899997672
1226, 9.023429129129786, 34.255855062733524, 41.30768751061481, 0.19027449999999996, 40.0, 391, 899891, 1226, 15.080024599999888
1227, 4.812397462492332, 34.20210899785676, 41.08177921089394, 0.18977319999999995, 125.0, 723, 900614, 1227, 27.514482500002487
1228, 6.783015500054885, 34.25297825510909, 41.224798576702874, 0.18902349999999998, 215.0, 943, 901557, 1228, 36.02870609999809
1229, 3.7981197118930434, 34.31973865662498, 41.20623067877759, 0.18828594999999995, 90.0, 696, 902253, 1229, 26.718834100000095
1230, 4.179489148049932, 34.36542243732464, 41.308620616046376, 0.18766764999999994, 165.0, 678, 902931, 1230, 26.102073300000484
1231, 5.110937396861889, 34.279925992047346, 41.23206561618381, 0.18705879999999994, 130.0, 675, 903606, 1231, 25.77809569999954
1232, 5.072826633354028, 34.361915462546875, 41.33394082652198, 0.18610705, 350.0, 1440, 905046, 1232, 55.52406730000075
1233, 3.7024074310135697, 34.193502588900266, 41.13086077410304, 0.18515844999999992, 230.0, 668, 905714, 1233, 25.59585650000008
1234, 5.870413872309058, 34.3624289689377, 41.32128760805461, 0.18439164999999988, 445.0, 1036, 906750, 1234, 40.034942899997986
1235, 4.8018717465045135, 34.22651272385065, 41.12893672471636, 0.18348490000000003, 305.0, 979, 907729, 1235, 38.03908720000254
1236, 5.556750081526261, 34.36416738982485, 41.31793263713394, 0.18275724999999995, 50.0, 638, 908367, 1236, 24.637928200001625
1237, 5.073310027745637, 34.38548845233339, 41.32655221309388, 0.18218799999999993, 55.0, 627, 908994, 1237, 24.168710800000554
1238, 4.977160190510285, 34.34953519585845, 41.305985246385845, 0.18162864999999992, 100.0, 616, 909610, 1238, 24.08382850000271
1239, 4.51390830343992, 34.383525447991055, 41.35159985588404, 0.18099774999999996, 165.0, 786, 910396, 1239, 30.4175479000005
1240, 5.572616459368389, 34.2650818765481, 41.14391757158784, 0.1803907, 195.0, 563, 910959, 1240, 22.051758699999482
1241, 4.444004183231569, 34.28138622877045, 41.19184482999039, 0.17960769999999987, 345.0, 1177, 912136, 1241, 45.8189547999973
1242, 4.785887566001141, 34.19794348804839, 41.09535205538114, 0.1788003999999999, 135.0, 617, 912753, 1242, 23.933466399997997
1243, 2.388306246187589, 34.11435916325817, 40.92781964654792, 0.17835849999999992, 90.0, 365, 913118, 1243, 14.277868299999682
1244, 3.8465404646092907, 34.20912201833907, 41.11449715917595, 0.17795934999999988, 50.0, 522, 913640, 1244, 20.358998400002747
1245, 6.857257703084212, 34.27863386300894, 41.30483583890475, 0.17743194999999992, 200.0, 650, 914290, 1245, 25.51472620000277
1246, 3.8083203327376984, 34.306749585003374, 41.212310168896856, 0.17678349999999993, 185.0, 791, 915081, 1246, 30.91959140000108
1247, 6.276060272793984, 34.29705177247524, 41.32315739492575, 0.17608194999999996, 175.0, 768, 915849, 1247, 30.066313399998762
1248, 4.789815202039583, 34.315663902127014, 41.263305682028104, 0.17544969999999996, 200.0, 637, 916486, 1248, 25.188097400001425
1249, 8.09286999281715, 34.309047897189274, 41.27672908259373, 0.1749335499999999, 120.0, 510, 916996, 1249, 19.94644650000191
1250, 5.1490238495674845, 34.269552050281675, 41.182243005067, 0.17407179999999994, 490.0, 1405, 918401, 1250, 54.609151500000735
1251, 5.810126814962067, 34.18000389372209, 41.10811265949702, 0.1730372499999999, 155.0, 894, 919295, 1251, 34.97420090000014
1252, 3.36415072157979, 34.38060343776993, 41.31227899935379, 0.17208954999999998, 525.0, 1212, 920507, 1252, 47.39298750000307
1253, 5.976156392343484, 34.49017049854111, 41.487644545789394, 0.1710001, 325.0, 1209, 921716, 1253, 47.000328199999785
1254, 5.179066744213628, 34.48347807031353, 41.467779026475064, 0.17003035, 245.0, 946, 922662, 1254, 37.09051299999919
1255, 6.416132130237233, 34.49741191563644, 41.448720506482864, 0.16926175, 190.0, 762, 923424, 1255, 29.832681899999443
1256, 4.805521780103924, 34.472342923523144, 41.42870039290809, 0.16849899999999995, 385.0, 933, 924357, 1256, 36.463015400000586
1257, 4.925040131550832, 34.508440174040246, 41.48206852146836, 0.16780464999999994, 115.0, 610, 924967, 1257, 23.967451600001368
1258, 5.116063355658835, 34.44485972220438, 41.417664388466996, 0.16722234999999994, 175.0, 684, 925651, 1258, 26.969420499997796
1259, 5.446626722800674, 34.51730929156975, 41.50676116759371, 0.1663547499999999, 390.0, 1244, 926895, 1259, 49.11045670000021
1260, 3.64400861413426, 34.48203194177843, 41.43893961658536, 0.16550064999999992, 190.0, 654, 927549, 1260, 25.91407480000271
1261, 6.847419688658368, 34.516701765259484, 41.51161624539283, 0.16473204999999988, 395.0, 1054, 928603, 1261, 41.709741899998335
1262, 5.408039026151214, 34.45915720641084, 41.40453386971555, 0.16390269999999996, 225.0, 789, 929392, 1262, 31.188308099997812
1263, 5.271835240894361, 34.47251431347441, 41.4653740089346, 0.16301169999999998, 315.0, 1191, 930583, 1263, 47.15088079999987
1264, 3.547015103011184, 34.48873443526761, 41.46578142484669, 0.16202844999999988, 315.0, 994, 931577, 1264, 39.62151420000009
1265, 3.236254873884325, 34.404216601267585, 41.344484479888145, 0.16104564999999996, 365.0, 1190, 932767, 1265, 47.50973260000319
1266, 5.587242509360533, 34.412923768075245, 41.414669201098775, 0.16028019999999996, 65.0, 511, 933278, 1266, 20.325113000002602
1267, 6.029451560833691, 34.42652326354182, 41.41715626941301, 0.15987834999999997, 25.0, 382, 933660, 1267, 15.483802099999593
1268, 6.452222855226163, 34.577471693312035, 41.65349660570216, 0.15930729999999996, 185.0, 887, 934547, 1268, 35.85648079999737
1269, 2.713853728612687, 34.33257154911122, 41.200382679066756, 0.15869664999999994, 30.0, 470, 935017, 1269, 19.31604149999839
1270, 5.044167610280441, 34.3856564968616, 41.328310212888915, 0.15809904999999996, 460.0, 858, 935875, 1270, 34.28288389999943
1271, 4.753001852212311, 34.430906932214015, 41.39086956491676, 0.15727599999999997, 335.0, 971, 936846, 1271, 38.84364349999669
1272, 4.155484045906115, 34.469655115719874, 41.415317716535114, 0.15636519999999987, 305.0, 1053, 937899, 1272, 42.09507880000092
1273, 7.67795342937203, 34.466087968342165, 41.52582915769805, 0.1555970499999999, 85.0, 654, 938553, 1273, 26.249577800001134
1274, 4.7128622978813155, 34.41492649723756, 41.38843371572811, 0.15500484999999992, 115.0, 662, 939215, 1274, 26.823493300002156
1275, 5.44977162596303, 34.617966692871846, 41.6450557591725, 0.1542668499999999, 235.0, 978, 940193, 1275, 41.35347779999938
1276, 4.542725032725293, 34.943113959080314, 41.967905318632155, 0.15367329999999993, 30.0, 341, 940534, 1276, 14.033082699999795
1277, 5.775164235548647, 34.92713363593984, 42.051985067741896, 0.15313465, 180.0, 856, 941390, 1277, 34.87701769999694
1278, 3.9503133654221307, 34.8623857065359, 41.87706796589405, 0.15246189999999993, 215.0, 639, 942029, 1278, 26.086129100000107
1279, 3.079927111044526, 34.899167108535764, 41.88915288788932, 0.15192234999999998, 105.0, 560, 942589, 1279, 22.736395200001425
1280, 4.075410362016531, 35.028028220133066, 42.09731939103868, 0.15139494999999992, 55.0, 612, 943201, 1280, 24.769049200000154
1281, 5.1350194249863845, 35.034138811729605, 42.09685968237072, 0.15060024999999994, 260.0, 1154, 944355, 1281, 46.750932900002226
1282, 7.987098887245091, 35.00824992601262, 42.16514159357825, 0.14984874999999995, 35.0, 516, 944871, 1282, 21.11423940000168
1283, 4.583837023966432, 35.00571367663268, 42.04665578431436, 0.14931144999999993, 105.0, 678, 945549, 1283, 27.524565400002757
1284, 5.727168115822302, 35.016879720273224, 42.0591824186021, 0.14869584999999996, 165.0, 690, 946239, 1284, 28.11276100000032
1285, 4.094863238168489, 35.059157845221065, 42.13700033802735, 0.14783814999999995, 435.0, 1216, 947455, 1285, 49.038339700000506
1286, 6.767549744549424, 35.02221636531329, 42.176718864055594, 0.14706819999999987, 120.0, 495, 947950, 1286, 20.19462829999975
1287, 4.452848588941353, 34.88954380807422, 41.93278341747465, 0.14646744999999994, 95.0, 840, 948790, 1287, 34.399395899999945
1288, 6.254509117082334, 35.01937979011125, 42.14013028474447, 0.1457964999999999, 150.0, 651, 949441, 1288, 26.365413100000296
1289, 4.358596358009653, 35.27887193598964, 42.411787718768394, 0.14493024999999998, 285.0, 1274, 950715, 1289, 52.12394819999827
1290, 4.3846557018811705, 35.54021383954593, 42.70877864669309, 0.14375529999999986, 495.0, 1337, 952052, 1290, 54.7388749999991
1291, 4.6884787543970035, 35.63314767928808, 42.82778627986572, 0.1429749999999999, 35.0, 397, 952449, 1291, 16.202076000001398
1292, 4.359910246683563, 35.65004943291631, 42.86359617445204, 0.14241969999999995, 295.0, 837, 953286, 1292, 34.578001799996855
1293, 5.25955634192982, 35.56739464359007, 42.80526217170384, 0.14179464999999994, 125.0, 552, 953838, 1293, 22.787196699999186
1294, 4.5821475874966335, 35.670920399718945, 42.87312966686184, 0.14117454999999995, 325.0, 826, 954664, 1294, 33.95293899999888
1295, 4.079439493705928, 35.58606088110159, 42.768112921475335, 0.14048919999999998, 205.0, 697, 955361, 1295, 28.57631539999784
1296, 7.891441742873798, 35.636182113331365, 42.92007488674588, 0.1399365999999999, 105.0, 531, 955892, 1296, 21.843942899999092
1297, 6.223233625950632, 35.69503034164774, 42.9755939977125, 0.13925934999999995, 335.0, 974, 956866, 1297, 40.30332599999747
1298, 3.449729521025768, 35.55570767843567, 42.721824350732724, 0.1381698999999999, 640.0, 1447, 958313, 1298, 59.07109639999908
1299, 2.857596430861995, 35.655806898471695, 42.809369978593224, 0.1371605499999999, 165.0, 796, 959109, 1299, 32.67167139999947
1300, 6.207681361999777, 35.63009870660914, 42.86419889089223, 0.13650264999999992, 160.0, 666, 959775, 1300, 27.69929129999946
1301, 8.78267392681964, 36.78251142412144, 44.40595981394609, 0.13591584999999992, 155.0, 638, 960413, 1301, 26.399442899997666
1302, 6.212385656821336, 37.34818022624835, 44.90770361287336, 0.13525839999999992, 350.0, 823, 961236, 1302, 37.32556090000071
1303, 6.71762032182523, 37.41149021482556, 44.945434826046395, 0.13464639999999994, 135.0, 537, 961773, 1303, 22.3842298999989
1304, 5.36900931718979, 37.33938261953632, 44.87649896171656, 0.13400424999999996, 245.0, 890, 962663, 1304, 36.66786229999707
1305, 6.327308316645437, 37.33111976549724, 44.90882019002708, 0.13309209999999996, 250.0, 1137, 963800, 1305, 46.46346120000089
1306, 3.9432422701526693, 37.287219634643186, 44.774598703012096, 0.13228074999999992, 110.0, 666, 964466, 1306, 27.417872800000623
1307, 6.0986083938923725, 37.33683881911391, 44.915089806845025, 0.13161339999999994, 130.0, 817, 965283, 1307, 35.04362820000097
1308, 4.067972802688372, 37.22972852561617, 44.70424496296739, 0.1309680999999999, 140.0, 617, 965900, 1308, 25.802013000000443
1309, 7.4651037031482605, 37.3186896974976, 44.93720999923912, 0.13042404999999996, 100.0, 592, 966492, 1309, 25.00599499999953
1310, 5.98403704034997, 37.38710138580368, 44.95688642265194, 0.12985659999999996, 165.0, 669, 967161, 1310, 28.12878109999656
1311, 5.83580821465681, 37.32059836362135, 44.83793851475027, 0.12913479999999994, 165.0, 935, 968096, 1311, 39.79810540000108
1312, 5.357692205550378, 37.33807362874349, 44.923517833508946, 0.12807279999999996, 400.0, 1425, 969521, 1312, 59.653802100001485
1313, 3.2156238986730576, 37.44964670104981, 44.967490032958985, 0.12715029999999994, 115.0, 625, 970146, 1313, 26.644299299998238
1314, 4.78738361042751, 37.2220534673144, 44.740231424244016, 0.12645774999999995, 90.0, 914, 971060, 1314, 39.09721780000109
1315, 5.835583673006742, 37.26747400515547, 44.8235527109877, 0.12566124999999997, 130.0, 856, 971916, 1315, 36.20314089999738
1316, 2.98735409064311, 37.126930905969104, 44.589009010989365, 0.12495024999999994, 200.0, 724, 972640, 1316, 30.39283929999874
1317, 6.637825215593354, 37.06682658394731, 44.597059457082935, 0.12430134999999994, 190.0, 718, 973358, 1317, 30.27829709999787
1318, 4.48917850491473, 37.18726727715854, 44.68640102079545, 0.12358674999999995, 190.0, 870, 974228, 1318, 36.89114999999947
1319, 6.009481028913198, 37.16017345023331, 44.662370940488216, 0.12276729999999995, 330.0, 951, 975179, 1319, 40.35527550000188
1320, 4.154804819341629, 37.050339366543675, 44.49540153626473, 0.12206034999999991, 125.0, 620, 975799, 1320, 26.303126300001168
1321, 4.816751771510255, 37.37165914699327, 44.953824094636296, 0.12147219999999993, 235.0, 687, 976486, 1321, 29.42103159999897
1322, 3.830632955217321, 37.30125214595165, 44.83566446054782, 0.12076749999999996, 320.0, 879, 977365, 1322, 37.68170349999855
1323, 3.795163433405723, 37.23709120338591, 44.74760060305402, 0.11993949999999992, 295.0, 961, 978326, 1323, 41.094055199999275
1324, 4.198075738164686, 37.06449635823568, 44.5761209816061, 0.11933964999999992, 35.0, 372, 978698, 1324, 15.885099300001457
1325, 5.574402543025858, 37.236951850442324, 44.804070626053154, 0.11871324999999994, 245.0, 1020, 979718, 1325, 43.388720300001296
1326, 5.486955169007696, 37.51854032319167, 45.103307779246364, 0.11760174999999996, 545.0, 1450, 981168, 1326, 61.80380810000133
1327, 5.847142068569464, 37.610452320744784, 45.23092425024803, 0.11663829999999996, 95.0, 691, 981859, 1327, 29.544161699999677
1328, 5.997891128015518, 37.5186115814209, 45.17258246459961, 0.11604609999999996, 55.0, 625, 982484, 1328, 27.156949799998984
1329, 4.821575270173792, 37.329804768819294, 44.886015435178834, 0.11546424999999991, 105.0, 668, 983152, 1329, 28.75668890000088
1330, 3.2288996982423566, 37.53987483736835, 45.09645111470283, 0.11498589999999997, 60.0, 395, 983547, 1330, 16.867198899999494
1331, 4.6298545764617405, 37.61628792479908, 45.19035241735263, 0.11446524999999995, 150.0, 762, 984309, 1331, 32.48216189999948
1332, 5.96971445788623, 37.56765709488158, 45.18478425705894, 0.11372724999999999, 195.0, 878, 985187, 1332, 37.96570129999964
1333, 4.923609321209265, 37.505501365433744, 45.06352863744738, 0.11295549999999994, 230.0, 837, 986024, 1333, 36.077610500000446
1334, 5.068197963528261, 37.60998681714323, 45.23209586703555, 0.11216889999999993, 365.0, 911, 986935, 1334, 39.126601899999514
1335, 5.428034666837133, 37.573873380420416, 45.18333533389913, 0.11151279999999995, 115.0, 547, 987482, 1335, 23.46314220000204
1336, 3.9891848132478125, 37.484704093710455, 45.041864124253564, 0.11080404999999993, 250.0, 1028, 988510, 1336, 44.27348360000178
1337, 4.371416513974241, 37.576894083458356, 45.14757036865994, 0.1101245499999999, 45.0, 482, 988992, 1337, 20.828718699998717
1338, 5.144616785911266, 37.49866110818428, 45.100946376198216, 0.10959984999999992, 205.0, 684, 989676, 1338, 29.30902690000221
1339, 6.5429353290388725, 37.660032601641795, 45.322058881449905, 0.10902879999999993, 75.0, 585, 990261, 1339, 25.134047200001078
1340, 7.977551467986922, 37.74481599442082, 45.49929786840251, 0.10859184999999998, 40.0, 386, 990647, 1340, 16.985194500000944
1341, 5.178711040154861, 37.70631210995417, 45.30406258576108, 0.10810989999999997, 195.0, 685, 991332, 1341, 29.733162399999856
1342, 6.749985274057815, 37.93202758416897, 45.641933133720975, 0.10737729999999993, 310.0, 943, 992275, 1342, 40.96611679999842
1343, 7.006194877882871, 38.01997104873005, 45.77984389513549, 0.10658439999999994, 140.0, 819, 993094, 1343, 35.364375900000596
1344, 4.177724640849811, 37.82541163999643, 45.39734850641507, 0.10591434999999993, 125.0, 670, 993764, 1344, 28.981266899998445
1345, 5.607072596238038, 37.885575379166646, 45.5348912622327, 0.10522764999999995, 225.0, 856, 994620, 1345, 37.175298699999985
1346, 4.06540607050175, 37.78905815823388, 45.41711624378466, 0.10454769999999995, 155.0, 655, 995275, 1346, 28.46401369999876
1347, 6.52351808986832, 37.84820333653842, 45.477243622099564, 0.10385109999999996, 180.0, 893, 996168, 1347, 38.954635599999165
1348, 4.89549885221514, 37.86395734807719, 45.50703527616418, 0.10311804999999995, 130.0, 736, 996904, 1348, 32.32361149999997
1349, 3.406273176910892, 37.85127104177563, 45.46874515190951, 0.10249614999999988, 100.0, 646, 997550, 1349, 28.19477360000019
1350, 5.963034601482821, 37.904627813079415, 45.62400943953485, 0.10177929999999993, 65.0, 947, 998497, 1350, 41.45394849999866
1351, 5.536166078603851, 37.84280710208371, 45.51901354723922, 0.10099449999999995, 190.0, 797, 999294, 1351, 35.11265520000234
1352, 5.163809234921062, 37.926417105886166, 45.5942016796252, 0.1003536999999999, 110.0, 627, 999921, 1352, 27.46182730000146
