,loss,mae,mean_q,mean_eps,episode_reward,nb_episode_steps,nb_steps,episode,duration
0,0,0,0,0,60.0,621,621,0,1.324111900000002
1, 0, 0, 0, 0, 210.0, 781, 1402, 1, 1.7290719999999986
2, 0, 0, 0, 0, 110.0, 668, 2070, 2, 1.424862400000002
3, 0, 0, 0, 0, 135.0, 727, 2797, 3, 1.4384264000000009
4, 0, 0, 0, 0, 120.0, 651, 3448, 4, 1.2796233999999984
5, 0, 0, 0, 0, 590.0, 1356, 4804, 5, 2.634687200000002
6, 0, 0, 0, 0, 210.0, 812, 5616, 6, 1.6228112999999986
7, 0, 0, 0, 0, 180.0, 657, 6273, 7, 1.3377113999999963
8, 0, 0, 0, 0, 110.0, 704, 6977, 8, 1.4690915999999987
9, 0, 0, 0, 0, 180.0, 789, 7766, 9, 1.578552000000002
10, 0, 0, 0, 0, 270.0, 887, 8653, 10, 1.7943824000000035
11, 0, 0, 0, 0, 120.0, 616, 9269, 11, 1.3000086999999994
12, 0, 0, 0, 0, 110.0, 631, 9900, 12, 1.3262670999999955
13, 0, 0, 0, 0, 155.0, 546, 10446, 13, 1.1147491000000045
14, 0, 0, 0, 0, 225.0, 902, 11348, 14, 1.7780316000000056
15, 0, 0, 0, 0, 210.0, 806, 12154, 15, 1.6615831000000014
16, 0, 0, 0, 0, 320.0, 796, 12950, 16, 1.5551831000000007
17, 0, 0, 0, 0, 110.0, 528, 13478, 17, 1.0417357000000038
18, 0, 0, 0, 0, 410.0, 1075, 14553, 18, 2.1073405000000065
19, 0, 0, 0, 0, 35.0, 499, 15052, 19, 0.9863957999999968
20, 0, 0, 0, 0, 85.0, 643, 15695, 20, 1.3039604000000011
21, 0, 0, 0, 0, 80.0, 391, 16086, 21, 0.817647700000002
22, 0, 0, 0, 0, 155.0, 590, 16676, 22, 1.2046934999999976
23, 0, 0, 0, 0, 45.0, 383, 17059, 23, 0.8258574999999979
24, 0, 0, 0, 0, 65.0, 422, 17481, 24, 0.8183395000000004
25, 0, 0, 0, 0, 210.0, 800, 18281, 25, 1.542320800000006
26, 0, 0, 0, 0, 180.0, 860, 19141, 26, 1.6630623
27, 0, 0, 0, 0, 500.0, 1476, 20617, 27, 2.8906174000000036
28, 0, 0, 0, 0, 30.0, 541, 21158, 28, 1.0896536999999995
29, 0, 0, 0, 0, 410.0, 1057, 22215, 29, 2.0659418000000045
30, 0, 0, 0, 0, 135.0, 635, 22850, 30, 1.2884286999999972
31, 0, 0, 0, 0, 45.0, 412, 23262, 31, 0.8618531999999988
32, 0, 0, 0, 0, 155.0, 787, 24049, 32, 1.6103845000000092
33, 0, 0, 0, 0, 210.0, 685, 24734, 33, 1.4316167000000064
34, 0, 0, 0, 0, 215.0, 1498, 26232, 34, 3.0002511
35, 0, 0, 0, 0, 110.0, 616, 26848, 35, 1.2629795000000001
36, 0, 0, 0, 0, 120.0, 760, 27608, 36, 1.5747861000000114
37, 0, 0, 0, 0, 60.0, 357, 27965, 37, 0.7386255000000119
38, 0, 0, 0, 0, 210.0, 871, 28836, 38, 1.7085687000000007
39, 0, 0, 0, 0, 210.0, 804, 29640, 39, 1.6084756000000056
40, 0, 0, 0, 0, 225.0, 950, 30590, 40, 1.9079382000000038
41, 0, 0, 0, 0, 95.0, 395, 30985, 41, 0.7775378000000046
42, 0, 0, 0, 0, 290.0, 922, 31907, 42, 1.7860154999999907
43, 0, 0, 0, 0, 65.0, 394, 32301, 43, 0.7784596999999991
44, 0, 0, 0, 0, 110.0, 619, 32920, 44, 1.2911041999999924
45, 0, 0, 0, 0, 75.0, 509, 33429, 45, 1.0074316000000039
46, 0, 0, 0, 0, 95.0, 650, 34079, 46, 1.2818180000000012
47, 0, 0, 0, 0, 35.0, 581, 34660, 47, 1.1703925000000055
48, 0, 0, 0, 0, 70.0, 537, 35197, 48, 1.1152818000000053
49, 0, 0, 0, 0, 55.0, 394, 35591, 49, 0.8215555999999964
50, 0, 0, 0, 0, 110.0, 641, 36232, 50, 1.2716034999999977
51, 0, 0, 0, 0, 105.0, 688, 36920, 51, 1.407601299999996
52, 0, 0, 0, 0, 100.0, 630, 37550, 52, 1.2702139000000017
53, 0, 0, 0, 0, 135.0, 791, 38341, 53, 1.6424732999999918
54, 0, 0, 0, 0, 410.0, 1459, 39800, 54, 2.8214824999999877
55, 0, 0, 0, 0, 300.0, 1211, 41011, 55, 2.3944211000000024
56, 0, 0, 0, 0, 135.0, 792, 41803, 56, 1.5674166000000014
57, 0, 0, 0, 0, 50.0, 403, 42206, 57, 0.826779700000003
58, 0, 0, 0, 0, 105.0, 701, 42907, 58, 1.4177415999999994
59, 0, 0, 0, 0, 155.0, 718, 43625, 59, 1.523982899999993
60, 0, 0, 0, 0, 515.0, 1270, 44895, 60, 2.4553326000000055
61, 0, 0, 0, 0, 425.0, 1121, 46016, 61, 2.239209399999993
62, 0, 0, 0, 0, 415.0, 901, 46917, 62, 1.814691499999995
63, 0, 0, 0, 0, 50.0, 377, 47294, 63, 0.7622133999999932
64, 0, 0, 0, 0, 180.0, 873, 48167, 64, 2.028690299999994
65, 0, 0, 0, 0, 110.0, 657, 48824, 65, 1.5957297000000068
66, 0, 0, 0, 0, 335.0, 788, 49612, 66, 1.5796808999999996
67, 0, 0, 0, 0, 110.0, 651, 50263, 67, 1.3010850999999946
68, 0, 0, 0, 0, 110.0, 625, 50888, 68, 1.3143595999999889
69, 0, 0, 0, 0, 460.0, 1008, 51896, 69, 1.997759600000009
70, 0, 0, 0, 0, 165.0, 644, 52540, 70, 1.2734134000000097
71, 0, 0, 0, 0, 210.0, 823, 53363, 71, 1.77154010000001
72, 0, 0, 0, 0, 80.0, 653, 54016, 72, 1.3530930000000012
73, 0, 0, 0, 0, 50.0, 378, 54394, 73, 0.790590399999985
74, 0, 0, 0, 0, 180.0, 771, 55165, 74, 1.5736538000000166
75, 0, 0, 0, 0, 155.0, 691, 55856, 75, 1.4855138000000068
76, 0, 0, 0, 0, 125.0, 655, 56511, 76, 1.3174641999999892
77, 0, 0, 0, 0, 150.0, 751, 57262, 77, 1.5243372000000193
78, 0, 0, 0, 0, 155.0, 766, 58028, 78, 1.6049328999999943
79, 0, 0, 0, 0, 120.0, 779, 58807, 79, 1.6076233000000002
80, 0, 0, 0, 0, 155.0, 807, 59614, 80, 1.6078986999999927
81, 0, 0, 0, 0, 180.0, 844, 60458, 81, 1.7534326999999905
82, 0, 0, 0, 0, 380.0, 1097, 61555, 82, 2.2423054999999863
83, 0, 0, 0, 0, 155.0, 789, 62344, 83, 1.6086280000000102
84, 0, 0, 0, 0, 155.0, 788, 63132, 84, 1.6239280000000065
85, 0, 0, 0, 0, 105.0, 780, 63912, 85, 1.5479665000000011
86, 0, 0, 0, 0, 135.0, 788, 64700, 86, 1.5655055000000004
87, 0, 0, 0, 0, 210.0, 826, 65526, 87, 1.6428962999999897
88, 0, 0, 0, 0, 485.0, 1136, 66662, 88, 2.26724710000002
89, 0, 0, 0, 0, 50.0, 614, 67276, 89, 1.255146499999995
90, 0, 0, 0, 0, 185.0, 812, 68088, 90, 1.6355125000000044
91, 0, 0, 0, 0, 55.0, 628, 68716, 91, 1.328267000000011
92, 0, 0, 0, 0, 210.0, 817, 69533, 92, 1.6480516999999963
93, 0, 0, 0, 0, 110.0, 728, 70261, 93, 1.4507922999999892
94, 0, 0, 0, 0, 135.0, 795, 71056, 94, 1.6630898999999886
95, 0, 0, 0, 0, 155.0, 813, 71869, 95, 1.7044314000000043
96, 0, 0, 0, 0, 155.0, 817, 72686, 96, 1.6229872000000114
97, 0, 0, 0, 0, 75.0, 411, 73097, 97, 0.8537742999999978
98, 0, 0, 0, 0, 75.0, 618, 73715, 98, 1.3224680999999805
99, 0, 0, 0, 0, 110.0, 772, 74487, 99, 1.556941600000016
100, 0, 0, 0, 0, 210.0, 803, 75290, 100, 1.5813800999999899
101, 0, 0, 0, 0, 75.0, 703, 75993, 101, 1.4121331000000055
102, 0, 0, 0, 0, 180.0, 851, 76844, 102, 1.7129501000000005
103, 0, 0, 0, 0, 290.0, 1035, 77879, 103, 2.0947280000000035
104, 0, 0, 0, 0, 120.0, 779, 78658, 104, 1.605317599999978
105, 0, 0, 0, 0, 55.0, 361, 79019, 105, 0.7808051000000091
106, 0, 0, 0, 0, 410.0, 820, 79839, 106, 1.6223684999999932
107, 0, 0, 0, 0, 110.0, 597, 80436, 107, 1.2088871000000267
108, 0, 0, 0, 0, 180.0, 816, 81252, 108, 1.712530700000002
109, 0, 0, 0, 0, 210.0, 866, 82118, 109, 1.7294692000000111
110, 0, 0, 0, 0, 20.0, 383, 82501, 110, 0.7933568000000264
111, 0, 0, 0, 0, 165.0, 772, 83273, 111, 1.560434799999996
112, 0, 0, 0, 0, 110.0, 764, 84037, 112, 1.567471100000006
113, 0, 0, 0, 0, 65.0, 609, 84646, 113, 1.2299882000000082
114, 0, 0, 0, 0, 15.0, 491, 85137, 114, 1.0073898999999926
115, 0, 0, 0, 0, 460.0, 946, 86083, 115, 1.8671506000000022
116, 0, 0, 0, 0, 155.0, 796, 86879, 116, 1.6291539999999998
117, 0, 0, 0, 0, 135.0, 743, 87622, 117, 1.4835753999999781
118, 0, 0, 0, 0, 105.0, 656, 88278, 118, 1.3022365999999863
119, 0, 0, 0, 0, 135.0, 778, 89056, 119, 1.6251880000000085
120, 0, 0, 0, 0, 110.0, 699, 89755, 120, 1.431753399999991
121, 0, 0, 0, 0, 185.0, 890, 90645, 121, 1.735448799999972
122, 0, 0, 0, 0, 135.0, 782, 91427, 122, 1.5509220000000141
123, 0, 0, 0, 0, 120.0, 626, 92053, 123, 1.3306232000000193
124, 0, 0, 0, 0, 105.0, 635, 92688, 124, 1.2898631000000194
125, 0, 0, 0, 0, 150.0, 846, 93534, 125, 1.691556399999996
126, 0, 0, 0, 0, 180.0, 789, 94323, 126, 1.6586845999999866
127, 0, 0, 0, 0, 135.0, 780, 95103, 127, 1.583791500000018
128, 0, 0, 0, 0, 210.0, 806, 95909, 128, 1.6315768999999989
129, 0, 0, 0, 0, 110.0, 782, 96691, 129, 1.6154917000000069
130, 0, 0, 0, 0, 380.0, 853, 97544, 130, 1.8495550000000094
131, 0, 0, 0, 0, 180.0, 832, 98376, 131, 1.6853505999999925
132, 0, 0, 0, 0, 105.0, 394, 98770, 132, 0.8221494000000007
133, 0, 0, 0, 0, 180.0, 813, 99583, 133, 1.676646500000004
134, 4.911211292473775, 4.90437142534076, 6.224231867520315, 0.8197605999999998, 110.0, 683, 100266, 134, 16.183689600000008
135, 5.292164070235913, 4.9183264119878904, 6.12680515568918, 0.8190064000000001, 20.0, 573, 100839, 135, 32.00319670000002
136, 5.789544734155169, 4.911407936433828, 6.066060547502885, 0.8179111000000004, 130.0, 644, 101483, 136, 35.88535619999999
137, 5.222169755690144, 4.909538612991083, 6.0050481968238705, 0.8167275999999997, 210.0, 671, 102154, 137, 38.63647169999996
138, 5.403653023657557, 4.914821585921325, 6.000705843137326, 0.8154496000000001, 235.0, 749, 102903, 138, 43.27186009999997
139, 5.777461843977448, 4.915900582029619, 6.024492193178366, 0.8141859999999996, 185.0, 655, 103558, 139, 37.701707200000044
140, 5.016571661374371, 4.912814561728459, 5.968201623600759, 0.8130312999999998, 135.0, 628, 104186, 140, 35.755788300000006
141, 5.630575359937894, 4.92521574044974, 5.973405864796367, 0.8114886999999995, 455.0, 1086, 105272, 141, 61.855857499999956
142, 4.944218576825638, 4.915723701923105, 5.954523378109671, 0.8097724000000001, 150.0, 821, 106093, 142, 47.148655899999994
143, 4.715365038698651, 4.915533602141098, 5.926298760517683, 0.8084781999999997, 60.0, 617, 106710, 143, 35.107265900000016
144, 5.454759117765845, 4.928843913968227, 5.973892890643277, 0.8072767000000001, 140.0, 718, 107428, 144, 40.970710199999985
145, 4.672633330134013, 4.917073908708189, 5.931990140005852, 0.8059185999999999, 140.0, 791, 108219, 145, 45.234349799999904
146, 4.503643024980874, 4.920969522916353, 5.934157287512464, 0.8048440000000002, 45.0, 403, 108622, 146, 23.134166400000026
147, 4.573399174641742, 4.916873763929977, 5.92132831005915, 0.8035921000000001, 265.0, 988, 109610, 147, 57.434683199999995
148, 5.222771099461131, 4.968674547126494, 6.018008486046848, 0.8023294, 35.0, 415, 110025, 148, 24.181749500000024
149, 4.6669876353215365, 5.598325378905827, 6.766543081251242, 0.8013717999999999, 135.0, 649, 110674, 149, 37.964257299999986
150, 4.10084634326021, 5.5876991644905365, 6.724948054067659, 0.8000235999999994, 225.0, 849, 111523, 150, 50.1870351
151, 5.182492597114721, 5.60913428018853, 6.779202715323789, 0.7985196999999999, 160.0, 822, 112345, 151, 48.509942900000055
152, 4.842476347841883, 5.622375076816928, 6.778249642754968, 0.7967754999999996, 495.0, 1116, 113461, 152, 65.87348710000003
153, 5.015233433123414, 5.612500407564358, 6.781999173126821, 0.7953139000000001, 90.0, 508, 113969, 153, 30.19053269999995
154, 4.924127235645644, 5.608994139533095, 6.77323261683809, 0.7941177999999994, 80.0, 821, 114790, 154, 48.81966390000002
155, 5.514516413718019, 5.609782987339481, 6.780518745414264, 0.7929549999999999, 140.0, 471, 115261, 155, 28.09298130000002
156, 4.393999952144963, 5.607332653668316, 6.766473151058462, 0.7920514000000001, 60.0, 533, 115794, 156, 31.944416400000136
157, 4.882067073069446, 5.603362162907918, 6.731462876001994, 0.7911720999999999, 100.0, 444, 116238, 157, 26.520754900000156
158, 4.640980885939971, 5.60747282741634, 6.749922702785667, 0.7898293000000001, 325.0, 1048, 117286, 158, 62.84252790000005
159, 4.204254166088031, 5.606133003574595, 6.7552920516210655, 0.7885324000000001, 65.0, 393, 117679, 159, 23.695109999999886
160, 5.421773281996836, 5.613203788231947, 6.800024702639399, 0.7877277999999999, 75.0, 501, 118180, 160, 30.292454200000066
161, 5.705088242923105, 5.626689305416373, 6.784036573143893, 0.7868899, 65.0, 430, 118610, 161, 26.068901000000096
162, 4.877911102806703, 5.611337575481166, 6.739969674466643, 0.7859655999999996, 85.0, 597, 119207, 162, 36.201766300000145
163, 4.657952243583753, 5.6128565142394375, 6.744833983231263, 0.784918, 210.0, 567, 119774, 163, 34.474573599999985
164, 5.378951866060812, 5.7492947743294085, 6.93093493517409, 0.7840693, 50.0, 376, 120150, 164, 22.9492537000001
165, 4.833420217865044, 5.940706386767998, 7.140625189221095, 0.7833906999999997, 45.0, 378, 120528, 165, 23.074885900000027
166, 4.561259508851519, 5.952959841883122, 7.148233100847545, 0.7823413000000005, 335.0, 788, 121316, 166, 48.27133170000002
167, 5.034544808882101, 5.957907709801627, 7.166268291396993, 0.7809579999999998, 185.0, 749, 122065, 167, 45.97877930000004
168, 4.520046185177305, 5.9440574330868925, 7.152055282592773, 0.7797664000000002, 65.0, 575, 122640, 168, 35.49388679999993
169, 3.9700192794772127, 5.935623801565091, 7.128537450856831, 0.7787062000000002, 110.0, 603, 123243, 169, 37.40368709999984
170, 4.78351172661582, 5.954189049412838, 7.155573757215478, 0.7773021999999993, 400.0, 957, 124200, 170, 59.41921339999999
171, 5.0143227118570195, 5.954884422774864, 7.15980173381029, 0.7759324000000002, 110.0, 565, 124765, 171, 35.36696830000005
172, 5.551158232118387, 5.95722994458076, 7.179318645590954, 0.7749405999999996, 110.0, 537, 125302, 172, 33.625934500000085
173, 4.531025180104658, 5.951845330532414, 7.137644433837803, 0.7738326999999999, 150.0, 694, 125996, 173, 44.213269099999934
174, 4.301664147786643, 5.937835326410616, 7.127622120664934, 0.7727707, 105.0, 486, 126482, 174, 30.805212400000073
175, 4.846203027262749, 5.956018019706237, 7.153009403282605, 0.7715043999999998, 345.0, 921, 127403, 175, 58.40038219999997
176, 5.510002866922849, 5.9674057848243764, 7.176391408936833, 0.7699492000000001, 120.0, 807, 128210, 176, 51.29019440000002
177, 4.651691967920868, 5.950770299967246, 7.150628600588422, 0.7683607000000007, 165.0, 958, 129168, 177, 61.017490699999826
178, 5.062938080627573, 5.958506341986197, 7.174315516883707, 0.7668711999999999, 135.0, 697, 129865, 178, 44.68553059999999
179, 4.365463860987163, 6.220014726243368, 7.460152543463358, 0.7655059000000004, 165.0, 820, 130685, 179, 52.776928
180, 4.25238809910472, 6.278113322801868, 7.531460937201502, 0.7640893000000001, 180.0, 754, 131439, 180, 48.78699069999993
181, 4.987624478511785, 6.2891279040830925, 7.558330806762136, 0.7630669, 50.0, 382, 131821, 181, 24.831544900000154
182, 4.8731252742437725, 6.284333968264425, 7.534380135373173, 0.7618807, 430.0, 936, 132757, 182, 60.87154920000012
183, 4.772659833678111, 6.283011321873628, 7.53723931814217, 0.7602255999999996, 210.0, 903, 133660, 183, 58.96708179999996
184, 4.97025911216225, 6.286308485439846, 7.556689444950648, 0.7587829000000004, 115.0, 700, 134360, 184, 45.941937999999936
185, 4.259130209763844, 6.272249422073364, 7.529979365666708, 0.7574779, 155.0, 750, 135110, 185, 49.441148500000054
186, 4.9427652553008015, 6.2769689221503375, 7.545138107012894, 0.7559533, 255.0, 944, 136054, 186, 62.491286800000125
187, 4.6061923881773374, 6.2810628833167375, 7.5501793038447, 0.7540795000000007, 210.0, 1138, 137192, 187, 75.64410130000033
188, 5.048240921268017, 6.281376448619717, 7.552060547073338, 0.7525359999999998, 110.0, 577, 137769, 188, 38.569240900000295
189, 4.107637713904734, 6.266017700332442, 7.520344724322716, 0.7511905000000003, 215.0, 918, 138687, 189, 61.49432560000014
190, 4.7842974398906035, 6.275687025652991, 7.528632881740729, 0.7498459, 110.0, 576, 139263, 190, 38.78510319999987
191, 4.3640670266518695, 6.444757905343304, 7.74548285195361, 0.7480027000000004, 260.0, 1472, 140735, 191, 99.24228420000009
192, 4.952188347866697, 6.6265295558707615, 7.978195689995023, 0.7457338000000008, 250.0, 1049, 141784, 192, 71.25624449999987
193, 4.829030320635833, 6.6291732060012, 7.972870058312639, 0.7435341999999996, 565.0, 1395, 143179, 193, 95.22858870000027
194, 4.1616935752013315, 6.61875865307918, 7.958615102038155, 0.7415847999999999, 260.0, 771, 143950, 194, 52.88405890000013
195, 4.509784477061259, 6.628408949599307, 7.969451223683153, 0.7401538000000003, 430.0, 819, 144769, 195, 56.445074100000056
196, 4.497026403049852, 6.63350633573855, 7.974285533142951, 0.7386192999999998, 260.0, 886, 145655, 196, 61.20027389999996
197, 4.080762460085245, 6.629928844711709, 7.9679853876563795, 0.7372800999999999, 110.0, 602, 146257, 197, 41.812910999999986
198, 4.961496238602451, 6.6377228140099644, 7.976420810617552, 0.7361515, 110.0, 652, 146909, 198, 45.2719503000003
199, 4.6928049578426885, 6.6377502373154895, 7.998541447364615, 0.7350994000000002, 35.0, 517, 147426, 199, 36.105073000000175
200, 5.077373686013261, 6.633902226916011, 7.978594118517131, 0.7341993999999998, 65.0, 483, 147909, 200, 33.83056529999976
201, 4.821867296575273, 6.636044922022285, 7.972713011418837, 0.7330653999999998, 160.0, 777, 148686, 201, 54.26718329999994
202, 4.528190637602394, 6.628196840355721, 7.971674809966946, 0.7315012000000003, 260.0, 961, 149647, 202, 67.76797169999963
203, 5.571710893838423, 6.958847540352732, 8.371676899529444, 0.7299054999999995, 210.0, 812, 150459, 203, 57.52816369999982
204, 4.871136958809147, 7.168308912321579, 8.627309006740454, 0.7286715999999999, 210.0, 559, 151018, 204, 39.67186150000043
205, 4.829646341949344, 7.1699020719642546, 8.612015764204433, 0.7277931999999999, 30.0, 417, 151435, 205, 29.781833900000038
206, 4.518936922751109, 7.154333258432056, 8.604057359205687, 0.7264539999999998, 230.0, 1071, 152506, 206, 76.53895479999983
207, 4.788746476991148, 7.170091367349392, 8.634919223746634, 0.7250473, 80.0, 492, 152998, 207, 35.176367200000186
208, 4.808750648402725, 7.168348217305297, 8.62946867684861, 0.7240221999999998, 120.0, 647, 153645, 208, 46.53947840000001
209, 4.700331512460342, 7.169024890752939, 8.635113540062537, 0.7228548999999997, 105.0, 650, 154295, 209, 46.87449409999999
210, 4.238875247162143, 7.1560720456849545, 8.588810813536337, 0.7214850999999997, 450.0, 872, 155167, 210, 62.9335001000004
211, 4.663720061634127, 7.1728349311575705, 8.634208922096379, 0.7198858, 250.0, 905, 156072, 211, 65.58879449999995
212, 5.283374734119767, 7.1919484724222995, 8.628890060636, 0.7185510999999998, 100.0, 578, 156650, 212, 42.23768280000013
213, 3.9895913615597016, 7.1667685671286145, 8.614679285372146, 0.7173180999999998, 185.0, 792, 157442, 213, 57.88195739999992
214, 4.985437051153861, 7.176674343398397, 8.627669843339243, 0.7156557999999994, 325.0, 1055, 158497, 214, 77.45545949999996
215, 4.778463416217547, 7.177164747428571, 8.63173576538938, 0.7141743999999999, 105.0, 591, 159088, 215, 42.96236940000017
216, 5.26337687099862, 7.172151764412098, 8.65605720810826, 0.7132411000000001, 40.0, 446, 159534, 216, 30.91318999999976
217, 5.484452185558162, 7.235072458944013, 8.686373636286746, 0.7123375000000002, 15.0, 558, 160092, 217, 38.540597499999876
218, 4.802380764621028, 7.508379789499136, 9.037293550480959, 0.7106769999999999, 320.0, 1287, 161379, 218, 89.28331060000028
219, 3.9216143435276134, 7.500111077616855, 9.02067890545217, 0.7089282999999998, 120.0, 656, 162035, 219, 45.71800669999993
220, 5.094024052586354, 7.512135074508023, 9.03416053879429, 0.7080184, 15.0, 355, 162390, 220, 24.998505300000033
221, 4.157206470895747, 7.507294024983928, 9.030335781567418, 0.7067566000000001, 235.0, 1047, 163437, 221, 73.12567510000008
222, 4.7768293336485375, 7.5132196130174576, 9.058416362242266, 0.7052203000000001, 110.0, 660, 164097, 222, 46.15612510000028
223, 4.434723522771227, 7.503039443473755, 9.03114275526656, 0.7040656000000003, 180.0, 623, 164720, 223, 43.952141499999925
224, 4.672628224732909, 7.515139648211355, 9.039791691879772, 0.702928, 120.0, 641, 165361, 224, 45.72396509999999
225, 5.324276727106836, 7.520386293199327, 9.073265588548448, 0.7019461, 105.0, 450, 165811, 225, 32.16739279999911
226, 4.492359780469192, 7.507354901695893, 9.029492107438452, 0.7007392000000002, 195.0, 891, 166702, 226, 63.49768649999987
227, 3.761272535686128, 7.504651131610375, 9.02213419641581, 0.6992793999999999, 180.0, 731, 167433, 227, 52.33913459999985
228, 4.268263957367234, 7.505417182933437, 9.028734337262733, 0.6980014000000001, 160.0, 689, 168122, 228, 49.3172112000002
229, 4.637701140784541, 7.515976588253068, 9.046549399372054, 0.6969367000000001, 50.0, 494, 168616, 229, 35.29342650000035
230, 4.047668259666479, 7.50889081593618, 9.036116424529576, 0.695827, 110.0, 739, 169355, 230, 53.034783699999934
231, 4.129707939471539, 7.560174075575783, 9.10204476449634, 0.6944338000000001, 160.0, 809, 170164, 231, 58.523648700000194
232, 4.228603474631467, 7.771728552439633, 9.34148811768083, 0.6932160999999997, 110.0, 544, 170708, 232, 39.40975990000061
233, 4.427917222524512, 7.773262086294494, 9.345711325918735, 0.6919695999999999, 195.0, 841, 171549, 233, 61.06853510000019
234, 4.914541196545392, 7.778033304385387, 9.356657000852742, 0.6907104999999999, 135.0, 558, 172107, 234, 40.74873759999991
235, 4.226585532200709, 7.759571891243725, 9.32634736863728, 0.6897196, 80.0, 543, 172650, 235, 39.55340160000014
236, 4.656771033606072, 7.7780934829204735, 9.361342302414766, 0.6882832000000001, 240.0, 1053, 173703, 236, 77.43467540000074
237, 4.303734139057925, 7.775703201497215, 9.34784359025701, 0.6868288000000001, 120.0, 563, 174266, 237, 41.66283680000015
238, 4.365987489768998, 7.769260949953759, 9.341793072279806, 0.6857488000000004, 110.0, 637, 174903, 238, 47.01043500000014
239, 4.304834771868786, 7.76347698901207, 9.341771150816982, 0.6848667999999999, 35.0, 343, 175246, 239, 25.62084330000016
240, 4.175284291414776, 7.76677380799017, 9.314567359239325, 0.6836860000000003, 230.0, 969, 176215, 240, 72.24507900000026
241, 3.992889796766526, 7.757570422078013, 9.31916319385562, 0.6815790999999997, 320.0, 1372, 177587, 241, 102.3428587999997
242, 3.7956975139771836, 7.7712274823007705, 9.353379313553436, 0.6796333, 210.0, 790, 178377, 242, 58.98475090000011
243, 4.18683831988828, 7.76384499762793, 9.337830314096415, 0.6783499, 160.0, 636, 179013, 243, 48.3159255999999
244, 4.213208860639438, 7.775225263926013, 9.345580002864883, 0.6772528000000001, 120.0, 583, 179596, 244, 44.009758500000316
245, 4.320052906804021, 7.759444097766962, 9.315363903216717, 0.6763266999999997, 45.0, 446, 180042, 245, 33.598581500000364
246, 4.079681275780931, 7.711365731427986, 9.253059405298414, 0.6752610999999998, 120.0, 738, 180780, 246, 55.7861283000002
247, 4.090571430757103, 7.708952861481094, 9.238083114338279, 0.6738759999999998, 200.0, 801, 181581, 247, 60.97176909999962
248, 3.932961402457904, 7.721774561036893, 9.260045605171017, 0.6726015999999999, 80.0, 615, 182196, 248, 47.09774000000016
249, 4.037179858047144, 7.700909387036629, 9.25556216102768, 0.6715162000000001, 180.0, 591, 182787, 249, 45.06779629999983
250, 3.756144648829317, 7.687407573999143, 9.227761433171292, 0.6702958, 225.0, 765, 183552, 250, 58.543812799999614
251, 3.6395630680573614, 7.689492840014006, 9.239476274189196, 0.6691798000000001, 30.0, 475, 184027, 251, 36.58246880000024
252, 4.235079581260073, 7.694592953944693, 9.222990140622976, 0.6680466999999998, 210.0, 784, 184811, 252, 60.03375860000051
253, 3.730347391303915, 7.687537563764132, 9.216368948496305, 0.6668731, 75.0, 520, 185331, 253, 39.97304729999996
254, 3.4645391896306745, 7.6857904210264385, 9.21785372761097, 0.6659605, 30.0, 494, 185825, 254, 38.463461800000005
255, 3.5055257998641007, 7.683781433458028, 9.197856435934408, 0.6650289999999998, 100.0, 541, 186366, 255, 41.93307019999975
256, 4.351169177691418, 7.701139590280562, 9.241336516963626, 0.6638931999999999, 165.0, 721, 187087, 256, 56.241873699999815
257, 4.248871390396285, 7.697594911729083, 9.229617924469412, 0.6621948999999994, 490.0, 1166, 188253, 257, 91.03400019999935
258, 4.089619879231033, 7.700363710076023, 9.23319952494442, 0.6601546000000001, 405.0, 1101, 189354, 258, 86.0762306000006
259, 4.3328721922423155, 7.707880514008658, 9.246434145233257, 0.6586345, 45.0, 588, 189942, 259, 46.026138100000026
260, 4.204007674824407, 7.933236012597544, 9.520735279159195, 0.6575176000000003, 275.0, 653, 190595, 260, 51.653804700000364
261, 3.4567649498733166, 7.936282687985957, 9.528712549790512, 0.6562207000000001, 140.0, 788, 191383, 261, 62.484237499999836
262, 4.281593903077869, 7.947571144329281, 9.534901647117195, 0.6550543000000002, 80.0, 508, 191891, 262, 40.359564299999874
263, 4.426799995199865, 7.961174774624775, 9.557267595360882, 0.6540309999999998, 130.0, 629, 192520, 263, 50.36199199999919
264, 3.948056658246684, 7.946700979325293, 9.539644098171737, 0.6522958000000001, 390.0, 1299, 193819, 264, 103.76521810000031
265, 4.122231482436616, 7.953090332971534, 9.539316259196694, 0.6505498000000003, 120.0, 641, 194460, 265, 51.22778540000036
266, 3.868655331313419, 7.942004337524756, 9.529551149942936, 0.6494113000000001, 50.0, 624, 195084, 266, 50.453688199999306
267, 4.482882916543781, 7.963248366401309, 9.54133653824854, 0.6481503999999999, 195.0, 777, 195861, 267, 63.0648168000007
268, 4.250783112662327, 7.938470002210106, 9.510760325176228, 0.6468264999999996, 210.0, 694, 196555, 268, 56.47536989999935
269, 4.05936440042087, 7.936026844297136, 9.513952849251883, 0.6458869, 40.0, 350, 196905, 269, 28.62861510000039
270, 4.009082573417586, 7.941461837984371, 9.534452208685218, 0.6443947000000008, 420.0, 1308, 198213, 270, 106.08231009999963
271, 4.01496621190359, 7.949467109034237, 9.526413655509582, 0.6426540999999998, 125.0, 626, 198839, 271, 51.116615699999784
272, 3.9728065268519392, 7.94373202644656, 9.522484393041408, 0.6414885999999999, 115.0, 669, 199508, 272, 55.22094620000007
273, 4.245652072752516, 8.21539256021832, 9.854803517912373, 0.6399360999999996, 280.0, 1056, 200564, 273, 86.86124749999999
274, 3.985162834190961, 8.434550799023022, 10.11539877689246, 0.6383916999999999, 165.0, 660, 201224, 274, 54.28337929999998
275, 4.075527217856554, 8.43207557418937, 10.122674419893233, 0.6373144, 75.0, 537, 201761, 275, 44.326073399999586
276, 3.8150688363644876, 8.434171861739035, 10.107542660206354, 0.6359014000000002, 435.0, 1033, 202794, 276, 85.25047840000025
277, 4.252618055596689, 8.446906646835469, 10.131002578939073, 0.6342975999999996, 190.0, 749, 203543, 277, 61.15233029999945
278, 4.534652423897536, 8.446622698380935, 10.146899802066374, 0.6330718, 85.0, 613, 204156, 278, 50.30594420000034
279, 4.606005153412204, 8.445158126977969, 10.14574504436883, 0.6318423999999998, 310.0, 753, 204909, 279, 62.011425800000325
280, 3.791413912490206, 8.436315475216949, 10.113928234823202, 0.6302053000000003, 305.0, 1066, 205975, 280, 87.26228310000079
281, 3.168559005842738, 8.425681555032362, 10.099829534169155, 0.6286617999999997, 110.0, 649, 206624, 281, 53.36871509999946
282, 4.289574896703001, 8.44762112166949, 10.140589695573741, 0.6268699, 360.0, 1342, 207966, 282, 110.2549755
283, 4.102747908362479, 8.442484156409307, 10.139208343491626, 0.6246973000000003, 320.0, 1072, 209038, 283, 87.3531382000001
284, 3.947865332562135, 8.4407312290602, 10.131518249967659, 0.6232806999999999, 55.0, 502, 209540, 284, 41.466092100000424
285, 4.198084834322356, 8.40476772810589, 10.090645640589512, 0.6222376, 115.0, 657, 210197, 285, 54.03591249999954
286, 3.7134386556688694, 8.32329209074378, 9.986393669247628, 0.6210703000000002, 125.0, 640, 210837, 286, 52.3937990000004
287, 4.19903065284899, 8.317330338529995, 9.989137637322587, 0.619651, 150.0, 937, 211774, 287, 76.91233910000028
288, 4.282626740871945, 8.319115406225535, 9.97740463157753, 0.6180454000000003, 215.0, 847, 212621, 288, 68.86244420000003
289, 4.4303446505384, 8.333242331167591, 9.98332174105336, 0.616573, 210.0, 789, 213410, 289, 64.41453360000014
290, 3.9987919175703275, 8.318240636273435, 9.979707274520607, 0.6150420999999999, 140.0, 912, 214322, 290, 74.54139849999956
291, 4.286136651171089, 8.334228119287104, 9.9992783254363, 0.6132457, 460.0, 1084, 215406, 291, 88.7433028000014
292, 3.73002125833606, 8.31236868482275, 9.983069922506195, 0.6115716999999998, 415.0, 776, 216182, 292, 63.22952729999997
293, 4.4120071785008195, 8.329642655108279, 9.999595456612603, 0.6102855999999998, 170.0, 653, 216835, 293, 53.05337220000001
294, 4.647822060877994, 8.340474263692306, 9.996854744927358, 0.6091669000000001, 165.0, 590, 217425, 294, 48.09688129999995
295, 4.9590652016126535, 8.332670032756479, 9.99281888025844, 0.6081517000000001, 90.0, 538, 217963, 295, 43.94615750000048
296, 4.21725108669833, 8.33198431694314, 9.99856820183951, 0.6068917000000003, 215.0, 862, 218825, 296, 70.08881699999984
297, 3.6913292458684173, 8.318585392126103, 9.981576749958943, 0.6057667, 40.0, 388, 219213, 297, 31.76678279999942
298, 4.141469540687846, 8.343344424066226, 10.002382439789095, 0.6048216999999998, 130.0, 662, 219875, 298, 54.07498080000005
299, 4.306706083256167, 8.496047338973225, 10.194785286596723, 0.6034617999999999, 130.0, 849, 220724, 299, 69.44502180000018
300, 4.003660950233352, 8.521055821652682, 10.225491329409042, 0.6022207, 75.0, 530, 221254, 300, 43.470682499999384
301, 3.9002724479745936, 8.51996691433, 10.227560370645405, 0.6013791999999999, 75.0, 405, 221659, 301, 33.13517479999973
302, 4.308299512389861, 8.517650015942461, 10.222986923741498, 0.6005295999999999, 65.0, 539, 222198, 302, 43.95154940000066
303, 4.086760056112275, 8.511534539742806, 10.20278055056479, 0.5992407999999998, 130.0, 893, 223091, 303, 73.26138489999903
304, 3.2321053297996523, 8.498032379150391, 10.182924324035644, 0.5978745999999999, 45.0, 625, 223716, 304, 51.191451299999244
305, 3.9277416933018503, 8.526110608712383, 10.213946150782892, 0.5967703, 75.0, 602, 224318, 305, 49.189231300000756
306, 3.984710845080289, 8.507665608312701, 10.194933761249889, 0.5957137000000001, 105.0, 572, 224890, 306, 46.89720690000104
307, 4.252371880402671, 8.538779497901096, 10.238925521886802, 0.5946300999999998, 110.0, 632, 225522, 307, 75.55346959999952
308, 3.7031806923795156, 8.500570495437584, 10.202751078057696, 0.5936931999999999, 50.0, 409, 225931, 308, 38.6984539999994
309, 4.278997548988888, 8.519669957760808, 10.225176011067209, 0.5924809, 300.0, 938, 226869, 309, 88.7193342999999
310, 4.953632314420409, 8.558688271045686, 10.240530387560527, 0.5913127, 50.0, 360, 227229, 310, 34.348349199999575
311, 3.528979805697791, 8.524333964674144, 10.235453287459952, 0.5900365000000002, 290.0, 1058, 228287, 311, 105.8926692999994
312, 3.9062086123856385, 8.541634318495747, 10.246962713040517, 0.5884524999999999, 125.0, 702, 228989, 312, 68.29902899999979
313, 4.373064107373175, 8.535633069087357, 10.244212620415723, 0.5870845, 160.0, 818, 229807, 313, 74.1023153999995
314, 4.510195428442552, 8.788727925019563, 10.578182905768427, 0.5856031, 220.0, 828, 230635, 314, 72.27406190000147
315, 3.9587122210624703, 8.887564023335775, 10.676833957331286, 0.5843341000000002, 105.0, 582, 231217, 315, 50.91195829999924
316, 4.5980650680859885, 8.900665908813476, 10.70099663035075, 0.5834728, 120.0, 375, 231592, 316, 34.003464199999144
317, 4.150117919809418, 8.875071231275797, 10.655609101988375, 0.5822137000000001, 210.0, 1024, 232616, 317, 95.66911620000064
318, 4.200021037925035, 8.902902726829051, 10.714226607233286, 0.5801401000000002, 315.0, 1280, 233896, 318, 119.23736579999968
319, 4.485612825735619, 8.896508240908908, 10.69109442777801, 0.5785777000000002, 85.0, 456, 234352, 319, 42.5591031999993
320, 5.329638962747355, 8.961705499600418, 10.767616471893051, 0.5775319000000004, 335.0, 706, 235058, 320, 66.0170435
321, 4.3633085108310885, 8.941547389837565, 10.735289371644967, 0.5760298000000001, 290.0, 963, 236021, 321, 89.9585533999998
322, 4.035980462963725, 8.950897267666356, 10.740032425214505, 0.5743279, 210.0, 928, 236949, 322, 86.6671791000008
323, 4.753385015986569, 8.96128351685727, 10.747502872377733, 0.5726853999999998, 360.0, 897, 237846, 323, 84.96019920000072
324, 4.7205012750487, 8.9687380347141, 10.774105411352114, 0.5714911, 80.0, 430, 238276, 324, 44.2596680000006
325, 3.56520923976883, 8.947894353425484, 10.759960729729807, 0.5705398000000002, 165.0, 627, 238903, 325, 60.62542240000039
326, 3.940747604776391, 8.943774459607933, 10.737673285830716, 0.5691727, 215.0, 892, 239795, 326, 87.92620370000077
327, 3.8907567343169815, 9.137173033624741, 10.984406397409455, 0.5678236000000002, 110.0, 607, 240402, 327, 72.29235479999988
328, 3.5760911696393727, 9.220325105962619, 11.080796831426486, 0.5666382999999997, 125.0, 710, 241112, 328, 146.1473186000003
329, 4.333884665688265, 9.239315769047414, 11.096463097877873, 0.5650723, 210.0, 1030, 242142, 329, 203.4881652999993
330, 3.954373476211245, 9.223139095488744, 11.099243082006392, 0.5636746, 50.0, 523, 242665, 330, 86.06551359999867
331, 4.476459200502137, 9.241828317892447, 11.096546032685927, 0.5625864999999997, 105.0, 686, 243351, 331, 91.97425160000057
332, 4.340245621934417, 9.25434130883032, 11.104682685792909, 0.5613885999999999, 90.0, 645, 243996, 332, 68.90259850000075
333, 5.403280866709197, 9.246770253580946, 11.088495472110742, 0.5603032, 125.0, 561, 244557, 333, 58.72671309999896
334, 4.187151741407117, 9.21000609465685, 11.081442145939686, 0.5592286000000002, 110.0, 633, 245190, 334, 63.70406430000003
335, 4.115383195143091, 9.213629738793506, 11.081067741296852, 0.5582349999999999, 125.0, 471, 245661, 335, 48.70887399999992
336, 3.8951740383180145, 9.224582792557392, 11.07309350524981, 0.5574619000000002, 35.0, 388, 246049, 336, 58.50664179999876
337, 3.999418062481238, 9.204093898516245, 11.048146690111704, 0.5564179000000001, 60.0, 772, 246821, 337, 144.49223020000136
338, 3.4298102764682916, 9.218676556885697, 11.065626659830109, 0.5551336000000002, 155.0, 655, 247476, 338, 135.3548382000008
339, 3.6747206836223603, 9.193789686584473, 11.027848741149903, 0.5539815999999999, 120.0, 625, 248101, 339, 136.32581359999858
340, 3.666787511415102, 9.20247609777884, 11.07544796033339, 0.5531022999999999, 60.0, 352, 248453, 340, 76.07210850000047
341, 3.708967729774584, 9.197029831897781, 11.055936583553452, 0.5521879000000002, 210.0, 664, 249117, 341, 106.03703069999938
342, 4.056298430083751, 9.378806988618381, 11.256422531571745, 0.5506156000000002, 305.0, 1083, 250200, 342, 226.5160474000004
343, 4.3370558318711385, 10.131062541246857, 12.180406259030711, 0.5491557999999999, 65.0, 539, 250739, 343, 136.34243090000018
344, 4.461419289178479, 10.142923288137514, 12.193051155773837, 0.5479273000000002, 130.0, 826, 251565, 344, 149.15658030000122
345, 4.146432731137928, 10.167225769441641, 12.21160490135679, 0.5459266000000005, 385.0, 1397, 252962, 345, 313.95038510000086
346, 3.734981769195167, 10.202613820311843, 12.254696459131623, 0.5437486000000001, 245.0, 1023, 253985, 346, 139.48966479999945
347, 4.033461869010978, 10.219738720855501, 12.282306024337112, 0.5421790000000001, 320.0, 721, 254706, 347, 80.5151195999988
348, 3.780062938073896, 10.198844400303457, 12.254989486993312, 0.5409100000000002, 110.0, 689, 255395, 348, 116.28338889999941
349, 3.999335938973951, 10.222370154337028, 12.288301873770807, 0.5396428000000002, 275.0, 719, 256114, 349, 168.90211210000052
350, 3.6935621574907107, 10.202672440770995, 12.256014280368627, 0.5383009000000001, 135.0, 772, 256886, 350, 203.07516679999935
351, 3.9418514694745603, 10.234055148886, 12.293164864820486, 0.5366602000000003, 260.0, 1051, 257937, 351, 258.84068209999896
352, 4.3871843997689615, 10.221186668295797, 12.262685036793435, 0.5352346, 25.0, 533, 258470, 352, 129.7862365000001
353, 4.1480353531032925, 10.244923536669571, 12.304010053720985, 0.5338801000000001, 295.0, 972, 259442, 353, 239.81191760000002
354, 4.140835334735861, 10.229882874523806, 12.288551377200847, 0.5326371999999999, 105.0, 409, 259851, 354, 105.25661059999948
355, 4.209378634489731, 10.241577421131105, 12.306903601069397, 0.5316993999999997, 65.0, 633, 260484, 355, 151.79718279999906
356, 3.3652152348875375, 10.235820226020214, 12.301667283342772, 0.5307859, 30.0, 382, 260866, 356, 96.94965459999912
357, 4.398373449879272, 10.266590688830224, 12.330970255236759, 0.5294791000000003, 365.0, 1070, 261936, 357, 244.08088309999948
358, 4.341832919296248, 10.246048708498735, 12.305915754078786, 0.5281002999999999, 95.0, 462, 262398, 358, 116.40416010000081
359, 3.939026399817819, 10.24539680531283, 12.312871561830466, 0.5270023000000001, 110.0, 758, 263156, 359, 187.4138555999998
360, 3.899394869522615, 10.252822429310191, 12.312891713229092, 0.5250826, 370.0, 1375, 264531, 360, 202.42781579999973
361, 4.194665761044644, 10.265733828041657, 12.320771727324116, 0.5227444, 475.0, 1223, 265754, 361, 126.52636729999904
362, 3.950885808628416, 10.256755160964298, 12.316442718409528, 0.5205745, 530.0, 1188, 266942, 362, 121.65956870000082
363, 4.362477493479731, 10.28499642695029, 12.358039261787896, 0.5185909, 300.0, 1016, 267958, 363, 116.98835899999904
364, 3.848671090855839, 10.289051546658381, 12.362557274593282, 0.5173372, 35.0, 377, 268335, 364, 47.26827570000023
365, 4.00252330117198, 10.283406772530476, 12.341127660001137, 0.5163777999999999, 105.0, 689, 269024, 365, 80.46311800000149
366, 4.738593496600358, 10.289985993242778, 12.350458344987066, 0.5151735999999999, 120.0, 649, 269673, 366, 87.27366189999884
367, 4.102403007109057, 10.360090275003452, 12.438858592148984, 0.5138767, 245.0, 792, 270465, 367, 200.883710099999
368, 4.208244396189291, 10.436432594738823, 12.526731289648058, 0.5125546000000001, 105.0, 677, 271142, 368, 186.53527659999963
369, 4.019778634324395, 10.433371790786463, 12.519918144553717, 0.5112118, 210.0, 815, 271957, 369, 233.6589155999991
370, 3.8022969533768736, 10.438060108697384, 12.531105303949165, 0.5097816999999999, 120.0, 774, 272731, 370, 214.75980440000058
371, 4.7762197525156616, 10.453749227297815, 12.560869797711124, 0.5083255, 185.0, 844, 273575, 371, 212.4638300000006
372, 3.5241997481798593, 10.44083126563076, 12.54664608566664, 0.5068792, 120.0, 763, 274338, 372, 213.3761259999992
373, 4.159726273351246, 10.451146285916552, 12.57901658423153, 0.5058279999999999, 60.0, 405, 274743, 373, 104.40357100000256
374, 4.019099858105182, 10.449998235702514, 12.548624744415283, 0.5051034999999999, 55.0, 400, 275143, 374, 103.37492870000278
375, 4.223956143969043, 10.462452031989798, 12.500258382462777, 0.5043636999999997, 35.0, 422, 275565, 375, 125.21202489999996
376, 4.243240312782157, 10.450342154845565, 12.562528385029191, 0.5031073, 165.0, 974, 276539, 376, 263.90068859999883
377, 3.5717570020813643, 10.428949159482988, 12.522293156759382, 0.5015278000000001, 185.0, 781, 277320, 377, 222.23906369999895
378, 4.24894493360712, 10.44850578115444, 12.528211838308007, 0.5003794, 50.0, 495, 277815, 378, 130.75004940000144
379, 4.003109869628693, 10.438730834106304, 12.535320371006863, 0.4991626, 265.0, 857, 278672, 379, 235.98079030000008
380, 4.137466606161044, 10.458575242285383, 12.54744264207039, 0.4978575999999999, 130.0, 593, 279265, 380, 79.1155934999988
381, 4.642773883225548, 10.458715377315398, 12.556426027769684, 0.4967379999999999, 200.0, 651, 279916, 381, 83.58340920000046
382, 4.132269808740327, 10.557718216770827, 12.668141551692077, 0.4954392999999998, 135.0, 792, 280708, 382, 92.73440130000017
383, 4.356782835893186, 10.575011058170448, 12.70511583537131, 0.49422520000000014, 75.0, 557, 281265, 383, 77.0519080999984
384, 4.75703207451581, 10.57717960959605, 12.693933427107199, 0.49325050000000015, 125.0, 526, 281791, 384, 170.07977210000172
385, 3.727087975519495, 10.558994234943585, 12.69309013390007, 0.4923351999999999, 80.0, 491, 282282, 385, 166.47037979999732
386, 4.246993083340361, 10.5859882181341, 12.696761629430833, 0.4913091999999999, 90.0, 649, 282931, 386, 224.50423619999856
387, 4.0775324098740935, 10.568182102413878, 12.68363932462839, 0.4896486999999999, 340.0, 1196, 284127, 387, 384.56310719999965
388, 3.773084451057363, 10.562829469095405, 12.669257875747077, 0.4877775999999999, 180.0, 883, 285010, 388, 291.48712440000236
389, 4.306585033180066, 10.579439068303525, 12.69878677720005, 0.48624130000000015, 185.0, 824, 285834, 389, 306.1459126000009
390, 3.9963938993012746, 10.599003505165951, 12.730967110632047, 0.4845475000000001, 295.0, 1058, 286892, 390, 260.5559777999988
391, 4.233774073574486, 10.608541936198558, 12.732612215627835, 0.48245229999999967, 515.0, 1270, 288162, 391, 114.80248070000016
392, 3.7895897277201716, 10.614601456643463, 12.741038203075467, 0.48065500000000017, 185.0, 727, 288889, 392, 67.86177730000054
393, 4.333048176223581, 10.639452833287857, 12.771278348708535, 0.4791592000000001, 335.0, 935, 289824, 393, 85.64905510000244
394, 4.227146964289236, 10.762781833048276, 12.916214286428188, 0.47775160000000017, 110.0, 629, 290453, 394, 57.74837679999837
395, 3.998506708932287, 10.819858234347278, 12.982306515351507, 0.4760065000000004, 380.0, 1310, 291763, 395, 120.65777650000018
396, 4.276327950899456, 10.855311611663371, 13.036920681439605, 0.47439820000000005, 90.0, 477, 292240, 396, 45.126708300002065
397, 4.156035695854129, 10.829592654103346, 13.006219561683611, 0.4734945999999999, 80.0, 527, 292767, 397, 49.13822290000098
398, 4.298009844897669, 10.82469523017704, 12.995449297251366, 0.47252259999999985, 135.0, 553, 293320, 398, 54.62789939999857
399, 4.390383606130563, 10.851134142091002, 13.009301702282096, 0.4713138999999999, 160.0, 790, 294110, 399, 72.83516529999906
400, 5.206616285265001, 10.849843282781096, 13.031512157733625, 0.47007640000000006, 140.0, 585, 294695, 400, 58.52506340000036
401, 4.55542106497734, 10.870704633539374, 13.036449633307635, 0.46870839999999986, 550.0, 935, 295630, 401, 86.538107700002
402, 4.506606698005752, 10.83957623315174, 13.007179132642737, 0.46698579999999995, 365.0, 979, 296609, 402, 90.12640250000186
403, 4.417391387124856, 10.849350303411484, 13.031679093837738, 0.46575909999999987, 35.0, 384, 296993, 403, 35.4590649999991
404, 4.337308119106952, 10.842573470234322, 13.010524254240748, 0.4646322999999999, 205.0, 868, 297861, 404, 80.28104679999888
405, 4.252671281083837, 10.836767846474915, 13.010807628549022, 0.46281159999999977, 515.0, 1155, 299016, 405, 106.70354150000276
406, 4.617129491090519, 10.852221894161895, 13.025041512665318, 0.46093330000000027, 505.0, 932, 299948, 406, 86.46722179999779
407, 4.211983807693572, 11.144737815010478, 13.382918996923774, 0.45948610000000006, 125.0, 676, 300624, 407, 62.16018560000157
408, 4.728346493763802, 11.175661892463, 13.415115857735659, 0.45831609999999995, 185.0, 624, 301248, 408, 57.65492529999756
409, 4.479607816450461, 11.19697051985295, 13.450043679116595, 0.456724, 305.0, 1145, 302393, 409, 106.08606169999985
410, 4.811620729658195, 11.161866664886475, 13.37995394569002, 0.4550329, 115.0, 734, 303127, 410, 69.84755099999893
411, 4.731697629784762, 11.233472598047731, 13.445671814019173, 0.4534876, 160.0, 983, 304110, 411, 88.87555270000303
412, 4.340366549721272, 11.230945706245477, 13.47309642487197, 0.4517235999999998, 200.0, 977, 305087, 412, 87.54517400000259
413, 4.084818617847866, 11.208223504220655, 13.430669483310448, 0.45024309999999984, 115.0, 668, 305755, 413, 59.23453829999926
414, 4.517621052191581, 11.267691008249919, 13.457383056923195, 0.4489128999999999, 165.0, 810, 306565, 414, 72.88608870000098
415, 4.661081561210792, 11.25761467014091, 13.476841251469937, 0.4475799999999999, 125.0, 671, 307236, 415, 60.32432089999929
416, 4.678060421551288, 11.24065086598842, 13.477784684844929, 0.44633079999999997, 220.0, 717, 307953, 416, 65.8390855999969
417, 4.266255116922111, 11.199485546986576, 13.435058684217129, 0.4452301, 80.0, 506, 308459, 417, 48.24576050000178
418, 4.181353014106213, 11.208786293731599, 13.447080819708185, 0.4438648000000002, 540.0, 1011, 309470, 418, 95.61669230000189
419, 4.340734752472813, 11.433916855095042, 13.72199637126686, 0.4422295, 245.0, 806, 310276, 419, 76.13883419999911
420, 4.567948494933722, 11.80024909072035, 14.163111216627707, 0.44093260000000006, 105.0, 635, 310911, 420, 60.127870899999834
421, 3.9864934541677175, 11.78554658244427, 14.123158829552787, 0.4398823, 105.0, 532, 311443, 421, 50.31714640000064
422, 4.6605515761751874, 11.804827833677592, 14.171175959737678, 0.43854850000000006, 370.0, 950, 312393, 422, 89.85619860000224
423, 4.097965964005748, 11.769851451804614, 14.118332038198389, 0.4370482000000002, 180.0, 717, 313110, 423, 67.77964910000082
424, 4.183970440387902, 11.787379115028719, 14.141459265993056, 0.4351824999999999, 340.0, 1356, 314466, 424, 128.03198700000212
425, 4.648720654893917, 11.823495379376974, 14.187941787463567, 0.43297030000000003, 310.0, 1102, 315568, 425, 103.98167420000027
426, 4.141884321704425, 11.853811984960078, 14.220158685931775, 0.4309939, 220.0, 1094, 316662, 426, 103.25892269999895
427, 3.9685876181502953, 11.851014963348343, 14.226552681091729, 0.42883209999999977, 580.0, 1308, 317970, 427, 123.57429219999904
428, 3.4923469992134515, 11.83945584234603, 14.207807155418896, 0.42731199999999997, 50.0, 381, 318351, 428, 36.06444080000074
429, 4.312004481578431, 11.877936149898328, 14.256773478803579, 0.4263534999999999, 120.0, 684, 319035, 429, 64.60480199999802
430, 4.402998220286028, 11.922575478778459, 14.312796680090939, 0.42470650000000004, 235.0, 1146, 320181, 430, 108.64701589999822
431, 3.8862190487603825, 12.04914048350001, 14.458965213902026, 0.42307749999999994, 55.0, 664, 320845, 431, 62.92825470000025
432, 3.6478491008125675, 12.052308061360064, 14.44832091680996, 0.42179229999999995, 195.0, 764, 321609, 432, 72.09102410000196
433, 4.29401760743071, 12.045035607005136, 14.452324095652884, 0.42052959999999995, 165.0, 639, 322248, 433, 60.46973910000088
434, 4.31710787585496, 12.06102482535205, 14.46517255418137, 0.4192065999999999, 250.0, 831, 323079, 434, 78.69755950000035
435, 4.110394661999368, 12.063730786063454, 14.469697277267258, 0.41776569999999974, 230.0, 770, 323849, 435, 73.17712229999961
436, 4.892465398118302, 12.062376510631573, 14.479387516731972, 0.41647329999999977, 140.0, 666, 324515, 436, 63.22851059999812
437, 3.8259873956392125, 12.082907824763074, 14.491873486412189, 0.4153348, 60.0, 599, 325114, 437, 56.9349790999986
438, 4.374049596936957, 12.05803512276955, 14.490580608775314, 0.4143322, 80.0, 515, 325629, 438, 49.03000600000087
439, 4.022933669279615, 12.038917105626828, 14.43766117868779, 0.4133134, 160.0, 617, 326246, 439, 58.661974399998144
440, 4.2030603542109395, 12.079223518586236, 14.499781681410369, 0.4116384999999999, 390.0, 1244, 327490, 440, 118.27584840000054
441, 4.432946034406202, 12.066049430943742, 14.49125573414314, 0.4091679999999998, 500.0, 1501, 328991, 441, 142.58558599999742
442, 3.6044311533807445, 12.061330366783892, 14.489084728546835, 0.4072222, 175.0, 661, 329652, 442, 62.746491299996705
443, 4.173226342261213, 12.095516336788922, 14.505660506914246, 0.4063410999999999, 30.0, 318, 329970, 443, 30.16362880000088
444, 3.8371360602712197, 11.966366837452249, 14.34890045438494, 0.4054626999999999, 215.0, 658, 330628, 444, 62.22656629999983
445, 4.192874230497777, 11.976351899577212, 14.37120219460535, 0.4041162999999999, 135.0, 838, 331466, 445, 79.5086384999995
446, 4.470117415160668, 11.986674052913015, 14.378805567578572, 0.4026240999999998, 200.0, 820, 332286, 446, 77.67081999999937
447, 3.893752144733962, 11.950532330886821, 14.333042458143147, 0.40119039999999995, 150.0, 773, 333059, 447, 73.34239809999781
448, 3.913208275418014, 11.940891279935133, 14.329356625368462, 0.3998844999999999, 155.0, 678, 333737, 448, 64.46140739999828
449, 3.8063569335077427, 11.951978019918224, 14.35841293178139, 0.3983985999999998, 585.0, 973, 334710, 449, 92.255430600002
450, 4.682477330342504, 11.980976576477516, 14.395424671027497, 0.39693339999999994, 125.0, 655, 335365, 450, 62.16261229999873
451, 3.8493882296340804, 11.951572164467402, 14.350236310277666, 0.3958399, 105.0, 560, 335925, 451, 53.09922259999803
452, 3.9029566745551842, 11.92695458127424, 14.311438376304663, 0.39457629999999994, 265.0, 844, 336769, 452, 80.2466886000002
453, 4.069264339027718, 11.934556716974736, 14.32171240149294, 0.39332439999999985, 45.0, 547, 337316, 453, 52.153788700001314
454, 4.215341473864504, 11.951363670969585, 14.345934473750104, 0.39133810000000024, 550.0, 1660, 338976, 454, 156.79116870000144
455, 3.9416478461218345, 11.967045984840126, 14.364160664078248, 0.38919879999999996, 150.0, 717, 339693, 455, 68.04420639999807
456, 3.8710332928939346, 12.14690185563212, 14.593748989146068, 0.3881332, 95.0, 467, 340160, 456, 44.400427099997614
457, 4.354469999898481, 12.582277740230998, 15.118674660457, 0.38724130000000007, 70.0, 524, 340684, 457, 49.664338899998256
458, 4.382687606568119, 12.57872803184819, 15.110137271998406, 0.38603800000000005, 235.0, 813, 341497, 458, 76.91174280000268
459, 4.399313174508101, 12.564678031242698, 15.062511300748112, 0.38471950000000005, 155.0, 652, 342149, 459, 61.57944750000024
460, 3.9659698811040855, 12.547024559928555, 15.045650298636932, 0.38320209999999993, 430.0, 1034, 343183, 460, 98.00025710000045
461, 4.08135822720415, 12.510336374047547, 15.01049639358921, 0.38158569999999997, 175.0, 762, 343945, 461, 72.09623079999801
462, 4.256242173922742, 12.510696395003015, 15.02604799694037, 0.38047420000000004, 50.0, 473, 344418, 462, 44.876124999998865
463, 4.05539489367429, 12.526554278205422, 15.037270152148078, 0.3792835000000001, 120.0, 850, 345268, 463, 80.48255989999961
464, 3.6444094242744143, 12.51175783040218, 15.002132330454145, 0.3773313999999998, 450.0, 1319, 346587, 464, 125.3732001999997
465, 4.301228585259531, 12.537714543675941, 15.055374539731845, 0.37555209999999994, 195.0, 658, 347245, 465, 60.38351229999898
466, 4.30475933258874, 12.559425222124371, 15.071166536603656, 0.3741723999999999, 280.0, 875, 348120, 466, 74.54651599999852
467, 3.9796615533782664, 12.552788160849309, 15.058271281385192, 0.37301229999999985, 30.0, 414, 348534, 467, 35.54921640000248
468, 3.89810546235329, 12.537895529237511, 15.050226816225893, 0.3721797999999999, 140.0, 511, 349045, 468, 43.78288489999977
469, 4.233437231338093, 12.624954830934087, 15.140464969223405, 0.3707857000000001, 300.0, 1038, 350083, 469, 88.94706570000199
470, 3.7688458984986895, 13.792773702103279, 16.549253155041292, 0.3690729999999999, 215.0, 865, 350948, 470, 74.02364390000002
471, 4.5173610771927875, 13.809083448392208, 16.575459539704607, 0.36771669999999984, 110.0, 642, 351590, 471, 55.05912580000222
472, 3.70293967205504, 13.80904740938511, 16.57801264533936, 0.3665727999999999, 110.0, 629, 352219, 472, 54.07381350000287
473, 4.113658361877037, 13.828231906259298, 16.588996941522257, 0.3653272, 270.0, 755, 352974, 473, 64.86175379999986
474, 3.6524976537470524, 13.830852140370387, 16.5739296703492, 0.36397630000000003, 140.0, 746, 353720, 474, 63.679186900000786
475, 4.528790761887188, 13.853720750943037, 16.62393198147626, 0.36298539999999996, 110.0, 355, 354075, 475, 30.703175399998145
476, 3.865972251057339, 13.828767742184427, 16.585751313957378, 0.3619152999999999, 105.0, 834, 354909, 476, 71.35023830000137
477, 3.8467207483691204, 13.854002456228004, 16.614906248601486, 0.3606148, 75.0, 611, 355520, 477, 52.379477500002395
478, 3.920506174980958, 13.829499158632373, 16.591397063276432, 0.35896779999999984, 670.0, 1219, 356739, 478, 104.19987519999995
479, 4.058684409489386, 13.861056362399617, 16.6293161543271, 0.3569275000000001, 255.0, 1048, 357787, 479, 89.75141380000059
480, 3.7981172145488027, 13.84884820720237, 16.59055232428358, 0.3555351999999999, 50.0, 499, 358286, 480, 42.78728630000114
481, 4.244835343973115, 13.839972402907193, 16.595381760899024, 0.35458839999999986, 125.0, 553, 358839, 481, 47.20881340000051
482, 4.256483972492353, 13.85232104046244, 16.61613133367798, 0.35332389999999986, 180.0, 852, 359691, 482, 72.77217169999858
483, 3.9345822126716956, 13.917977401718556, 16.70342524413469, 0.3520945, 45.0, 514, 360205, 483, 44.10554289999709
484, 4.144297628091421, 14.050444329409878, 16.84546957572537, 0.3507219999999999, 430.0, 1011, 361216, 484, 86.47398369999792
485, 3.6461525140664515, 14.048135631919926, 16.853392023917955, 0.3492856, 100.0, 585, 361801, 485, 50.018395499999315
486, 4.469015174848852, 14.035246092513953, 16.85350082972862, 0.34827579999999986, 120.0, 537, 362338, 486, 45.74636289999762
487, 4.5475510553173395, 14.058610629078537, 16.851124801763323, 0.34725430000000007, 100.0, 598, 362936, 487, 51.32076600000073
488, 4.15520391718195, 14.046950432418805, 16.849327364955986, 0.345943, 175.0, 859, 363795, 488, 73.78556039999967
489, 4.0552791637100585, 14.041314935031002, 16.85162801350633, 0.3445128999999999, 180.0, 730, 364525, 489, 62.56486640000003
490, 4.3502506853352365, 14.05829115216258, 16.863436267424042, 0.3432312999999999, 130.0, 694, 365219, 490, 59.35959670000011
491, 4.533657352574429, 14.061795906047916, 16.86130976202476, 0.3418830999999999, 200.0, 804, 366023, 491, 68.75990889999957
492, 3.852306735040485, 14.060531768245973, 16.866508349992227, 0.3401659000000001, 230.0, 1104, 367127, 492, 93.86338140000225
493, 3.736008933322684, 14.05249438890951, 16.84764759334816, 0.3382857999999999, 290.0, 985, 368112, 493, 84.25852270000178
494, 3.789274363460079, 14.028166755553215, 16.816048299112627, 0.3368412999999999, 120.0, 620, 368732, 494, 52.98651859999882
495, 4.269196710588647, 14.075870757371607, 16.863098791787323, 0.3352608999999998, 330.0, 1136, 369868, 495, 97.24302259999968
496, 4.246508856330599, 14.196838643815783, 17.02529976103041, 0.3336714999999999, 140.0, 630, 370498, 496, 53.87926370000059
497, 4.014885902630134, 14.19025013712719, 17.037991680585144, 0.33262840000000016, 60.0, 529, 371027, 497, 45.142804299997806
498, 4.151363984128119, 14.224947140474274, 17.063962318527867, 0.3311937999999999, 280.0, 1065, 372092, 498, 91.42698459999883
499, 4.480714748624642, 14.261303685592834, 17.090214828413227, 0.32917870000000005, 255.0, 1174, 373266, 499, 100.6453947000009
500, 4.344322582434963, 14.220471402761099, 17.068230549064843, 0.3277891, 60.0, 370, 373636, 500, 31.578855400002794
501, 4.416088477955871, 14.25111657465689, 17.09202055902075, 0.3270124, 40.0, 493, 374129, 501, 42.13216960000136
502, 4.206776507736481, 14.2444719481714, 17.075039067219212, 0.32621949999999994, 15.0, 388, 374517, 502, 33.299175600001035
503, 4.2892068943569654, 14.248224254877593, 17.093610674918363, 0.32538609999999996, 110.0, 538, 375055, 503, 46.07688860000053
504, 4.006439266463583, 14.245673025855723, 17.078466678589812, 0.3243214, 175.0, 645, 375700, 504, 55.127378899996984
505, 4.127507892723608, 14.244051640087733, 17.077451408102288, 0.32318469999999994, 105.0, 618, 376318, 505, 52.920415700002195
506, 4.657667406372577, 14.242126601082939, 17.0894044679797, 0.3220426, 100.0, 651, 376969, 506, 55.70801340000253
507, 4.499317578451578, 14.226153772930767, 17.056976483588993, 0.3206827, 240.0, 860, 377829, 507, 73.419151099999
508, 4.6009975761737465, 14.234420881058707, 17.07503890336889, 0.3193839999999999, 60.0, 583, 378412, 508, 50.200821200000064
509, 4.313274954494677, 14.22495934335809, 17.068153692546645, 0.3182607999999999, 105.0, 665, 379077, 509, 57.20126299999902
510, 4.048638831993849, 14.22440078367177, 17.062891604753347, 0.31732659999999996, 75.0, 373, 379450, 510, 32.04625809999925
511, 4.367608711515221, 14.12256264431219, 16.947426125508784, 0.3160666, 490.0, 1027, 380477, 511, 88.35337860000072
512, 4.062821576780176, 13.99240491734469, 16.781817448967917, 0.3148057000000001, 65.0, 374, 380851, 512, 32.045979700000316
513, 4.34676161628248, 14.0110394928735, 16.807140367639395, 0.3137247999999999, 415.0, 827, 381678, 513, 70.85614110000097
514, 4.319175852087251, 14.012754852872758, 16.803150070494038, 0.3115782999999999, 445.0, 1558, 383236, 514, 133.2283740999992
515, 4.224165646237511, 14.02887928358298, 16.830302565049614, 0.30941919999999995, 95.0, 841, 384077, 515, 72.21834429999944
516, 4.2775345414371815, 14.0509853512243, 16.86320871852989, 0.30797199999999997, 320.0, 767, 384844, 516, 65.87861319999865
517, 4.325039955950875, 14.069488230032386, 16.889215013843067, 0.30645639999999996, 220.0, 917, 385761, 517, 78.43074429999979
518, 4.520710063170972, 14.069579999228866, 16.86709086884608, 0.305011, 240.0, 689, 386450, 518, 59.08667439999772
519, 4.587808829858041, 14.081587912274905, 16.893717091745106, 0.3035313999999999, 195.0, 955, 387405, 519, 81.9900286000011
520, 4.715531607578089, 14.088329638566476, 16.889968457364212, 0.30209859999999994, 210.0, 637, 388042, 520, 55.15200999999797
521, 4.053022502012321, 14.055265168396142, 16.845413382432806, 0.3011463999999999, 75.0, 421, 388463, 521, 36.22520160000204
522, 4.514405043411504, 14.06309255918697, 16.866364098093218, 0.30007809999999996, 155.0, 766, 389229, 522, 65.90905709999788
523, 3.715255478549196, 14.135470479212367, 16.944518652280536, 0.2986065999999999, 300.0, 869, 390098, 523, 74.6330769999986
524, 4.5402140313234085, 14.603045738252819, 17.52264170198359, 0.2967715, 480.0, 1170, 391268, 524, 100.54881620000015
525, 4.484232905414277, 14.631653901202457, 17.53474195495746, 0.2949381999999999, 185.0, 867, 392135, 525, 74.62559150000016
526, 4.885096806648363, 14.632052984101916, 17.557323822347296, 0.2931462999999999, 415.0, 1124, 393259, 526, 96.55217090000224
527, 4.68798182191823, 14.636796896406215, 17.555830881749984, 0.2911339000000001, 445.0, 1112, 394371, 527, 95.45609370000238
528, 4.480697002092546, 14.630851578983394, 17.53773247924718, 0.2894994999999999, 210.0, 704, 395075, 528, 60.365030600001774
529, 5.049526137243645, 14.664328827325432, 17.592456930256013, 0.28746369999999993, 500.0, 1558, 396633, 529, 133.14074959999925
530, 5.3797424819044215, 14.715839285649851, 17.651732937845296, 0.28516330000000006, 245.0, 998, 397631, 530, 85.5640330999995
531, 4.4727245539963345, 14.67865315435756, 17.612822769901758, 0.2831652999999998, 465.0, 1222, 398853, 531, 104.95776029999979
532, 4.268104971907171, 14.70534216733275, 17.65189475409151, 0.2813265999999999, 255.0, 821, 399674, 532, 70.41465210000024
533, 4.349758006082213, 14.854396630017133, 17.816702239060486, 0.27933219999999986, 435.0, 1395, 401069, 533, 119.38608799999929
534, 4.8039550851156685, 14.949896273200894, 17.94306347458451, 0.2773477, 220.0, 810, 401879, 534, 69.75363370000196
535, 3.964200710200451, 14.92943326993422, 17.91029974005439, 0.27630189999999993, 55.0, 352, 402231, 535, 30.186734399998386
536, 4.476446184004341, 14.908028938046165, 17.873637232603002, 0.27523539999999996, 230.0, 833, 403064, 536, 71.2265625
537, 4.366375386099661, 14.951561722293977, 17.936072690409997, 0.2737881999999999, 195.0, 775, 403839, 537, 66.52398849999736
538, 4.471116353140021, 14.94483841936756, 17.92449030716664, 0.2723104, 210.0, 867, 404706, 538, 74.2427615000015
539, 4.41579585189515, 14.921667285675698, 17.897633169728813, 0.27089559999999996, 155.0, 705, 405411, 539, 63.69386470000245
540, 4.250873909483724, 14.917673541895299, 17.8900605297276, 0.2698029999999999, 110.0, 509, 405920, 540, 45.27820350000184
541, 4.216727825334414, 14.945507164932911, 17.933547717484995, 0.26853399999999994, 240.0, 901, 406821, 541, 79.7551467000012
542, 4.649465085933046, 14.971980532128308, 17.968606422492233, 0.2671165, 330.0, 674, 407495, 542, 60.45673230000102
543, 4.44194378405676, 14.94915376354139, 17.924912004462286, 0.26550460000000004, 540.0, 1117, 408612, 543, 109.7610334000019
544, 4.68326438808073, 14.979405999643923, 17.964176951227962, 0.2635668999999998, 285.0, 1036, 409648, 544, 108.37617880000107
545, 4.770586234793527, 15.09583763564431, 18.110980199069957, 0.26178759999999995, 155.0, 941, 410589, 545, 103.44119420000061
546, 4.529267674825323, 15.137793223688922, 18.14253074916329, 0.26048349999999987, 90.0, 508, 411097, 546, 57.474097999998776
547, 4.940842221259649, 15.152456166362677, 18.157538930891256, 0.25900839999999997, 420.0, 1131, 412228, 547, 127.88457849999759
548, 4.88206042477773, 15.150285952393936, 18.17891019974957, 0.25701939999999995, 320.0, 1079, 413307, 548, 117.63329659999727
549, 4.8622760367185265, 15.17985625204561, 18.20661912943078, 0.2550177999999998, 550.0, 1145, 414452, 549, 122.07147270000132
550, 4.563658595872463, 15.164836770171052, 18.186132994194594, 0.25282899999999997, 545.0, 1287, 415739, 550, 135.4055965999978
551, 4.913775266018234, 15.188913866251456, 18.216072446358304, 0.2505997, 220.0, 1190, 416929, 551, 124.45788090000133
552, 5.275056971081396, 15.19352697570317, 18.234044404813122, 0.2489041, 105.0, 694, 417623, 552, 72.58156589999999
553, 3.9650043871162373, 15.176403388665223, 18.21315579323418, 0.24794919999999993, 80.0, 367, 417990, 553, 40.03727760000038
554, 5.2926846588741645, 15.239903552315452, 18.270986043756658, 0.24712389999999987, 80.0, 550, 418540, 554, 59.33575740000015
555, 5.032236557897895, 15.20930972340131, 18.238547879999334, 0.2457379, 535.0, 990, 419530, 555, 105.1306474999983
556, 5.458366083337905, 15.214629081969566, 18.244458518129715, 0.24450849999999996, 80.0, 376, 419906, 556, 41.614814900000056
557, 5.200781589138635, 15.512034969242741, 18.60341369942443, 0.2435787999999999, 85.0, 657, 420563, 557, 69.91097739999896
558, 4.821234971766326, 15.5623683721453, 18.662424685304114, 0.24187329999999999, 225.0, 1238, 421801, 558, 135.6479326000008
559, 4.474066749933043, 15.57454467688268, 18.67495737624925, 0.23999319999999993, 325.0, 851, 422652, 559, 92.84353109999938
560, 3.9855069146156312, 15.566427255630494, 18.653901165008545, 0.23877729999999997, 165.0, 500, 423152, 560, 55.59875060000195
561, 4.62441294780001, 15.61360140889883, 18.704829674959182, 0.23775129999999994, 175.0, 640, 423792, 561, 69.41226680000545
562, 5.226958333458031, 15.585947342340459, 18.69419906679438, 0.2365236999999999, 140.0, 724, 424516, 562, 69.39047730000311
563, 5.0671970714881, 15.58587334849555, 18.69694931427753, 0.23525019999999988, 170.0, 691, 425207, 563, 74.21809299999586
564, 5.369400464138895, 15.590232996343543, 18.70046017550277, 0.23410359999999994, 70.0, 583, 425790, 564, 60.96603010000399
565, 4.800488929222296, 15.559724184843871, 18.657929388968437, 0.23297949999999995, 140.0, 666, 426456, 565, 67.07906309999817
566, 4.845921480540813, 15.585817667823775, 18.68020230616324, 0.2314927, 255.0, 986, 427442, 566, 101.60650500000338
567, 4.721616342351153, 15.568959230587478, 18.664519703471576, 0.22983309999999998, 155.0, 858, 428300, 567, 86.98708249999618
568, 5.3930753040791926, 15.61500924227914, 18.70977200614689, 0.2287467999999999, 35.0, 349, 428649, 568, 34.5289705000032
569, 5.134609568407558, 15.59922228635401, 18.700334442877253, 0.22755880000000003, 245.0, 971, 429620, 569, 98.91810290000285
570, 5.012032940775849, 16.003034726963488, 19.204085990994475, 0.22591089999999994, 170.0, 860, 430480, 570, 87.50617860000057
571, 5.007211021637257, 16.343190210138857, 19.59278875283102, 0.22422609999999993, 375.0, 1012, 431492, 571, 101.55126050000399
572, 5.44811539551255, 16.37304080899354, 19.6285823712683, 0.22218489999999994, 385.0, 1256, 432748, 572, 127.03652819999843
573, 5.2333404138450925, 16.356854922019394, 19.59945468347878, 0.22024989999999997, 270.0, 894, 433642, 573, 90.31460759999754
574, 5.276480150521681, 16.37003721857962, 19.619914560308615, 0.21852999999999992, 245.0, 1017, 434659, 574, 104.33823019999545
575, 4.794012646583681, 16.39668161538498, 19.65937468435912, 0.21700449999999985, 180.0, 678, 435337, 575, 69.90295920000062
576, 4.100781515660421, 16.380896556545313, 19.642168740151632, 0.2158830999999999, 65.0, 568, 435905, 576, 58.53708840000036
577, 5.0303246165381035, 16.377021393839037, 19.641000920748215, 0.2144196999999999, 185.0, 1058, 436963, 577, 109.40101790000335
578, 5.135104137096765, 16.39621700190898, 19.64813139573583, 0.21275199999999986, 145.0, 795, 437758, 578, 79.34907650000241
579, 5.035191840997957, 16.39172239727252, 19.66022424360675, 0.21104379999999986, 305.0, 1103, 438861, 579, 112.72883490000095
580, 4.733636558591742, 16.42940783665553, 19.705725123773473, 0.20874969999999982, 330.0, 1446, 440307, 580, 145.2293135
581, 4.942842483294733, 16.467988153298695, 19.74790553974383, 0.2069731, 80.0, 528, 440835, 581, 55.436695899996266
582, 5.089219910157416, 16.50749041868354, 19.80260042906041, 0.20557899999999993, 270.0, 1021, 441856, 582, 107.07716939999955
583, 4.6450016791844675, 16.49209177787328, 19.753562825115992, 0.20403819999999995, 150.0, 691, 442547, 583, 72.3660693999991
584, 4.914436196238099, 16.53503284018272, 19.831172660615287, 0.20251089999999994, 235.0, 1006, 443553, 584, 94.09398919999512
585, 4.127607877760839, 16.535578307372656, 19.819829855301084, 0.20076219999999995, 255.0, 937, 444490, 585, 80.66737519999879
586, 4.436263811189207, 16.55027300750205, 19.856643015571084, 0.1990855, 435.0, 926, 445416, 586, 80.48554100000183
587, 4.763404451614052, 16.568411392971402, 19.859976070283224, 0.1972575999999999, 365.0, 1105, 446521, 587, 100.83872039999551
588, 5.179898996980112, 16.602906981768452, 19.906910428092047, 0.1955169999999999, 115.0, 829, 447350, 588, 75.79985119999765
589, 4.899544624630938, 16.57705685527054, 19.885430962769025, 0.19407249999999993, 120.0, 776, 448126, 589, 71.02082630000223
590, 4.865183872892629, 16.664686779141505, 19.973558566765394, 0.1920213999999998, 415.0, 1503, 449629, 590, 137.4528838000042
591, 5.195874990435925, 17.022977611303574, 20.414381894020853, 0.18978939999999989, 315.0, 977, 450606, 591, 89.40315009999904
592, 4.681271314906503, 17.15458478413656, 20.551704196587295, 0.18815859999999987, 285.0, 835, 451441, 592, 76.51356929999747
593, 4.775033955288127, 17.148707622435033, 20.56078915092034, 0.18696429999999992, 55.0, 492, 451933, 593, 45.02126000000135
594, 4.725337994777091, 17.133988824963247, 20.53330808086447, 0.18618939999999992, 65.0, 369, 452302, 594, 33.91915080000035
595, 4.358123474342879, 17.060950925368672, 20.437772401913193, 0.18527679999999996, 300.0, 645, 452947, 595, 59.286861799999315
596, 5.098236023001588, 17.071041404856423, 20.450908238258435, 0.18422919999999987, 115.0, 519, 453466, 596, 47.60836749999726
597, 5.609546551546017, 17.07883974777791, 20.46863287367743, 0.18298989999999996, 220.0, 858, 454324, 597, 78.70709559999523
598, 5.106925476029629, 17.09768534434661, 20.48948860896453, 0.18127449999999998, 210.0, 1048, 455372, 598, 96.13534739999886
599, 4.99876978325919, 17.157537634816457, 20.544097286669615, 0.17976069999999994, 225.0, 634, 456006, 599, 58.333982200005266
600, 4.572652760603792, 17.083788225038038, 20.497757962839998, 0.17806599999999995, 390.0, 1249, 457255, 600, 114.80638490000274
601, 5.369019183684919, 17.088868793749985, 20.504858726951355, 0.17620929999999993, 220.0, 814, 458069, 601, 74.35461460000079
602, 5.159751847364086, 17.0845007262066, 20.48616442658976, 0.1748745999999999, 175.0, 669, 458738, 602, 62.86822089999623
603, 5.329075677514234, 17.06163860089851, 20.453759835485727, 0.17358939999999992, 315.0, 759, 459497, 603, 67.46516639999754
604, 4.50029825992545, 17.065760341691384, 20.4493587517444, 0.17246889999999998, 75.0, 486, 459983, 604, 43.0943127999999
605, 4.551568612648733, 17.330720143475524, 20.769703986826038, 0.17140419999999992, 115.0, 697, 460680, 605, 61.72413719999895
606, 5.429125433450422, 17.331185572687993, 20.76455236686968, 0.17022519999999997, 90.0, 613, 461293, 606, 54.07887560000381
607, 5.1110313297017225, 17.317629355489334, 20.75795590073482, 0.16905969999999995, 275.0, 682, 461975, 607, 60.33740960000432
608, 4.866656531305874, 17.32151066962863, 20.765508449054987, 0.16749729999999993, 655.0, 1054, 463029, 608, 95.6243065000017
609, 5.078959314701921, 17.348250091682047, 20.795418684361344, 0.1660176999999999, 145.0, 590, 463619, 609, 52.46962500000518
610, 5.162439931136225, 17.355658382900092, 20.809995105705315, 0.1642248999999999, 545.0, 1402, 465021, 610, 123.63655680000375
611, 5.0138040702532605, 17.354198028086994, 20.805552327182177, 0.1622727999999999, 270.0, 767, 465788, 611, 66.09263039999496
612, 5.175429846784648, 17.335073689853445, 20.777863850313075, 0.1612764999999999, 55.0, 340, 466128, 612, 29.25209249999898
613, 5.1076521916099615, 17.326024340787576, 20.785696743497972, 0.1602153999999999, 250.0, 839, 466967, 613, 72.76308450000215
614, 4.75104292467254, 17.319357823821267, 20.764168343728915, 0.15869439999999993, 235.0, 851, 467818, 614, 77.60697290000098
615, 4.861662065571245, 17.31808652654382, 20.757938255658132, 0.1571985999999999, 245.0, 811, 468629, 615, 74.08624930000224
616, 4.94360594175812, 17.3289047212529, 20.785719938923542, 0.15587019999999996, 130.0, 665, 469294, 616, 60.670549700000265
617, 4.704553732912924, 17.32233323917002, 20.762524275995453, 0.15469479999999997, 110.0, 641, 469935, 617, 58.383101100000204
618, 5.515154101846407, 17.724675374355982, 21.253873241979555, 0.15314049999999993, 375.0, 1086, 471021, 618, 99.15926010000112
619, 4.920449649309044, 17.760965469701965, 21.274699413242626, 0.15156009999999998, 135.0, 670, 471691, 619, 61.14848740000161
620, 5.021301331245794, 17.772305679883928, 21.30849887769131, 0.15034689999999992, 155.0, 678, 472369, 620, 62.00082770000154
621, 5.132453598575015, 17.72359246612722, 21.25678047295554, 0.14926059999999994, 55.0, 529, 472898, 621, 48.255387100005464
622, 4.753131497357831, 17.767560057206587, 21.290962300156103, 0.14819049999999992, 200.0, 660, 473558, 622, 60.2084967999981
623, 5.271173069754396, 17.715266968188327, 21.221165072161625, 0.14700069999999996, 175.0, 662, 474220, 623, 60.503690800003824
624, 4.631991683280829, 17.723180983572295, 21.259399356264055, 0.14566239999999994, 390.0, 825, 475045, 624, 75.21791919999669
625, 4.905032509638939, 17.75043480955524, 21.278967972743658, 0.14455539999999992, 65.0, 405, 475450, 625, 36.92309959999693
626, 4.861266964201581, 17.73146222775541, 21.262314074357082, 0.14312349999999996, 335.0, 1186, 476636, 626, 108.35992789999727
627, 5.081328626875312, 17.74980708210785, 21.277152219474246, 0.14129019999999995, 420.0, 851, 477487, 627, 77.51146019999578
628, 5.430670926019493, 17.754057116276314, 21.286357038476496, 0.13956309999999994, 350.0, 1068, 478555, 628, 97.17479589999857
629, 5.611395006793347, 17.802706981081993, 21.34022366327841, 0.13780449999999994, 285.0, 886, 479441, 629, 80.62794179999764
630, 5.492844814719523, 17.84148842306698, 21.397047919385574, 0.13578309999999993, 660.0, 1360, 480801, 630, 123.59956420000526
631, 5.514902087358328, 17.865512534454986, 21.404771131235403, 0.13404429999999984, 75.0, 572, 481373, 631, 52.12250970000605
632, 6.286547162363249, 17.918134899720744, 21.493384991052014, 0.13290939999999996, 200.0, 689, 482062, 632, 62.85574329999508
633, 4.483566507311065, 17.84331868720178, 21.39505287526185, 0.13194189999999992, 50.0, 386, 482448, 633, 35.31969979999849
634, 5.389699266778717, 17.89031226673503, 21.442427712240168, 0.1310932, 100.0, 557, 483005, 634, 50.97334899999987
635, 6.144965398946457, 17.86803163720306, 21.418876938565948, 0.12998349999999995, 170.0, 676, 483681, 635, 61.766288099999656
636, 6.096856913831499, 17.890311770968967, 21.456309706370035, 0.12856509999999993, 240.0, 900, 484581, 636, 82.01029299999936
637, 5.470955278829563, 17.855016076491655, 21.390453106932846, 0.12702159999999996, 305.0, 815, 485396, 637, 74.3774812000047
638, 5.544569357439202, 17.853209280077742, 21.39711435089411, 0.12582999999999991, 120.0, 509, 485905, 638, 46.54078049999953
639, 5.600233625188136, 17.85362272398535, 21.406611879585718, 0.12448809999999996, 170.0, 982, 486887, 639, 89.59525190000568
640, 5.843377044749638, 17.845456379010773, 21.394328241836035, 0.12258369999999993, 515.0, 1134, 488021, 640, 103.41000440000062
641, 4.728842060725698, 17.83172647449672, 21.37435570438351, 0.12085119999999988, 240.0, 791, 488812, 641, 72.200170300006
642, 5.227709868301948, 17.874724495644664, 21.431058278270797, 0.11940489999999994, 180.0, 816, 489628, 642, 74.56105229999957
643, 5.010613544487096, 17.99963874349908, 21.59030460453982, 0.1174941999999999, 630.0, 1307, 490935, 643, 119.18946319999668
644, 6.267078902889934, 18.059757161289145, 21.660017287161146, 0.1158849999999999, 70.0, 481, 491416, 644, 43.975329000000784
645, 5.586186629393671, 18.059579017834785, 21.647886192696728, 0.1146096999999999, 280.0, 936, 492352, 645, 85.57235490000312
646, 5.952936946605657, 18.039022256219056, 21.644921183472263, 0.11282499999999993, 340.0, 1047, 493399, 646, 95.7986077999958
647, 5.667955982631871, 18.0315725065413, 21.62670460201445, 0.11127789999999996, 150.0, 672, 494071, 647, 61.53729939999903
648, 5.505068432169351, 18.01941738909448, 21.617981643007514, 0.11005749999999996, 175.0, 684, 494755, 648, 62.554937699998845
649, 5.332649615703271, 18.022073727881, 21.606184347052324, 0.10867239999999992, 315.0, 855, 495610, 649, 78.25924859999941
650, 5.341865012189751, 17.977570726960366, 21.56469378479103, 0.1073475999999999, 175.0, 617, 496227, 650, 56.5362524000011
651, 5.13442975388351, 18.02659573453538, 21.62422715180309, 0.1062846999999999, 110.0, 564, 496791, 651, 51.72474830000283
652, 5.571391230731299, 17.9701617009712, 21.567338556231874, 0.1051830999999999, 165.0, 660, 497451, 652, 60.549290500006464
653, 5.741759852634084, 18.020350654030032, 21.613927154021, 0.10366479999999995, 345.0, 1027, 498478, 653, 94.03690519999509
654, 5.238843851791316, 17.98886580143828, 21.583245595296223, 0.10211679999999992, 60.0, 693, 499171, 654, 63.5789081000039
655, 5.253857334421036, 18.022530546797082, 21.61535762868029, 0.10052703234042386, 340.0, 1175, 500346, 655, 108.13059169999906
656, 5.433674354101606, 18.055176897975645, 21.655096462291986, 0.09999999999999958, 250.0, 813, 501159, 656, 74.67281039999943
657, 5.366667184372281, 18.093884183454882, 21.68594755867655, 0.1000000000000009, 110.0, 516, 501675, 657, 47.49840580000455
658, 5.408864470808787, 18.0764160406121, 21.674732957864954, 0.09999999999999898, 190.0, 916, 502591, 658, 84.30272349999723
659, 5.427220918390543, 18.083334016337975, 21.67775849505569, 0.09999999999999892, 305.0, 929, 503520, 659, 85.57116379999934
660, 4.903280544639969, 18.057067037630482, 21.66387589104703, 0.09999999999999733, 535.0, 1428, 504948, 660, 131.46003850000125
661, 5.740650648536858, 18.035947056635756, 21.640390507282653, 0.10000000000000088, 155.0, 652, 505600, 661, 60.07765250000375
662, 5.267294574988009, 18.021246426514907, 21.60085412613069, 0.10000000000000088, 120.0, 495, 506095, 662, 45.77706439999747
663, 6.167184755006539, 18.0798565905009, 21.682817450591497, 0.09999999999999909, 115.0, 896, 506991, 663, 82.55160800000158
664, 6.0297607045353265, 18.068609203780554, 21.669840820138983, 0.09999999999999737, 490.0, 1407, 508398, 664, 122.38750819999404
665, 4.839262301635405, 18.084824493551984, 21.68475612510079, 0.09999999999999935, 280.0, 849, 509247, 665, 71.47403270000359
666, 5.361185648009915, 18.14544595232357, 21.765059197485066, 0.0999999999999989, 320.0, 934, 510181, 666, 77.97217459999956
667, 5.515082495885018, 18.21845942570613, 21.844029717078577, 0.0999999999999987, 280.0, 975, 511156, 667, 81.83892779999587
668, 5.65277456236886, 18.31967205501103, 21.95931609894012, 0.1000000000000003, 180.0, 715, 511871, 668, 59.893305699995835
669, 4.895163384659979, 18.30131047310712, 21.94353692910282, 0.0999999999999991, 230.0, 894, 512765, 669, 74.78950849999819
670, 5.204377438076946, 18.334562385646205, 21.99133487471165, 0.10000000000000098, 100.0, 613, 513378, 670, 51.62736360000417
671, 5.863990004714526, 18.30387486121287, 21.94654596990984, 0.09999999999999837, 350.0, 1057, 514435, 671, 88.35815240000375
672, 5.271246359397687, 18.271686067239937, 21.90176238403033, 0.09999999999999834, 345.0, 1062, 515497, 672, 88.8481071999995
673, 5.765547106816219, 18.22740168804889, 21.86921747114275, 0.1000000000000003, 250.0, 715, 516212, 673, 59.74973350000073
674, 5.498002531888775, 18.238903532061975, 21.862487781709312, 0.09999999999999937, 435.0, 847, 517059, 674, 70.5058183000001
675, 5.455076137960518, 18.20272227738718, 21.816038137693017, 0.100000000000001, 140.0, 638, 517697, 675, 53.0335275000034
676, 4.986947190202772, 18.17163223028183, 21.78093622624874, 0.100000000000001, 145.0, 640, 518337, 676, 53.245737199998985
677, 5.4701068035785525, 18.19375776884419, 21.82902054148018, 0.09999999999999862, 285.0, 993, 519330, 677, 82.98826130000089
678, 5.518366554266765, 18.288035927700395, 21.926732357810526, 0.09999999999999881, 250.0, 952, 520282, 678, 79.55903050000052
679, 5.100071765227577, 18.43225577563587, 22.102639221329564, 0.09999999999999862, 200.0, 994, 521276, 679, 83.25380089999817
680, 5.49586661731781, 18.48558058295139, 22.16088495143624, 0.10000000000000053, 90.0, 688, 521964, 680, 57.49538770000072
681, 5.20942348630532, 18.477901629380955, 22.156254511613113, 0.0999999999999979, 315.0, 1196, 523160, 681, 99.85764760000166
682, 5.3646484315395355, 18.540450434352078, 22.225583766782005, 0.10000000000000053, 35.0, 688, 523848, 682, 57.86323309999716
683, 5.68737968059175, 18.529667219792703, 22.217675712859013, 0.09999999999999773, 660.0, 1255, 525103, 683, 105.1344253999996
684, 5.736843089262645, 18.574930529870436, 22.260653752766682, 0.10000000000000088, 95.0, 501, 525604, 684, 41.88452089999919
685, 5.82287269973327, 18.55716303695116, 22.253816171039492, 0.09999999999999858, 240.0, 1003, 526607, 685, 83.84870929999306
686, 5.0991736565231065, 18.536068308909574, 22.218179785939306, 0.09999999999999866, 205.0, 986, 527593, 686, 82.69500929999776
687, 5.505413039835613, 18.497162930944928, 22.1810043247518, 0.0999999999999974, 345.0, 1396, 528989, 687, 116.09901379999792
688, 5.201465292342578, 18.46965418473842, 22.137613275614516, 0.100000000000001, 105.0, 639, 529628, 688, 53.587331800001266
689, 5.490247150831737, 18.74307700370612, 22.466984097986526, 0.09999999999999903, 305.0, 907, 530535, 689, 76.00675469999987
690, 5.325914177321648, 18.8293645745408, 22.56799718575884, 0.10000000000000073, 70.0, 387, 530922, 690, 32.472551000006206
691, 5.263682591008522, 18.822182257198595, 22.556693928913006, 0.10000000000000099, 110.0, 618, 531540, 691, 51.421449899993604
692, 5.390393279917793, 18.824689694683816, 22.562789030401426, 0.09999999999999838, 360.0, 1052, 532592, 692, 87.65560579999874
693, 5.972994810003194, 18.892353496289207, 22.667574683903243, 0.09999999999999852, 245.0, 1018, 533610, 693, 85.15182859999913
694, 4.8341911313166985, 18.883684108440693, 22.64074214054988, 0.1000000000000009, 105.0, 650, 534260, 694, 54.36587529999815
695, 5.067664308315616, 18.906739481424882, 22.65414059768289, 0.10000000000000085, 95.0, 472, 534732, 695, 39.636389999999665
696, 5.548533001306541, 18.920236462989624, 22.681626598449917, 0.099999999999998, 340.0, 1164, 535896, 696, 97.46612240000104
697, 5.254196497456094, 18.926697983111527, 22.692569271287418, 0.09999999999999964, 215.0, 802, 536698, 697, 66.79285150000214
698, 4.873075662453969, 18.924119578770227, 22.69125821431478, 0.10000000000000091, 140.0, 525, 537223, 698, 44.1306368000005
699, 5.481842535447251, 18.915290676605473, 22.682386121134883, 0.0999999999999982, 655.0, 1101, 538324, 699, 92.12937200000306
700, 5.7377756985121, 18.91359900319299, 22.67470961060635, 0.09999999999999928, 240.0, 860, 539184, 700, 73.1703364999994
701, 5.882723015329847, 18.850114480745745, 22.602619390378052, 0.09999999999999841, 275.0, 1044, 540228, 701, 86.9706503999987
702, 5.691021432424938, 18.688076502204158, 22.421124720616852, 0.10000000000000094, 20.0, 549, 540777, 702, 45.675196300006064
703, 5.247505121977895, 18.67121416994347, 22.392088071390653, 0.09999999999999992, 125.0, 763, 541540, 703, 63.54610870000033
704, 5.5504552001705845, 18.73020022629292, 22.457911411143563, 0.0999999999999985, 380.0, 1022, 542562, 704, 85.09671660000458
705, 5.922015769013177, 18.716891299499586, 22.445109034360424, 0.09999999999999967, 185.0, 799, 543361, 705, 66.79219580000063
706, 5.111369846806381, 18.743622224981134, 22.480738819006717, 0.1000000000000008, 110.0, 660, 544021, 706, 55.25057350000134
707, 5.758297131129122, 18.779607270893298, 22.52271263544698, 0.10000000000000009, 130.0, 741, 544762, 707, 61.98918609999964
708, 4.856285817577748, 18.74730639753934, 22.475972978289953, 0.0999999999999986, 325.0, 998, 545760, 708, 83.40661059999547
709, 5.789135065476988, 18.78246029022467, 22.516208580409653, 0.09999999999999752, 465.0, 1341, 547101, 709, 111.67064920000121
710, 6.0571431791479675, 18.828143967394386, 22.594515587139014, 0.09999999999999949, 445.0, 827, 547928, 710, 69.13673250000284
711, 6.057113950544231, 18.816437453366397, 22.57483203759354, 0.09999999999999966, 230.0, 801, 548729, 711, 66.61017539999739
712, 5.220976566255328, 18.850559487173207, 22.60739682125951, 0.09999999999999855, 225.0, 1012, 549741, 712, 84.4307312000019
713, 5.549830456185662, 18.877570053063234, 22.632549554364918, 0.09999999999999955, 110.0, 817, 550558, 713, 68.20687780000299
714, 5.755485179006506, 18.982378133894496, 22.768391095992357, 0.09999999999999663, 665.0, 1849, 552407, 714, 153.85976500000106
715, 5.627449698017952, 18.991738998202752, 22.789230695643223, 0.09999999999999967, 130.0, 798, 553205, 715, 66.42707320000045
716, 6.314619870111346, 19.02634779214859, 22.81486124098301, 0.100000000000001, 90.0, 640, 553845, 716, 53.47351929999422
717, 6.058163381324937, 19.023126414188972, 22.81418721492474, 0.09999999999999945, 215.0, 832, 554677, 717, 68.94911470000079
718, 4.906047719664969, 18.961110281631935, 22.742189669713184, 0.10000000000000084, 130.0, 458, 555135, 718, 38.2632367000042
719, 5.909951744994422, 19.003100469820243, 22.793648530688188, 0.0999999999999989, 420.0, 933, 556068, 719, 78.02497759999824
720, 5.238257244652519, 18.97879130387698, 22.759025345646926, 0.10000000000000071, 210.0, 669, 556737, 720, 55.578893199999584
721, 5.805074870342613, 18.96624403253411, 22.74721871124455, 0.09999999999999869, 220.0, 978, 557715, 721, 81.24625699999888
722, 5.508360611472882, 18.993558322993977, 22.776723576718688, 0.0999999999999973, 530.0, 1439, 559154, 722, 119.85679710000113
723, 5.806452496584519, 19.16258981027009, 22.98593444963951, 0.09999999999999823, 570.0, 1092, 560246, 723, 91.05215429999953
724, 6.07879718798932, 19.46392949939097, 23.351003463352274, 0.10000000000000012, 140.0, 738, 560984, 724, 61.36362139999983
725, 5.272842658408167, 19.478380034827765, 23.37847267134037, 0.10000000000000082, 90.0, 453, 561437, 725, 37.70503290000488
726, 5.680525599864492, 19.468025274444045, 23.340438215356123, 0.099999999999999, 230.0, 912, 562349, 726, 76.10136890000285
727, 6.504729326844026, 19.540063063556325, 23.44170838130108, 0.10000000000000099, 205.0, 629, 562978, 727, 52.34416780000174
728, 5.685603934501813, 19.503867744414276, 23.379584336083784, 0.09999999999999873, 260.0, 968, 563946, 728, 80.66223809999792
729, 6.202840170138711, 19.491532660497704, 23.39034547671885, 0.10000000000000099, 120.0, 641, 564587, 729, 53.629596999999194
730, 5.331706287668032, 19.518472099304198, 23.411831721137553, 0.1000000000000006, 125.0, 680, 565267, 730, 56.45454539999628
731, 5.492012924705333, 19.479680702700254, 23.354719990178157, 0.10000000000000057, 140.0, 684, 565951, 731, 56.732434899997315
732, 5.492308032359833, 19.499199348840957, 23.375774183028785, 0.10000000000000073, 75.0, 390, 566341, 732, 32.34847140000056
733, 5.093411354742188, 19.454547185483186, 23.338622062793675, 0.10000000000000064, 80.0, 345, 566686, 733, 28.51869910000096
734, 6.0902127926918155, 19.484864663673278, 23.37523379132615, 0.09999999999999835, 400.0, 1061, 567747, 734, 87.91923550000502
735, 5.791425380855799, 19.49958453809514, 23.382465541362762, 0.10000000000000092, 100.0, 544, 568291, 735, 45.2684448
736, 5.432567222887957, 19.499457738369326, 23.389782992495768, 0.09999999999999973, 250.0, 790, 569081, 736, 65.68362280000292
737, 5.6003250985817985, 19.708146182762302, 23.634145668729676, 0.09999999999999756, 730.0, 1319, 570400, 737, 109.91802689999895
738, 5.158512576884051, 20.215298060074595, 24.241028723979074, 0.10000000000000099, 150.0, 618, 571018, 738, 51.65432950000104
739, 6.144879150719226, 20.288822597602973, 24.34076669935428, 0.10000000000000087, 175.0, 653, 571671, 739, 54.58651880000252
740, 5.7151534985713885, 20.264687331485938, 24.302527994569207, 0.09999999999999856, 340.0, 1006, 572677, 740, 84.06418149999809
741, 6.303252166886873, 20.25731373316125, 24.31697441052787, 0.09999999999999973, 280.0, 790, 573467, 741, 66.16653039999801
742, 5.121722406493592, 20.246769131659118, 24.293086709693725, 0.10000000000000035, 225.0, 709, 574176, 742, 59.40249279999989
743, 5.900697470025013, 20.30825954571105, 24.367293270847252, 0.10000000000000095, 190.0, 570, 574746, 743, 47.33427249999659
744, 5.64205567135357, 20.3407044617001, 24.384556066562574, 0.0999999999999996, 285.0, 809, 575555, 744, 67.23333750000165
745, 6.045483963697721, 20.328793500599108, 24.3824250686682, 0.09999999999999944, 195.0, 836, 576391, 745, 69.93993420000334
746, 6.180902361869812, 20.342955595292384, 24.420525208959038, 0.0999999999999997, 245.0, 795, 577186, 746, 66.27685419999762
747, 5.748473831994848, 20.300710154103708, 24.348346628985563, 0.10000000000000019, 135.0, 728, 577914, 747, 61.07006520000141
748, 6.248846217765281, 20.372763897306356, 24.41832857275728, 0.10000000000000074, 25.0, 398, 578312, 748, 33.35301400000026
749, 6.109874153172845, 20.288345237127512, 24.352265721479338, 0.10000000000000071, 160.0, 669, 578981, 749, 55.891406200003985
750, 6.11592481443576, 20.313082492457028, 24.362119364527473, 0.09999999999999905, 225.0, 904, 579885, 750, 75.05445369999507
751, 6.237049427485593, 20.713860496534547, 24.834388856565973, 0.09999999999999812, 590.0, 1126, 581011, 751, 93.65115150000202
752, 6.250518918103937, 20.78253608090537, 24.913300448230334, 0.09999999999999909, 290.0, 896, 581907, 752, 74.6752090000009
753, 5.6213460794987125, 20.76541652854966, 24.901190257511256, 0.10000000000000088, 180.0, 652, 582559, 753, 54.52767859999585
754, 5.709831460512859, 20.788312030845965, 24.933547484706825, 0.10000000000000034, 155.0, 710, 583269, 754, 59.379844699993555
755, 5.517952094630648, 20.824191222588222, 24.98720412949721, 0.10000000000000071, 60.0, 384, 583653, 755, 32.05001679999987
756, 6.655415347713865, 20.782980879905764, 24.930677169675075, 0.10000000000000069, 50.0, 367, 584020, 756, 30.78023740000208
757, 5.4045924748603404, 20.716770366541322, 24.851160924338288, 0.10000000000000095, 135.0, 569, 584589, 757, 47.338495000003604
758, 6.296819415617093, 20.766420160763143, 24.93337414726972, 0.10000000000000084, 75.0, 459, 585048, 758, 38.11565490000066
759, 6.696172314909937, 20.732739576884047, 24.854715415883785, 0.09999999999999928, 355.0, 862, 585910, 759, 71.92176159999508
760, 6.211367514480378, 20.702520447249753, 24.823753914965934, 0.10000000000000094, 190.0, 646, 586556, 760, 54.12972489999811
761, 6.054513055305704, 20.69517689659482, 24.82049491998856, 0.09999999999999816, 505.0, 1113, 587669, 761, 92.78309250000166
762, 6.143310471919248, 20.78475669433973, 24.940328296505538, 0.09999999999999812, 325.0, 1126, 588795, 762, 94.31327559999772
763, 6.02203787647347, 20.703519186894287, 24.855736317940394, 0.0999999999999994, 265.0, 842, 589637, 763, 70.27064950000204
764, 5.775126393556595, 20.57388998667399, 24.67562247212728, 0.10000000000000002, 200.0, 750, 590387, 764, 62.97441300000355
765, 6.289861002840464, 20.49037620448617, 24.574313419767225, 0.10000000000000099, 105.0, 637, 591024, 765, 53.35878590000357
766, 6.246600394563157, 20.501120917248787, 24.592697764551918, 0.09999999999999984, 260.0, 774, 591798, 766, 64.69580049999786
767, 5.561194969905363, 20.458624663689324, 24.549589135340142, 0.09999999999999876, 130.0, 964, 592762, 767, 80.40608490000159
768, 5.818255199405369, 20.44817496696279, 24.523692200684867, 0.10000000000000069, 175.0, 671, 593433, 768, 56.36003160000109
769, 5.6533625170665704, 20.41687213324512, 24.50108626963561, 0.10000000000000073, 105.0, 386, 593819, 769, 32.37268050000421
770, 5.7602249445811, 20.443863780120683, 24.53819588833168, 0.09999999999999899, 200.0, 915, 594734, 770, 76.22169530000247
771, 5.525055837123952, 20.43751213978127, 24.530973648952497, 0.10000000000000081, 200.0, 658, 595392, 771, 55.24114759999793
772, 5.566882988868056, 20.468455935649313, 24.555940899361534, 0.09999999999999738, 565.0, 1399, 596791, 772, 117.09058450000157
773, 5.632917003212748, 20.40282007423607, 24.47310599765262, 0.1000000000000001, 385.0, 740, 597531, 773, 62.06123639999714
774, 4.888556776150979, 20.41312793043793, 24.47834471926663, 0.10000000000000069, 75.0, 366, 597897, 774, 30.770118000000366
775, 6.074960353149884, 20.419857018235803, 24.493495443592902, 0.10000000000000094, 170.0, 552, 598449, 775, 46.04842359999748
776, 5.729620394699367, 20.395153778991162, 24.46578319825403, 0.09999999999999809, 275.0, 1134, 599583, 776, 95.27563240000018
777, 5.604863535600362, 20.37009454810101, 24.444832975649117, 0.0999999999999979, 325.0, 1196, 600779, 777, 99.74247460000333
778, 5.540878949831198, 20.27623681764345, 24.329302552369263, 0.10000000000000094, 135.0, 555, 601334, 778, 46.603664900001604
779, 5.996649661462766, 20.29048619235226, 24.336581786724295, 0.09999999999999881, 170.0, 951, 602285, 779, 79.36428719999822
780, 5.458488853247861, 20.31004084570933, 24.354727604684822, 0.09999999999999813, 365.0, 1121, 603406, 780, 94.0098319999961
781, 5.6773471304071625, 20.363666573191075, 24.417437995352397, 0.10000000000000087, 90.0, 492, 603898, 781, 41.00709530000313
782, 5.989029524168132, 20.308187382292786, 24.361748287086428, 0.10000000000000099, 90.0, 633, 604531, 782, 52.769792099999904
783, 5.622741314918226, 20.303099319183726, 24.36766480091279, 0.09999999999999837, 360.0, 1057, 605588, 783, 88.20272510000359
784, 4.8150195190952525, 20.286774994092738, 24.337649584583147, 0.10000000000000099, 110.0, 622, 606210, 784, 51.95321780000086
785, 5.706583713185966, 20.33605680925874, 24.406193676090083, 0.09999999999999787, 370.0, 1202, 607412, 785, 100.40485849999823
786, 5.670307730193615, 20.37110090094825, 24.450260913278175, 0.09999999999999913, 510.0, 889, 608301, 786, 74.17095620000327
787, 5.9126228805773895, 20.380079748852005, 24.450444356991294, 0.10000000000000069, 50.0, 366, 608667, 787, 30.98992349999753
788, 5.5614602561298225, 20.356634050160967, 24.411128415795925, 0.0999999999999989, 155.0, 934, 609601, 788, 78.06824129999586
789, 5.7471286890202, 20.42125382100729, 24.50203953506355, 0.10000000000000074, 155.0, 665, 610266, 789, 55.308336499998404
790, 5.378244855505102, 20.526038892557857, 24.630198120326735, 0.09999999999999966, 235.0, 801, 611067, 790, 66.43872650000412
791, 6.130768800737294, 20.55154067323408, 24.659759525124354, 0.10000000000000091, 100.0, 524, 611591, 791, 43.45788960000209
792, 5.251179446519962, 20.539841737235278, 24.62577196049169, 0.10000000000000088, 80.0, 503, 612094, 792, 42.062909299995226
793, 5.6481033229565885, 20.56512804196057, 24.679713577078875, 0.10000000000000099, 155.0, 637, 612731, 793, 53.41853999999876
794, 6.4160578559910695, 20.551117283191957, 24.645502313947603, 0.10000000000000099, 125.0, 623, 613354, 794, 52.1006425999949
795, 5.386572036133426, 20.494502282252174, 24.588403536751297, 0.0999999999999976, 505.0, 1306, 614660, 795, 108.20280759999878
796, 5.4035300019762555, 20.450508693566068, 24.526590123076755, 0.09999999999999776, 270.0, 1242, 615902, 796, 103.18203280000307
797, 5.42289154720612, 20.456668455172807, 24.538224846277483, 0.0999999999999998, 85.0, 780, 616682, 797, 64.83767939999962
798, 4.81869829272983, 20.434608886538932, 24.521406597561306, 0.10000000000000096, 155.0, 594, 617276, 798, 49.02404910000041
799, 4.622010881530827, 20.450546568205247, 24.533363306870196, 0.09999999999999999, 240.0, 754, 618030, 799, 62.3239642999979
800, 5.573393047238621, 20.448409106528587, 24.538033165480122, 0.10000000000000099, 205.0, 623, 618653, 800, 52.12187890000496
801, 4.930520617547242, 20.41771514892578, 24.50964327936587, 0.10000000000000095, 130.0, 575, 619228, 801, 47.61483340000268
802, 4.801222357471941, 20.32368009552183, 24.37925133874765, 0.09999999999999855, 300.0, 1012, 620240, 802, 83.69945690000168
803, 4.875939225792696, 20.065170890723735, 24.070342589705287, 0.10000000000000099, 165.0, 633, 620873, 803, 52.5315671999997
804, 4.889485159599449, 20.004994331603033, 23.98846675485254, 0.09999999999999858, 280.0, 1004, 621877, 804, 83.24294739999459
805, 5.792433811636532, 20.015123369802836, 24.00698892181995, 0.09999999999999991, 215.0, 765, 622642, 805, 63.606803599999694
806, 5.201418477634836, 20.027478900028296, 24.02097035641492, 0.10000000000000023, 275.0, 723, 623365, 806, 60.1429461000007
807, 5.461183600704297, 20.06082601937973, 24.070899158761424, 0.10000000000000081, 90.0, 659, 624024, 807, 54.63583690000087
808, 5.297021138850408, 20.07750914156095, 24.07964352303208, 0.09999999999999841, 355.0, 1046, 625070, 808, 86.77867860000697
809, 5.142990241110589, 20.041116596148672, 24.029716077548187, 0.10000000000000063, 210.0, 677, 625747, 809, 55.75129719999677
810, 4.750136408037945, 20.048850782477572, 24.051753378115627, 0.10000000000000034, 125.0, 711, 626458, 810, 58.921122599997034
811, 5.259349855410177, 20.02753652421768, 24.020513620753746, 0.10000000000000035, 215.0, 708, 627166, 811, 58.41148800000519
812, 4.969705322465929, 20.01821824482509, 24.030422142573766, 0.10000000000000096, 135.0, 588, 627754, 812, 48.72964409999986
813, 4.76476081886372, 20.047736337718078, 24.04806180221622, 0.09999999999999792, 280.0, 1185, 628939, 813, 98.4129116999975
814, 4.85590819864528, 20.13114142267959, 24.156291301895237, 0.10000000000000099, 110.0, 636, 629575, 814, 52.6173689999996
815, 5.429949678304627, 20.22342912096811, 24.263998617337446, 0.09999999999999913, 280.0, 889, 630464, 815, 73.82555699999648
816, 4.942516565532752, 20.27875624911886, 24.33594628119133, 0.10000000000000095, 85.0, 568, 631032, 816, 47.21216439999989
817, 5.485883509740233, 20.27685458290166, 24.340013578020294, 0.09999999999999892, 535.0, 928, 631960, 817, 77.58640269999887
818, 5.491676636870331, 20.268364960094594, 24.314871883785873, 0.09999999999999727, 545.0, 1454, 633414, 818, 120.56356080000114
819, 4.9353710724989, 20.235223198625587, 24.268196985035885, 0.09999999999999946, 200.0, 831, 634245, 819, 68.83985119999852
820, 5.2825747962309935, 20.189957731609404, 24.23498120114811, 0.09999999999999766, 275.0, 1284, 635529, 820, 106.23815759999707
821, 5.048646996367691, 20.25857844230456, 24.285455654828976, 0.10000000000000096, 150.0, 585, 636114, 821, 48.60829129999911
822, 5.437437177678628, 20.209904431233966, 24.251998992058354, 0.10000000000000067, 215.0, 673, 636787, 822, 56.02612180000142
823, 4.827611698451655, 20.194164324073153, 24.22760798544857, 0.10000000000000028, 155.0, 716, 637503, 823, 59.19440830000531
824, 4.86175541808972, 20.20962598792508, 24.249885235077297, 0.09999999999999888, 215.0, 936, 638439, 824, 77.7219555000047
825, 5.331240118866464, 20.14360686765617, 24.174757513176484, 0.10000000000000088, 95.0, 498, 638937, 825, 41.49173940000037
826, 5.434987775243331, 20.144854887846474, 24.15950152495197, 0.09999999999999831, 360.0, 1070, 640007, 826, 88.9576359000057
827, 5.763330711725172, 20.19100835737488, 24.20654577455237, 0.100000000000001, 140.0, 639, 640646, 827, 53.01536430000124
828, 5.039308939573793, 20.164762732162778, 24.17550857905814, 0.0999999999999977, 505.0, 1265, 641911, 828, 103.72322319999512
829, 5.189975702285085, 20.134075765104935, 24.14248403732016, 0.10000000000000044, 95.0, 699, 642610, 829, 58.160946500000136
830, 5.712378970355786, 20.07330620180804, 24.087284442521295, 0.10000000000000078, 165.0, 662, 643272, 830, 55.06667649999872
831, 5.3084739051685315, 20.133796992612123, 24.141418215195426, 0.09999999999999903, 305.0, 907, 644179, 831, 75.73740750000434
832, 4.835676130349593, 20.12299094603159, 24.142151358913267, 0.09999999999999838, 235.0, 1053, 645232, 832, 87.78655699999945
833, 4.913805557156279, 20.138744741416353, 24.16102332767158, 0.09999999999999808, 290.0, 1138, 646370, 833, 94.33965899999748
834, 4.882817695424763, 20.110881662290986, 24.112493154080813, 0.10000000000000098, 145.0, 613, 646983, 834, 51.51277259999915
835, 5.36837789262786, 20.143269423282508, 24.154381143685544, 0.09999999999999756, 455.0, 1320, 648303, 835, 110.05045260000043
836, 5.379218602913658, 20.087010568258158, 24.093018851139007, 0.09999999999999919, 300.0, 878, 649181, 836, 73.4488418999972
837, 5.083077286969145, 20.10928605455871, 24.123029170293936, 0.09999999999999867, 240.0, 981, 650162, 837, 82.71791689999372
838, 5.016395860611458, 20.316643235078054, 24.371032542943208, 0.09999999999999767, 205.0, 1276, 651438, 838, 106.88746979999996
839, 4.990130275058472, 20.34325315766788, 24.403848689296403, 0.10000000000000048, 220.0, 694, 652132, 839, 57.98677309999766
840, 5.1355891279014, 20.339364903616975, 24.380745791539947, 0.10000000000000066, 135.0, 674, 652806, 840, 56.42610270000296
841, 4.688259733335547, 20.333721797692068, 24.384648673607106, 0.10000000000000099, 110.0, 623, 653429, 841, 52.13687270000082
842, 4.533909154667539, 20.33760729205147, 24.384305792057262, 0.09999999999999966, 205.0, 801, 654230, 842, 67.16779159999714
843, 4.676362266745819, 20.300473972775933, 24.337849025390387, 0.1000000000000009, 65.0, 511, 654741, 843, 42.75496729999577
844, 5.28271760951641, 20.275015079587003, 24.325892247044763, 0.0999999999999983, 405.0, 1075, 655816, 844, 90.15983429999324
845, 5.446854925928099, 20.34315916953279, 24.405440151795823, 0.10000000000000095, 85.0, 571, 656387, 845, 48.05520389999583
846, 5.572213267932204, 20.324387207166165, 24.378463245934874, 0.0999999999999981, 480.0, 1131, 657518, 846, 95.40837579999788
847, 5.0478353312141016, 20.37227345516807, 24.417947032995393, 0.10000000000000095, 200.0, 570, 658088, 847, 48.0853317000001
848, 5.890835960194616, 20.37297308326948, 24.436273429417373, 0.09999999999999855, 300.0, 1010, 659098, 848, 84.8670473999955
849, 5.091645915425539, 20.374032688441712, 24.437474687016724, 0.10000000000000099, 115.0, 634, 659732, 849, 53.597189300002356
850, 5.1576116392661255, 20.09857264178538, 24.097651336625304, 0.10000000000000057, 130.0, 684, 660416, 850, 57.57192339999892
851, 4.611947082660415, 19.920216008651355, 23.888225728815254, 0.10000000000000087, 60.0, 484, 660900, 851, 40.69448150000244
852, 4.509729790171033, 19.928287023285502, 23.914149872661316, 0.09999999999999919, 120.0, 877, 661777, 852, 73.52776930000255
853, 4.71708702697491, 19.88205683858771, 23.857504804032786, 0.09999999999999967, 250.0, 798, 662575, 853, 66.80831809999654
854, 5.26444319463349, 19.908324573849058, 23.89640949008701, 0.10000000000000074, 215.0, 666, 663241, 854, 55.79673129999719
855, 4.463590351223946, 19.882375720977784, 23.856131813049316, 0.10000000000000088, 100.0, 500, 663741, 855, 41.88409479999973
856, 5.078104048448347, 19.86190000266574, 23.830462617463304, 0.09999999999999824, 515.0, 1091, 664832, 856, 91.73274189999938
857, 4.640271364491195, 19.85514362216173, 23.806705616558467, 0.10000000000000067, 175.0, 673, 665505, 857, 56.59005679999973
858, 4.745715557003584, 19.87558776374877, 23.8354932886409, 0.09999999999999852, 380.0, 1016, 666521, 858, 85.13786909999908
859, 4.931436879704358, 19.909131994114478, 23.865030054206027, 0.09999999999999974, 205.0, 789, 667310, 859, 66.08989969999675
860, 4.819757726682428, 19.87043711591307, 23.830474439948123, 0.10000000000000099, 175.0, 618, 667928, 860, 51.75482919999922
861, 4.580116636386284, 19.90740080319918, 23.885668962918796, 0.1000000000000009, 160.0, 650, 668578, 861, 54.42104339999787
862, 4.84887146001941, 19.922655538667605, 23.888637126246586, 0.0999999999999977, 500.0, 1264, 669842, 862, 104.91469789999974
863, 4.864682243701941, 20.001002351680917, 23.991492851051742, 0.10000000000000071, 180.0, 668, 670510, 863, 55.83601959999942
864, 4.972324984601379, 20.005143658145442, 23.98798769796662, 0.10000000000000099, 120.0, 637, 671147, 864, 53.07685360000323
865, 5.214443180694359, 20.022202578275014, 24.00668236575549, 0.09999999999999883, 330.0, 948, 672095, 865, 79.19957940000313
866, 5.292228455916267, 20.05719266083154, 24.054438428775633, 0.09999999999999852, 235.0, 1017, 673112, 866, 84.97391260000586
867, 4.587294661064221, 20.098663767710697, 24.100340728322134, 0.10000000000000091, 65.0, 523, 673635, 867, 43.8109895000016
868, 4.966711032624338, 20.08311004264682, 24.084652719934002, 0.10000000000000098, 110.0, 612, 674247, 868, 51.24916780000058
869, 4.961430145317668, 20.082819131002474, 24.096597263877662, 0.10000000000000099, 95.0, 627, 674874, 869, 52.83643280000251
870, 4.8296432557053555, 20.06887250074839, 24.0739377798253, 0.09999999999999955, 220.0, 818, 675692, 870, 68.41959599999973
871, 5.390500128269196, 20.073775635642566, 24.07356896674496, 0.1000000000000008, 70.0, 435, 676127, 871, 36.255421999994724
872, 5.309904082893401, 20.060588194972784, 24.05203119322311, 0.10000000000000095, 170.0, 645, 676772, 872, 53.80837109999993
873, 4.810489837211161, 20.055086195278474, 24.065356502898585, 0.09999999999999773, 320.0, 1252, 678024, 873, 104.34886779999943
874, 4.7271875535068775, 20.06746369106264, 24.060342113219754, 0.09999999999999892, 450.0, 929, 678953, 874, 77.36206780000066
875, 4.344961605420926, 20.10268572287831, 24.105020081124653, 0.10000000000000087, 125.0, 492, 679445, 875, 41.33729039999889
876, 4.201710934672968, 20.05259983894053, 24.044868543046068, 0.10000000000000087, 125.0, 491, 679936, 876, 41.060350700005074
877, 4.393016624175585, 19.90027727273794, 23.882109160790076, 0.1000000000000009, 135.0, 650, 680586, 877, 54.093308100003924
878, 3.5556130097602225, 19.806714338699575, 23.744586363661714, 0.10000000000000074, 75.0, 394, 680980, 878, 32.873427400001674
879, 4.369731855966552, 19.808882575534895, 23.757117001260642, 0.10000000000000038, 80.0, 706, 681686, 879, 58.98615379999683
880, 4.755791961921325, 19.862031814009626, 23.8237425491056, 0.09999999999999756, 410.0, 1322, 683008, 880, 110.16252860000532
881, 3.9141572960974185, 19.865750567698573, 23.828434512699133, 0.0999999999999999, 255.0, 767, 683775, 881, 63.854887299996335
882, 4.283682191875619, 19.872372080677895, 23.82966719572619, 0.09999999999999895, 170.0, 923, 684698, 882, 76.74862669999857
883, 5.046958737313114, 19.922904156624003, 23.899370601836672, 0.09999999999999717, 770.0, 1504, 686202, 883, 124.6061394999997
884, 4.795591426502287, 19.942533349568865, 23.925777414203743, 0.10000000000000082, 80.0, 452, 686654, 884, 37.67742590000125
885, 3.819187645792961, 19.924702445983886, 23.879371963500976, 0.10000000000000088, 30.0, 500, 687154, 885, 41.61564669999643
886, 4.585471744189446, 19.941202212812563, 23.89926859101171, 0.10000000000000044, 135.0, 699, 687853, 886, 58.30026640000142
887, 4.622514311216477, 19.914966484117407, 23.89189209016098, 0.10000000000000087, 140.0, 481, 688334, 887, 40.04489679999824
888, 4.392161327830465, 19.85126161728641, 23.826093661440147, 0.10000000000000099, 120.0, 622, 688956, 888, 51.60675440000341
889, 4.849240345769115, 19.869461822509766, 23.85682299230006, 0.10000000000000071, 50.0, 385, 689341, 889, 32.117126000004646
890, 4.114573596572448, 19.92377549096961, 23.890482701046366, 0.0999999999999998, 420.0, 781, 690122, 890, 64.7543783000001
891, 4.774576364160636, 20.268677045428564, 24.323824544432302, 0.09999999999999809, 405.0, 1134, 691256, 891, 94.12199490000057
892, 4.653208013363336, 20.32596352070938, 24.375487392331348, 0.09999999999999871, 355.0, 972, 692228, 892, 80.96434650000447
893, 4.699719886215546, 20.330640432176345, 24.38977147918843, 0.09999999999999928, 200.0, 862, 693090, 893, 72.06465700000263
894, 5.170907736185825, 20.298048377759528, 24.361110750834147, 0.1000000000000006, 90.0, 330, 693420, 894, 27.620586199998797
895, 4.754625564171621, 20.352810844574456, 24.414147426359506, 0.09999999999999658, 760.0, 1894, 695314, 895, 157.37438480000128
896, 5.659146608973062, 20.393875269736014, 24.47871850126533, 0.10000000000000084, 45.0, 465, 695779, 896, 38.73222430000169
897, 5.901129353122833, 20.36561421553294, 24.418930891232613, 0.10000000000000099, 175.0, 624, 696403, 897, 52.182435499998974
898, 4.939062473647494, 20.339604054895837, 24.39366065693348, 0.10000000000000099, 145.0, 641, 697044, 898, 53.52750779999769
899, 5.182250175476074, 20.3626081750748, 24.43096384738354, 0.09999999999999795, 310.0, 1175, 698219, 899, 98.26008840000577
900, 4.9874810605342015, 20.355374079326104, 24.42360051541493, 0.09999999999999892, 240.0, 928, 699147, 900, 77.68666790000134
901, 4.2037389444164495, 20.317359016257214, 24.363008049359177, 0.09999999999999908, 435.0, 899, 700046, 901, 75.2560788999981
902, 4.887516935190776, 20.063469265179226, 24.069947113020504, 0.09999999999999896, 525.0, 919, 700965, 902, 76.29792100000486
903, 4.501741369969067, 20.07201305736195, 24.088768250164502, 0.0999999999999989, 360.0, 935, 701900, 903, 78.06873020000057
904, 5.262695219755869, 20.060345886512764, 24.057872198340725, 0.09999999999999848, 305.0, 1027, 702927, 904, 85.97673390000273
905, 4.699719039493062, 20.062020272351383, 24.064488635973984, 0.10000000000000032, 125.0, 712, 703639, 905, 59.595388400004595
906, 4.331319319438855, 20.03703629009345, 24.036613836946433, 0.09999999999999787, 365.0, 1203, 704842, 906, 100.99324539999361
907, 4.370623716545589, 20.01415725649916, 24.012802661372927, 0.10000000000000074, 110.0, 394, 705236, 907, 32.91317700000218
908, 4.677287849954968, 20.01857645201899, 24.027015665866816, 0.10000000000000078, 180.0, 662, 705898, 908, 55.77699919999577
909, 4.502256840381732, 20.049473430600628, 24.043288906605795, 0.09999999999999842, 405.0, 1043, 706941, 909, 87.69407849999698
910, 4.837136961217981, 20.04514296106832, 24.049889754654835, 0.10000000000000098, 110.0, 642, 707583, 910, 54.017578799997864
911, 4.710335401841152, 19.981149487222485, 23.974901370595468, 0.09999999999999912, 205.0, 891, 708474, 911, 74.97345279999718
912, 5.007188808748775, 20.013950173411082, 24.011737537684876, 0.10000000000000099, 115.0, 634, 709108, 912, 52.92666240000108
913, 4.438036880944743, 19.980889946461488, 23.95965301244255, 0.10000000000000099, 100.0, 623, 709731, 913, 52.50108149999869
914, 5.402934641176669, 20.340796997084613, 24.390633464194728, 0.09999999999999833, 400.0, 1067, 710798, 914, 89.59859119999601
915, 5.029351599202532, 20.436501750927473, 24.513711316443928, 0.09999999999999848, 525.0, 1027, 711825, 915, 88.26952880000317
916, 5.129390003122346, 20.421547677407418, 24.501333501791084, 0.09999999999999935, 285.0, 849, 712674, 916, 70.72715990000142
917, 4.845905628526645, 20.424227686440716, 24.51101490529819, 0.10000000000000095, 115.0, 577, 713251, 917, 48.48954010000307
918, 5.42130950814978, 20.4502807030311, 24.533677940694695, 0.10000000000000066, 50.0, 351, 713602, 918, 29.393990700002178
919, 4.981274444362959, 20.39489697448115, 24.465846614123077, 0.10000000000000048, 110.0, 694, 714296, 919, 57.95481640000071
920, 5.57289478150549, 20.459333590783146, 24.569732129481697, 0.10000000000000092, 80.0, 647, 714943, 920, 54.3075278000033
921, 4.4413255480852385, 20.397164297709175, 24.455829797914234, 0.10000000000000035, 350.0, 709, 715652, 921, 59.31056440000248
922, 4.888311028997333, 20.430255492987662, 24.50393754595277, 0.09999999999999926, 240.0, 865, 716517, 922, 72.48120039999776
923, 5.124162738665569, 20.41501147096807, 24.478562288047854, 0.09999999999999873, 290.0, 968, 717485, 923, 81.01249680000183
924, 5.11213959986344, 20.460890546441078, 24.53831716775894, 0.09999999999999766, 475.0, 1280, 718765, 924, 107.96779239999887
925, 5.258590512805515, 20.43648386142247, 24.51587434129143, 0.09999999999999852, 270.0, 1017, 719782, 925, 85.31601400000363
926, 5.065040657042276, 20.506379193598683, 24.595747513346154, 0.09999999999999855, 285.0, 1010, 720792, 926, 85.1768133000005
927, 5.482217442165477, 20.513652701976437, 24.611508432665396, 0.10000000000000035, 145.0, 709, 721501, 927, 59.67230230000132
928, 5.554561682285801, 20.556382801221766, 24.642159118224328, 0.10000000000000031, 165.0, 713, 722214, 928, 59.91123119999975
929, 4.831822814451013, 20.509456542024644, 24.59928159490477, 0.10000000000000096, 90.0, 598, 722812, 929, 50.11925380000321
930, 5.419048129131435, 20.511999815127105, 24.58716246336123, 0.09999999999999845, 285.0, 1036, 723848, 930, 87.04856930000096
931, 5.3876895151500195, 20.533006670929137, 24.618761457148054, 0.10000000000000069, 105.0, 672, 724520, 931, 56.604271700001846
932, 4.73551014355964, 20.45367975884083, 24.529655812048787, 0.0999999999999988, 390.0, 955, 725475, 932, 80.21149520000472
933, 5.204720281183529, 20.476123864658344, 24.557749349088333, 0.10000000000000099, 165.0, 626, 726101, 933, 52.961519399999816
934, 5.075283464439754, 20.44043621271016, 24.51319855018701, 0.09999999999999731, 380.0, 1432, 727533, 934, 120.07185880000179
935, 5.134973904530786, 20.515039703972505, 24.60251270893585, 0.09999999999999877, 310.0, 961, 728494, 935, 80.77037879999989
936, 4.883551246637516, 20.524852237001316, 24.611337239974933, 0.09999999999999815, 480.0, 1117, 729611, 936, 93.76142470000195
937, 5.043034622413772, 20.521505740029472, 24.60368482589722, 0.10000000000000042, 105.0, 700, 730311, 937, 58.81405509999604
938, 5.249846366231627, 20.431792164615906, 24.517887483653052, 0.1000000000000007, 75.0, 373, 730684, 938, 31.44212250000419
939, 4.857018256157106, 20.436067935467978, 24.50792832896303, 0.10000000000000073, 80.0, 393, 731077, 939, 33.164513499999885
940, 5.022337712057225, 20.45125659306844, 24.533304784205054, 0.09999999999999895, 450.0, 924, 732001, 940, 77.63812039999902
941, 5.677876137208569, 20.433573765717735, 24.505641830799192, 0.10000000000000095, 185.0, 645, 732646, 941, 54.20598990000144
942, 5.7908691571280935, 20.416175684556478, 24.521986799254716, 0.10000000000000087, 80.0, 653, 733299, 942, 54.38712809999561
943, 5.47083346017635, 20.415839680982288, 24.5037071851952, 0.10000000000000045, 220.0, 697, 733996, 943, 58.26774589999695
944, 5.269735240159821, 20.435024425901215, 24.50937849899818, 0.10000000000000091, 45.0, 522, 734518, 944, 43.69905909999943
945, 5.476782015477768, 20.464044893630827, 24.546226371418346, 0.10000000000000074, 70.0, 396, 734914, 945, 33.10711750000337
946, 5.570841299221579, 20.420910377226235, 24.494129952747592, 0.09999999999999776, 305.0, 1243, 736157, 946, 104.14807700000529
947, 5.459985530207514, 20.435394877846907, 24.531399850420623, 0.10000000000000088, 125.0, 494, 736651, 947, 41.721255200005544
948, 4.191124900686588, 20.39405917169024, 24.469907583761827, 0.10000000000000042, 45.0, 701, 737352, 948, 58.74008599999797
949, 4.83982632863615, 20.401662278735607, 24.472259909926134, 0.10000000000000071, 110.0, 383, 737735, 949, 32.02533570000378
950, 5.4220694186439085, 20.392240012965615, 24.46247042989446, 0.09999999999999716, 475.0, 1507, 739242, 950, 126.01117190000514
951, 5.930787017770633, 20.43843529330697, 24.549667941536875, 0.10000000000000056, 30.0, 314, 739556, 951, 26.546272200001113
952, 6.3303375310268715, 20.596384966391316, 24.705518153475143, 0.10000000000000073, 160.0, 667, 740223, 952, 56.20333810000011
953, 5.289244153231335, 20.776192433860526, 24.91994802774227, 0.10000000000000099, 125.0, 631, 740854, 953, 52.90140149999934
954, 4.971542124728025, 20.830757527432198, 24.976611460669567, 0.09999999999999794, 570.0, 1180, 742034, 954, 98.60224640000524
955, 4.841246637860207, 20.824383324804877, 24.984193340397795, 0.09999999999999803, 275.0, 1149, 743183, 955, 101.60284859999956
956, 5.595712596955507, 20.827141305674676, 24.962603973305743, 0.10000000000000069, 50.0, 368, 743551, 956, 33.52626579999924
957, 5.346882096581321, 20.815723143149267, 24.969873437249248, 0.09999999999999831, 350.0, 1071, 744622, 957, 93.817970899996
958, 5.604640196998113, 20.767279880534677, 24.92541756203951, 0.10000000000000064, 90.0, 347, 744969, 958, 29.762956700003997
959, 5.136327926433029, 20.77684585645003, 24.92641279248224, 0.09999999999999845, 375.0, 1035, 746004, 959, 87.97403670000494
960, 5.194487738609314, 20.73218035617117, 24.867962659415554, 0.10000000000000096, 85.0, 590, 746594, 960, 50.1692761000013
961, 5.600736114548901, 20.70014769213621, 24.84138762767063, 0.0999999999999994, 235.0, 843, 747437, 961, 71.47430239999812
962, 5.513195883010733, 20.73426970168673, 24.881763089920174, 0.09999999999999958, 230.0, 813, 748250, 962, 70.44290770000225
963, 4.583432471663864, 20.717121242947048, 24.861024158619067, 0.10000000000000066, 90.0, 675, 748925, 963, 61.733855099999346
964, 5.697495183679792, 20.714813698662653, 24.851165759374226, 0.09999999999999884, 380.0, 945, 749870, 964, 84.00575430000026
965, 4.893556781094931, 20.79426647456759, 24.95604408049642, 0.09999999999999955, 185.0, 818, 750688, 965, 69.97734460000356
966, 4.94065687878689, 20.799668101228942, 24.94890897617295, 0.09999999999999769, 415.0, 1271, 751959, 966, 111.58046979999926
967, 5.633400941499367, 20.757467401741838, 24.892094300089894, 0.1000000000000008, 120.0, 434, 752393, 967, 37.54173759999685
968, 4.976120902709728, 20.756732043587515, 24.91288476048548, 0.09999999999999805, 360.0, 1146, 753539, 968, 98.54481460000534
969, 5.041631078152429, 20.730450728280204, 24.87652646564302, 0.0999999999999984, 420.0, 1050, 754589, 969, 94.56681569999637
970, 5.486841616718413, 20.779385852653977, 24.924477885516247, 0.0999999999999979, 210.0, 1194, 755783, 970, 99.9540771000029
971, 4.367332055891518, 20.735107989506258, 24.873307797064733, 0.10000000000000035, 110.0, 709, 756492, 971, 59.39661320000596
972, 5.069242924397245, 20.75000909134582, 24.902048465533134, 0.09999999999999823, 190.0, 1092, 757584, 972, 96.91783349999605
973, 5.434000416235491, 20.737016738407196, 24.886745736368464, 0.10000000000000049, 110.0, 693, 758277, 973, 62.69250319999992
974, 4.950275174220403, 20.67408257293701, 24.79722434234619, 0.10000000000000002, 150.0, 750, 759027, 974, 67.88243960000545
975, 5.127217822515933, 20.610311738287795, 24.714870616513988, 0.1000000000000007, 105.0, 373, 759400, 975, 33.7312368999992
976, 5.589561262406593, 20.650219477897835, 24.768998922395312, 0.09999999999999873, 260.0, 968, 760368, 976, 87.10648519999813
977, 5.365840251804367, 20.643920177366674, 24.762470862535928, 0.0999999999999978, 320.0, 1230, 761598, 977, 110.82283309999912
978, 5.104203489785661, 20.622860651530193, 24.73724742325956, 0.09999999999999859, 500.0, 1002, 762600, 978, 90.30745999999635
979, 5.143547285187758, 20.619442022588263, 24.73123557715895, 0.09999999999999944, 295.0, 836, 763436, 979, 75.19681250000576
980, 5.528911111651691, 20.66138678302097, 24.800569341340417, 0.1000000000000009, 120.0, 514, 763950, 980, 46.276035100003355
981, 5.448656095864293, 20.653988678742266, 24.779925414421562, 0.09999999999999887, 420.0, 939, 764889, 981, 84.82899989999714
982, 5.686639299452925, 20.752786051111094, 24.908396565010786, 0.09999999999999751, 465.0, 1346, 766235, 982, 121.06422759999987
983, 4.907304159041201, 20.77041708217578, 24.926160798983627, 0.10000000000000032, 160.0, 712, 766947, 983, 64.20320830000128
984, 5.049954022825227, 20.762219261938288, 24.90261765709219, 0.10000000000000095, 125.0, 645, 767592, 984, 58.14128530000016
985, 5.248029788911815, 20.76244024110658, 24.90051224992898, 0.09999999999999996, 185.0, 758, 768350, 985, 68.26264680000168
986, 5.288894872431592, 20.772321618860932, 24.91567705219603, 0.10000000000000067, 210.0, 673, 769023, 986, 60.61967700000241
987, 5.012615244202373, 20.762061167274464, 24.898846543036047, 0.10000000000000087, 110.0, 653, 769676, 987, 58.75886639999953
988, 5.5418573939416405, 20.72162377727693, 24.86765015658411, 0.09999999999999815, 440.0, 1118, 770794, 988, 100.62306420000095
989, 5.21679302877677, 20.730223678830843, 24.860701096591665, 0.09999999999999831, 360.0, 1072, 771866, 989, 96.3163887999981
990, 5.002004460293071, 20.720479012395586, 24.854283251130333, 0.09999999999999817, 375.0, 1109, 772975, 990, 99.68579039999895
991, 6.0125410516857105, 20.801201719734536, 24.94515111658042, 0.10000000000000096, 130.0, 597, 773572, 991, 53.69221649999963
992, 5.253150885528134, 20.71320525138609, 24.828890818934287, 0.10000000000000099, 145.0, 620, 774192, 992, 55.86767189999955
993, 4.369104752081907, 20.651621296792804, 24.780126755127686, 0.10000000000000088, 80.0, 499, 774691, 993, 45.0334440000006
994, 4.965311538140242, 20.70663763303104, 24.833403656814273, 0.09999999999999903, 190.0, 906, 775597, 994, 81.48990110000159
995, 5.087763322336333, 20.696585570744105, 24.820304404667446, 0.10000000000000042, 170.0, 700, 776297, 995, 63.13045129999955
996, 4.716313487685778, 20.700893210429772, 24.841661191454122, 0.09999999999999956, 165.0, 816, 777113, 996, 73.65768959999696
997, 5.202165719124796, 20.7666158160004, 24.90166007112603, 0.09999999999999788, 540.0, 1201, 778314, 997, 108.31553719999647
998, 4.827742184459516, 20.79221569930975, 24.957301884134658, 0.09999999999999948, 50.0, 829, 779143, 998, 74.88781860000017
999, 5.385391139229874, 20.775609466764664, 24.938320886941604, 0.10000000000000092, 180.0, 648, 779791, 999, 58.42938769999455
1000, 5.743829565030514, 20.818806157253757, 24.97275123973884, 0.10000000000000075, 55.0, 404, 780195, 1000, 36.547428200006834
1001, 5.480962666662613, 20.838421740390288, 25.014644245109935, 0.10000000000000088, 75.0, 505, 780700, 1001, 45.517986600003496
1002, 5.578807533600114, 20.81922694986517, 24.975873987602466, 0.1000000000000008, 110.0, 660, 781360, 1002, 59.51066069999797
1003, 4.8283536955367685, 20.786807572564413, 24.942340442746186, 0.09999999999999928, 135.0, 860, 782220, 1003, 77.57784679999895
1004, 5.395956013495751, 20.831718847896514, 25.015942786938577, 0.10000000000000023, 210.0, 724, 782944, 1004, 65.30886270000337
1005, 5.584127991816886, 20.797610183064275, 24.964804683506653, 0.10000000000000021, 175.0, 726, 783670, 1005, 65.54254670000228
1006, 4.904629031487551, 20.81015321993715, 24.966278451313904, 0.09999999999999938, 325.0, 844, 784514, 1006, 76.12481309999566
1007, 5.102976770624855, 20.809901975398688, 24.966945585621968, 0.09999999999999916, 140.0, 884, 785398, 1007, 79.90295380000316
1008, 4.737605620522399, 20.841872868237196, 25.01182063563808, 0.10000000000000074, 180.0, 666, 786064, 1008, 60.234792000002926
1009, 4.703754367746509, 20.829943769479513, 25.001935942490213, 0.09999999999999891, 115.0, 932, 786996, 1009, 84.43374980000226
1010, 5.005800725349897, 20.83898688268058, 25.013506373272666, 0.10000000000000099, 140.0, 632, 787628, 1010, 57.15829699999449
1011, 4.650809009419622, 20.80411688396681, 24.953850954180062, 0.10000000000000066, 50.0, 353, 787981, 1011, 32.00145740000153
1012, 5.249956475603604, 20.82051960409504, 24.980962219536888, 0.0999999999999985, 430.0, 1022, 789003, 1012, 92.19817740000144
1013, 5.166004247475214, 20.855211948057864, 25.0208343368197, 0.09999999999999838, 360.0, 1053, 790056, 1013, 95.3686391999945
1014, 5.177875870376601, 20.95134809441435, 25.13877420736136, 0.09999999999999967, 235.0, 798, 790854, 1014, 72.33091969999805
1015, 5.480972695388371, 20.96420974972882, 25.165845940384685, 0.10000000000000099, 110.0, 632, 791486, 1015, 57.35634769999888
1016, 4.358778644786325, 20.940276007319607, 25.111676643061084, 0.10000000000000063, 80.0, 344, 791830, 1016, 31.156912999998895
1017, 4.725657194852829, 20.932712468233976, 25.122305176474832, 0.09999999999999828, 595.0, 1078, 792908, 1017, 97.42008700000588
1018, 5.247483585558859, 20.96763979830263, 25.166316386226384, 0.09999999999999751, 245.0, 1345, 794253, 1018, 121.29740049999964
1019, 5.1922161336544015, 20.919295952316308, 25.106587784468463, 0.10000000000000099, 110.0, 629, 794882, 1019, 56.932750699997996
1020, 5.437810074279955, 20.976194246663013, 25.176851653269832, 0.09999999999999652, 880.0, 1949, 796831, 1020, 175.8579966000034
1021, 5.679302937615797, 20.964441607848066, 25.152628434509086, 0.09999999999999767, 365.0, 1274, 798105, 1021, 114.51684789999854
1022, 6.020142775581729, 20.984655718649588, 25.178870111896146, 0.10000000000000099, 200.0, 620, 798725, 1022, 51.742270599999756
1023, 5.1343437749179985, 20.96080630203414, 25.139655376392636, 0.10000000000000016, 80.0, 732, 799457, 1023, 61.16933020000579
1024, 5.189409006663731, 20.99211050669352, 25.189774613153368, 0.0999999999999984, 340.0, 1050, 800507, 1024, 87.23265009999159
1025, 5.130533691293303, 21.08582138441974, 25.310435718865875, 0.09999999999999812, 180.0, 1123, 801630, 1025, 94.03714640000544
1026, 4.871926733875663, 21.06086815081961, 25.263277123614056, 0.10000000000000087, 115.0, 492, 802122, 1026, 41.043441999994684
1027, 5.2934160997721715, 21.028942925014576, 25.235657190974756, 0.09999999999999883, 205.0, 948, 803070, 1027, 79.01867160000256
1028, 5.4731985878261575, 21.046735870525204, 25.266854233844185, 0.09999999999999942, 210.0, 838, 803908, 1028, 70.03312029999506
1029, 4.513765521605626, 21.014981789621967, 25.225848484259554, 0.09999999999999926, 410.0, 866, 804774, 1029, 72.15099320000445
1030, 5.561661885276673, 21.042193412175255, 25.266798248291014, 0.09999999999999704, 695.0, 1575, 806349, 1030, 130.88197610000498
1031, 5.749389940029297, 21.01675072623798, 25.223243128372232, 0.09999999999999795, 375.0, 1177, 807526, 1031, 97.63065859999915
1032, 5.360278558545273, 21.032335417499496, 25.244576231195264, 0.09999999999999783, 285.0, 1219, 808745, 1032, 101.33614070000476
1033, 5.193063060468957, 21.02909601651705, 25.242778798313292, 0.09999999999999999, 125.0, 754, 809499, 1033, 62.80936300000758
1034, 5.530172912501046, 20.93743501681287, 25.137471445363843, 0.09999999999999938, 160.0, 844, 810343, 1034, 70.28639609999664
1035, 4.513753005681328, 20.83476442574693, 25.01403704999735, 0.10000000000000099, 110.0, 626, 810969, 1035, 52.08795219998865
1036, 5.399068747544253, 20.816185566011967, 24.97412753141233, 0.10000000000000078, 160.0, 661, 811630, 1036, 55.09098949999316
1037, 5.204340931990533, 20.838663876867116, 25.008529017086524, 0.0999999999999996, 320.0, 809, 812439, 1037, 67.33212249999633
1038, 5.648286673941131, 20.853149395423912, 25.04048427308421, 0.10000000000000098, 220.0, 614, 813053, 1038, 51.121223199996166
1039, 5.096230649191, 20.841891187807988, 25.012705469190852, 0.09999999999999964, 165.0, 803, 813856, 1039, 67.08641439999337
1040, 5.314992182819885, 20.841355995554103, 25.006834454288814, 0.1, 105.0, 751, 814607, 1040, 62.36062120000133
1041, 5.581431236153146, 20.84574492369589, 25.024516581453163, 0.09999999999999742, 335.0, 1381, 815988, 1041, 113.94652080000378
1042, 5.201327349683545, 20.848719573132172, 25.0293052756397, 0.09999999999999765, 185.0, 1286, 817274, 1042, 106.78441329998896
1043, 5.471124034713029, 20.905682689894245, 25.100168528181783, 0.09999999999999801, 335.0, 1157, 818431, 1043, 95.06293329999608
1044, 5.397129620581666, 20.97980377818114, 25.184273046135104, 0.09999999999999791, 170.0, 1192, 819623, 1044, 98.85374240000965
1045, 4.875620580944125, 21.077735181124705, 25.29400154129764, 0.10000000000000085, 55.0, 477, 820100, 1045, 39.49187169999641
1046, 5.167872201503021, 21.365333094064564, 25.648626870982447, 0.09999999999999766, 425.0, 1281, 821381, 1046, 105.63396849999845
1047, 5.806379093913612, 21.41632325090244, 25.702128268912702, 0.0999999999999986, 195.0, 998, 822379, 1047, 82.82182170001033
1048, 5.604895654993673, 21.404258588565295, 25.687804115459482, 0.09999999999999891, 250.0, 930, 823309, 1048, 77.28105800000776
1049, 5.451993345351847, 21.419051989098453, 25.72321888871515, 0.09999999999999776, 255.0, 1244, 824553, 1049, 103.14789250001195
1050, 5.38801271845504, 21.508740970252482, 25.813197230902407, 0.10000000000000014, 205.0, 733, 825286, 1050, 60.516760800004704
1051, 5.2460497554797865, 21.53727906485998, 25.844974393910984, 0.09999999999999928, 225.0, 862, 826148, 1051, 71.40056029999687
1052, 4.875165582016895, 21.49994477723774, 25.81606711738988, 0.09999999999999881, 195.0, 950, 827098, 1052, 78.52460160000192
1053, 5.479105316499657, 21.553034682772054, 25.878361476255634, 0.10000000000000085, 50.0, 469, 827567, 1053, 38.83227610000176
1054, 5.179823798483068, 21.54285310302118, 25.859024359963158, 0.10000000000000088, 100.0, 495, 828062, 1054, 40.79918039999029
1055, 5.554421145983828, 21.500434436643026, 25.798032552827664, 0.0999999999999978, 455.0, 1230, 829292, 1055, 101.71508700000413
1056, 5.25635395381474, 21.68723787446795, 26.02875415959737, 0.09999999999999665, 775.0, 1838, 831130, 1056, 151.33012990000134
1057, 5.064971716239534, 21.751731113666565, 26.142392343172027, 0.1000000000000007, 60.0, 377, 831507, 1057, 31.197817499996745
1058, 5.85928966684045, 21.750430309710726, 26.118300754171578, 0.10000000000000073, 55.0, 386, 831893, 1058, 31.913127299994812
1059, 5.808274151542323, 21.737602292812937, 26.083550073267, 0.10000000000000098, 170.0, 615, 832508, 1059, 50.72765060000529
1060, 5.467893130905617, 21.71758819322249, 26.062279717347224, 0.09999999999999762, 395.0, 1302, 833810, 1060, 107.36469470000884
1061, 5.417437053509688, 21.763824535628498, 26.121664194333352, 0.09999999999999794, 445.0, 1180, 834990, 1061, 97.80455809998966
1062, 5.297355338767335, 21.810452250146792, 26.175968721111303, 0.10000000000000099, 125.0, 637, 835627, 1062, 52.59295560000464
1063, 5.5797013260974415, 21.807886908509946, 26.180982795438062, 0.09999999999999933, 335.0, 853, 836480, 1063, 70.4621965999977
1064, 5.4497491822987, 21.82012537799815, 26.205280528497443, 0.09999999999999998, 230.0, 756, 837236, 1064, 62.32280100000207
1065, 6.039795389264336, 21.812553061194077, 26.182403086504458, 0.0999999999999993, 295.0, 858, 838094, 1065, 70.83566310000606
1066, 5.326288757794494, 21.78884979563022, 26.15703713128326, 0.10000000000000085, 170.0, 654, 838748, 1066, 54.15675909999118
1067, 4.751568757387308, 21.76278475834773, 26.131460459782527, 0.10000000000000059, 45.0, 325, 839073, 1067, 26.79331419999653
1068, 5.649679691711468, 21.75274214459889, 26.128154694144406, 0.10000000000000092, 105.0, 536, 839609, 1068, 44.41933350000181
1069, 4.986839753765636, 21.847905285513303, 26.225070059899334, 0.09999999999999823, 275.0, 1093, 840702, 1069, 90.71698230000038
1070, 6.121166833156457, 21.927323338444246, 26.32292614685246, 0.10000000000000088, 145.0, 652, 841354, 1070, 54.11951429999317
1071, 5.325642778671214, 21.918938738959177, 26.3232235511144, 0.10000000000000069, 190.0, 672, 842026, 1071, 55.718470200008596
1072, 5.608773795317631, 21.90834149049253, 26.29271469797407, 0.10000000000000073, 80.0, 392, 842418, 1072, 32.69173390000651
1073, 4.72572059077164, 21.86519266636741, 26.247745720173338, 0.09999999999999909, 115.0, 897, 843315, 1073, 74.71589900000254
1074, 5.43083479701809, 21.907677115204606, 26.294611272408332, 0.09999999999999908, 445.0, 898, 844213, 1074, 74.46647169999778
1075, 5.830852490625804, 21.944748474072806, 26.31372577329225, 0.10000000000000099, 125.0, 632, 844845, 1075, 52.69797340000514
1076, 5.83232226062704, 21.892794828061703, 26.280655198273834, 0.10000000000000066, 140.0, 675, 845520, 1076, 56.007362899996224
1077, 6.05056854360818, 21.891674448804157, 26.272028604035594, 0.09999999999999803, 295.0, 1148, 846668, 1077, 95.11324239999522
1078, 5.583408197354616, 21.886162777007446, 26.265109409626334, 0.09999999999999883, 245.0, 947, 847615, 1078, 78.94727549998788
1079, 5.549102279391602, 21.86565107399281, 26.23887217405317, 0.09999999999999877, 380.0, 959, 848574, 1079, 80.01796290000493
1080, 5.3487290583746265, 21.896411314736888, 26.284721755505203, 0.09999999999999966, 165.0, 801, 849375, 1080, 66.78909930000373
1081, 5.2594934432928415, 21.86980678262578, 26.24206668482149, 0.10000000000000088, 35.0, 503, 849878, 1081, 41.920567900000606
1082, 5.418750447017459, 21.559109003828844, 25.8905057740281, 0.10000000000000055, 215.0, 686, 850564, 1082, 57.60133250000945
1083, 6.090882409808687, 21.50895835742092, 25.822576955806486, 0.1000000000000009, 45.0, 511, 851075, 1083, 42.64791849999165
1084, 5.148698039536105, 21.524915140183246, 25.845857405271687, 0.0999999999999987, 320.0, 976, 852051, 1084, 81.47074649999558
1085, 5.818577977312894, 21.544919330876628, 25.87643928051739, 0.10000000000000099, 110.0, 641, 852692, 1085, 53.49030679999851
1086, 5.979393565965878, 21.559224712979663, 25.87608120729635, 0.10000000000000019, 130.0, 728, 853420, 1086, 60.38052520000201
1087, 5.2287683245649035, 21.549389826048404, 25.868556081701858, 0.09999999999999921, 140.0, 872, 854292, 1087, 72.40249799999583
1088, 5.182310457009051, 21.544403395463718, 25.877525410813206, 0.1000000000000006, 105.0, 681, 854973, 1088, 57.02768860000651
1089, 5.505054195310748, 21.54358765861389, 25.859462748802954, 0.09999999999999834, 270.0, 1063, 856036, 1089, 88.82268650000333
1090, 5.581984537821087, 21.515806089816408, 25.83604336085756, 0.10000000000000099, 155.0, 634, 856670, 1090, 53.20616050000535
1091, 5.6478434866624525, 21.51572954705421, 25.81817363982505, 0.09999999999999735, 850.0, 1410, 858080, 1091, 118.00251539998862
1092, 5.568378332129654, 21.540445202844268, 25.861000786500252, 0.10000000000000074, 15.0, 397, 858477, 1092, 33.42779979998886
1093, 4.953927734911999, 21.507031857855967, 25.8239605645153, 0.09999999999999831, 325.0, 1070, 859547, 1093, 88.90232589999505
1094, 5.668952018823675, 21.509481245471584, 25.82866637937484, 0.1000000000000007, 55.0, 372, 859919, 1094, 31.135450800007675
1095, 6.870945968333332, 21.602718594430506, 25.904423960323992, 0.10000000000000064, 50.0, 348, 860267, 1095, 29.194743899992318
1096, 5.46547784715466, 21.49499493072572, 25.812252588524593, 0.10000000000000087, 125.0, 491, 860758, 1096, 40.993293799998355
1097, 5.187004818841815, 21.499501717090606, 25.82002450942993, 0.09999999999999966, 230.0, 800, 861558, 1097, 66.64282549999189
1098, 5.6699656677704215, 21.500699748977325, 25.813399519963237, 0.09999999999999781, 205.0, 1223, 862781, 1098, 102.15192479999678
1099, 5.24564007697074, 21.583434166939725, 25.9010597106761, 0.09999999999999835, 300.0, 1061, 863842, 1099, 88.28976890000922
1100, 6.075922366629167, 21.60916293880188, 25.932673506346294, 0.09999999999999962, 425.0, 806, 864648, 1100, 66.89671329999692
1101, 5.964125313939559, 21.588156194150592, 25.923826581400007, 0.10000000000000075, 55.0, 409, 865057, 1101, 34.31239530000312
1102, 5.797270813916312, 21.598162036851793, 25.91900114823853, 0.0999999999999998, 400.0, 781, 865838, 1102, 64.8336883999873
1103, 5.562519198597068, 21.506023437197847, 25.814435905985313, 0.10000000000000088, 105.0, 505, 866343, 1103, 42.07671649999975
1104, 6.513914366496871, 21.54593491531532, 25.860565498286594, 0.0999999999999984, 540.0, 1049, 867392, 1104, 87.0240877999895
1105, 6.062177883897509, 21.587702769688196, 25.912516350882395, 0.0999999999999992, 260.0, 875, 868267, 1105, 72.59819889999926
1106, 5.717440243948389, 21.596437442449876, 25.916345622804428, 0.10000000000000092, 175.0, 648, 868915, 1106, 53.68815220000397
1107, 5.2521846217668875, 21.5296681606258, 25.856915829860654, 0.09999999999999988, 285.0, 769, 869684, 1107, 64.00522390000697
1108, 5.470288658608271, 21.55566818887295, 25.877178991307094, 0.10000000000000028, 190.0, 716, 870400, 1108, 59.72767899998871
1109, 5.142194024219956, 21.586339601536388, 25.924449370079433, 0.10000000000000073, 75.0, 388, 870788, 1109, 32.392995100002736
1110, 5.98058713407554, 21.58178664846364, 25.910018958370905, 0.1000000000000009, 100.0, 509, 871297, 1110, 42.50144400000863
1111, 5.743882096683892, 21.544357784299084, 25.87549505860266, 0.10000000000000056, 170.0, 685, 871982, 1111, 57.030686300000525
1112, 6.337236735513831, 21.546580733976253, 25.857636456044286, 0.09999999999999819, 435.0, 1103, 873085, 1112, 91.22196100000292
1113, 5.6099371628288495, 21.565930861227457, 25.8795180568672, 0.09999999999999949, 160.0, 827, 873912, 1113, 68.80506910000986
1114, 6.213428242080038, 21.592394974422632, 25.913248239726773, 0.0999999999999983, 395.0, 1074, 874986, 1114, 89.22734599999967
1115, 6.058848204996564, 21.6200680304607, 25.943881135237845, 0.10000000000000094, 115.0, 646, 875632, 1115, 53.90915500000119
1116, 5.830920523117908, 21.578284858676717, 25.90536487144533, 0.09999999999999934, 105.0, 851, 876483, 1116, 70.85130989999743
1117, 5.726934840295469, 21.544396029213928, 25.867302141622467, 0.09999999999999727, 215.0, 1454, 877937, 1117, 120.59611940001196
1118, 6.24712487802231, 21.554511667155534, 25.875766916069196, 0.10000000000000046, 85.0, 695, 878632, 1118, 57.713842099998146
1119, 6.2208282615884345, 21.50918320802312, 25.819610757140158, 0.100000000000001, 85.0, 638, 879270, 1119, 52.71606839999731
1120, 6.265590306590585, 21.525854708166683, 25.84938139073989, 0.1000000000000006, 55.0, 680, 879950, 1120, 56.18140219998895
1121, 6.213352850901553, 21.580033026271998, 25.9094917565821, 0.09999999999999917, 245.0, 881, 880831, 1121, 73.09651180000219
1122, 6.426904054539816, 21.59466559274725, 25.937711597059334, 0.09999999999999773, 380.0, 1254, 882085, 1122, 103.76992209999298
1123, 5.126784999536563, 21.543531800121194, 25.861909912608343, 0.09999999999999883, 145.0, 948, 883033, 1123, 78.49286100000609
1124, 6.066530322865821, 21.62738913534987, 25.95337725173898, 0.09999999999999919, 295.0, 879, 883912, 1124, 72.9286495000124
1125, 6.438947652896133, 21.57807640699809, 25.91815944989074, 0.10000000000000035, 175.0, 709, 884621, 1125, 58.875333299991325
1126, 5.711702745613151, 21.535228513357207, 25.86480312460051, 0.09999999999999852, 310.0, 1016, 885637, 1126, 84.1897195999918
1127, 6.302928675065829, 21.506245124997115, 25.828967354241318, 0.10000000000000099, 180.0, 635, 886272, 1127, 52.489559599998756
1128, 6.40812590226231, 21.54336961067763, 25.87037518904513, 0.10000000000000006, 340.0, 745, 887017, 1128, 62.146016900005634
1129, 5.628325818413097, 21.51858434774548, 25.838495672358015, 0.09999999999999917, 525.0, 881, 887898, 1129, 73.285360400012
1130, 5.467549444240898, 21.569243095221434, 25.90348590125155, 0.09999999999999981, 190.0, 778, 888676, 1130, 64.90178200000082
1131, 6.0598692892980175, 21.614665571581416, 25.95637786608784, 0.10000000000000096, 65.0, 595, 889271, 1131, 49.31585410000116
1132, 6.006768074849183, 21.61927629692785, 25.970716711567235, 0.09999999999999853, 275.0, 1014, 890285, 1132, 84.30794420000166
1133, 5.833746487518035, 21.582095190795542, 25.920195681774594, 0.09999999999999848, 205.0, 1026, 891311, 1133, 85.28222589999496
1134, 5.859671436424018, 21.546736350882664, 25.875091493407822, 0.10000000000000096, 85.0, 643, 891954, 1134, 53.65960399998585
1135, 6.150446567498654, 21.58614460382263, 25.933794113256017, 0.09999999999999819, 355.0, 1103, 893057, 1135, 91.56252030000906
1136, 5.94893199707278, 21.572111275460983, 25.899688531955082, 0.09999999999999803, 220.0, 1152, 894209, 1136, 95.67755210000905
1137, 6.17671876775926, 21.553899500793193, 25.902036650356276, 0.10000000000000049, 130.0, 693, 894902, 1137, 57.52048730000388
1138, 5.666219805551451, 21.57480311259038, 25.919315988734617, 0.09999999999999734, 530.0, 1416, 896318, 1138, 117.10279669999727
1139, 6.482156449046574, 21.587759055589373, 25.930995269825583, 0.10000000000000098, 160.0, 608, 896926, 1139, 50.64892510000209
1140, 6.469743526467709, 21.616035264113854, 25.963989502957624, 0.09999999999999878, 485.0, 957, 897883, 1140, 79.90277690000948
1141, 5.231330586554006, 21.562102173649986, 25.897641921228217, 0.1000000000000009, 20.0, 516, 898399, 1141, 43.125687300009304
1142, 5.4490274550564655, 21.55412171964438, 25.889705703325085, 0.09999999999999874, 230.0, 967, 899366, 1142, 80.44063320000714
1143, 5.80970023474411, 21.664938479139092, 26.008329619441117, 0.099999999999999, 185.0, 912, 900278, 1143, 76.4439318000077
1144, 6.235580243533704, 21.810143348647326, 26.18403250705905, 0.10000000000000084, 135.0, 656, 900934, 1144, 54.91059869999299
1145, 5.782040126807325, 21.75655080584869, 26.12375570616264, 0.10000000000000094, 105.0, 562, 901496, 1145, 47.18406839999079
1146, 6.185734191708181, 21.79827033514264, 26.173139337561597, 0.09999999999999923, 340.0, 870, 902366, 1146, 72.5768997999985
1147, 5.775962007109278, 21.73748114681983, 26.115598040957785, 0.09999999999999847, 400.0, 1032, 903398, 1147, 85.77409589999297
1148, 5.649837938818469, 21.753702492856267, 26.124718247954526, 0.09999999999999831, 305.0, 1072, 904470, 1148, 89.32934399999795
1149, 6.353671642587506, 21.704621418145255, 26.076429090960055, 0.10000000000000098, 110.0, 601, 905071, 1149, 50.09267749999708
1150, 5.946731017273048, 21.758164116431928, 26.134717326328673, 0.10000000000000095, 225.0, 580, 905651, 1150, 48.66871140000876
1151, 5.709397527188312, 21.712474616122332, 26.076839071917163, 0.09999999999999941, 275.0, 839, 906490, 1151, 70.49327099999937
1152, 6.151901440843166, 21.732987393969896, 26.10540357015537, 0.10000000000000095, 130.0, 578, 907068, 1152, 48.50774220000312
1153, 6.553070614913742, 21.751409130895922, 26.134084728187666, 0.09999999999999859, 175.0, 1002, 908070, 1153, 83.77944289999141
1154, 6.175483669948217, 21.769693739141285, 26.15619190616662, 0.09999999999999837, 395.0, 1057, 909127, 1154, 88.48757460000343
1155, 5.827962527954087, 21.754580967205086, 26.130276820094316, 0.09999999999999983, 190.0, 776, 909903, 1155, 65.03168909999658
1156, 6.269517301263924, 22.082396361642257, 26.520116240678433, 0.10000000000000071, 160.0, 668, 910571, 1156, 55.31529739999678
1157, 5.542578400081059, 22.0486530064037, 26.48008617904951, 0.0999999999999997, 370.0, 795, 911366, 1157, 66.33621219999623
1158, 5.547214678040257, 22.033920989801853, 26.472593561808267, 0.10000000000000075, 100.0, 405, 911771, 1158, 34.15770729999349
1159, 6.355543677133939, 22.042671618955584, 26.467374047567677, 0.09999999999999884, 460.0, 946, 912717, 1159, 79.08958150001126
1160, 6.111651088218246, 22.06407675911895, 26.508205869556527, 0.09999999999999905, 415.0, 904, 913621, 1160, 75.94066839999869
1161, 6.305946214458881, 22.07932423730182, 26.506595448551014, 0.10000000000000084, 75.0, 468, 914089, 1161, 39.34226380000473
1162, 6.3752630537002, 22.08730572002012, 26.53818854500458, 0.10000000000000096, 65.0, 583, 914672, 1162, 48.880060600000434
1163, 6.754201198363826, 22.101708952817894, 26.540447571561863, 0.09999999999999952, 155.0, 822, 915494, 1163, 68.50165510000079
1164, 6.507736444323694, 22.06628295678267, 26.52551689770171, 0.09999999999999969, 190.0, 797, 916291, 1164, 66.85291129999678
1165, 5.233142954692991, 22.067084274694597, 26.494799772478974, 0.10000000000000071, 65.0, 379, 916670, 1165, 31.457254699998884
1166, 5.916900832744474, 22.034011399148138, 26.468639238745766, 0.10000000000000063, 130.0, 678, 917348, 1166, 56.582704600004945
1167, 6.749227422136004, 22.025847542267552, 26.46123950470394, 0.10000000000000091, 115.0, 649, 917997, 1167, 54.3691947000043
1168, 5.838541516537068, 21.986729615754253, 26.39200400692857, 0.10000000000000099, 140.0, 622, 918619, 1168, 52.0501324999932
1169, 6.2773657995514505, 21.984157443195397, 26.392851299709744, 0.09999999999999966, 340.0, 801, 919420, 1169, 67.00466809999489
1170, 5.3933462960003595, 21.887578093135296, 26.285030057353357, 0.10000000000000096, 100.0, 589, 920009, 1170, 49.427352300001075
1171, 6.029311676903042, 22.39282875188404, 26.911657586519627, 0.09999999999999788, 460.0, 1198, 921207, 1171, 99.85176829999546
1172, 5.699158949913775, 22.35850523448572, 26.857633989031722, 0.10000000000000084, 180.0, 656, 921863, 1172, 54.98204010000336
1173, 6.013382132025971, 22.387295448917083, 26.887166867310974, 0.09999999999999878, 210.0, 957, 922820, 1173, 80.194874599998
1174, 5.47443054443391, 22.395318717438712, 26.905179528629077, 0.10000000000000077, 130.0, 663, 923483, 1174, 55.45168460000423
1175, 6.126785940941303, 22.415611390144594, 26.91854214668274, 0.10000000000000088, 85.0, 496, 923979, 1175, 41.59701800000039
1176, 6.099434062880768, 22.393562062941598, 26.910781725270216, 0.10000000000000066, 90.0, 353, 924332, 1176, 29.695330000002286
1177, 6.572271991450831, 22.40445149769573, 26.90717204111927, 0.09999999999999767, 445.0, 1272, 925604, 1177, 106.39628630000516
1178, 5.978224186054895, 22.42769736293497, 26.939054119630935, 0.09999999999999826, 370.0, 1084, 926688, 1178, 90.59724600000482
1179, 6.273747182436406, 22.44883047588288, 26.97340871417333, 0.09999999999999856, 490.0, 1008, 927696, 1179, 84.2321174999961
1180, 6.523313968539855, 22.49185445913997, 27.00695408045319, 0.09999999999999874, 415.0, 965, 928661, 1180, 80.18765789999452
1181, 6.326723987776315, 22.405381136096427, 26.920564543793496, 0.10000000000000067, 125.0, 673, 929334, 1181, 56.193044700004975
1182, 5.84836860471855, 22.416182271494254, 26.91234351075972, 0.10000000000000071, 45.0, 383, 929717, 1182, 32.3196203999978
1183, 6.029336398250326, 22.61134695376285, 27.15370965074022, 0.0999999999999985, 530.0, 1021, 930738, 1183, 85.34329060000891
1184, 6.134511840369733, 22.706055586558605, 27.291785958579982, 0.09999999999999902, 320.0, 908, 931646, 1184, 75.48707879999711
1185, 5.922645026794759, 22.700636160733644, 27.25352645724959, 0.10000000000000094, 115.0, 563, 932209, 1185, 46.96562590000394
1186, 6.663451898066539, 22.64181556802312, 27.19484190827624, 0.10000000000000071, 75.0, 379, 932588, 1186, 31.486678300003405
1187, 6.639291071122693, 22.65943508763467, 27.223453145727888, 0.09999999999999942, 135.0, 837, 933425, 1187, 69.5182907999988
1188, 6.154703533370048, 22.66627282500267, 27.214290028810503, 0.100000000000001, 30.0, 640, 934065, 1188, 53.38657000000239
1189, 6.549122778781347, 22.634168481551153, 27.196631859722395, 0.10000000000000091, 35.0, 519, 934584, 1189, 43.119882300001336
1190, 7.08224148150602, 22.703283162497303, 27.25209122406193, 0.09999999999999956, 240.0, 815, 935399, 1190, 68.19921659999818
1191, 6.290083138308361, 22.6442189779695, 27.19671332640142, 0.10000000000000071, 140.0, 669, 936068, 1191, 55.84729760000482
1192, 5.8065801772593275, 22.599192886069268, 27.14460606150108, 0.0999999999999996, 170.0, 808, 936876, 1192, 67.4335213000013
1193, 5.554954011865708, 22.699925316310726, 27.25345036176944, 0.10000000000000092, 160.0, 538, 937414, 1193, 44.99245440000959
1194, 5.758655722434628, 22.665186715946454, 27.22674348530854, 0.09999999999999877, 250.0, 959, 938373, 1194, 79.67824630001269
1195, 6.564147078671429, 22.711228035734674, 27.260998644802353, 0.09999999999999827, 335.0, 1082, 939455, 1195, 89.77813289999904
1196, 5.799460334747605, 22.678070932862877, 27.25613959202109, 0.10000000000000099, 70.0, 631, 940086, 1196, 52.40396090000286
1197, 5.982653537465492, 22.696010037278576, 27.265790232360132, 0.09999999999999708, 445.0, 1554, 941640, 1197, 128.7735296000028
1198, 5.782200681727107, 22.670094373749524, 27.22002054307519, 0.09999999999999953, 110.0, 820, 942460, 1198, 67.669095499994
1199, 6.026210011887377, 22.656695471293684, 27.211451834526613, 0.09999999999999819, 360.0, 1104, 943564, 1199, 91.14161179999064
1200, 6.08201833658872, 22.693068201296796, 27.262822510668794, 0.10000000000000098, 130.0, 642, 944206, 1200, 53.534006299989414
1201, 6.486413735275467, 22.69079397916794, 27.263977932929993, 0.10000000000000085, 80.0, 480, 944686, 1201, 40.018034300010186
1202, 6.255105734392025, 22.693805286457444, 27.248732526021232, 0.09999999999999805, 350.0, 1145, 945831, 1202, 94.91244329999608
1203, 6.00098422318697, 22.67404004573822, 27.201889791488647, 0.10000000000000074, 75.0, 400, 946231, 1203, 33.328535200009355
1204, 6.099624979241281, 22.655999951484876, 27.2119965072371, 0.09999999999999797, 445.0, 1170, 947401, 1204, 96.89646019999054
1205, 6.214709846005923, 22.701788534634357, 27.24159527654233, 0.10000000000000064, 55.0, 345, 947746, 1205, 28.729111799999373
1206, 6.358576431290781, 22.709355887522868, 27.263365446566443, 0.09999999999999759, 275.0, 1311, 949057, 1206, 108.65847100000246
1207, 6.047809303975573, 22.749463528070056, 27.31210119168483, 0.09999999999999898, 385.0, 918, 949975, 1207, 76.25236900000891
1208, 6.284433714562081, 22.669352435425623, 27.21399069792472, 0.0999999999999991, 255.0, 894, 950869, 1208, 74.31667400000151
1209, 6.2917149642985715, 22.688443242210372, 27.25794058579665, 0.1000000000000009, 75.0, 507, 951376, 1209, 41.9227469000034
1210, 6.117011102247672, 22.654511973126255, 27.204514718824818, 0.09999999999999785, 495.0, 1209, 952585, 1210, 100.43984649999766
1211, 5.988172707110834, 22.667982150409586, 27.202156559034552, 0.09999999999999981, 210.0, 779, 953364, 1211, 65.04892440000549
1212, 6.806452379221433, 22.692413968661807, 27.25567640396992, 0.10000000000000082, 75.0, 454, 953818, 1212, 37.693149300001096
1213, 5.654425399270124, 22.624490743625664, 27.16731228895054, 0.09999999999999859, 200.0, 1002, 954820, 1213, 83.28435040000477
1214, 6.1735088060991545, 22.67858001276622, 27.23283828726344, 0.09999999999999937, 235.0, 847, 955667, 1214, 70.46674090001034
1215, 5.246767225212225, 22.68426636211033, 27.232320966667302, 0.10000000000000067, 75.0, 358, 956025, 1215, 29.845338099999935
1216, 6.460729185004293, 22.72207720878193, 27.296078820876133, 0.09999999999999784, 420.0, 1215, 957240, 1216, 100.94815570001083
1217, 5.538735966233417, 22.78428978856535, 27.36999657551854, 0.09999999999999869, 335.0, 977, 958217, 1217, 80.93382869999914
1218, 6.088165613848396, 22.853310386513346, 27.439876312078173, 0.10000000000000055, 145.0, 687, 958904, 1218, 57.18358029999945
1219, 6.569869735191777, 22.83160226861226, 27.41701129785518, 0.09999999999999983, 230.0, 776, 959680, 1219, 64.51074559999688
1220, 5.821142857650231, 22.798149240428003, 27.357868789804392, 0.10000000000000095, 70.0, 580, 960260, 1220, 48.15107239999634
1221, 6.280995109948245, 22.830396468918046, 27.411335803936055, 0.10000000000000071, 50.0, 385, 960645, 1221, 31.86159359999874
1222, 5.721931084769416, 22.7777616942318, 27.35559180511565, 0.10000000000000066, 95.0, 674, 961319, 1222, 56.09552800000529
1223, 6.230692083217306, 22.809922832871234, 27.39211038428346, 0.09999999999999852, 585.0, 1018, 962337, 1223, 84.87241709999216
1224, 6.22495935020093, 22.802186709831965, 27.364701749579226, 0.10000000000000095, 45.0, 566, 962903, 1224, 47.11349399999017
1225, 5.792007255609389, 22.761556715876967, 27.342302746242947, 0.09999999999999927, 300.0, 864, 963767, 1225, 71.29863009999099
1226, 6.021400216198465, 22.812966436381128, 27.38776502783554, 0.0999999999999999, 315.0, 766, 964533, 1226, 63.889906299998984
1227, 6.364104527434346, 22.72990959009547, 27.287236997276356, 0.09999999999999772, 405.0, 1256, 965789, 1227, 103.90852769999765
1228, 5.992634681024575, 22.769614138926965, 27.313294611352887, 0.0999999999999979, 390.0, 1193, 966982, 1228, 98.8368225999875
1229, 5.841737746267729, 22.801239371015235, 27.377114915051152, 0.09999999999999942, 255.0, 838, 967820, 1229, 69.34714289999101
1230, 6.01092943790362, 22.805091947102717, 27.379447703738865, 0.09999999999999816, 380.0, 1112, 968932, 1230, 92.29783670000324
1231, 6.597346589747785, 22.884704638512428, 27.483465871428518, 0.09999999999999952, 190.0, 823, 969755, 1231, 68.76369279999926
1232, 6.066081480207768, 22.915638865846574, 27.5177853938305, 0.10000000000000091, 190.0, 528, 970283, 1232, 44.05768850000459
1233, 5.671023369085364, 22.846162380162525, 27.409755726780283, 0.10000000000000085, 80.0, 477, 970760, 1233, 39.84658969999873
1234, 6.022406053701333, 22.838302408066472, 27.411171948593275, 0.0999999999999981, 390.0, 1130, 971890, 1234, 93.80252460000338
1235, 5.524919345457847, 22.853547610695053, 27.44404169437637, 0.10000000000000099, 85.0, 634, 972524, 1235, 52.83159419998992
1236, 5.592111755398255, 22.80938264560527, 27.3902767864317, 0.09999999999999819, 395.0, 1106, 973630, 1236, 91.87739530000545
1237, 6.062999215492836, 22.87942843314929, 27.46490366275494, 0.0999999999999998, 185.0, 780, 974410, 1237, 65.00489010001183
1238, 5.990589783699424, 22.823587447877916, 27.396752962990412, 0.09999999999999998, 155.0, 756, 975166, 1238, 62.7795291999937
1239, 6.0312630168274435, 22.790918435101734, 27.36680688159004, 0.09999999999999991, 215.0, 764, 975930, 1239, 63.08818649999739
1240, 5.386111285767161, 22.768891145232924, 27.344900306185384, 0.09999999999999755, 420.0, 1330, 977260, 1240, 110.57721399998991
1241, 6.286284452275763, 22.792034933690996, 27.38046091120542, 0.10000000000000085, 165.0, 654, 977914, 1241, 54.40029270001105
1242, 5.385613112005659, 22.76914271959319, 27.328475383434153, 0.09999999999999892, 360.0, 929, 978843, 1242, 77.33499499999743
1243, 6.135881935646631, 22.73137091511515, 27.289778618790983, 0.09999999999999916, 340.0, 884, 979727, 1243, 77.73200930000166
1244, 5.825901819921252, 22.87615939396531, 27.458913223067327, 0.10000000000000092, 95.0, 536, 980263, 1244, 49.666242100007366
1245, 5.554824103599022, 22.93295116286012, 27.53531610244123, 0.09999999999999949, 195.0, 826, 981089, 1245, 80.18648379998922
1246, 5.70934286378324, 22.90109272301197, 27.501107543706894, 0.100000000000001, 175.0, 640, 981729, 1246, 63.75605270000233
1247, 5.747229753461393, 22.951220309768114, 27.55260341453372, 0.09999999999999835, 445.0, 1059, 982788, 1247, 98.34206249999988
1248, 6.22149439025489, 22.986954146532423, 27.581404748314444, 0.10000000000000027, 220.0, 719, 983507, 1248, 64.76152189999993
1249, 5.508187758571961, 22.963027106024402, 27.563750100383295, 0.09999999999999802, 465.0, 1156, 984663, 1249, 108.96970370000054
1250, 6.154241217520293, 23.0856388122078, 27.705992646104708, 0.1000000000000009, 105.0, 508, 985171, 1250, 46.713693099998636
1251, 5.478221081477359, 22.998335508475627, 27.592609774797484, 0.10000000000000091, 50.0, 532, 985703, 1251, 52.20928389999608
1252, 6.578494222185511, 23.003140500780038, 27.596027009261935, 0.0999999999999978, 385.0, 1228, 986931, 1252, 132.351416599995
1253, 6.060273565687575, 23.020780423024036, 27.64032448662652, 0.10000000000000074, 165.0, 666, 987597, 1253, 62.10362999999779
1254, 5.775176012917504, 22.9948635842516, 27.577285119288945, 0.10000000000000073, 100.0, 386, 987983, 1254, 35.05505460000131
1255, 5.40866895759885, 22.943164599953175, 27.54982435255621, 0.10000000000000027, 95.0, 719, 988702, 1255, 65.44187979999697
1256, 6.304016731861161, 22.926801641200615, 27.529690227663615, 0.0999999999999978, 720.0, 1230, 989932, 1256, 108.76764209999237
1257, 6.64738868794145, 22.774877666721682, 27.32675481830123, 0.10000000000000064, 215.0, 676, 990608, 1257, 60.73136779999186
1258, 5.49079395375634, 22.734993727152585, 27.254866290638464, 0.10000000000000091, 125.0, 524, 991132, 1258, 49.54435559999547
1259, 5.953956932928453, 22.793809301165336, 27.33733545208184, 0.09999999999999895, 210.0, 922, 992054, 1259, 84.49198799999431
1260, 6.182363059747656, 22.78803187991501, 27.336205893700274, 0.09999999999999921, 295.0, 872, 992926, 1260, 76.6997801999969
1261, 6.165635094588793, 22.802380266273335, 27.36879653643485, 0.09999999999999969, 210.0, 797, 993723, 1261, 69.9472711999988
1262, 5.729151484831958, 22.74998537587448, 27.317986481626267, 0.10000000000000095, 110.0, 568, 994291, 1262, 52.56658030000108
1263, 6.229539051015153, 22.781059712539484, 27.322699308621804, 0.09999999999999838, 200.0, 1053, 995344, 1263, 98.74238480000349
1264, 5.400931166097166, 22.754224396402925, 27.295072998203107, 0.09999999999999797, 365.0, 1172, 996516, 1264, 110.04467940000177
1265, 5.226201732723699, 22.749895102440277, 27.293001547576374, 0.09999999999999926, 195.0, 865, 997381, 1265, 81.49424650000583
1266, 6.055358318638462, 22.775566703712016, 27.319794364073452, 0.10000000000000099, 120.0, 633, 998014, 1266, 59.93903900000441
1267, 6.2552137441988345, 22.780115915934246, 27.34177829036006, 0.10000000000000066, 115.0, 675, 998689, 1267, 63.740636599992285
1268, 5.747949897467746, 22.76077702417539, 27.308846776885105, 0.10000000000000049, 220.0, 692, 999381, 1268, 65.31324269999459
1269, 6.0503721052869, 22.758068179846404, 27.29027133570645, 0.10000000000000074, 95.0, 401, 999782, 1269, 37.89064059998782
